seriesid,date,statefips,countyfips,state,county,labforce,employed,unemployed,urate
CN0100100000000,2022-04-01,01,001,AL,Autauga County,26615,26152,463,1.7
CN0100300000000,2022-04-01,01,003,AL,Baldwin County,102295,100416,1879,1.8
CN0100500000000,2022-04-01,01,005,AL,Barbour County,8280,8032,248,3
CN0100700000000,2022-04-01,01,007,AL,Bibb County,8692,8529,163,1.9
CN0100900000000,2022-04-01,01,009,AL,Blount County,25625,25181,444,1.7
CN0101100000000,2022-04-01,01,011,AL,Bullock County,4405,4306,99,2.2
CN0101300000000,2022-04-01,01,013,AL,Butler County,8653,8411,242,2.8
CN0101500000000,2022-04-01,01,015,AL,Calhoun County,46214,45057,1157,2.5
CN0101700000000,2022-04-01,01,017,AL,Chambers County,15893,15582,311,2
CN0101900000000,2022-04-01,01,019,AL,Cherokee County,11702,11494,208,1.8
CN0102100000000,2022-04-01,01,021,AL,Chilton County,20110,19742,368,1.8
CN0102300000000,2022-04-01,01,023,AL,Choctaw County,4329,4196,133,3.1
CN0102500000000,2022-04-01,01,025,AL,Clarke County,7653,7374,279,3.6
CN0102700000000,2022-04-01,01,027,AL,Clay County,6060,5955,105,1.7
CN0102900000000,2022-04-01,01,029,AL,Cleburne County,6059,5946,113,1.9
CN0103100000000,2022-04-01,01,031,AL,Coffee County,21498,21085,413,1.9
CN0103300000000,2022-04-01,01,033,AL,Colbert County,23827,23268,559,2.3
CN0103500000000,2022-04-01,01,035,AL,Conecuh County,4212,4096,116,2.8
CN0103700000000,2022-04-01,01,037,AL,Coosa County,4413,4329,84,1.9
CN0103900000000,2022-04-01,01,039,AL,Covington County,15063,14764,299,2
CN0104100000000,2022-04-01,01,041,AL,Crenshaw County,5820,5701,119,2
CN0104300000000,2022-04-01,01,043,AL,Cullman County,39738,39095,643,1.6
CN0104500000000,2022-04-01,01,045,AL,Dale County,20977,20548,429,2
CN0104700000000,2022-04-01,01,047,AL,Dallas County,13658,13119,539,3.9
CN0104900000000,2022-04-01,01,049,AL,DeKalb County,30860,30291,569,1.8
CN0105100000000,2022-04-01,01,051,AL,Elmore County,38064,37437,627,1.6
CN0105300000000,2022-04-01,01,053,AL,Escambia County,14092,13766,326,2.3
CN0105500000000,2022-04-01,01,055,AL,Etowah County,39386,38420,966,2.5
CN0105700000000,2022-04-01,01,057,AL,Fayette County,6727,6575,152,2.3
CN0105900000000,2022-04-01,01,059,AL,Franklin County,14515,14264,251,1.7
CN0106100000000,2022-04-01,01,061,AL,Geneva County,11012,10806,206,1.9
CN0106300000000,2022-04-01,01,063,AL,Greene County,2741,2646,95,3.5
CN0106500000000,2022-04-01,01,065,AL,Hale County,5762,5584,178,3.1
CN0106700000000,2022-04-01,01,067,AL,Henry County,6970,6820,150,2.2
CN0106900000000,2022-04-01,01,069,AL,Houston County,47800,46833,967,2
CN0107100000000,2022-04-01,01,071,AL,Jackson County,23089,22639,450,1.9
CN0107300000000,2022-04-01,01,073,AL,Jefferson County,323563,316896,6667,2.1
CN0107500000000,2022-04-01,01,075,AL,Lamar County,5696,5576,120,2.1
CN0107700000000,2022-04-01,01,077,AL,Lauderdale County,42928,42055,873,2
CN0107900000000,2022-04-01,01,079,AL,Lawrence County,14604,14318,286,2
CN0108100000000,2022-04-01,01,081,AL,Lee County,79161,77759,1402,1.8
CN0108300000000,2022-04-01,01,083,AL,Limestone County,48165,47387,778,1.6
CN0108500000000,2022-04-01,01,085,AL,Lowndes County,3429,3295,134,3.9
CN0108700000000,2022-04-01,01,087,AL,Macon County,7847,7606,241,3.1
CN0108900000000,2022-04-01,01,089,AL,Madison County,199124,195886,3238,1.6
CN0109100000000,2022-04-01,01,091,AL,Marengo County,7557,7362,195,2.6
CN0109300000000,2022-04-01,01,093,AL,Marion County,13931,13680,251,1.8
CN0109500000000,2022-04-01,01,095,AL,Marshall County,45346,44635,711,1.6
CN0109700000000,2022-04-01,01,097,AL,Mobile County,191248,186266,4982,2.6
CN0109900000000,2022-04-01,01,099,AL,Monroe County,7388,7150,238,3.2
CN0110100000000,2022-04-01,01,101,AL,Montgomery County,106669,104060,2609,2.4
CN0110300000000,2022-04-01,01,103,AL,Morgan County,60592,59593,999,1.6
CN0110500000000,2022-04-01,01,105,AL,Perry County,2987,2870,117,3.9
CN0110700000000,2022-04-01,01,107,AL,Pickens County,7553,7363,190,2.5
CN0110900000000,2022-04-01,01,109,AL,Pike County,16031,15697,334,2.1
CN0111100000000,2022-04-01,01,111,AL,Randolph County,9616,9438,178,1.9
CN0111300000000,2022-04-01,01,113,AL,Russell County,23559,23088,471,2
CN0111500000000,2022-04-01,01,115,AL,St. Clair County,42187,41466,721,1.7
CN0111700000000,2022-04-01,01,117,AL,Shelby County,121545,119838,1707,1.4
CN0111900000000,2022-04-01,01,119,AL,Sumter County,4538,4421,117,2.6
CN0112100000000,2022-04-01,01,121,AL,Talladega County,35980,35083,897,2.5
CN0112300000000,2022-04-01,01,123,AL,Tallapoosa County,17737,17332,405,2.3
CN0112500000000,2022-04-01,01,125,AL,Tuscaloosa County,103290,101271,2019,2
CN0112700000000,2022-04-01,01,127,AL,Walker County,25504,24954,550,2.2
CN0112900000000,2022-04-01,01,129,AL,Washington County,6474,6281,193,3
CN0113100000000,2022-04-01,01,131,AL,Wilcox County,2449,2297,152,6.2
CN0113300000000,2022-04-01,01,133,AL,Winston County,10221,10031,190,1.9
CN0201300000000,2022-04-01,02,013,AK,Aleutians East Borough,2334,2297,37,1.6
CN0201600000000,2022-04-01,02,016,AK,Aleutians West Census Area,3497,3397,100,2.9
CN0202000000000,2022-04-01,02,020,AK,Anchorage Borough/municipality,149945,144618,5327,3.6
CN0205000000000,2022-04-01,02,050,AK,Bethel Census Area,6492,5863,629,9.7
CN0206000000000,2022-04-01,02,060,AK,Bristol Bay Borough,387,372,15,3.9
CN0206300000000,2022-04-01,02,063,AK,Chugach Census Area,3180,3084,96,3
CN0206600000000,2022-04-01,02,066,AK,Copper River Census Area,1331,1198,133,10
CN0206800000000,2022-04-01,02,068,AK,Denali Borough,725,661,64,8.8
CN0207000000000,2022-04-01,02,070,AK,Dillingham Census Area,1593,1500,93,5.8
CN0209000000000,2022-04-01,02,090,AK,Fairbanks North Star Borough,44941,43172,1769,3.9
CN0210000000000,2022-04-01,02,100,AK,Haines Borough,988,923,65,6.6
CN0210500000000,2022-04-01,02,105,AK,Hoonah-Angoon Census Area,1199,1133,66,5.5
CN0211000000000,2022-04-01,02,110,AK,Juneau Borough/city,17230,16750,480,2.8
CN0212200000000,2022-04-01,02,122,AK,Kenai Peninsula Borough,27332,26030,1302,4.8
CN0213000000000,2022-04-01,02,130,AK,Ketchikan Gateway Borough,6427,6158,269,4.2
CN0215000000000,2022-04-01,02,150,AK,Kodiak Island Borough,5755,5535,220,3.8
CN0215800000000,2022-04-01,02,158,AK,Kusilvak Census Area,2293,1996,297,13
CN0216400000000,2022-04-01,02,164,AK,Lake and Peninsula Borough,568,530,38,6.7
CN0217000000000,2022-04-01,02,170,AK,Matanuska-Susitna Borough,49512,47095,2417,4.9
CN0218000000000,2022-04-01,02,180,AK,Nome Census Area,4172,3852,320,7.7
CN0218500000000,2022-04-01,02,185,AK,North Slope Borough,2967,2816,151,5.1
CN0218800000000,2022-04-01,02,188,AK,Northwest Arctic Borough,2729,2465,264,9.7
CN0219500000000,2022-04-01,02,195,AK,Petersburg Borough,1377,1285,92,6.7
CN0219800000000,2022-04-01,02,198,AK,Prince of Wales-Hyder Census Area,2679,2531,148,5.5
CN0222000000000,2022-04-01,02,220,AK,Sitka Borough/city,4397,4277,120,2.7
CN0223000000000,2022-04-01,02,230,AK,Skagway Municipality,681,639,42,6.2
CN0224000000000,2022-04-01,02,240,AK,Southeast Fairbanks Census Area,3232,3042,190,5.9
CN0227500000000,2022-04-01,02,275,AK,Wrangell Borough/city,862,817,45,5.2
CN0228200000000,2022-04-01,02,282,AK,Yakutat Borough/city,302,288,14,4.6
CN0229000000000,2022-04-01,02,290,AK,Yukon-Koyukuk Census Area,2408,2187,221,9.2
CN0400100000000,2022-04-01,04,001,AZ,Apache County,18058,16782,1276,7.1
CN0400300000000,2022-04-01,04,003,AZ,Cochise County,48553,46574,1979,4.1
CN0400500000000,2022-04-01,04,005,AZ,Coconino County,73426,70524,2902,4
CN0400700000000,2022-04-01,04,007,AZ,Gila County,20128,19332,796,4
CN0400900000000,2022-04-01,04,009,AZ,Graham County,16123,15603,520,3.2
CN0401100000000,2022-04-01,04,011,AZ,Greenlee County,4616,4484,132,2.9
CN0401200000000,2022-04-01,04,012,AZ,La Paz County,8300,7898,402,4.8
CN0401300000000,2022-04-01,04,013,AZ,Maricopa County,2365837,2292226,73611,3.1
CN0401500000000,2022-04-01,04,015,AZ,Mohave County,88927,85084,3843,4.3
CN0401700000000,2022-04-01,04,017,AZ,Navajo County,38695,36855,1840,4.8
CN0401900000000,2022-04-01,04,019,AZ,Pima County,487748,470446,17302,3.5
CN0402100000000,2022-04-01,04,021,AZ,Pinal County,196169,189131,7038,3.6
CN0402300000000,2022-04-01,04,023,AZ,Santa Cruz County,18766,17651,1115,5.9
CN0402500000000,2022-04-01,04,025,AZ,Yavapai County,106750,103292,3458,3.2
CN0402700000000,2022-04-01,04,027,AZ,Yuma County,93299,82837,10462,11.2
CN0500100000000,2022-04-01,05,001,AR,Arkansas County,9150,8855,295,3.2
CN0500300000000,2022-04-01,05,003,AR,Ashley County,6750,6441,309,4.6
CN0500500000000,2022-04-01,05,005,AR,Baxter County,16614,16108,506,3
CN0500700000000,2022-04-01,05,007,AR,Benton County,150383,147202,3181,2.1
CN0500900000000,2022-04-01,05,009,AR,Boone County,15977,15597,380,2.4
CN0501100000000,2022-04-01,05,011,AR,Bradley County,4179,4005,174,4.2
CN0501300000000,2022-04-01,05,013,AR,Calhoun County,2394,2330,64,2.7
CN0501500000000,2022-04-01,05,015,AR,Carroll County,12577,12257,320,2.5
CN0501700000000,2022-04-01,05,017,AR,Chicot County,3058,2874,184,6
CN0501900000000,2022-04-01,05,019,AR,Clark County,8620,8310,310,3.6
CN0502100000000,2022-04-01,05,021,AR,Clay County,5574,5385,189,3.4
CN0502300000000,2022-04-01,05,023,AR,Cleburne County,8960,8620,340,3.8
CN0502500000000,2022-04-01,05,025,AR,Cleveland County,3111,3000,111,3.6
CN0502700000000,2022-04-01,05,027,AR,Columbia County,8948,8610,338,3.8
CN0502900000000,2022-04-01,05,029,AR,Conway County,8443,8168,275,3.3
CN0503100000000,2022-04-01,05,031,AR,Craighead County,57353,55978,1375,2.4
CN0503300000000,2022-04-01,05,033,AR,Crawford County,26296,25524,772,2.9
CN0503500000000,2022-04-01,05,035,AR,Crittenden County,20532,19855,677,3.3
CN0503700000000,2022-04-01,05,037,AR,Cross County,7105,6888,217,3.1
CN0503900000000,2022-04-01,05,039,AR,Dallas County,2727,2633,94,3.4
CN0504100000000,2022-04-01,05,041,AR,Desha County,5048,4809,239,4.7
CN0504300000000,2022-04-01,05,043,AR,Drew County,7400,7110,290,3.9
CN0504500000000,2022-04-01,05,045,AR,Faulkner County,62992,61354,1638,2.6
CN0504700000000,2022-04-01,05,047,AR,Franklin County,7478,7252,226,3
CN0504900000000,2022-04-01,05,049,AR,Fulton County,5014,4872,142,2.8
CN0505100000000,2022-04-01,05,051,AR,Garland County,42400,40987,1413,3.3
CN0505300000000,2022-04-01,05,053,AR,Grant County,8469,8237,232,2.7
CN0505500000000,2022-04-01,05,055,AR,Greene County,19752,19214,538,2.7
CN0505700000000,2022-04-01,05,057,AR,Hempstead County,9375,9116,259,2.8
CN0505900000000,2022-04-01,05,059,AR,Hot Spring County,13840,13427,413,3
CN0506100000000,2022-04-01,05,061,AR,Howard County,5504,5357,147,2.7
CN0506300000000,2022-04-01,05,063,AR,Independence County,16574,16092,482,2.9
CN0506500000000,2022-04-01,05,065,AR,Izard County,4536,4339,197,4.3
CN0506700000000,2022-04-01,05,067,AR,Jackson County,5568,5337,231,4.1
CN0506900000000,2022-04-01,05,069,AR,Jefferson County,25582,24339,1243,4.9
CN0507100000000,2022-04-01,05,071,AR,Johnson County,10193,9846,347,3.4
CN0507300000000,2022-04-01,05,073,AR,Lafayette County,2388,2297,91,3.8
CN0507500000000,2022-04-01,05,075,AR,Lawrence County,6981,6765,216,3.1
CN0507700000000,2022-04-01,05,077,AR,Lee County,2630,2531,99,3.8
CN0507900000000,2022-04-01,05,079,AR,Lincoln County,3734,3582,152,4.1
CN0508100000000,2022-04-01,05,081,AR,Little River County,5208,5019,189,3.6
CN0508300000000,2022-04-01,05,083,AR,Logan County,8371,8086,285,3.4
CN0508500000000,2022-04-01,05,085,AR,Lonoke County,34291,33439,852,2.5
CN0508700000000,2022-04-01,05,087,AR,Madison County,7822,7650,172,2.2
CN0508900000000,2022-04-01,05,089,AR,Marion County,6326,6124,202,3.2
CN0509100000000,2022-04-01,05,091,AR,Miller County,18748,18085,663,3.5
CN0509300000000,2022-04-01,05,093,AR,Mississippi County,16269,15546,723,4.4
CN0509500000000,2022-04-01,05,095,AR,Monroe County,2567,2466,101,3.9
CN0509700000000,2022-04-01,05,097,AR,Montgomery County,2950,2829,121,4.1
CN0509900000000,2022-04-01,05,099,AR,Nevada County,3437,3318,119,3.5
CN0510100000000,2022-04-01,05,101,AR,Newton County,3239,3155,84,2.6
CN0510300000000,2022-04-01,05,103,AR,Ouachita County,9685,9334,351,3.6
CN0510500000000,2022-04-01,05,105,AR,Perry County,4232,4092,140,3.3
CN0510700000000,2022-04-01,05,107,AR,Phillips County,5745,5451,294,5.1
CN0510900000000,2022-04-01,05,109,AR,Pike County,4197,4052,145,3.5
CN0511100000000,2022-04-01,05,111,AR,Poinsett County,10012,9713,299,3
CN0511300000000,2022-04-01,05,113,AR,Polk County,7925,7668,257,3.2
CN0511500000000,2022-04-01,05,115,AR,Pope County,27612,26751,861,3.1
CN0511700000000,2022-04-01,05,117,AR,Prairie County,3554,3465,89,2.5
CN0511900000000,2022-04-01,05,119,AR,Pulaski County,189034,183035,5999,3.2
CN0512100000000,2022-04-01,05,121,AR,Randolph County,7314,7104,210,2.9
CN0512300000000,2022-04-01,05,123,AR,St. Francis County,7722,7405,317,4.1
CN0512500000000,2022-04-01,05,125,AR,Saline County,59844,58381,1463,2.4
CN0512700000000,2022-04-01,05,127,AR,Scott County,4229,4125,104,2.5
CN0512900000000,2022-04-01,05,129,AR,Searcy County,2885,2781,104,3.6
CN0513100000000,2022-04-01,05,131,AR,Sebastian County,55157,53611,1546,2.8
CN0513300000000,2022-04-01,05,133,AR,Sevier County,5413,5219,194,3.6
CN0513500000000,2022-04-01,05,135,AR,Sharp County,5841,5634,207,3.5
CN0513700000000,2022-04-01,05,137,AR,Stone County,4658,4498,160,3.4
CN0513900000000,2022-04-01,05,139,AR,Union County,14838,14210,628,4.2
CN0514100000000,2022-04-01,05,141,AR,Van Buren County,5933,5723,210,3.5
CN0514300000000,2022-04-01,05,143,AR,Washington County,132946,130147,2799,2.1
CN0514500000000,2022-04-01,05,145,AR,White County,34461,33362,1099,3.2
CN0514700000000,2022-04-01,05,147,AR,Woodruff County,2843,2756,87,3.1
CN0514900000000,2022-04-01,05,149,AR,Yell County,8001,7739,262,3.3
CN0600100000000,2022-04-01,06,001,CA,Alameda County,816117,791361,24756,3
CN0600300000000,2022-04-01,06,003,CA,Alpine County,563,538,25,4.4
CN0600500000000,2022-04-01,06,005,CA,Amador County,14210,13627,583,4.1
CN0600700000000,2022-04-01,06,007,CA,Butte County,91795,88013,3782,4.1
CN0600900000000,2022-04-01,06,009,CA,Calaveras County,22108,21362,746,3.4
CN0601100000000,2022-04-01,06,011,CA,Colusa County,9945,8702,1243,12.5
CN0601300000000,2022-04-01,06,013,CA,Contra Costa County,544812,527091,17721,3.3
CN0601500000000,2022-04-01,06,015,CA,Del Norte County,9189,8734,455,5
CN0601700000000,2022-04-01,06,017,CA,El Dorado County,92439,89544,2895,3.1
CN0601900000000,2022-04-01,06,019,CA,Fresno County,448993,420105,28888,6.4
CN0602100000000,2022-04-01,06,021,CA,Glenn County,12733,12093,640,5
CN0602300000000,2022-04-01,06,023,CA,Humboldt County,59228,57015,2213,3.7
CN0602500000000,2022-04-01,06,025,CA,Imperial County,66462,58629,7833,11.8
CN0602700000000,2022-04-01,06,027,CA,Inyo County,8063,7771,292,3.6
CN0602900000000,2022-04-01,06,029,CA,Kern County,386358,359399,26959,7
CN0603100000000,2022-04-01,06,031,CA,Kings County,55653,51735,3918,7
CN0603300000000,2022-04-01,06,033,CA,Lake County,28291,26979,1312,4.6
CN0603500000000,2022-04-01,06,035,CA,Lassen County,8684,8324,360,4.1
CN0603700000000,2022-04-01,06,037,CA,Los Angeles County,5000847,4761695,239152,4.8
CN0603900000000,2022-04-01,06,039,CA,Madera County,62277,58488,3789,6.1
CN0604100000000,2022-04-01,06,041,CA,Marin County,130177,127018,3159,2.4
CN0604300000000,2022-04-01,06,043,CA,Mariposa County,7021,6714,307,4.4
CN0604500000000,2022-04-01,06,045,CA,Mendocino County,36674,35209,1465,4
CN0604700000000,2022-04-01,06,047,CA,Merced County,113794,104664,9130,8
CN0604900000000,2022-04-01,06,049,CA,Modoc County,3175,3004,171,5.4
CN0605100000000,2022-04-01,06,051,CA,Mono County,9058,8788,270,3
CN0605300000000,2022-04-01,06,053,CA,Monterey County,221051,207194,13857,6.3
CN0605500000000,2022-04-01,06,055,CA,Napa County,70309,68227,2082,3
CN0605700000000,2022-04-01,06,057,CA,Nevada County,47516,45968,1548,3.3
CN0605900000000,2022-04-01,06,059,CA,Orange County,1575310,1529447,45863,2.9
CN0606100000000,2022-04-01,06,061,CA,Placer County,191938,186600,5338,2.8
CN0606300000000,2022-04-01,06,063,CA,Plumas County,7192,6703,489,6.8
CN0606500000000,2022-04-01,06,065,CA,Riverside County,1140903,1098473,42430,3.7
CN0606700000000,2022-04-01,06,067,CA,Sacramento County,721213,695326,25887,3.6
CN0606900000000,2022-04-01,06,069,CA,San Benito County,32085,30456,1629,5.1
CN0607100000000,2022-04-01,06,071,CA,San Bernardino County,999914,962670,37244,3.7
CN0607300000000,2022-04-01,06,073,CA,San Diego County,1573804,1524112,49692,3.2
CN0607500000000,2022-04-01,06,075,CA,San Francisco County/city,564833,551536,13297,2.4
CN0607700000000,2022-04-01,06,077,CA,San Joaquin County,340274,323345,16929,5
CN0607900000000,2022-04-01,06,079,CA,San Luis Obispo County,137029,133279,3750,2.7
CN0608100000000,2022-04-01,06,081,CA,San Mateo County,447158,437145,10013,2.2
CN0608300000000,2022-04-01,06,083,CA,Santa Barbara County,224599,217460,7139,3.2
CN0608500000000,2022-04-01,06,085,CA,Santa Clara County,1023985,998818,25167,2.5
CN0608700000000,2022-04-01,06,087,CA,Santa Cruz County,132925,126154,6771,5.1
CN0608900000000,2022-04-01,06,089,CA,Shasta County,72053,68901,3152,4.4
CN0609100000000,2022-04-01,06,091,CA,Sierra County,1263,1204,59,4.7
CN0609300000000,2022-04-01,06,093,CA,Siskiyou County,16215,15294,921,5.7
CN0609500000000,2022-04-01,06,095,CA,Solano County,200053,192109,7944,4
CN0609700000000,2022-04-01,06,097,CA,Sonoma County,245769,238632,7137,2.9
CN0609900000000,2022-04-01,06,099,CA,Stanislaus County,238932,226246,12686,5.3
CN0610100000000,2022-04-01,06,101,CA,Sutter County,45903,42796,3107,6.8
CN0610300000000,2022-04-01,06,103,CA,Tehama County,25292,24141,1151,4.6
CN0610500000000,2022-04-01,06,105,CA,Trinity County,4454,4262,192,4.3
CN0610700000000,2022-04-01,06,107,CA,Tulare County,208117,192082,16035,7.7
CN0610900000000,2022-04-01,06,109,CA,Tuolumne County,19628,18801,827,4.2
CN0611100000000,2022-04-01,06,111,CA,Ventura County,412061,398623,13438,3.3
CN0611300000000,2022-04-01,06,113,CA,Yolo County,108264,104155,4109,3.8
CN0611500000000,2022-04-01,06,115,CA,Yuba County,31139,29531,1608,5.2
CN0800100000000,2022-04-01,08,001,CO,Adams County,280890,271670,9220,3.3
CN0800300000000,2022-04-01,08,003,CO,Alamosa County,8040,7755,285,3.5
CN0800500000000,2022-04-01,08,005,CO,Arapahoe County,374386,363070,11316,3
CN0800700000000,2022-04-01,08,007,CO,Archuleta County,6721,6502,219,3.3
CN0800900000000,2022-04-01,08,009,CO,Baca County,1952,1917,35,1.8
CN0801100000000,2022-04-01,08,011,CO,Bent County,1658,1594,64,3.9
CN0801300000000,2022-04-01,08,013,CO,Boulder County,201103,196232,4871,2.4
CN0801400000000,2022-04-01,08,014,CO,Broomfield County/city,42353,41303,1050,2.5
CN0801500000000,2022-04-01,08,015,CO,Chaffee County,9533,9284,249,2.6
CN0801700000000,2022-04-01,08,017,CO,Cheyenne County,984,965,19,1.9
CN0801900000000,2022-04-01,08,019,CO,Clear Creek County,6135,5961,174,2.8
CN0802100000000,2022-04-01,08,021,CO,Conejos County,3850,3727,123,3.2
CN0802300000000,2022-04-01,08,023,CO,Costilla County,1693,1621,72,4.3
CN0802500000000,2022-04-01,08,025,CO,Crowley County,1349,1296,53,3.9
CN0802700000000,2022-04-01,08,027,CO,Custer County,2200,2135,65,3
CN0802900000000,2022-04-01,08,029,CO,Delta County,12974,12516,458,3.5
CN0803100000000,2022-04-01,08,031,CO,Denver County/city,435127,422032,13095,3
CN0803300000000,2022-04-01,08,033,CO,Dolores County,1105,1070,35,3.2
CN0803500000000,2022-04-01,08,035,CO,Douglas County,207067,202112,4955,2.4
CN0803700000000,2022-04-01,08,037,CO,Eagle County,35326,34432,894,2.5
CN0803900000000,2022-04-01,08,039,CO,Elbert County,15804,15428,376,2.4
CN0804100000000,2022-04-01,08,041,CO,El Paso County,356973,345834,11139,3.1
CN0804300000000,2022-04-01,08,043,CO,Fremont County,14263,13609,654,4.6
CN0804500000000,2022-04-01,08,045,CO,Garfield County,30247,29359,888,2.9
CN0804700000000,2022-04-01,08,047,CO,Gilpin County,3927,3815,112,2.9
CN0804900000000,2022-04-01,08,049,CO,Grand County,9020,8775,245,2.7
CN0805100000000,2022-04-01,08,051,CO,Gunnison County,11179,10886,293,2.6
CN0805300000000,2022-04-01,08,053,CO,Hinsdale County,390,380,10,2.6
CN0805500000000,2022-04-01,08,055,CO,Huerfano County,2358,2220,138,5.9
CN0805700000000,2022-04-01,08,057,CO,Jackson County,888,870,18,2
CN0805900000000,2022-04-01,08,059,CO,Jefferson County,342005,332781,9224,2.7
CN0806100000000,2022-04-01,08,061,CO,Kiowa County,829,815,14,1.7
CN0806300000000,2022-04-01,08,063,CO,Kit Carson County,3857,3780,77,2
CN0806500000000,2022-04-01,08,065,CO,Lake County,4903,4777,126,2.6
CN0806700000000,2022-04-01,08,067,CO,La Plata County,30423,29536,887,2.9
CN0806900000000,2022-04-01,08,069,CO,Larimer County,209149,203587,5562,2.7
CN0807100000000,2022-04-01,08,071,CO,Las Animas County,6049,5787,262,4.3
CN0807300000000,2022-04-01,08,073,CO,Lincoln County,2133,2078,55,2.6
CN0807500000000,2022-04-01,08,075,CO,Logan County,10009,9739,270,2.7
CN0807700000000,2022-04-01,08,077,CO,Mesa County,76710,74241,2469,3.2
CN0807900000000,2022-04-01,08,079,CO,Mineral County,417,406,11,2.6
CN0808100000000,2022-04-01,08,081,CO,Moffat County,6684,6464,220,3.3
CN0808300000000,2022-04-01,08,083,CO,Montezuma County,12099,11652,447,3.7
CN0808500000000,2022-04-01,08,085,CO,Montrose County,20821,20079,742,3.6
CN0808700000000,2022-04-01,08,087,CO,Morgan County,14995,14486,509,3.4
CN0808900000000,2022-04-01,08,089,CO,Otero County,7625,7318,307,4
CN0809100000000,2022-04-01,08,091,CO,Ouray County,2355,2272,83,3.5
CN0809300000000,2022-04-01,08,093,CO,Park County,11558,11265,293,2.5
CN0809500000000,2022-04-01,08,095,CO,Phillips County,2213,2167,46,2.1
CN0809700000000,2022-04-01,08,097,CO,Pitkin County,10395,10062,333,3.2
CN0809900000000,2022-04-01,08,099,CO,Prowers County,5890,5720,170,2.9
CN0810100000000,2022-04-01,08,101,CO,Pueblo County,76271,72967,3304,4.3
CN0810300000000,2022-04-01,08,103,CO,Rio Blanco County,2750,2645,105,3.8
CN0810500000000,2022-04-01,08,105,CO,Rio Grande County,5022,4812,210,4.2
CN0810700000000,2022-04-01,08,107,CO,Routt County,14984,14572,412,2.7
CN0810900000000,2022-04-01,08,109,CO,Saguache County,3201,3089,112,3.5
CN0811100000000,2022-04-01,08,111,CO,San Juan County,488,473,15,3.1
CN0811300000000,2022-04-01,08,113,CO,San Miguel County,4761,4488,273,5.7
CN0811500000000,2022-04-01,08,115,CO,Sedgwick County,992,966,26,2.6
CN0811700000000,2022-04-01,08,117,CO,Summit County,22151,21685,466,2.1
CN0811900000000,2022-04-01,08,119,CO,Teller County,13368,12972,396,3
CN0812100000000,2022-04-01,08,121,CO,Washington County,2596,2530,66,2.5
CN0812300000000,2022-04-01,08,123,CO,Weld County,166993,161687,5306,3.2
CN0812500000000,2022-04-01,08,125,CO,Yuma County,5160,5053,107,2.1
CN0900100000000,2022-04-01,09,001,CT,Fairfield County,484274,465096,19178,4
CN0900300000000,2022-04-01,09,003,CT,Hartford County,482493,461315,21178,4.4
CN0900500000000,2022-04-01,09,005,CT,Litchfield County,105338,101403,3935,3.7
CN0900700000000,2022-04-01,09,007,CT,Middlesex County,94561,91347,3214,3.4
CN0900900000000,2022-04-01,09,009,CT,New Haven County,471034,451622,19412,4.1
CN0901100000000,2022-04-01,09,011,CT,New London County,133852,128478,5374,4
CN0901300000000,2022-04-01,09,013,CT,Tolland County,86664,83784,2880,3.3
CN0901500000000,2022-04-01,09,015,CT,Windham County,64176,61643,2533,3.9
CN1000100000000,2022-04-01,10,001,DE,Kent County,81104,77257,3847,4.7
CN1000300000000,2022-04-01,10,003,DE,New Castle County,305635,293417,12218,4
CN1000500000000,2022-04-01,10,005,DE,Sussex County,110686,106039,4647,4.2
CN1100100000000,2022-04-01,11,001,DC,District of Columbia,386488,370349,16139,4.2
CN1200100000000,2022-04-01,12,001,FL,Alachua County,141919,138315,3604,2.5
CN1200300000000,2022-04-01,12,003,FL,Baker County,12460,12149,311,2.5
CN1200500000000,2022-04-01,12,005,FL,Bay County,87017,84936,2081,2.4
CN1200700000000,2022-04-01,12,007,FL,Bradford County,10937,10615,322,2.9
CN1200900000000,2022-04-01,12,009,FL,Brevard County,292727,285085,7642,2.6
CN1201100000000,2022-04-01,12,011,FL,Broward County,1055128,1026365,28763,2.7
CN1201300000000,2022-04-01,12,013,FL,Calhoun County,4817,4675,142,2.9
CN1201500000000,2022-04-01,12,015,FL,Charlotte County,76320,74158,2162,2.8
CN1201700000000,2022-04-01,12,017,FL,Citrus County,49045,47270,1775,3.6
CN1201900000000,2022-04-01,12,019,FL,Clay County,111444,108773,2671,2.4
CN1202100000000,2022-04-01,12,021,FL,Collier County,190619,186301,4318,2.3
CN1202300000000,2022-04-01,12,023,FL,Columbia County,29546,28668,878,3
CN1202700000000,2022-04-01,12,027,FL,DeSoto County,13829,13439,390,2.8
CN1202900000000,2022-04-01,12,029,FL,Dixie County,5842,5667,175,3
CN1203100000000,2022-04-01,12,031,FL,Duval County,505164,490790,14374,2.8
CN1203300000000,2022-04-01,12,033,FL,Escambia County,148093,143922,4171,2.8
CN1203500000000,2022-04-01,12,035,FL,Flagler County,49799,48296,1503,3
CN1203700000000,2022-04-01,12,037,FL,Franklin County,4865,4744,121,2.5
CN1203900000000,2022-04-01,12,039,FL,Gadsden County,19060,18385,675,3.5
CN1204100000000,2022-04-01,12,041,FL,Gilchrist County,7405,7206,199,2.7
CN1204300000000,2022-04-01,12,043,FL,Glades County,5144,5004,140,2.7
CN1204500000000,2022-04-01,12,045,FL,Gulf County,5363,5240,123,2.3
CN1204700000000,2022-04-01,12,047,FL,Hamilton County,4115,3960,155,3.8
CN1204900000000,2022-04-01,12,049,FL,Hardee County,8734,8438,296,3.4
CN1205100000000,2022-04-01,12,051,FL,Hendry County,15654,15051,603,3.9
CN1205300000000,2022-04-01,12,053,FL,Hernando County,76129,73629,2500,3.3
CN1205500000000,2022-04-01,12,055,FL,Highlands County,36211,34853,1358,3.8
CN1205700000000,2022-04-01,12,057,FL,Hillsborough County,797466,776956,20510,2.6
CN1205900000000,2022-04-01,12,059,FL,Holmes County,6965,6772,193,2.8
CN1206100000000,2022-04-01,12,061,FL,Indian River County,67976,65877,2099,3.1
CN1206300000000,2022-04-01,12,063,FL,Jackson County,16633,16125,508,3.1
CN1206500000000,2022-04-01,12,065,FL,Jefferson County,5726,5560,166,2.9
CN1206700000000,2022-04-01,12,067,FL,Lafayette County,2791,2708,83,3
CN1206900000000,2022-04-01,12,069,FL,Lake County,168687,163955,4732,2.8
CN1207100000000,2022-04-01,12,071,FL,Lee County,372457,362947,9510,2.6
CN1207300000000,2022-04-01,12,073,FL,Leon County,159730,155269,4461,2.8
CN1207500000000,2022-04-01,12,075,FL,Levy County,17070,16527,543,3.2
CN1207700000000,2022-04-01,12,077,FL,Liberty County,2614,2539,75,2.9
CN1207900000000,2022-04-01,12,079,FL,Madison County,7800,7557,243,3.1
CN1208100000000,2022-04-01,12,081,FL,Manatee County,185465,180794,4671,2.5
CN1208300000000,2022-04-01,12,083,FL,Marion County,146503,141928,4575,3.1
CN1208500000000,2022-04-01,12,085,FL,Martin County,75567,73753,1814,2.4
CN1208600000000,2022-04-01,12,086,FL,Miami-Dade County,1361251,1325974,35277,2.6
CN1208700000000,2022-04-01,12,087,FL,Monroe County,49227,48408,819,1.7
CN1208900000000,2022-04-01,12,089,FL,Nassau County,44033,43032,1001,2.3
CN1209100000000,2022-04-01,12,091,FL,Okaloosa County,102719,100454,2265,2.2
CN1209300000000,2022-04-01,12,093,FL,Okeechobee County,17510,17011,499,2.8
CN1209500000000,2022-04-01,12,095,FL,Orange County,781831,760280,21551,2.8
CN1209700000000,2022-04-01,12,097,FL,Osceola County,194661,188301,6360,3.3
CN1209900000000,2022-04-01,12,099,FL,Palm Beach County,759864,739778,20086,2.6
CN1210100000000,2022-04-01,12,101,FL,Pasco County,255662,248557,7105,2.8
CN1210300000000,2022-04-01,12,103,FL,Pinellas County,505533,493391,12142,2.4
CN1210500000000,2022-04-01,12,105,FL,Polk County,335912,325138,10774,3.2
CN1210700000000,2022-04-01,12,107,FL,Putnam County,27467,26415,1052,3.8
CN1210900000000,2022-04-01,12,109,FL,St. Johns County,147114,144053,3061,2.1
CN1211100000000,2022-04-01,12,111,FL,St. Lucie County,154425,149551,4874,3.2
CN1211300000000,2022-04-01,12,113,FL,Santa Rosa County,86874,84810,2064,2.4
CN1211500000000,2022-04-01,12,115,FL,Sarasota County,194603,189704,4899,2.5
CN1211700000000,2022-04-01,12,117,FL,Seminole County,260067,253663,6404,2.5
CN1211900000000,2022-04-01,12,119,FL,Sumter County,36793,35514,1279,3.5
CN1212100000000,2022-04-01,12,121,FL,Suwannee County,17310,16797,513,3
CN1212300000000,2022-04-01,12,123,FL,Taylor County,8033,7783,250,3.1
CN1212500000000,2022-04-01,12,125,FL,Union County,4462,4353,109,2.4
CN1212700000000,2022-04-01,12,127,FL,Volusia County,262856,255276,7580,2.9
CN1212900000000,2022-04-01,12,129,FL,Wakulla County,15960,15583,377,2.4
CN1213100000000,2022-04-01,12,131,FL,Walton County,34791,34004,787,2.3
CN1213300000000,2022-04-01,12,133,FL,Washington County,9689,9395,294,3
CN1300100000000,2022-04-01,13,001,GA,Appling County,9444,9168,276,2.9
CN1300300000000,2022-04-01,13,003,GA,Atkinson County,4448,4346,102,2.3
CN1300500000000,2022-04-01,13,005,GA,Bacon County,4819,4702,117,2.4
CN1300700000000,2022-04-01,13,007,GA,Baker County,1139,1098,41,3.6
CN1300900000000,2022-04-01,13,009,GA,Baldwin County,17652,17087,565,3.2
CN1301100000000,2022-04-01,13,011,GA,Banks County,10966,10774,192,1.8
CN1301300000000,2022-04-01,13,013,GA,Barrow County,42805,41943,862,2
CN1301500000000,2022-04-01,13,015,GA,Bartow County,51975,50751,1224,2.4
CN1301700000000,2022-04-01,13,017,GA,Ben Hill County,5582,5387,195,3.5
CN1301900000000,2022-04-01,13,019,GA,Berrien County,7845,7639,206,2.6
CN1302100000000,2022-04-01,13,021,GA,Bibb County,65465,63377,2088,3.2
CN1302300000000,2022-04-01,13,023,GA,Bleckley County,4600,4448,152,3.3
CN1302500000000,2022-04-01,13,025,GA,Brantley County,7354,7149,205,2.8
CN1302700000000,2022-04-01,13,027,GA,Brooks County,6763,6601,162,2.4
CN1302900000000,2022-04-01,13,029,GA,Bryan County,20181,19766,415,2.1
CN1303100000000,2022-04-01,13,031,GA,Bulloch County,38279,37246,1033,2.7
CN1303300000000,2022-04-01,13,033,GA,Burke County,9160,8742,418,4.6
CN1303500000000,2022-04-01,13,035,GA,Butts County,11272,11010,262,2.3
CN1303700000000,2022-04-01,13,037,GA,Calhoun County,2212,2153,59,2.7
CN1303900000000,2022-04-01,13,039,GA,Camden County,21671,21135,536,2.5
CN1304300000000,2022-04-01,13,043,GA,Candler County,6173,6049,124,2
CN1304500000000,2022-04-01,13,045,GA,Carroll County,56893,55466,1427,2.5
CN1304700000000,2022-04-01,13,047,GA,Catoosa County,33080,32363,717,2.2
CN1304900000000,2022-04-01,13,049,GA,Charlton County,5098,4960,138,2.7
CN1305100000000,2022-04-01,13,051,GA,Chatham County,144589,140794,3795,2.6
CN1305300000000,2022-04-01,13,053,GA,Chattahoochee County,1899,1823,76,4
CN1305500000000,2022-04-01,13,055,GA,Chattooga County,9381,8931,450,4.8
CN1305700000000,2022-04-01,13,057,GA,Cherokee County,141874,139182,2692,1.9
CN1305900000000,2022-04-01,13,059,GA,Clarke County,57589,56089,1500,2.6
CN1306100000000,2022-04-01,13,061,GA,Clay County,859,806,53,6.2
CN1306300000000,2022-04-01,13,063,GA,Clayton County,139390,134519,4871,3.5
CN1306500000000,2022-04-01,13,065,GA,Clinch County,3097,3030,67,2.2
CN1306700000000,2022-04-01,13,067,GA,Cobb County,428985,419670,9315,2.2
CN1306900000000,2022-04-01,13,069,GA,Coffee County,18617,18043,574,3.1
CN1307100000000,2022-04-01,13,071,GA,Colquitt County,22079,21552,527,2.4
CN1307300000000,2022-04-01,13,073,GA,Columbia County,76903,75183,1720,2.2
CN1307500000000,2022-04-01,13,075,GA,Cook County,8256,8036,220,2.7
CN1307700000000,2022-04-01,13,077,GA,Coweta County,77292,75563,1729,2.2
CN1307900000000,2022-04-01,13,079,GA,Crawford County,5383,5250,133,2.5
CN1308100000000,2022-04-01,13,081,GA,Crisp County,9723,9373,350,3.6
CN1308300000000,2022-04-01,13,083,GA,Dade County,7966,7802,164,2.1
CN1308500000000,2022-04-01,13,085,GA,Dawson County,13361,13088,273,2
CN1308700000000,2022-04-01,13,087,GA,Decatur County,11929,11618,311,2.6
CN1308900000000,2022-04-01,13,089,GA,DeKalb County,402953,391848,11105,2.8
CN1309100000000,2022-04-01,13,091,GA,Dodge County,6903,6679,224,3.2
CN1309300000000,2022-04-01,13,093,GA,Dooly County,4699,4531,168,3.6
CN1309500000000,2022-04-01,13,095,GA,Dougherty County,36214,34863,1351,3.7
CN1309700000000,2022-04-01,13,097,GA,Douglas County,74641,72567,2074,2.8
CN1309900000000,2022-04-01,13,099,GA,Early County,4425,4283,142,3.2
CN1310100000000,2022-04-01,13,101,GA,Echols County,1907,1869,38,2
CN1310300000000,2022-04-01,13,103,GA,Effingham County,33767,33047,720,2.1
CN1310500000000,2022-04-01,13,105,GA,Elbert County,7864,7626,238,3
CN1310700000000,2022-04-01,13,107,GA,Emanuel County,8644,8355,289,3.3
CN1310900000000,2022-04-01,13,109,GA,Evans County,5052,4926,126,2.5
CN1311100000000,2022-04-01,13,111,GA,Fannin County,11854,11602,252,2.1
CN1311300000000,2022-04-01,13,113,GA,Fayette County,59160,57924,1236,2.1
CN1311500000000,2022-04-01,13,115,GA,Floyd County,43130,41982,1148,2.7
CN1311700000000,2022-04-01,13,117,GA,Forsyth County,129445,127050,2395,1.9
CN1311900000000,2022-04-01,13,119,GA,Franklin County,10020,9781,239,2.4
CN1312100000000,2022-04-01,13,121,GA,Fulton County,572263,556527,15736,2.7
CN1312300000000,2022-04-01,13,123,GA,Gilmer County,12424,12119,305,2.5
CN1312500000000,2022-04-01,13,125,GA,Glascock County,1272,1243,29,2.3
CN1312700000000,2022-04-01,13,127,GA,Glynn County,39248,38248,1000,2.5
CN1312900000000,2022-04-01,13,129,GA,Gordon County,28704,28022,682,2.4
CN1313100000000,2022-04-01,13,131,GA,Grady County,11102,10819,283,2.5
CN1313300000000,2022-04-01,13,133,GA,Greene County,7219,7033,186,2.6
CN1313500000000,2022-04-01,13,135,GA,Gwinnett County,498201,486952,11249,2.3
CN1313700000000,2022-04-01,13,137,GA,Habersham County,18708,18263,445,2.4
CN1313900000000,2022-04-01,13,139,GA,Hall County,106578,104527,2051,1.9
CN1314100000000,2022-04-01,13,141,GA,Hancock County,2521,2419,102,4
CN1314300000000,2022-04-01,13,143,GA,Haralson County,12933,12612,321,2.5
CN1314500000000,2022-04-01,13,145,GA,Harris County,16706,16332,374,2.2
CN1314700000000,2022-04-01,13,147,GA,Hart County,12114,11823,291,2.4
CN1314900000000,2022-04-01,13,149,GA,Heard County,5301,5169,132,2.5
CN1315100000000,2022-04-01,13,151,GA,Henry County,119926,116663,3263,2.7
CN1315300000000,2022-04-01,13,153,GA,Houston County,70653,68864,1789,2.5
CN1315500000000,2022-04-01,13,155,GA,Irwin County,3599,3487,112,3.1
CN1315700000000,2022-04-01,13,157,GA,Jackson County,46317,45544,773,1.7
CN1315900000000,2022-04-01,13,159,GA,Jasper County,7182,7021,161,2.2
CN1316100000000,2022-04-01,13,161,GA,Jeff Davis County,6201,6033,168,2.7
CN1316300000000,2022-04-01,13,163,GA,Jefferson County,6608,6384,224,3.4
CN1316500000000,2022-04-01,13,165,GA,Jenkins County,3320,3203,117,3.5
CN1316700000000,2022-04-01,13,167,GA,Johnson County,4018,3920,98,2.4
CN1316900000000,2022-04-01,13,169,GA,Jones County,13343,13029,314,2.4
CN1317100000000,2022-04-01,13,171,GA,Lamar County,8329,8102,227,2.7
CN1317300000000,2022-04-01,13,173,GA,Lanier County,3786,3684,102,2.7
CN1317500000000,2022-04-01,13,175,GA,Laurens County,19129,18515,614,3.2
CN1317700000000,2022-04-01,13,177,GA,Lee County,14979,14609,370,2.5
CN1317900000000,2022-04-01,13,179,GA,Liberty County,26119,25375,744,2.8
CN1318100000000,2022-04-01,13,181,GA,Lincoln County,3575,3470,105,2.9
CN1318300000000,2022-04-01,13,183,GA,Long County,8500,8267,233,2.7
CN1318500000000,2022-04-01,13,185,GA,Lowndes County,50581,49236,1345,2.7
CN1318700000000,2022-04-01,13,187,GA,Lumpkin County,18676,18335,341,1.8
CN1318900000000,2022-04-01,13,189,GA,McDuffie County,8502,8196,306,3.6
CN1319100000000,2022-04-01,13,191,GA,McIntosh County,6171,6013,158,2.6
CN1319300000000,2022-04-01,13,193,GA,Macon County,4591,4432,159,3.5
CN1319500000000,2022-04-01,13,195,GA,Madison County,13316,13004,312,2.3
CN1319700000000,2022-04-01,13,197,GA,Marion County,3216,3130,86,2.7
CN1319900000000,2022-04-01,13,199,GA,Meriwether County,8947,8652,295,3.3
CN1320100000000,2022-04-01,13,201,GA,Miller County,2881,2816,65,2.3
CN1320500000000,2022-04-01,13,205,GA,Mitchell County,8253,7976,277,3.4
CN1320700000000,2022-04-01,13,207,GA,Monroe County,12809,12530,279,2.2
CN1320900000000,2022-04-01,13,209,GA,Montgomery County,3827,3715,112,2.9
CN1321100000000,2022-04-01,13,211,GA,Morgan County,9680,9463,217,2.2
CN1321300000000,2022-04-01,13,213,GA,Murray County,15309,14868,441,2.9
CN1321500000000,2022-04-01,13,215,GA,Muscogee County,74756,72127,2629,3.5
CN1321700000000,2022-04-01,13,217,GA,Newton County,53942,52391,1551,2.9
CN1321900000000,2022-04-01,13,219,GA,Oconee County,19930,19571,359,1.8
CN1322100000000,2022-04-01,13,221,GA,Oglethorpe County,6907,6760,147,2.1
CN1322300000000,2022-04-01,13,223,GA,Paulding County,90882,88917,1965,2.2
CN1322500000000,2022-04-01,13,225,GA,Peach County,11860,11499,361,3
CN1322700000000,2022-04-01,13,227,GA,Pickens County,15827,15485,342,2.2
CN1322900000000,2022-04-01,13,229,GA,Pierce County,8894,8705,189,2.1
CN1323100000000,2022-04-01,13,231,GA,Pike County,9142,8954,188,2.1
CN1323300000000,2022-04-01,13,233,GA,Polk County,18417,17976,441,2.4
CN1323500000000,2022-04-01,13,235,GA,Pulaski County,4013,3907,106,2.6
CN1323700000000,2022-04-01,13,237,GA,Putnam County,8790,8532,258,2.9
CN1323900000000,2022-04-01,13,239,GA,Quitman County,746,722,24,3.2
CN1324100000000,2022-04-01,13,241,GA,Rabun County,7767,7590,177,2.3
CN1324300000000,2022-04-01,13,243,GA,Randolph County,2389,2297,92,3.9
CN1324500000000,2022-04-01,13,245,GA,Richmond County,83658,80729,2929,3.5
CN1324700000000,2022-04-01,13,247,GA,Rockdale County,44983,43612,1371,3
CN1324900000000,2022-04-01,13,249,GA,Schley County,2135,2067,68,3.2
CN1325100000000,2022-04-01,13,251,GA,Screven County,5023,4853,170,3.4
CN1325300000000,2022-04-01,13,253,GA,Seminole County,3107,3018,89,2.9
CN1325500000000,2022-04-01,13,255,GA,Spalding County,29131,28342,789,2.7
CN1325700000000,2022-04-01,13,257,GA,Stephens County,10715,10429,286,2.7
CN1325900000000,2022-04-01,13,259,GA,Stewart County,2587,2507,80,3.1
CN1326100000000,2022-04-01,13,261,GA,Sumter County,12121,11707,414,3.4
CN1326300000000,2022-04-01,13,263,GA,Talbot County,2791,2708,83,3
CN1326500000000,2022-04-01,13,265,GA,Taliaferro County,529,514,15,2.8
CN1326700000000,2022-04-01,13,267,GA,Tattnall County,9505,9257,248,2.6
CN1326900000000,2022-04-01,13,269,GA,Taylor County,2615,2509,106,4.1
CN1327100000000,2022-04-01,13,271,GA,Telfair County,3687,3532,155,4.2
CN1327300000000,2022-04-01,13,273,GA,Terrell County,3471,3330,141,4.1
CN1327500000000,2022-04-01,13,275,GA,Thomas County,17095,16592,503,2.9
CN1327700000000,2022-04-01,13,277,GA,Tift County,21124,20647,477,2.3
CN1327900000000,2022-04-01,13,279,GA,Toombs County,12033,11675,358,3
CN1328100000000,2022-04-01,13,281,GA,Towns County,3895,3766,129,3.3
CN1328300000000,2022-04-01,13,283,GA,Treutlen County,2614,2538,76,2.9
CN1328500000000,2022-04-01,13,285,GA,Troup County,36769,35852,917,2.5
CN1328700000000,2022-04-01,13,287,GA,Turner County,3155,3043,112,3.5
CN1328900000000,2022-04-01,13,289,GA,Twiggs County,2731,2619,112,4.1
CN1329100000000,2022-04-01,13,291,GA,Union County,11532,11293,239,2.1
CN1329300000000,2022-04-01,13,293,GA,Upson County,11754,11468,286,2.4
CN1329500000000,2022-04-01,13,295,GA,Walker County,30926,30179,747,2.4
CN1329700000000,2022-04-01,13,297,GA,Walton County,47720,46628,1092,2.3
CN1329900000000,2022-04-01,13,299,GA,Ware County,15838,15464,374,2.4
CN1330100000000,2022-04-01,13,301,GA,Warren County,2671,2597,74,2.8
CN1330300000000,2022-04-01,13,303,GA,Washington County,6886,6656,230,3.3
CN1330500000000,2022-04-01,13,305,GA,Wayne County,11938,11632,306,2.6
CN1330700000000,2022-04-01,13,307,GA,Webster County,994,964,30,3
CN1330900000000,2022-04-01,13,309,GA,Wheeler County,1667,1600,67,4
CN1331100000000,2022-04-01,13,311,GA,White County,16766,16452,314,1.9
CN1331300000000,2022-04-01,13,313,GA,Whitfield County,43006,41768,1238,2.9
CN1331500000000,2022-04-01,13,315,GA,Wilcox County,2706,2621,85,3.1
CN1331700000000,2022-04-01,13,317,GA,Wilkes County,3669,3539,130,3.5
CN1331900000000,2022-04-01,13,319,GA,Wilkinson County,3939,3834,105,2.7
CN1332100000000,2022-04-01,13,321,GA,Worth County,8739,8515,224,2.6
CN1500100000000,2022-04-01,15,001,HI,Hawaii County,93803,90790,3013,3.2
CN1500300000000,2022-04-01,15,003,HI,Honolulu County/city,456729,442563,14166,3.1
CN1500700000000,2022-04-01,15,007,HI,Kauai County,36324,35119,1205,3.3
CN1500900000000,2022-04-01,15,009,HI,Maui County,86688,83896,2792,3.2
CN1600100000000,2022-04-01,16,001,ID,Ada County,276105,270386,5719,2.1
CN1600300000000,2022-04-01,16,003,ID,Adams County,1739,1620,119,6.8
CN1600500000000,2022-04-01,16,005,ID,Bannock County,44314,43192,1122,2.5
CN1600700000000,2022-04-01,16,007,ID,Bear Lake County,3223,3135,88,2.7
CN1600900000000,2022-04-01,16,009,ID,Benewah County,4162,3942,220,5.3
CN1601100000000,2022-04-01,16,011,ID,Bingham County,25106,24533,573,2.3
CN1601300000000,2022-04-01,16,013,ID,Blaine County,12916,12566,350,2.7
CN1601500000000,2022-04-01,16,015,ID,Boise County,3842,3690,152,4
CN1601700000000,2022-04-01,16,017,ID,Bonner County,22009,21153,856,3.9
CN1601900000000,2022-04-01,16,019,ID,Bonneville County,62736,61372,1364,2.2
CN1602100000000,2022-04-01,16,021,ID,Boundary County,5807,5569,238,4.1
CN1602300000000,2022-04-01,16,023,ID,Butte County,1498,1452,46,3.1
CN1602500000000,2022-04-01,16,025,ID,Camas County,724,699,25,3.5
CN1602700000000,2022-04-01,16,027,ID,Canyon County,113433,110483,2950,2.6
CN1602900000000,2022-04-01,16,029,ID,Caribou County,4189,4074,115,2.7
CN1603100000000,2022-04-01,16,031,ID,Cassia County,12861,12561,300,2.3
CN1603300000000,2022-04-01,16,033,ID,Clark County,401,386,15,3.7
CN1603500000000,2022-04-01,16,035,ID,Clearwater County,3024,2818,206,6.8
CN1603700000000,2022-04-01,16,037,ID,Custer County,2050,1979,71,3.5
CN1603900000000,2022-04-01,16,039,ID,Elmore County,12026,11704,322,2.7
CN1604100000000,2022-04-01,16,041,ID,Franklin County,7721,7583,138,1.8
CN1604300000000,2022-04-01,16,043,ID,Fremont County,8436,8215,221,2.6
CN1604500000000,2022-04-01,16,045,ID,Gem County,8979,8722,257,2.9
CN1604700000000,2022-04-01,16,047,ID,Gooding County,8503,8303,200,2.4
CN1604900000000,2022-04-01,16,049,ID,Idaho County,6817,6534,283,4.2
CN1605100000000,2022-04-01,16,051,ID,Jefferson County,15180,14878,302,2
CN1605300000000,2022-04-01,16,053,ID,Jerome County,12613,12314,299,2.4
CN1605500000000,2022-04-01,16,055,ID,Kootenai County,83985,81459,2526,3
CN1605700000000,2022-04-01,16,057,ID,Latah County,20764,20249,515,2.5
CN1605900000000,2022-04-01,16,059,ID,Lemhi County,3616,3466,150,4.1
CN1606100000000,2022-04-01,16,061,ID,Lewis County,1664,1594,70,4.2
CN1606300000000,2022-04-01,16,063,ID,Lincoln County,2721,2627,94,3.5
CN1606500000000,2022-04-01,16,065,ID,Madison County,23811,23444,367,1.5
CN1606700000000,2022-04-01,16,067,ID,Minidoka County,12169,11898,271,2.2
CN1606900000000,2022-04-01,16,069,ID,Nez Perce County,21491,20971,520,2.4
CN1607100000000,2022-04-01,16,071,ID,Oneida County,2703,2652,51,1.9
CN1607300000000,2022-04-01,16,073,ID,Owyhee County,5451,5281,170,3.1
CN1607500000000,2022-04-01,16,075,ID,Payette County,12248,11900,348,2.8
CN1607700000000,2022-04-01,16,077,ID,Power County,4384,4273,111,2.5
CN1607900000000,2022-04-01,16,079,ID,Shoshone County,5507,5230,277,5
CN1608100000000,2022-04-01,16,081,ID,Teton County,7151,6979,172,2.4
CN1608300000000,2022-04-01,16,083,ID,Twin Falls County,42966,41912,1054,2.5
CN1608500000000,2022-04-01,16,085,ID,Valley County,5550,5290,260,4.7
CN1608700000000,2022-04-01,16,087,ID,Washington County,4887,4734,153,3.1
CN1700100000000,2022-04-01,17,001,IL,Adams County,30696,29711,985,3.2
CN1700300000000,2022-04-01,17,003,IL,Alexander County,1799,1690,109,6.1
CN1700500000000,2022-04-01,17,005,IL,Bond County,7463,7173,290,3.9
CN1700700000000,2022-04-01,17,007,IL,Boone County,24767,23188,1579,6.4
CN1700900000000,2022-04-01,17,009,IL,Brown County,3046,2980,66,2.2
CN1701100000000,2022-04-01,17,011,IL,Bureau County,16108,15401,707,4.4
CN1701300000000,2022-04-01,17,013,IL,Calhoun County,2160,2082,78,3.6
CN1701500000000,2022-04-01,17,015,IL,Carroll County,7322,7057,265,3.6
CN1701700000000,2022-04-01,17,017,IL,Cass County,5637,5411,226,4
CN1701900000000,2022-04-01,17,019,IL,Champaign County,110952,106943,4009,3.6
CN1702100000000,2022-04-01,17,021,IL,Christian County,13139,12542,597,4.5
CN1702300000000,2022-04-01,17,023,IL,Clark County,7306,7013,293,4
CN1702500000000,2022-04-01,17,025,IL,Clay County,5711,5460,251,4.4
CN1702700000000,2022-04-01,17,027,IL,Clinton County,19847,19299,548,2.8
CN1702900000000,2022-04-01,17,029,IL,Coles County,22870,21915,955,4.2
CN1703100000000,2022-04-01,17,031,IL,Cook County,2673347,2549355,123992,4.6
CN1703300000000,2022-04-01,17,033,IL,Crawford County,8251,7905,346,4.2
CN1703500000000,2022-04-01,17,035,IL,Cumberland County,5931,5743,188,3.2
CN1703700000000,2022-04-01,17,037,IL,DeKalb County,53317,51053,2264,4.2
CN1703900000000,2022-04-01,17,039,IL,De Witt County,7353,7076,277,3.8
CN1704100000000,2022-04-01,17,041,IL,Douglas County,10036,9714,322,3.2
CN1704300000000,2022-04-01,17,043,IL,DuPage County,521657,504436,17221,3.3
CN1704500000000,2022-04-01,17,045,IL,Edgar County,9107,8810,297,3.3
CN1704700000000,2022-04-01,17,047,IL,Edwards County,2406,2302,104,4.3
CN1704900000000,2022-04-01,17,049,IL,Effingham County,19596,19037,559,2.9
CN1705100000000,2022-04-01,17,051,IL,Fayette County,9639,9221,418,4.3
CN1705300000000,2022-04-01,17,053,IL,Ford County,6348,6112,236,3.7
CN1705500000000,2022-04-01,17,055,IL,Franklin County,15817,15034,783,5
CN1705700000000,2022-04-01,17,057,IL,Fulton County,14615,13942,673,4.6
CN1705900000000,2022-04-01,17,059,IL,Gallatin County,1972,1874,98,5
CN1706100000000,2022-04-01,17,061,IL,Greene County,5844,5613,231,4
CN1706300000000,2022-04-01,17,063,IL,Grundy County,26291,25162,1129,4.3
CN1706500000000,2022-04-01,17,065,IL,Hamilton County,4218,4074,144,3.4
CN1706700000000,2022-04-01,17,067,IL,Hancock County,7980,7664,316,4
CN1706900000000,2022-04-01,17,069,IL,Hardin County,1400,1334,66,4.7
CN1707100000000,2022-04-01,17,071,IL,Henderson County,3511,3377,134,3.8
CN1707300000000,2022-04-01,17,073,IL,Henry County,23445,22441,1004,4.3
CN1707500000000,2022-04-01,17,075,IL,Iroquois County,12482,11913,569,4.6
CN1707700000000,2022-04-01,17,077,IL,Jackson County,27261,26152,1109,4.1
CN1707900000000,2022-04-01,17,079,IL,Jasper County,4789,4621,168,3.5
CN1708100000000,2022-04-01,17,081,IL,Jefferson County,16272,15505,767,4.7
CN1708300000000,2022-04-01,17,083,IL,Jersey County,10560,10202,358,3.4
CN1708500000000,2022-04-01,17,085,IL,Jo Daviess County,10410,10043,367,3.5
CN1708700000000,2022-04-01,17,087,IL,Johnson County,4131,3913,218,5.3
CN1708900000000,2022-04-01,17,089,IL,Kane County,261797,249853,11944,4.6
CN1709100000000,2022-04-01,17,091,IL,Kankakee County,51715,49037,2678,5.2
CN1709300000000,2022-04-01,17,093,IL,Kendall County,72815,70187,2628,3.6
CN1709500000000,2022-04-01,17,095,IL,Knox County,19818,18794,1024,5.2
CN1709700000000,2022-04-01,17,097,IL,Lake County,359397,344375,15022,4.2
CN1709900000000,2022-04-01,17,099,IL,LaSalle County,51595,49094,2501,4.8
CN1710100000000,2022-04-01,17,101,IL,Lawrence County,5125,4833,292,5.7
CN1710300000000,2022-04-01,17,103,IL,Lee County,16564,15920,644,3.9
CN1710500000000,2022-04-01,17,105,IL,Livingston County,15494,14879,615,4
CN1710700000000,2022-04-01,17,107,IL,Logan County,11775,11314,461,3.9
CN1710900000000,2022-04-01,17,109,IL,McDonough County,13098,12599,499,3.8
CN1711100000000,2022-04-01,17,111,IL,McHenry County,170573,164263,6310,3.7
CN1711300000000,2022-04-01,17,113,IL,McLean County,89111,86067,3044,3.4
CN1711500000000,2022-04-01,17,115,IL,Macon County,44955,42420,2535,5.6
CN1711700000000,2022-04-01,17,117,IL,Macoupin County,22041,21238,803,3.6
CN1711900000000,2022-04-01,17,119,IL,Madison County,130846,126080,4766,3.6
CN1712100000000,2022-04-01,17,121,IL,Marion County,16559,15796,763,4.6
CN1712300000000,2022-04-01,17,123,IL,Marshall County,5050,4816,234,4.6
CN1712500000000,2022-04-01,17,125,IL,Mason County,5849,5604,245,4.2
CN1712700000000,2022-04-01,17,127,IL,Massac County,5313,5069,244,4.6
CN1712900000000,2022-04-01,17,129,IL,Menard County,6106,5883,223,3.7
CN1713100000000,2022-04-01,17,131,IL,Mercer County,7450,7164,286,3.8
CN1713300000000,2022-04-01,17,133,IL,Monroe County,18624,18125,499,2.7
CN1713500000000,2022-04-01,17,135,IL,Montgomery County,11100,10619,481,4.3
CN1713700000000,2022-04-01,17,137,IL,Morgan County,15548,14926,622,4
CN1713900000000,2022-04-01,17,139,IL,Moultrie County,7363,7128,235,3.2
CN1714100000000,2022-04-01,17,141,IL,Ogle County,24649,23499,1150,4.7
CN1714300000000,2022-04-01,17,143,IL,Peoria County,81300,77154,4146,5.1
CN1714500000000,2022-04-01,17,145,IL,Perry County,7820,7451,369,4.7
CN1714700000000,2022-04-01,17,147,IL,Piatt County,8717,8424,293,3.4
CN1714900000000,2022-04-01,17,149,IL,Pike County,6760,6473,287,4.2
CN1715100000000,2022-04-01,17,151,IL,Pope County,1742,1665,77,4.4
CN1715300000000,2022-04-01,17,153,IL,Pulaski County,1654,1546,108,6.5
CN1715500000000,2022-04-01,17,155,IL,Putnam County,2920,2781,139,4.8
CN1715700000000,2022-04-01,17,157,IL,Randolph County,13394,12927,467,3.5
CN1715900000000,2022-04-01,17,159,IL,Richland County,7117,6847,270,3.8
CN1716100000000,2022-04-01,17,161,IL,Rock Island County,66563,63798,2765,4.2
CN1716300000000,2022-04-01,17,163,IL,St. Clair County,122956,117750,5206,4.2
CN1716500000000,2022-04-01,17,165,IL,Saline County,9283,8813,470,5.1
CN1716700000000,2022-04-01,17,167,IL,Sangamon County,96234,92306,3928,4.1
CN1716900000000,2022-04-01,17,169,IL,Schuyler County,3141,3037,104,3.3
CN1717100000000,2022-04-01,17,171,IL,Scott County,2254,2145,109,4.8
CN1717300000000,2022-04-01,17,173,IL,Shelby County,9867,9468,399,4
CN1717500000000,2022-04-01,17,175,IL,Stark County,2367,2239,128,5.4
CN1717700000000,2022-04-01,17,177,IL,Stephenson County,20493,19569,924,4.5
CN1717900000000,2022-04-01,17,179,IL,Tazewell County,61066,58596,2470,4
CN1718100000000,2022-04-01,17,181,IL,Union County,7118,6740,378,5.3
CN1718300000000,2022-04-01,17,183,IL,Vermilion County,31797,30242,1555,4.9
CN1718500000000,2022-04-01,17,185,IL,Wabash County,5663,5463,200,3.5
CN1718700000000,2022-04-01,17,187,IL,Warren County,7656,7346,310,4
CN1718900000000,2022-04-01,17,189,IL,Washington County,9592,9379,213,2.2
CN1719100000000,2022-04-01,17,191,IL,Wayne County,6898,6642,256,3.7
CN1719300000000,2022-04-01,17,193,IL,White County,5975,5749,226,3.8
CN1719500000000,2022-04-01,17,195,IL,Whiteside County,27080,26030,1050,3.9
CN1719700000000,2022-04-01,17,197,IL,Will County,369563,354059,15504,4.2
CN1719900000000,2022-04-01,17,199,IL,Williamson County,31219,29916,1303,4.2
CN1720100000000,2022-04-01,17,201,IL,Winnebago County,131847,123989,7858,6
CN1720300000000,2022-04-01,17,203,IL,Woodford County,17947,17366,581,3.2
CN1800100000000,2022-04-01,18,001,IN,Adams County,16982,16671,311,1.8
CN1800300000000,2022-04-01,18,003,IN,Allen County,188442,183305,5137,2.7
CN1800500000000,2022-04-01,18,005,IN,Bartholomew County,44175,43353,822,1.9
CN1800700000000,2022-04-01,18,007,IN,Benton County,4377,4294,83,1.9
CN1800900000000,2022-04-01,18,009,IN,Blackford County,4820,4676,144,3
CN1801100000000,2022-04-01,18,011,IN,Boone County,37796,37216,580,1.5
CN1801300000000,2022-04-01,18,013,IN,Brown County,7760,7537,223,2.9
CN1801500000000,2022-04-01,18,015,IN,Carroll County,9930,9689,241,2.4
CN1801700000000,2022-04-01,18,017,IN,Cass County,17232,16797,435,2.5
CN1801900000000,2022-04-01,18,019,IN,Clark County,62671,61274,1397,2.2
CN1802100000000,2022-04-01,18,021,IN,Clay County,11671,11354,317,2.7
CN1802300000000,2022-04-01,18,023,IN,Clinton County,17152,16792,360,2.1
CN1802500000000,2022-04-01,18,025,IN,Crawford County,4791,4647,144,3
CN1802700000000,2022-04-01,18,027,IN,Daviess County,16495,16186,309,1.9
CN1802900000000,2022-04-01,18,029,IN,Dearborn County,25856,25304,552,2.1
CN1803100000000,2022-04-01,18,031,IN,Decatur County,14533,14218,315,2.2
CN1803300000000,2022-04-01,18,033,IN,DeKalb County,22405,21912,493,2.2
CN1803500000000,2022-04-01,18,035,IN,Delaware County,51645,50053,1592,3.1
CN1803700000000,2022-04-01,18,037,IN,Dubois County,21909,21526,383,1.7
CN1803900000000,2022-04-01,18,039,IN,Elkhart County,120075,117966,2109,1.8
CN1804100000000,2022-04-01,18,041,IN,Fayette County,8461,8144,317,3.7
CN1804300000000,2022-04-01,18,043,IN,Floyd County,42233,41369,864,2
CN1804500000000,2022-04-01,18,045,IN,Fountain County,7914,7742,172,2.2
CN1804700000000,2022-04-01,18,047,IN,Franklin County,11198,10960,238,2.1
CN1804900000000,2022-04-01,18,049,IN,Fulton County,9439,9199,240,2.5
CN1805100000000,2022-04-01,18,051,IN,Gibson County,19829,19467,362,1.8
CN1805300000000,2022-04-01,18,053,IN,Grant County,32313,31438,875,2.7
CN1805500000000,2022-04-01,18,055,IN,Greene County,13580,13130,450,3.3
CN1805700000000,2022-04-01,18,057,IN,Hamilton County,194047,190767,3280,1.7
CN1805900000000,2022-04-01,18,059,IN,Hancock County,42453,41522,931,2.2
CN1806100000000,2022-04-01,18,061,IN,Harrison County,20393,20001,392,1.9
CN1806300000000,2022-04-01,18,063,IN,Hendricks County,94695,92809,1886,2
CN1806500000000,2022-04-01,18,065,IN,Henry County,22128,21538,590,2.7
CN1806700000000,2022-04-01,18,067,IN,Howard County,33510,32147,1363,4.1
CN1806900000000,2022-04-01,18,069,IN,Huntington County,18545,18080,465,2.5
CN1807100000000,2022-04-01,18,071,IN,Jackson County,23574,23013,561,2.4
CN1807300000000,2022-04-01,18,073,IN,Jasper County,15761,15332,429,2.7
CN1807500000000,2022-04-01,18,075,IN,Jay County,8789,8600,189,2.2
CN1807700000000,2022-04-01,18,077,IN,Jefferson County,15143,14819,324,2.1
CN1807900000000,2022-04-01,18,079,IN,Jennings County,13686,13287,399,2.9
CN1808100000000,2022-04-01,18,081,IN,Johnson County,86349,84662,1687,2
CN1808300000000,2022-04-01,18,083,IN,Knox County,17896,17531,365,2
CN1808500000000,2022-04-01,18,085,IN,Kosciusko County,40290,39506,784,1.9
CN1808700000000,2022-04-01,18,087,IN,LaGrange County,21491,21195,296,1.4
CN1808900000000,2022-04-01,18,089,IN,Lake County,226145,217371,8774,3.9
CN1809100000000,2022-04-01,18,091,IN,LaPorte County,46712,45253,1459,3.1
CN1809300000000,2022-04-01,18,093,IN,Lawrence County,20758,20199,559,2.7
CN1809500000000,2022-04-01,18,095,IN,Madison County,59804,58071,1733,2.9
CN1809700000000,2022-04-01,18,097,IN,Marion County,504909,490931,13978,2.8
CN1809900000000,2022-04-01,18,099,IN,Marshall County,22681,22267,414,1.8
CN1810100000000,2022-04-01,18,101,IN,Martin County,5435,5312,123,2.3
CN1810300000000,2022-04-01,18,103,IN,Miami County,14299,13774,525,3.7
CN1810500000000,2022-04-01,18,105,IN,Monroe County,72036,70548,1488,2.1
CN1810700000000,2022-04-01,18,107,IN,Montgomery County,18850,18466,384,2
CN1810900000000,2022-04-01,18,109,IN,Morgan County,37066,36171,895,2.4
CN1811100000000,2022-04-01,18,111,IN,Newton County,6641,6449,192,2.9
CN1811300000000,2022-04-01,18,113,IN,Noble County,21639,21157,482,2.2
CN1811500000000,2022-04-01,18,115,IN,Ohio County,3190,3142,48,1.5
CN1811700000000,2022-04-01,18,117,IN,Orange County,8166,7934,232,2.8
CN1811900000000,2022-04-01,18,119,IN,Owen County,9461,9217,244,2.6
CN1812100000000,2022-04-01,18,121,IN,Parke County,7000,6830,170,2.4
CN1812300000000,2022-04-01,18,123,IN,Perry County,8699,8485,214,2.5
CN1812500000000,2022-04-01,18,125,IN,Pike County,5901,5727,174,2.9
CN1812700000000,2022-04-01,18,127,IN,Porter County,85260,82982,2278,2.7
CN1812900000000,2022-04-01,18,129,IN,Posey County,12972,12717,255,2
CN1813100000000,2022-04-01,18,131,IN,Pulaski County,6475,6333,142,2.2
CN1813300000000,2022-04-01,18,133,IN,Putnam County,16750,16323,427,2.5
CN1813500000000,2022-04-01,18,135,IN,Randolph County,11509,11206,303,2.6
CN1813700000000,2022-04-01,18,137,IN,Ripley County,12868,12555,313,2.4
CN1813900000000,2022-04-01,18,139,IN,Rush County,8832,8647,185,2.1
CN1814100000000,2022-04-01,18,141,IN,St. Joseph County,132306,128662,3644,2.8
CN1814300000000,2022-04-01,18,143,IN,Scott County,10575,10252,323,3.1
CN1814500000000,2022-04-01,18,145,IN,Shelby County,23507,23030,477,2
CN1814700000000,2022-04-01,18,147,IN,Spencer County,10443,10209,234,2.2
CN1814900000000,2022-04-01,18,149,IN,Starke County,9533,9252,281,2.9
CN1815100000000,2022-04-01,18,151,IN,Steuben County,20646,20309,337,1.6
CN1815300000000,2022-04-01,18,153,IN,Sullivan County,8010,7750,260,3.2
CN1815500000000,2022-04-01,18,155,IN,Switzerland County,4708,4595,113,2.4
CN1815700000000,2022-04-01,18,157,IN,Tippecanoe County,98319,96122,2197,2.2
CN1815900000000,2022-04-01,18,159,IN,Tipton County,8938,8750,188,2.1
CN1816100000000,2022-04-01,18,161,IN,Union County,3569,3495,74,2.1
CN1816300000000,2022-04-01,18,163,IN,Vanderburgh County,92638,90256,2382,2.6
CN1816500000000,2022-04-01,18,165,IN,Vermillion County,6577,6375,202,3.1
CN1816700000000,2022-04-01,18,167,IN,Vigo County,46109,44795,1314,2.8
CN1816900000000,2022-04-01,18,169,IN,Wabash County,14550,14220,330,2.3
CN1817100000000,2022-04-01,18,171,IN,Warren County,4086,4003,83,2
CN1817300000000,2022-04-01,18,173,IN,Warrick County,32357,31680,677,2.1
CN1817500000000,2022-04-01,18,175,IN,Washington County,13620,13341,279,2
CN1817700000000,2022-04-01,18,177,IN,Wayne County,29700,28925,775,2.6
CN1817900000000,2022-04-01,18,179,IN,Wells County,14176,13897,279,2
CN1818100000000,2022-04-01,18,181,IN,White County,13416,13142,274,2
CN1818300000000,2022-04-01,18,183,IN,Whitley County,17752,17365,387,2.2
CN1900100000000,2022-04-01,19,001,IA,Adair County,4284,4219,65,1.5
CN1900300000000,2022-04-01,19,003,IA,Adams County,2127,2096,31,1.5
CN1900500000000,2022-04-01,19,005,IA,Allamakee County,7171,6940,231,3.2
CN1900700000000,2022-04-01,19,007,IA,Appanoose County,6108,5983,125,2
CN1900900000000,2022-04-01,19,009,IA,Audubon County,3072,3023,49,1.6
CN1901100000000,2022-04-01,19,011,IA,Benton County,13079,12800,279,2.1
CN1901300000000,2022-04-01,19,013,IA,Black Hawk County,67859,66313,1546,2.3
CN1901500000000,2022-04-01,19,015,IA,Boone County,14879,14615,264,1.8
CN1901700000000,2022-04-01,19,017,IA,Bremer County,14025,13781,244,1.7
CN1901900000000,2022-04-01,19,019,IA,Buchanan County,11444,11211,233,2
CN1902100000000,2022-04-01,19,021,IA,Buena Vista County,11706,11515,191,1.6
CN1902300000000,2022-04-01,19,023,IA,Butler County,8074,7894,180,2.2
CN1902500000000,2022-04-01,19,025,IA,Calhoun County,4214,4134,80,1.9
CN1902700000000,2022-04-01,19,027,IA,Carroll County,10771,10614,157,1.5
CN1902900000000,2022-04-01,19,029,IA,Cass County,6858,6733,125,1.8
CN1903100000000,2022-04-01,19,031,IA,Cedar County,10569,10356,213,2
CN1903300000000,2022-04-01,19,033,IA,Cerro Gordo County,22174,21694,480,2.2
CN1903500000000,2022-04-01,19,035,IA,Cherokee County,6100,5999,101,1.7
CN1903700000000,2022-04-01,19,037,IA,Chickasaw County,6593,6457,136,2.1
CN1903900000000,2022-04-01,19,039,IA,Clarke County,4984,4869,115,2.3
CN1904100000000,2022-04-01,19,041,IA,Clay County,8508,8333,175,2.1
CN1904300000000,2022-04-01,19,043,IA,Clayton County,9597,9346,251,2.6
CN1904500000000,2022-04-01,19,045,IA,Clinton County,22055,21485,570,2.6
CN1904700000000,2022-04-01,19,047,IA,Crawford County,7872,7628,244,3.1
CN1904900000000,2022-04-01,19,049,IA,Dallas County,53710,52940,770,1.4
CN1905100000000,2022-04-01,19,051,IA,Davis County,4280,4204,76,1.8
CN1905300000000,2022-04-01,19,053,IA,Decatur County,4383,4299,84,1.9
CN1905500000000,2022-04-01,19,055,IA,Delaware County,10613,10422,191,1.8
CN1905700000000,2022-04-01,19,057,IA,Des Moines County,18157,17521,636,3.5
CN1905900000000,2022-04-01,19,059,IA,Dickinson County,10414,10178,236,2.3
CN1906100000000,2022-04-01,19,061,IA,Dubuque County,56396,55171,1225,2.2
CN1906300000000,2022-04-01,19,063,IA,Emmet County,4946,4845,101,2
CN1906500000000,2022-04-01,19,065,IA,Fayette County,10370,10106,264,2.5
CN1906700000000,2022-04-01,19,067,IA,Floyd County,8285,8092,193,2.3
CN1906900000000,2022-04-01,19,069,IA,Franklin County,5630,5515,115,2
CN1907100000000,2022-04-01,19,071,IA,Fremont County,3756,3691,65,1.7
CN1907300000000,2022-04-01,19,073,IA,Greene County,5361,5274,87,1.6
CN1907500000000,2022-04-01,19,075,IA,Grundy County,6418,6307,111,1.7
CN1907700000000,2022-04-01,19,077,IA,Guthrie County,5631,5523,108,1.9
CN1907900000000,2022-04-01,19,079,IA,Hamilton County,6925,6765,160,2.3
CN1908100000000,2022-04-01,19,081,IA,Hancock County,5726,5627,99,1.7
CN1908300000000,2022-04-01,19,083,IA,Hardin County,7925,7758,167,2.1
CN1908500000000,2022-04-01,19,085,IA,Harrison County,7108,6977,131,1.8
CN1908700000000,2022-04-01,19,087,IA,Henry County,9611,9404,207,2.2
CN1908900000000,2022-04-01,19,089,IA,Howard County,5246,5114,132,2.5
CN1909100000000,2022-04-01,19,091,IA,Humboldt County,4937,4840,97,2
CN1909300000000,2022-04-01,19,093,IA,Ida County,3974,3910,64,1.6
CN1909500000000,2022-04-01,19,095,IA,Iowa County,9807,9624,183,1.9
CN1909700000000,2022-04-01,19,097,IA,Jackson County,10723,10444,279,2.6
CN1909900000000,2022-04-01,19,099,IA,Jasper County,18646,18227,419,2.2
CN1910100000000,2022-04-01,19,101,IA,Jefferson County,10219,10027,192,1.9
CN1910300000000,2022-04-01,19,103,IA,Johnson County,86251,84778,1473,1.7
CN1910500000000,2022-04-01,19,105,IA,Jones County,10416,10156,260,2.5
CN1910700000000,2022-04-01,19,107,IA,Keokuk County,5193,5065,128,2.5
CN1910900000000,2022-04-01,19,109,IA,Kossuth County,8311,8160,151,1.8
CN1911100000000,2022-04-01,19,111,IA,Lee County,15071,14493,578,3.8
CN1911300000000,2022-04-01,19,113,IA,Linn County,120671,117959,2712,2.2
CN1911500000000,2022-04-01,19,115,IA,Louisa County,5877,5740,137,2.3
CN1911700000000,2022-04-01,19,117,IA,Lucas County,4679,4614,65,1.4
CN1911900000000,2022-04-01,19,119,IA,Lyon County,6993,6894,99,1.4
CN1912100000000,2022-04-01,19,121,IA,Madison County,8728,8523,205,2.3
CN1912300000000,2022-04-01,19,123,IA,Mahaska County,12287,12063,224,1.8
CN1912500000000,2022-04-01,19,125,IA,Marion County,18963,18671,292,1.5
CN1912700000000,2022-04-01,19,127,IA,Marshall County,17329,16528,801,4.6
CN1912900000000,2022-04-01,19,129,IA,Mills County,7083,6966,117,1.7
CN1913100000000,2022-04-01,19,131,IA,Mitchell County,5945,5852,93,1.6
CN1913300000000,2022-04-01,19,133,IA,Monona County,4446,4349,97,2.2
CN1913500000000,2022-04-01,19,135,IA,Monroe County,4013,3937,76,1.9
CN1913700000000,2022-04-01,19,137,IA,Montgomery County,4988,4899,89,1.8
CN1913900000000,2022-04-01,19,139,IA,Muscatine County,21290,20822,468,2.2
CN1914100000000,2022-04-01,19,141,IA,O'Brien County,8157,8028,129,1.6
CN1914300000000,2022-04-01,19,143,IA,Osceola County,3545,3498,47,1.3
CN1914500000000,2022-04-01,19,145,IA,Page County,6543,6430,113,1.7
CN1914700000000,2022-04-01,19,147,IA,Palo Alto County,4576,4483,93,2
CN1914900000000,2022-04-01,19,149,IA,Plymouth County,14803,14604,199,1.3
CN1915100000000,2022-04-01,19,151,IA,Pocahontas County,4254,4185,69,1.6
CN1915300000000,2022-04-01,19,153,IA,Polk County,274773,269064,5709,2.1
CN1915500000000,2022-04-01,19,155,IA,Pottawattamie County,47435,46533,902,1.9
CN1915700000000,2022-04-01,19,157,IA,Poweshiek County,10541,10306,235,2.2
CN1915900000000,2022-04-01,19,159,IA,Ringgold County,2375,2335,40,1.7
CN1916100000000,2022-04-01,19,161,IA,Sac County,5338,5245,93,1.7
CN1916300000000,2022-04-01,19,163,IA,Scott County,87794,85647,2147,2.4
CN1916500000000,2022-04-01,19,165,IA,Shelby County,6445,6337,108,1.7
CN1916700000000,2022-04-01,19,167,IA,Sioux County,22893,22569,324,1.4
CN1916900000000,2022-04-01,19,169,IA,Story County,60167,59260,907,1.5
CN1917100000000,2022-04-01,19,171,IA,Tama County,9159,8923,236,2.6
CN1917300000000,2022-04-01,19,173,IA,Taylor County,3148,3105,43,1.4
CN1917500000000,2022-04-01,19,175,IA,Union County,6124,6005,119,1.9
CN1917700000000,2022-04-01,19,177,IA,Van Buren County,3721,3642,79,2.1
CN1917900000000,2022-04-01,19,179,IA,Wapello County,16809,16407,402,2.4
CN1918100000000,2022-04-01,19,181,IA,Warren County,29189,28674,515,1.8
CN1918300000000,2022-04-01,19,183,IA,Washington County,11722,11515,207,1.8
CN1918500000000,2022-04-01,19,185,IA,Wayne County,2877,2822,55,1.9
CN1918700000000,2022-04-01,19,187,IA,Webster County,18793,18381,412,2.2
CN1918900000000,2022-04-01,19,189,IA,Winnebago County,4960,4849,111,2.2
CN1919100000000,2022-04-01,19,191,IA,Winneshiek County,11681,11353,328,2.8
CN1919300000000,2022-04-01,19,193,IA,Woodbury County,55796,54626,1170,2.1
CN1919500000000,2022-04-01,19,195,IA,Worth County,3987,3895,92,2.3
CN1919700000000,2022-04-01,19,197,IA,Wright County,6638,6487,151,2.3
CN2000100000000,2022-04-01,20,001,KS,Allen County,6310,6161,149,2.4
CN2000300000000,2022-04-01,20,003,KS,Anderson County,4265,4187,78,1.8
CN2000500000000,2022-04-01,20,005,KS,Atchison County,6677,6495,182,2.7
CN2000700000000,2022-04-01,20,007,KS,Barber County,2195,2163,32,1.5
CN2000900000000,2022-04-01,20,009,KS,Barton County,13020,12759,261,2
CN2001100000000,2022-04-01,20,011,KS,Bourbon County,6240,6069,171,2.7
CN2001300000000,2022-04-01,20,013,KS,Brown County,4995,4900,95,1.9
CN2001500000000,2022-04-01,20,015,KS,Butler County,32576,31870,706,2.2
CN2001700000000,2022-04-01,20,017,KS,Chase County,1375,1352,23,1.7
CN2001900000000,2022-04-01,20,019,KS,Chautauqua County,1401,1371,30,2.1
CN2002100000000,2022-04-01,20,021,KS,Cherokee County,9878,9683,195,2
CN2002300000000,2022-04-01,20,023,KS,Cheyenne County,1192,1168,24,2
CN2002500000000,2022-04-01,20,025,KS,Clark County,1059,1044,15,1.4
CN2002700000000,2022-04-01,20,027,KS,Clay County,3606,3538,68,1.9
CN2002900000000,2022-04-01,20,029,KS,Cloud County,3743,3666,77,2.1
CN2003100000000,2022-04-01,20,031,KS,Coffey County,3820,3713,107,2.8
CN2003300000000,2022-04-01,20,033,KS,Comanche County,838,823,15,1.8
CN2003500000000,2022-04-01,20,035,KS,Cowley County,16548,16165,383,2.3
CN2003700000000,2022-04-01,20,037,KS,Crawford County,19121,18696,425,2.2
CN2003900000000,2022-04-01,20,039,KS,Decatur County,1108,1088,20,1.8
CN2004100000000,2022-04-01,20,041,KS,Dickinson County,8503,8306,197,2.3
CN2004300000000,2022-04-01,20,043,KS,Doniphan County,3977,3905,72,1.8
CN2004500000000,2022-04-01,20,045,KS,Douglas County,67042,65751,1291,1.9
CN2004700000000,2022-04-01,20,047,KS,Edwards County,1320,1297,23,1.7
CN2004900000000,2022-04-01,20,049,KS,Elk County,1162,1139,23,2
CN2005100000000,2022-04-01,20,051,KS,Ellis County,17041,16799,242,1.4
CN2005300000000,2022-04-01,20,053,KS,Ellsworth County,2521,2473,48,1.9
CN2005500000000,2022-04-01,20,055,KS,Finney County,20233,19895,338,1.7
CN2005700000000,2022-04-01,20,057,KS,Ford County,17713,17423,290,1.6
CN2005900000000,2022-04-01,20,059,KS,Franklin County,14777,14498,279,1.9
CN2006100000000,2022-04-01,20,061,KS,Geary County,11449,11117,332,2.9
CN2006300000000,2022-04-01,20,063,KS,Gove County,1293,1273,20,1.5
CN2006500000000,2022-04-01,20,065,KS,Graham County,1155,1135,20,1.7
CN2006700000000,2022-04-01,20,067,KS,Grant County,2703,2640,63,2.3
CN2006900000000,2022-04-01,20,069,KS,Gray County,2988,2938,50,1.7
CN2007100000000,2022-04-01,20,071,KS,Greeley County,741,732,9,1.2
CN2007300000000,2022-04-01,20,073,KS,Greenwood County,3109,3055,54,1.7
CN2007500000000,2022-04-01,20,075,KS,Hamilton County,1511,1491,20,1.3
CN2007700000000,2022-04-01,20,077,KS,Harper County,2736,2691,45,1.6
CN2007900000000,2022-04-01,20,079,KS,Harvey County,17000,16660,340,2
CN2008100000000,2022-04-01,20,081,KS,Haskell County,2043,2011,32,1.6
CN2008300000000,2022-04-01,20,083,KS,Hodgeman County,956,942,14,1.5
CN2008500000000,2022-04-01,20,085,KS,Jackson County,7208,7080,128,1.8
CN2008700000000,2022-04-01,20,087,KS,Jefferson County,10253,10035,218,2.1
CN2008900000000,2022-04-01,20,089,KS,Jewell County,1134,1113,21,1.9
CN2009100000000,2022-04-01,20,091,KS,Johnson County,347500,341348,6152,1.8
CN2009300000000,2022-04-01,20,093,KS,Kearny County,1935,1908,27,1.4
CN2009500000000,2022-04-01,20,095,KS,Kingman County,3180,3117,63,2
CN2009700000000,2022-04-01,20,097,KS,Kiowa County,1205,1185,20,1.7
CN2009900000000,2022-04-01,20,099,KS,Labette County,9336,9093,243,2.6
CN2010100000000,2022-04-01,20,101,KS,Lane County,669,654,15,2.2
CN2010300000000,2022-04-01,20,103,KS,Leavenworth County,37174,36319,855,2.3
CN2010500000000,2022-04-01,20,105,KS,Lincoln County,1645,1607,38,2.3
CN2010700000000,2022-04-01,20,107,KS,Linn County,4294,4153,141,3.3
CN2010900000000,2022-04-01,20,109,KS,Logan County,1576,1552,24,1.5
CN2011100000000,2022-04-01,20,111,KS,Lyon County,17125,16806,319,1.9
CN2011300000000,2022-04-01,20,113,KS,McPherson County,17215,16966,249,1.4
CN2011500000000,2022-04-01,20,115,KS,Marion County,5948,5838,110,1.8
CN2011700000000,2022-04-01,20,117,KS,Marshall County,5225,5147,78,1.5
CN2011900000000,2022-04-01,20,119,KS,Meade County,2004,1975,29,1.4
CN2012100000000,2022-04-01,20,121,KS,Miami County,17908,17547,361,2
CN2012300000000,2022-04-01,20,123,KS,Mitchell County,3325,3275,50,1.5
CN2012500000000,2022-04-01,20,125,KS,Montgomery County,14631,14282,349,2.4
CN2012700000000,2022-04-01,20,127,KS,Morris County,3009,2952,57,1.9
CN2012900000000,2022-04-01,20,129,KS,Morton County,1097,1071,26,2.4
CN2013100000000,2022-04-01,20,131,KS,Nemaha County,5429,5354,75,1.4
CN2013300000000,2022-04-01,20,133,KS,Neosho County,5942,5772,170,2.9
CN2013500000000,2022-04-01,20,135,KS,Ness County,1277,1256,21,1.6
CN2013700000000,2022-04-01,20,137,KS,Norton County,2532,2491,41,1.6
CN2013900000000,2022-04-01,20,139,KS,Osage County,7913,7745,168,2.1
CN2014100000000,2022-04-01,20,141,KS,Osborne County,1838,1806,32,1.7
CN2014300000000,2022-04-01,20,143,KS,Ottawa County,2925,2866,59,2
CN2014500000000,2022-04-01,20,145,KS,Pawnee County,2563,2516,47,1.8
CN2014700000000,2022-04-01,20,147,KS,Phillips County,2602,2557,45,1.7
CN2014900000000,2022-04-01,20,149,KS,Pottawatomie County,12645,12415,230,1.8
CN2015100000000,2022-04-01,20,151,KS,Pratt County,4854,4779,75,1.5
CN2015300000000,2022-04-01,20,153,KS,Rawlins County,1437,1417,20,1.4
CN2015500000000,2022-04-01,20,155,KS,Reno County,29268,28634,634,2.2
CN2015700000000,2022-04-01,20,157,KS,Republic County,2233,2192,41,1.8
CN2015900000000,2022-04-01,20,159,KS,Rice County,5166,5076,90,1.7
CN2016100000000,2022-04-01,20,161,KS,Riley County,35154,34467,687,2
CN2016300000000,2022-04-01,20,163,KS,Rooks County,2277,2230,47,2.1
CN2016500000000,2022-04-01,20,165,KS,Rush County,1583,1556,27,1.7
CN2016700000000,2022-04-01,20,167,KS,Russell County,3247,3190,57,1.8
CN2016900000000,2022-04-01,20,169,KS,Saline County,30226,29661,565,1.9
CN2017100000000,2022-04-01,20,171,KS,Scott County,2645,2612,33,1.2
CN2017300000000,2022-04-01,20,173,KS,Sedgwick County,255312,248722,6590,2.6
CN2017500000000,2022-04-01,20,175,KS,Seward County,9675,9483,192,2
CN2017700000000,2022-04-01,20,177,KS,Shawnee County,91418,89457,1961,2.1
CN2017900000000,2022-04-01,20,179,KS,Sheridan County,1363,1342,21,1.5
CN2018100000000,2022-04-01,20,181,KS,Sherman County,2710,2663,47,1.7
CN2018300000000,2022-04-01,20,183,KS,Smith County,1832,1803,29,1.6
CN2018500000000,2022-04-01,20,185,KS,Stafford County,1824,1792,32,1.8
CN2018700000000,2022-04-01,20,187,KS,Stanton County,1028,1013,15,1.5
CN2018900000000,2022-04-01,20,189,KS,Stevens County,2792,2747,45,1.6
CN2019100000000,2022-04-01,20,191,KS,Sumner County,10638,10381,257,2.4
CN2019300000000,2022-04-01,20,193,KS,Thomas County,4093,4037,56,1.4
CN2019500000000,2022-04-01,20,195,KS,Trego County,1354,1331,23,1.7
CN2019700000000,2022-04-01,20,197,KS,Wabaunsee County,3640,3569,71,2
CN2019900000000,2022-04-01,20,199,KS,Wallace County,795,783,12,1.5
CN2020100000000,2022-04-01,20,201,KS,Washington County,2866,2825,41,1.4
CN2020300000000,2022-04-01,20,203,KS,Wichita County,1067,1052,15,1.4
CN2020500000000,2022-04-01,20,205,KS,Wilson County,3672,3574,98,2.7
CN2020700000000,2022-04-01,20,207,KS,Woodson County,1540,1495,45,2.9
CN2020900000000,2022-04-01,20,209,KS,Wyandotte County,77619,75451,2168,2.8
CN2100100000000,2022-04-01,21,001,KY,Adair County,7187,6893,294,4.1
CN2100300000000,2022-04-01,21,003,KY,Allen County,8830,8536,294,3.3
CN2100500000000,2022-04-01,21,005,KY,Anderson County,11970,11633,337,2.8
CN2100700000000,2022-04-01,21,007,KY,Ballard County,3490,3321,169,4.8
CN2100900000000,2022-04-01,21,009,KY,Barren County,18082,17432,650,3.6
CN2101100000000,2022-04-01,21,011,KY,Bath County,4707,4486,221,4.7
CN2101300000000,2022-04-01,21,013,KY,Bell County,8080,7733,347,4.3
CN2101500000000,2022-04-01,21,015,KY,Boone County,72852,70770,2082,2.9
CN2101700000000,2022-04-01,21,017,KY,Bourbon County,9291,8982,309,3.3
CN2101900000000,2022-04-01,21,019,KY,Boyd County,17362,16599,763,4.4
CN2102100000000,2022-04-01,21,021,KY,Boyle County,12722,12267,455,3.6
CN2102300000000,2022-04-01,21,023,KY,Bracken County,3797,3658,139,3.7
CN2102500000000,2022-04-01,21,025,KY,Breathitt County,3216,3014,202,6.3
CN2102700000000,2022-04-01,21,027,KY,Breckinridge County,7879,7574,305,3.9
CN2102900000000,2022-04-01,21,029,KY,Bullitt County,42915,41662,1253,2.9
CN2103100000000,2022-04-01,21,031,KY,Butler County,5021,4852,169,3.4
CN2103300000000,2022-04-01,21,033,KY,Caldwell County,6102,5926,176,2.9
CN2103500000000,2022-04-01,21,035,KY,Calloway County,17516,16885,631,3.6
CN2103700000000,2022-04-01,21,037,KY,Campbell County,51341,49730,1611,3.1
CN2103900000000,2022-04-01,21,039,KY,Carlisle County,2265,2184,81,3.6
CN2104100000000,2022-04-01,21,041,KY,Carroll County,5552,5396,156,2.8
CN2104300000000,2022-04-01,21,043,KY,Carter County,9716,9146,570,5.9
CN2104500000000,2022-04-01,21,045,KY,Casey County,6686,6450,236,3.5
CN2104700000000,2022-04-01,21,047,KY,Christian County,24839,23700,1139,4.6
CN2104900000000,2022-04-01,21,049,KY,Clark County,17302,16751,551,3.2
CN2105100000000,2022-04-01,21,051,KY,Clay County,5094,4852,242,4.8
CN2105300000000,2022-04-01,21,053,KY,Clinton County,3592,3438,154,4.3
CN2105500000000,2022-04-01,21,055,KY,Crittenden County,3783,3642,141,3.7
CN2105700000000,2022-04-01,21,057,KY,Cumberland County,3365,3277,88,2.6
CN2105900000000,2022-04-01,21,059,KY,Daviess County,46188,44697,1491,3.2
CN2106100000000,2022-04-01,21,061,KY,Edmonson County,4728,4537,191,4
CN2106300000000,2022-04-01,21,063,KY,Elliott County,1870,1741,129,6.9
CN2106500000000,2022-04-01,21,065,KY,Estill County,5220,4993,227,4.3
CN2106700000000,2022-04-01,21,067,KY,Fayette County,176118,171151,4967,2.8
CN2106900000000,2022-04-01,21,069,KY,Fleming County,5912,5668,244,4.1
CN2107100000000,2022-04-01,21,071,KY,Floyd County,10836,10268,568,5.2
CN2107300000000,2022-04-01,21,073,KY,Franklin County,25115,24362,753,3
CN2107500000000,2022-04-01,21,075,KY,Fulton County,2091,2005,86,4.1
CN2107700000000,2022-04-01,21,077,KY,Gallatin County,4007,3878,129,3.2
CN2107900000000,2022-04-01,21,079,KY,Garrard County,7888,7609,279,3.5
CN2108100000000,2022-04-01,21,081,KY,Grant County,11775,11382,393,3.3
CN2108300000000,2022-04-01,21,083,KY,Graves County,15394,14727,667,4.3
CN2108500000000,2022-04-01,21,085,KY,Grayson County,10363,9932,431,4.2
CN2108700000000,2022-04-01,21,087,KY,Green County,5055,4888,167,3.3
CN2108900000000,2022-04-01,21,089,KY,Greenup County,13033,12370,663,5.1
CN2109100000000,2022-04-01,21,091,KY,Hancock County,3838,3707,131,3.4
CN2109300000000,2022-04-01,21,093,KY,Hardin County,47265,45569,1696,3.6
CN2109500000000,2022-04-01,21,095,KY,Harlan County,6406,6054,352,5.5
CN2109700000000,2022-04-01,21,097,KY,Harrison County,8759,8512,247,2.8
CN2109900000000,2022-04-01,21,099,KY,Hart County,7698,7443,255,3.3
CN2110100000000,2022-04-01,21,101,KY,Henderson County,20750,20047,703,3.4
CN2110300000000,2022-04-01,21,103,KY,Henry County,8058,7835,223,2.8
CN2110500000000,2022-04-01,21,105,KY,Hickman County,1630,1572,58,3.6
CN2110700000000,2022-04-01,21,107,KY,Hopkins County,18232,17499,733,4
CN2110900000000,2022-04-01,21,109,KY,Jackson County,4184,3970,214,5.1
CN2111100000000,2022-04-01,21,111,KY,Jefferson County,396038,383855,12183,3.1
CN2111300000000,2022-04-01,21,113,KY,Jessamine County,26730,25960,770,2.9
CN2111500000000,2022-04-01,21,115,KY,Johnson County,6616,6269,347,5.2
CN2111700000000,2022-04-01,21,117,KY,Kenton County,88668,85974,2694,3
CN2111900000000,2022-04-01,21,119,KY,Knott County,4190,3975,215,5.1
CN2112100000000,2022-04-01,21,121,KY,Knox County,9859,9391,468,4.7
CN2112300000000,2022-04-01,21,123,KY,Larue County,5792,5567,225,3.9
CN2112500000000,2022-04-01,21,125,KY,Laurel County,24934,24038,896,3.6
CN2112700000000,2022-04-01,21,127,KY,Lawrence County,5672,5410,262,4.6
CN2112900000000,2022-04-01,21,129,KY,Lee County,2077,1978,99,4.8
CN2113100000000,2022-04-01,21,131,KY,Leslie County,2481,2337,144,5.8
CN2113300000000,2022-04-01,21,133,KY,Letcher County,5932,5630,302,5.1
CN2113500000000,2022-04-01,21,135,KY,Lewis County,4519,4242,277,6.1
CN2113700000000,2022-04-01,21,137,KY,Lincoln County,9295,8903,392,4.2
CN2113900000000,2022-04-01,21,139,KY,Livingston County,3642,3481,161,4.4
CN2114100000000,2022-04-01,21,141,KY,Logan County,12273,11904,369,3
CN2114300000000,2022-04-01,21,143,KY,Lyon County,3184,3073,111,3.5
CN2114500000000,2022-04-01,21,145,KY,McCracken County,30036,28944,1092,3.6
CN2114700000000,2022-04-01,21,147,KY,McCreary County,4701,4482,219,4.7
CN2114900000000,2022-04-01,21,149,KY,McLean County,3943,3799,144,3.7
CN2115100000000,2022-04-01,21,151,KY,Madison County,47087,45504,1583,3.4
CN2115300000000,2022-04-01,21,153,KY,Magoffin County,3191,2887,304,9.5
CN2115500000000,2022-04-01,21,155,KY,Marion County,9115,8841,274,3
CN2115700000000,2022-04-01,21,157,KY,Marshall County,14755,14215,540,3.7
CN2115900000000,2022-04-01,21,159,KY,Martin County,2268,2124,144,6.3
CN2116100000000,2022-04-01,21,161,KY,Mason County,6522,6247,275,4.2
CN2116300000000,2022-04-01,21,163,KY,Meade County,11598,11173,425,3.7
CN2116500000000,2022-04-01,21,165,KY,Menifee County,2398,2265,133,5.5
CN2116700000000,2022-04-01,21,167,KY,Mercer County,10090,9756,334,3.3
CN2116900000000,2022-04-01,21,169,KY,Metcalfe County,3929,3764,165,4.2
CN2117100000000,2022-04-01,21,171,KY,Monroe County,4549,4423,126,2.8
CN2117300000000,2022-04-01,21,173,KY,Montgomery County,12001,11521,480,4
CN2117500000000,2022-04-01,21,175,KY,Morgan County,4083,3899,184,4.5
CN2117700000000,2022-04-01,21,177,KY,Muhlenberg County,9998,9516,482,4.8
CN2117900000000,2022-04-01,21,179,KY,Nelson County,23462,22759,703,3
CN2118100000000,2022-04-01,21,181,KY,Nicholas County,3292,3165,127,3.9
CN2118300000000,2022-04-01,21,183,KY,Ohio County,8933,8555,378,4.2
CN2118500000000,2022-04-01,21,185,KY,Oldham County,33397,32503,894,2.7
CN2118700000000,2022-04-01,21,187,KY,Owen County,5220,5070,150,2.9
CN2118900000000,2022-04-01,21,189,KY,Owsley County,1057,988,69,6.5
CN2119100000000,2022-04-01,21,191,KY,Pendleton County,6988,6771,217,3.1
CN2119300000000,2022-04-01,21,193,KY,Perry County,7908,7563,345,4.4
CN2119500000000,2022-04-01,21,195,KY,Pike County,18953,18067,886,4.7
CN2119700000000,2022-04-01,21,197,KY,Powell County,5224,5046,178,3.4
CN2119900000000,2022-04-01,21,199,KY,Pulaski County,25308,24300,1008,4
CN2120100000000,2022-04-01,21,201,KY,Robertson County,798,762,36,4.5
CN2120300000000,2022-04-01,21,203,KY,Rockcastle County,6497,6233,264,4.1
CN2120500000000,2022-04-01,21,205,KY,Rowan County,10342,9889,453,4.4
CN2120700000000,2022-04-01,21,207,KY,Russell County,6254,6007,247,3.9
CN2120900000000,2022-04-01,21,209,KY,Scott County,30373,29552,821,2.7
CN2121100000000,2022-04-01,21,211,KY,Shelby County,25771,25050,721,2.8
CN2121300000000,2022-04-01,21,213,KY,Simpson County,8789,8538,251,2.9
CN2121500000000,2022-04-01,21,215,KY,Spencer County,10573,10284,289,2.7
CN2121700000000,2022-04-01,21,217,KY,Taylor County,12278,11862,416,3.4
CN2121900000000,2022-04-01,21,219,KY,Todd County,5530,5369,161,2.9
CN2122100000000,2022-04-01,21,221,KY,Trigg County,5973,5741,232,3.9
CN2122300000000,2022-04-01,21,223,KY,Trimble County,3816,3674,142,3.7
CN2122500000000,2022-04-01,21,225,KY,Union County,5705,5475,230,4
CN2122700000000,2022-04-01,21,227,KY,Warren County,65899,63769,2130,3.2
CN2122900000000,2022-04-01,21,229,KY,Washington County,6068,5892,176,2.9
CN2123100000000,2022-04-01,21,231,KY,Wayne County,6910,6612,298,4.3
CN2123300000000,2022-04-01,21,233,KY,Webster County,5186,5008,178,3.4
CN2123500000000,2022-04-01,21,235,KY,Whitley County,13800,13257,543,3.9
CN2123700000000,2022-04-01,21,237,KY,Wolfe County,2291,2186,105,4.6
CN2123900000000,2022-04-01,21,239,KY,Woodford County,14628,14220,408,2.8
CN2200100000000,2022-04-01,22,001,LA,Acadia Parish,23986,23239,747,3.1
CN2200300000000,2022-04-01,22,003,LA,Allen Parish,8161,7870,291,3.6
CN2200500000000,2022-04-01,22,005,LA,Ascension Parish,67229,65487,1742,2.6
CN2200700000000,2022-04-01,22,007,LA,Assumption Parish,8894,8529,365,4.1
CN2200900000000,2022-04-01,22,009,LA,Avoyelles Parish,14393,13879,514,3.6
CN2201100000000,2022-04-01,22,011,LA,Beauregard Parish,15117,14682,435,2.9
CN2201300000000,2022-04-01,22,013,LA,Bienville Parish,5294,5102,192,3.6
CN2201500000000,2022-04-01,22,015,LA,Bossier Parish,57995,56512,1483,2.6
CN2201700000000,2022-04-01,22,017,LA,Caddo Parish,101636,97963,3673,3.6
CN2201900000000,2022-04-01,22,019,LA,Calcasieu Parish,92688,89798,2890,3.1
CN2202100000000,2022-04-01,22,021,LA,Caldwell Parish,3685,3561,124,3.4
CN2202300000000,2022-04-01,22,023,LA,Cameron Parish,3445,3361,84,2.4
CN2202500000000,2022-04-01,22,025,LA,Catahoula Parish,3506,3383,123,3.5
CN2202700000000,2022-04-01,22,027,LA,Claiborne Parish,5431,5258,173,3.2
CN2202900000000,2022-04-01,22,029,LA,Concordia Parish,7119,6838,281,3.9
CN2203100000000,2022-04-01,22,031,LA,De Soto Parish,10911,10548,363,3.3
CN2203300000000,2022-04-01,22,033,LA,East Baton Rouge Parish,234459,227348,7111,3
CN2203500000000,2022-04-01,22,035,LA,East Carroll Parish,1618,1510,108,6.7
CN2203700000000,2022-04-01,22,037,LA,East Feliciana Parish,7941,7722,219,2.8
CN2203900000000,2022-04-01,22,039,LA,Evangeline Parish,12303,11867,436,3.5
CN2204100000000,2022-04-01,22,041,LA,Franklin Parish,7501,7195,306,4.1
CN2204300000000,2022-04-01,22,043,LA,Grant Parish,8330,8096,234,2.8
CN2204500000000,2022-04-01,22,045,LA,Iberia Parish,27758,26721,1037,3.7
CN2204700000000,2022-04-01,22,047,LA,Iberville Parish,13991,13436,555,4
CN2204900000000,2022-04-01,22,049,LA,Jackson Parish,6972,6788,184,2.6
CN2205100000000,2022-04-01,22,051,LA,Jefferson Parish,210363,203507,6856,3.3
CN2205300000000,2022-04-01,22,053,LA,Jefferson Davis Parish,12402,12023,379,3.1
CN2205500000000,2022-04-01,22,055,LA,Lafayette Parish,116655,113434,3221,2.8
CN2205700000000,2022-04-01,22,057,LA,Lafourche Parish,40626,39414,1212,3
CN2205900000000,2022-04-01,22,059,LA,LaSalle Parish,6764,6614,150,2.2
CN2206100000000,2022-04-01,22,061,LA,Lincoln Parish,21560,20960,600,2.8
CN2206300000000,2022-04-01,22,063,LA,Livingston Parish,72132,70357,1775,2.5
CN2206500000000,2022-04-01,22,065,LA,Madison Parish,3516,3361,155,4.4
CN2206700000000,2022-04-01,22,067,LA,Morehouse Parish,9986,9520,466,4.7
CN2206900000000,2022-04-01,22,069,LA,Natchitoches Parish,16795,16273,522,3.1
CN2207100000000,2022-04-01,22,071,LA,Orleans Parish,176441,169212,7229,4.1
CN2207300000000,2022-04-01,22,073,LA,Ouachita Parish,70111,67842,2269,3.2
CN2207500000000,2022-04-01,22,075,LA,Plaquemines Parish,9826,9561,265,2.7
CN2207700000000,2022-04-01,22,077,LA,Pointe Coupee Parish,9902,9568,334,3.4
CN2207900000000,2022-04-01,22,079,LA,Rapides Parish,56156,54609,1547,2.8
CN2208100000000,2022-04-01,22,081,LA,Red River Parish,3756,3650,106,2.8
CN2208300000000,2022-04-01,22,083,LA,Richland Parish,8126,7841,285,3.5
CN2208500000000,2022-04-01,22,085,LA,Sabine Parish,9231,8972,259,2.8
CN2208700000000,2022-04-01,22,087,LA,St. Bernard Parish,20018,19311,707,3.5
CN2208900000000,2022-04-01,22,089,LA,St. Charles Parish,24771,24042,729,2.9
CN2209100000000,2022-04-01,22,091,LA,St. Helena Parish,4289,4093,196,4.6
CN2209300000000,2022-04-01,22,093,LA,St. James Parish,8886,8527,359,4
CN2209500000000,2022-04-01,22,095,LA,St. John the Baptist Parish,19090,18185,905,4.7
CN2209700000000,2022-04-01,22,097,LA,St. Landry Parish,32221,30962,1259,3.9
CN2209900000000,2022-04-01,22,099,LA,St. Martin Parish,22103,21392,711,3.2
CN2210100000000,2022-04-01,22,101,LA,St. Mary Parish,19192,18449,743,3.9
CN2210300000000,2022-04-01,22,103,LA,St. Tammany Parish,119626,116657,2969,2.5
CN2210500000000,2022-04-01,22,105,LA,Tangipahoa Parish,56514,54376,2138,3.8
CN2210700000000,2022-04-01,22,107,LA,Tensas Parish,1350,1293,57,4.2
CN2210900000000,2022-04-01,22,109,LA,Terrebonne Parish,44734,43164,1570,3.5
CN2211100000000,2022-04-01,22,111,LA,Union Parish,9179,8888,291,3.2
CN2211300000000,2022-04-01,22,113,LA,Vermilion Parish,24223,23463,760,3.1
CN2211500000000,2022-04-01,22,115,LA,Vernon Parish,16182,15672,510,3.2
CN2211700000000,2022-04-01,22,117,LA,Washington Parish,17079,16464,615,3.6
CN2211900000000,2022-04-01,22,119,LA,Webster Parish,14124,13635,489,3.5
CN2212100000000,2022-04-01,22,121,LA,West Baton Rouge Parish,14045,13658,387,2.8
CN2212300000000,2022-04-01,22,123,LA,West Carroll Parish,3623,3457,166,4.6
CN2212500000000,2022-04-01,22,125,LA,West Feliciana Parish,5482,5363,119,2.2
CN2212700000000,2022-04-01,22,127,LA,Winn Parish,4632,4477,155,3.3
CN2300100000000,2022-04-01,23,001,ME,Androscoggin County,52723,51221,1502,2.8
CN2300300000000,2022-04-01,23,003,ME,Aroostook County,28818,27290,1528,5.3
CN2300500000000,2022-04-01,23,005,ME,Cumberland County,159675,156074,3601,2.3
CN2300700000000,2022-04-01,23,007,ME,Franklin County,13780,13258,522,3.8
CN2300900000000,2022-04-01,23,009,ME,Hancock County,27648,26574,1074,3.9
CN2301100000000,2022-04-01,23,011,ME,Kennebec County,60605,58961,1644,2.7
CN2301300000000,2022-04-01,23,013,ME,Knox County,19535,18949,586,3
CN2301500000000,2022-04-01,23,015,ME,Lincoln County,16186,15694,492,3
CN2301700000000,2022-04-01,23,017,ME,Oxford County,25543,24725,818,3.2
CN2301900000000,2022-04-01,23,019,ME,Penobscot County,74776,72419,2357,3.2
CN2302100000000,2022-04-01,23,021,ME,Piscataquis County,7270,6942,328,4.5
CN2302300000000,2022-04-01,23,023,ME,Sagadahoc County,18900,18444,456,2.4
CN2302500000000,2022-04-01,23,025,ME,Somerset County,21774,20838,936,4.3
CN2302700000000,2022-04-01,23,027,ME,Waldo County,20070,19400,670,3.3
CN2302900000000,2022-04-01,23,029,ME,Washington County,13343,12681,662,5
CN2303100000000,2022-04-01,23,031,ME,York County,110127,107253,2874,2.6
CN2400100000000,2022-04-01,24,001,MD,Allegany County,31030,29909,1121,3.6
CN2400300000000,2022-04-01,24,003,MD,Anne Arundel County,311452,303638,7814,2.5
CN2400500000000,2022-04-01,24,005,MD,Baltimore County,441284,428036,13248,3
CN2400900000000,2022-04-01,24,009,MD,Calvert County,49191,47867,1324,2.7
CN2401100000000,2022-04-01,24,011,MD,Caroline County,16929,16481,448,2.6
CN2401300000000,2022-04-01,24,013,MD,Carroll County,93469,91369,2100,2.2
CN2401500000000,2022-04-01,24,015,MD,Cecil County,53343,51838,1505,2.8
CN2401700000000,2022-04-01,24,017,MD,Charles County,86085,83476,2609,3
CN2401900000000,2022-04-01,24,019,MD,Dorchester County,15362,14872,490,3.2
CN2402100000000,2022-04-01,24,021,MD,Frederick County,134464,131040,3424,2.5
CN2402300000000,2022-04-01,24,023,MD,Garrett County,14521,14109,412,2.8
CN2402500000000,2022-04-01,24,025,MD,Harford County,138498,134996,3502,2.5
CN2402700000000,2022-04-01,24,027,MD,Howard County,186412,182085,4327,2.3
CN2402900000000,2022-04-01,24,029,MD,Kent County,9404,9114,290,3.1
CN2403100000000,2022-04-01,24,031,MD,Montgomery County,545319,531425,13894,2.5
CN2403300000000,2022-04-01,24,033,MD,Prince George's County,494956,478512,16444,3.3
CN2403500000000,2022-04-01,24,035,MD,Queen Anne's County,27495,26861,634,2.3
CN2403700000000,2022-04-01,24,037,MD,St. Mary's County,57691,56140,1551,2.7
CN2403900000000,2022-04-01,24,039,MD,Somerset County,8604,8221,383,4.5
CN2404100000000,2022-04-01,24,041,MD,Talbot County,17221,16757,464,2.7
CN2404300000000,2022-04-01,24,043,MD,Washington County,71477,69449,2028,2.8
CN2404500000000,2022-04-01,24,045,MD,Wicomico County,49959,48194,1765,3.5
CN2404700000000,2022-04-01,24,047,MD,Worcester County,24599,23460,1139,4.6
CN2451000000000,2022-04-01,24,510,MD,Baltimore city,271753,261236,10517,3.9
CN2500100000000,2022-04-01,25,001,MA,Barnstable County,108297,103148,5149,4.8
CN2500300000000,2022-04-01,25,003,MA,Berkshire County,61151,58597,2554,4.2
CN2500500000000,2022-04-01,25,005,MA,Bristol County,297586,284937,12649,4.3
CN2500700000000,2022-04-01,25,007,MA,Dukes County,8905,8377,528,5.9
CN2500900000000,2022-04-01,25,009,MA,Essex County,418284,403049,15235,3.6
CN2501100000000,2022-04-01,25,011,MA,Franklin County,40124,38857,1267,3.2
CN2501300000000,2022-04-01,25,013,MA,Hampden County,222382,212213,10169,4.6
CN2501500000000,2022-04-01,25,015,MA,Hampshire County,88716,86110,2606,2.9
CN2501700000000,2022-04-01,25,017,MA,Middlesex County,904741,879734,25007,2.8
CN2501900000000,2022-04-01,25,019,MA,Nantucket County/town,7159,6673,486,6.8
CN2502100000000,2022-04-01,25,021,MA,Norfolk County,390696,378665,12031,3.1
CN2502300000000,2022-04-01,25,023,MA,Plymouth County,281775,271191,10584,3.8
CN2502500000000,2022-04-01,25,025,MA,Suffolk County,450248,435696,14552,3.2
CN2502700000000,2022-04-01,25,027,MA,Worcester County,441448,425634,15814,3.6
CN2600100000000,2022-04-01,26,001,MI,Alcona County,3743,3490,253,6.8
CN2600300000000,2022-04-01,26,003,MI,Alger County,3025,2754,271,9
CN2600500000000,2022-04-01,26,005,MI,Allegan County,61174,59081,2093,3.4
CN2600700000000,2022-04-01,26,007,MI,Alpena County,13197,12553,644,4.9
CN2600900000000,2022-04-01,26,009,MI,Antrim County,9572,8946,626,6.5
CN2601100000000,2022-04-01,26,011,MI,Arenac County,5752,5312,440,7.6
CN2601300000000,2022-04-01,26,013,MI,Baraga County,3083,2811,272,8.8
CN2601500000000,2022-04-01,26,015,MI,Barry County,31617,30493,1124,3.6
CN2601700000000,2022-04-01,26,017,MI,Bay County,48745,46262,2483,5.1
CN2601900000000,2022-04-01,26,019,MI,Benzie County,8518,8031,487,5.7
CN2602100000000,2022-04-01,26,021,MI,Berrien County,70891,67921,2970,4.2
CN2602300000000,2022-04-01,26,023,MI,Branch County,19494,18785,709,3.6
CN2602500000000,2022-04-01,26,025,MI,Calhoun County,59610,56958,2652,4.4
CN2602700000000,2022-04-01,26,027,MI,Cass County,23383,22457,926,4
CN2602900000000,2022-04-01,26,029,MI,Charlevoix County,12165,11525,640,5.3
CN2603100000000,2022-04-01,26,031,MI,Cheboygan County,9991,8821,1170,11.7
CN2603300000000,2022-04-01,26,033,MI,Chippewa County,16062,14946,1116,6.9
CN2603500000000,2022-04-01,26,035,MI,Clare County,11411,10599,812,7.1
CN2603700000000,2022-04-01,26,037,MI,Clinton County,40335,38843,1492,3.7
CN2603900000000,2022-04-01,26,039,MI,Crawford County,5426,5055,371,6.8
CN2604100000000,2022-04-01,26,041,MI,Delta County,16561,15572,989,6
CN2604300000000,2022-04-01,26,043,MI,Dickinson County,11987,11430,557,4.6
CN2604500000000,2022-04-01,26,045,MI,Eaton County,56209,53835,2374,4.2
CN2604700000000,2022-04-01,26,047,MI,Emmet County,16068,15032,1036,6.4
CN2604900000000,2022-04-01,26,049,MI,Genesee County,176985,167512,9473,5.4
CN2605100000000,2022-04-01,26,051,MI,Gladwin County,9828,9221,607,6.2
CN2605300000000,2022-04-01,26,053,MI,Gogebic County,5662,5320,342,6
CN2605500000000,2022-04-01,26,055,MI,Grand Traverse County,47905,46105,1800,3.8
CN2605700000000,2022-04-01,26,057,MI,Gratiot County,17508,16731,777,4.4
CN2605900000000,2022-04-01,26,059,MI,Hillsdale County,20082,19241,841,4.2
CN2606100000000,2022-04-01,26,061,MI,Houghton County,16258,15406,852,5.2
CN2606300000000,2022-04-01,26,063,MI,Huron County,14829,14154,675,4.6
CN2606500000000,2022-04-01,26,065,MI,Ingham County,146846,140628,6218,4.2
CN2606700000000,2022-04-01,26,067,MI,Ionia County,30118,29031,1087,3.6
CN2606900000000,2022-04-01,26,069,MI,Iosco County,10015,9331,684,6.8
CN2607100000000,2022-04-01,26,071,MI,Iron County,4685,4378,307,6.6
CN2607300000000,2022-04-01,26,073,MI,Isabella County,32635,31179,1456,4.5
CN2607500000000,2022-04-01,26,075,MI,Jackson County,74291,71151,3140,4.2
CN2607700000000,2022-04-01,26,077,MI,Kalamazoo County,131362,126645,4717,3.6
CN2607900000000,2022-04-01,26,079,MI,Kalkaska County,7631,7165,466,6.1
CN2608100000000,2022-04-01,26,081,MI,Kent County,357621,346141,11480,3.2
CN2608300000000,2022-04-01,26,083,MI,Keweenaw County,913,847,66,7.2
CN2608500000000,2022-04-01,26,085,MI,Lake County,3820,3556,264,6.9
CN2608700000000,2022-04-01,26,087,MI,Lapeer County,39712,38114,1598,4
CN2608900000000,2022-04-01,26,089,MI,Leelanau County,10027,9576,451,4.5
CN2609100000000,2022-04-01,26,091,MI,Lenawee County,44996,42974,2022,4.5
CN2609300000000,2022-04-01,26,093,MI,Livingston County,101499,98971,2528,2.5
CN2609500000000,2022-04-01,26,095,MI,Luce County,2063,1907,156,7.6
CN2609700000000,2022-04-01,26,097,MI,Mackinac County,4621,3919,702,15.2
CN2609900000000,2022-04-01,26,099,MI,Macomb County,435459,420231,15228,3.5
CN2610100000000,2022-04-01,26,101,MI,Manistee County,9649,9053,596,6.2
CN2610300000000,2022-04-01,26,103,MI,Marquette County,31608,29998,1610,5.1
CN2610500000000,2022-04-01,26,105,MI,Mason County,12890,12232,658,5.1
CN2610700000000,2022-04-01,26,107,MI,Mecosta County,18333,17397,936,5.1
CN2610900000000,2022-04-01,26,109,MI,Menominee County,10622,10155,467,4.4
CN2611100000000,2022-04-01,26,111,MI,Midland County,39825,38142,1683,4.2
CN2611300000000,2022-04-01,26,113,MI,Missaukee County,6719,6362,357,5.3
CN2611500000000,2022-04-01,26,115,MI,Monroe County,74472,71241,3231,4.3
CN2611700000000,2022-04-01,26,117,MI,Montcalm County,27547,26428,1119,4.1
CN2611900000000,2022-04-01,26,119,MI,Montmorency County,2962,2702,260,8.8
CN2612100000000,2022-04-01,26,121,MI,Muskegon County,75933,72327,3606,4.7
CN2612300000000,2022-04-01,26,123,MI,Newaygo County,23062,22035,1027,4.5
CN2612500000000,2022-04-01,26,125,MI,Oakland County,656816,639205,17611,2.7
CN2612700000000,2022-04-01,26,127,MI,Oceana County,11048,10258,790,7.2
CN2612900000000,2022-04-01,26,129,MI,Ogemaw County,8262,7666,596,7.2
CN2613100000000,2022-04-01,26,131,MI,Ontonagon County,1937,1757,180,9.3
CN2613300000000,2022-04-01,26,133,MI,Osceola County,11170,10640,530,4.7
CN2613500000000,2022-04-01,26,135,MI,Oscoda County,2754,2522,232,8.4
CN2613700000000,2022-04-01,26,137,MI,Otsego County,11237,10576,661,5.9
CN2613900000000,2022-04-01,26,139,MI,Ottawa County,160602,155855,4747,3
CN2614100000000,2022-04-01,26,141,MI,Presque Isle County,4805,4432,373,7.8
CN2614300000000,2022-04-01,26,143,MI,Roscommon County,7826,7038,788,10.1
CN2614500000000,2022-04-01,26,145,MI,Saginaw County,82482,78034,4448,5.4
CN2614700000000,2022-04-01,26,147,MI,St. Clair County,73382,70807,2575,3.5
CN2614900000000,2022-04-01,26,149,MI,St. Joseph County,28179,27181,998,3.5
CN2615100000000,2022-04-01,26,151,MI,Sanilac County,18536,17574,962,5.2
CN2615300000000,2022-04-01,26,153,MI,Schoolcraft County,3096,2825,271,8.8
CN2615500000000,2022-04-01,26,155,MI,Shiawassee County,32189,30693,1496,4.6
CN2615700000000,2022-04-01,26,157,MI,Tuscola County,22862,21673,1189,5.2
CN2615900000000,2022-04-01,26,159,MI,Van Buren County,34092,32470,1622,4.8
CN2616100000000,2022-04-01,26,161,MI,Washtenaw County,195145,188831,6314,3.2
CN2616300000000,2022-04-01,26,163,MI,Wayne County,781795,747424,34371,4.4
CN2616500000000,2022-04-01,26,165,MI,Wexford County,14559,13870,689,4.7
CN2700100000000,2022-04-01,27,001,MN,Aitkin County,7347,7027,320,4.4
CN2700300000000,2022-04-01,27,003,MN,Anoka County,197587,193448,4139,2.1
CN2700500000000,2022-04-01,27,005,MN,Becker County,18944,18443,501,2.6
CN2700700000000,2022-04-01,27,007,MN,Beltrami County,24733,23932,801,3.2
CN2700900000000,2022-04-01,27,009,MN,Benton County,21532,20884,648,3
CN2701100000000,2022-04-01,27,011,MN,Big Stone County,2313,2240,73,3.2
CN2701300000000,2022-04-01,27,013,MN,Blue Earth County,40213,39493,720,1.8
CN2701500000000,2022-04-01,27,015,MN,Brown County,13715,13406,309,2.3
CN2701700000000,2022-04-01,27,017,MN,Carlton County,17528,16939,589,3.4
CN2701900000000,2022-04-01,27,019,MN,Carver County,58898,57917,981,1.7
CN2702100000000,2022-04-01,27,021,MN,Cass County,14263,13696,567,4
CN2702300000000,2022-04-01,27,023,MN,Chippewa County,6492,6362,130,2
CN2702500000000,2022-04-01,27,025,MN,Chisago County,29751,28961,790,2.7
CN2702700000000,2022-04-01,27,027,MN,Clay County,37318,36639,679,1.8
CN2702900000000,2022-04-01,27,029,MN,Clearwater County,4464,4110,354,7.9
CN2703100000000,2022-04-01,27,031,MN,Cook County,2637,2537,100,3.8
CN2703300000000,2022-04-01,27,033,MN,Cottonwood County,6521,6399,122,1.9
CN2703500000000,2022-04-01,27,035,MN,Crow Wing County,32889,31978,911,2.8
CN2703700000000,2022-04-01,27,037,MN,Dakota County,240950,236501,4449,1.8
CN2703900000000,2022-04-01,27,039,MN,Dodge County,11726,11448,278,2.4
CN2704100000000,2022-04-01,27,041,MN,Douglas County,21169,20755,414,2
CN2704300000000,2022-04-01,27,043,MN,Faribault County,6803,6614,189,2.8
CN2704500000000,2022-04-01,27,045,MN,Fillmore County,11149,10917,232,2.1
CN2704700000000,2022-04-01,27,047,MN,Freeborn County,15648,15314,334,2.1
CN2704900000000,2022-04-01,27,049,MN,Goodhue County,26317,25753,564,2.1
CN2705100000000,2022-04-01,27,051,MN,Grant County,3191,3096,95,3
CN2705300000000,2022-04-01,27,053,MN,Hennepin County,699682,686588,13094,1.9
CN2705500000000,2022-04-01,27,055,MN,Houston County,10377,10194,183,1.8
CN2705700000000,2022-04-01,27,057,MN,Hubbard County,9716,9299,417,4.3
CN2705900000000,2022-04-01,27,059,MN,Isanti County,21622,20976,646,3
CN2706100000000,2022-04-01,27,061,MN,Itasca County,21255,20318,937,4.4
CN2706300000000,2022-04-01,27,063,MN,Jackson County,5283,5181,102,1.9
CN2706500000000,2022-04-01,27,065,MN,Kanabec County,9058,8632,426,4.7
CN2706700000000,2022-04-01,27,067,MN,Kandiyohi County,23049,22460,589,2.6
CN2706900000000,2022-04-01,27,069,MN,Kittson County,2176,2120,56,2.6
CN2707100000000,2022-04-01,27,071,MN,Koochiching County,5755,5474,281,4.9
CN2707300000000,2022-04-01,27,073,MN,Lac qui Parle County,3355,3276,79,2.4
CN2707500000000,2022-04-01,27,075,MN,Lake County,5248,5118,130,2.5
CN2707700000000,2022-04-01,27,077,MN,Lake of the Woods County,2241,2179,62,2.8
CN2707900000000,2022-04-01,27,079,MN,Le Sueur County,15801,15255,546,3.5
CN2708100000000,2022-04-01,27,081,MN,Lincoln County,2963,2875,88,3
CN2708300000000,2022-04-01,27,083,MN,Lyon County,14461,14156,305,2.1
CN2708500000000,2022-04-01,27,085,MN,McLeod County,19167,18699,468,2.4
CN2708700000000,2022-04-01,27,087,MN,Mahnomen County,2182,2083,99,4.5
CN2708900000000,2022-04-01,27,089,MN,Marshall County,5236,5020,216,4.1
CN2709100000000,2022-04-01,27,091,MN,Martin County,9411,9215,196,2.1
CN2709300000000,2022-04-01,27,093,MN,Meeker County,13329,12974,355,2.7
CN2709500000000,2022-04-01,27,095,MN,Mille Lacs County,12589,12073,516,4.1
CN2709700000000,2022-04-01,27,097,MN,Morrison County,17045,16327,718,4.2
CN2709900000000,2022-04-01,27,099,MN,Mower County,20589,20182,407,2
CN2710100000000,2022-04-01,27,101,MN,Murray County,4558,4412,146,3.2
CN2710300000000,2022-04-01,27,103,MN,Nicollet County,20555,20247,308,1.5
CN2710500000000,2022-04-01,27,105,MN,Nobles County,10960,10778,182,1.7
CN2710700000000,2022-04-01,27,107,MN,Norman County,3079,2981,98,3.2
CN2710900000000,2022-04-01,27,109,MN,Olmsted County,90066,88544,1522,1.7
CN2711100000000,2022-04-01,27,111,MN,Otter Tail County,30845,29966,879,2.8
CN2711300000000,2022-04-01,27,113,MN,Pennington County,8710,8408,302,3.5
CN2711500000000,2022-04-01,27,115,MN,Pine County,14350,13744,606,4.2
CN2711700000000,2022-04-01,27,117,MN,Pipestone County,4519,4410,109,2.4
CN2711900000000,2022-04-01,27,119,MN,Polk County,15815,15389,426,2.7
CN2712100000000,2022-04-01,27,121,MN,Pope County,6402,6263,139,2.2
CN2712300000000,2022-04-01,27,123,MN,Ramsey County,283544,277644,5900,2.1
CN2712500000000,2022-04-01,27,125,MN,Red Lake County,2149,2065,84,3.9
CN2712700000000,2022-04-01,27,127,MN,Redwood County,7439,7272,167,2.2
CN2712900000000,2022-04-01,27,129,MN,Renville County,7912,7658,254,3.2
CN2713100000000,2022-04-01,27,131,MN,Rice County,37415,36626,789,2.1
CN2713300000000,2022-04-01,27,133,MN,Rock County,5919,5851,68,1.1
CN2713500000000,2022-04-01,27,135,MN,Roseau County,7909,7741,168,2.1
CN2713700000000,2022-04-01,27,137,MN,St. Louis County,99764,97105,2659,2.7
CN2713900000000,2022-04-01,27,139,MN,Scott County,83905,82422,1483,1.8
CN2714100000000,2022-04-01,27,141,MN,Sherburne County,52860,51602,1258,2.4
CN2714300000000,2022-04-01,27,143,MN,Sibley County,7927,7699,228,2.9
CN2714500000000,2022-04-01,27,145,MN,Stearns County,89028,87033,1995,2.2
CN2714700000000,2022-04-01,27,147,MN,Steele County,19152,18714,438,2.3
CN2714900000000,2022-04-01,27,149,MN,Stevens County,5281,5189,92,1.7
CN2715100000000,2022-04-01,27,151,MN,Swift County,4679,4553,126,2.7
CN2715300000000,2022-04-01,27,153,MN,Todd County,13344,12958,386,2.9
CN2715500000000,2022-04-01,27,155,MN,Traverse County,1589,1548,41,2.6
CN2715700000000,2022-04-01,27,157,MN,Wabasha County,11885,11639,246,2.1
CN2715900000000,2022-04-01,27,159,MN,Wadena County,6029,5801,228,3.8
CN2716100000000,2022-04-01,27,161,MN,Waseca County,8523,8266,257,3
CN2716300000000,2022-04-01,27,163,MN,Washington County,144034,141546,2488,1.7
CN2716500000000,2022-04-01,27,165,MN,Watonwan County,6331,6183,148,2.3
CN2716700000000,2022-04-01,27,167,MN,Wilkin County,3327,3265,62,1.9
CN2716900000000,2022-04-01,27,169,MN,Winona County,28271,27823,448,1.6
CN2717100000000,2022-04-01,27,171,MN,Wright County,76063,74467,1596,2.1
CN2717300000000,2022-04-01,27,173,MN,Yellow Medicine County,4960,4846,114,2.3
CN2800100000000,2022-04-01,28,001,MS,Adams County,10385,9901,484,4.7
CN2800300000000,2022-04-01,28,003,MS,Alcorn County,15227,14743,484,3.2
CN2800500000000,2022-04-01,28,005,MS,Amite County,4345,4149,196,4.5
CN2800700000000,2022-04-01,28,007,MS,Attala County,6925,6662,263,3.8
CN2800900000000,2022-04-01,28,009,MS,Benton County,3042,2917,125,4.1
CN2801100000000,2022-04-01,28,011,MS,Bolivar County,11329,10882,447,3.9
CN2801300000000,2022-04-01,28,013,MS,Calhoun County,5544,5360,184,3.3
CN2801500000000,2022-04-01,28,015,MS,Carroll County,3444,3305,139,4
CN2801700000000,2022-04-01,28,017,MS,Chickasaw County,6781,6545,236,3.5
CN2801900000000,2022-04-01,28,019,MS,Choctaw County,3630,3507,123,3.4
CN2802100000000,2022-04-01,28,021,MS,Claiborne County,2908,2711,197,6.8
CN2802300000000,2022-04-01,28,023,MS,Clarke County,5695,5446,249,4.4
CN2802500000000,2022-04-01,28,025,MS,Clay County,8654,8334,320,3.7
CN2802700000000,2022-04-01,28,027,MS,Coahoma County,7674,7308,366,4.8
CN2802900000000,2022-04-01,28,029,MS,Copiah County,10768,10348,420,3.9
CN2803100000000,2022-04-01,28,031,MS,Covington County,8220,7950,270,3.3
CN2803300000000,2022-04-01,28,033,MS,DeSoto County,93654,90950,2704,2.9
CN2803500000000,2022-04-01,28,035,MS,Forrest County,33319,32192,1127,3.4
CN2803700000000,2022-04-01,28,037,MS,Franklin County,2648,2528,120,4.5
CN2803900000000,2022-04-01,28,039,MS,George County,8797,8413,384,4.4
CN2804100000000,2022-04-01,28,041,MS,Greene County,4224,4016,208,4.9
CN2804300000000,2022-04-01,28,043,MS,Grenada County,8818,8526,292,3.3
CN2804500000000,2022-04-01,28,045,MS,Hancock County,19003,18316,687,3.6
CN2804700000000,2022-04-01,28,047,MS,Harrison County,87224,84313,2911,3.3
CN2804900000000,2022-04-01,28,049,MS,Hinds County,101201,97632,3569,3.5
CN2805100000000,2022-04-01,28,051,MS,Holmes County,5079,4790,289,5.7
CN2805300000000,2022-04-01,28,053,MS,Humphreys County,2020,1889,131,6.5
CN2805500000000,2022-04-01,28,055,MS,Issaquena County,329,305,24,7.3
CN2805700000000,2022-04-01,28,057,MS,Itawamba County,10318,10023,295,2.9
CN2805900000000,2022-04-01,28,059,MS,Jackson County,58401,56173,2228,3.8
CN2806100000000,2022-04-01,28,061,MS,Jasper County,5864,5603,261,4.5
CN2806300000000,2022-04-01,28,063,MS,Jefferson County,1857,1664,193,10.4
CN2806500000000,2022-04-01,28,065,MS,Jefferson Davis County,3829,3654,175,4.6
CN2806700000000,2022-04-01,28,067,MS,Jones County,24931,24016,915,3.7
CN2806900000000,2022-04-01,28,069,MS,Kemper County,3295,3138,157,4.8
CN2807100000000,2022-04-01,28,071,MS,Lafayette County,28397,27606,791,2.8
CN2807300000000,2022-04-01,28,073,MS,Lamar County,31683,30800,883,2.8
CN2807500000000,2022-04-01,28,075,MS,Lauderdale County,29083,28034,1049,3.6
CN2807700000000,2022-04-01,28,077,MS,Lawrence County,4816,4616,200,4.2
CN2807900000000,2022-04-01,28,079,MS,Leake County,7890,7592,298,3.8
CN2808100000000,2022-04-01,28,081,MS,Lee County,40859,39690,1169,2.9
CN2808300000000,2022-04-01,28,083,MS,Leflore County,9639,9187,452,4.7
CN2808500000000,2022-04-01,28,085,MS,Lincoln County,14995,14520,475,3.2
CN2808700000000,2022-04-01,28,087,MS,Lowndes County,24647,23751,896,3.6
CN2808900000000,2022-04-01,28,089,MS,Madison County,53140,51643,1497,2.8
CN2809100000000,2022-04-01,28,091,MS,Marion County,10238,9894,344,3.4
CN2809300000000,2022-04-01,28,093,MS,Marshall County,14248,13738,510,3.6
CN2809500000000,2022-04-01,28,095,MS,Monroe County,15849,15337,512,3.2
CN2809700000000,2022-04-01,28,097,MS,Montgomery County,3924,3771,153,3.9
CN2809900000000,2022-04-01,28,099,MS,Neshoba County,9892,9509,383,3.9
CN2810100000000,2022-04-01,28,101,MS,Newton County,8138,7831,307,3.8
CN2810300000000,2022-04-01,28,103,MS,Noxubee County,3475,3294,181,5.2
CN2810500000000,2022-04-01,28,105,MS,Oktibbeha County,22411,21634,777,3.5
CN2810700000000,2022-04-01,28,107,MS,Panola County,12370,11849,521,4.2
CN2810900000000,2022-04-01,28,109,MS,Pearl River County,23512,22693,819,3.5
CN2811100000000,2022-04-01,28,111,MS,Perry County,4252,4080,172,4
CN2811300000000,2022-04-01,28,113,MS,Pike County,14083,13491,592,4.2
CN2811500000000,2022-04-01,28,115,MS,Pontotoc County,14956,14532,424,2.8
CN2811700000000,2022-04-01,28,117,MS,Prentiss County,11422,11097,325,2.8
CN2811900000000,2022-04-01,28,119,MS,Quitman County,2376,2272,104,4.4
CN2812100000000,2022-04-01,28,121,MS,Rankin County,76192,74231,1961,2.6
CN2812300000000,2022-04-01,28,123,MS,Scott County,12120,11755,365,3
CN2812500000000,2022-04-01,28,125,MS,Sharkey County,1367,1293,74,5.4
CN2812700000000,2022-04-01,28,127,MS,Simpson County,10589,10233,356,3.4
CN2812900000000,2022-04-01,28,129,MS,Smith County,6734,6511,223,3.3
CN2813100000000,2022-04-01,28,131,MS,Stone County,6916,6656,260,3.8
CN2813300000000,2022-04-01,28,133,MS,Sunflower County,7298,6926,372,5.1
CN2813500000000,2022-04-01,28,135,MS,Tallahatchie County,4801,4626,175,3.6
CN2813700000000,2022-04-01,28,137,MS,Tate County,12195,11763,432,3.5
CN2813900000000,2022-04-01,28,139,MS,Tippah County,9707,9422,285,2.9
CN2814100000000,2022-04-01,28,141,MS,Tishomingo County,8577,8313,264,3.1
CN2814300000000,2022-04-01,28,143,MS,Tunica County,4196,4031,165,3.9
CN2814500000000,2022-04-01,28,145,MS,Union County,14655,14293,362,2.5
CN2814700000000,2022-04-01,28,147,MS,Walthall County,4944,4733,211,4.3
CN2814900000000,2022-04-01,28,149,MS,Warren County,19418,18703,715,3.7
CN2815100000000,2022-04-01,28,151,MS,Washington County,14920,14153,767,5.1
CN2815300000000,2022-04-01,28,153,MS,Wayne County,7130,6801,329,4.6
CN2815500000000,2022-04-01,28,155,MS,Webster County,3914,3780,134,3.4
CN2815700000000,2022-04-01,28,157,MS,Wilkinson County,2613,2459,154,5.9
CN2815900000000,2022-04-01,28,159,MS,Winston County,7085,6800,285,4
CN2816100000000,2022-04-01,28,161,MS,Yalobusha County,4836,4671,165,3.4
CN2816300000000,2022-04-01,28,163,MS,Yazoo County,8934,8575,359,4
CN2900100000000,2022-04-01,29,001,MO,Adair County,10085,9864,221,2.2
CN2900300000000,2022-04-01,29,003,MO,Andrew County,9414,9268,146,1.6
CN2900500000000,2022-04-01,29,005,MO,Atchison County,2643,2598,45,1.7
CN2900700000000,2022-04-01,29,007,MO,Audrain County,10052,9751,301,3
CN2900900000000,2022-04-01,29,009,MO,Barry County,14508,14205,303,2.1
CN2901100000000,2022-04-01,29,011,MO,Barton County,5241,5145,96,1.8
CN2901300000000,2022-04-01,29,013,MO,Bates County,7637,7476,161,2.1
CN2901500000000,2022-04-01,29,015,MO,Benton County,7267,7060,207,2.8
CN2901700000000,2022-04-01,29,017,MO,Bollinger County,5306,5202,104,2
CN2901900000000,2022-04-01,29,019,MO,Boone County,99596,98079,1517,1.5
CN2902100000000,2022-04-01,29,021,MO,Buchanan County,42087,41274,813,1.9
CN2902300000000,2022-04-01,29,023,MO,Butler County,17816,17409,407,2.3
CN2902500000000,2022-04-01,29,025,MO,Caldwell County,4242,4164,78,1.8
CN2902700000000,2022-04-01,29,027,MO,Callaway County,21602,21210,392,1.8
CN2902900000000,2022-04-01,29,029,MO,Camden County,18767,18310,457,2.4
CN2903100000000,2022-04-01,29,031,MO,Cape Girardeau County,40311,39613,698,1.7
CN2903300000000,2022-04-01,29,033,MO,Carroll County,4486,4385,101,2.3
CN2903500000000,2022-04-01,29,035,MO,Carter County,2490,2416,74,3
CN2903700000000,2022-04-01,29,037,MO,Cass County,54500,53438,1062,1.9
CN2903900000000,2022-04-01,29,039,MO,Cedar County,5723,5615,108,1.9
CN2904100000000,2022-04-01,29,041,MO,Chariton County,3703,3642,61,1.6
CN2904300000000,2022-04-01,29,043,MO,Christian County,47216,46466,750,1.6
CN2904500000000,2022-04-01,29,045,MO,Clark County,3049,2958,91,3
CN2904700000000,2022-04-01,29,047,MO,Clay County,137266,134612,2654,1.9
CN2904900000000,2022-04-01,29,049,MO,Clinton County,10556,10336,220,2.1
CN2905100000000,2022-04-01,29,051,MO,Cole County,39125,38538,587,1.5
CN2905300000000,2022-04-01,29,053,MO,Cooper County,7134,7010,124,1.7
CN2905500000000,2022-04-01,29,055,MO,Crawford County,10730,10475,255,2.4
CN2905700000000,2022-04-01,29,057,MO,Dade County,3530,3470,60,1.7
CN2905900000000,2022-04-01,29,059,MO,Dallas County,7248,7086,162,2.2
CN2906100000000,2022-04-01,29,061,MO,Daviess County,4074,3998,76,1.9
CN2906300000000,2022-04-01,29,063,MO,DeKalb County,4065,3986,79,1.9
CN2906500000000,2022-04-01,29,065,MO,Dent County,6141,5979,162,2.6
CN2906700000000,2022-04-01,29,067,MO,Douglas County,5141,5028,113,2.2
CN2906900000000,2022-04-01,29,069,MO,Dunklin County,11186,10795,391,3.5
CN2907100000000,2022-04-01,29,071,MO,Franklin County,52785,51793,992,1.9
CN2907300000000,2022-04-01,29,073,MO,Gasconade County,7625,7492,133,1.7
CN2907500000000,2022-04-01,29,075,MO,Gentry County,3264,3215,49,1.5
CN2907700000000,2022-04-01,29,077,MO,Greene County,154484,151945,2539,1.6
CN2907900000000,2022-04-01,29,079,MO,Grundy County,4159,4072,87,2.1
CN2908100000000,2022-04-01,29,081,MO,Harrison County,3788,3725,63,1.7
CN2908300000000,2022-04-01,29,083,MO,Henry County,10230,10014,216,2.1
CN2908500000000,2022-04-01,29,085,MO,Hickory County,4115,4030,85,2.1
CN2908700000000,2022-04-01,29,087,MO,Holt County,2507,2473,34,1.4
CN2908900000000,2022-04-01,29,089,MO,Howard County,4804,4713,91,1.9
CN2909100000000,2022-04-01,29,091,MO,Howell County,15904,15540,364,2.3
CN2909300000000,2022-04-01,29,093,MO,Iron County,3471,3349,122,3.5
CN2909500000000,2022-04-01,29,095,MO,Jackson County,356295,347724,8571,2.4
CN2909700000000,2022-04-01,29,097,MO,Jasper County,56501,55423,1078,1.9
CN2909900000000,2022-04-01,29,099,MO,Jefferson County,117572,115269,2303,2
CN2910100000000,2022-04-01,29,101,MO,Johnson County,23061,22595,466,2
CN2910300000000,2022-04-01,29,103,MO,Knox County,1740,1709,31,1.8
CN2910500000000,2022-04-01,29,105,MO,Laclede County,16504,16172,332,2
CN2910700000000,2022-04-01,29,107,MO,Lafayette County,16699,16349,350,2.1
CN2910900000000,2022-04-01,29,109,MO,Lawrence County,17303,16979,324,1.9
CN2911100000000,2022-04-01,29,111,MO,Lewis County,4835,4748,87,1.8
CN2911300000000,2022-04-01,29,113,MO,Lincoln County,29217,28608,609,2.1
CN2911500000000,2022-04-01,29,115,MO,Linn County,5048,4937,111,2.2
CN2911700000000,2022-04-01,29,117,MO,Livingston County,7244,7126,118,1.6
CN2911900000000,2022-04-01,29,119,MO,McDonald County,10967,10734,233,2.1
CN2912100000000,2022-04-01,29,121,MO,Macon County,7268,7124,144,2
CN2912300000000,2022-04-01,29,123,MO,Madison County,5365,5241,124,2.3
CN2912500000000,2022-04-01,29,125,MO,Maries County,3894,3816,78,2
CN2912700000000,2022-04-01,29,127,MO,Marion County,13775,13520,255,1.9
CN2912900000000,2022-04-01,29,129,MO,Mercer County,1799,1765,34,1.9
CN2913100000000,2022-04-01,29,131,MO,Miller County,12726,12470,256,2
CN2913300000000,2022-04-01,29,133,MO,Mississippi County,5254,5112,142,2.7
CN2913500000000,2022-04-01,29,135,MO,Moniteau County,7154,7021,133,1.9
CN2913700000000,2022-04-01,29,137,MO,Monroe County,3814,3730,84,2.2
CN2913900000000,2022-04-01,29,139,MO,Montgomery County,5880,5762,118,2
CN2914100000000,2022-04-01,29,141,MO,Morgan County,8291,8102,189,2.3
CN2914300000000,2022-04-01,29,143,MO,New Madrid County,8255,8044,211,2.6
CN2914500000000,2022-04-01,29,145,MO,Newton County,26829,26313,516,1.9
CN2914700000000,2022-04-01,29,147,MO,Nodaway County,11117,10945,172,1.5
CN2914900000000,2022-04-01,29,149,MO,Oregon County,3768,3680,88,2.3
CN2915100000000,2022-04-01,29,151,MO,Osage County,7095,6991,104,1.5
CN2915300000000,2022-04-01,29,153,MO,Ozark County,3498,3403,95,2.7
CN2915500000000,2022-04-01,29,155,MO,Pemiscot County,5834,5645,189,3.2
CN2915700000000,2022-04-01,29,157,MO,Perry County,9612,9454,158,1.6
CN2915900000000,2022-04-01,29,159,MO,Pettis County,20081,19687,394,2
CN2916100000000,2022-04-01,29,161,MO,Phelps County,19938,19564,374,1.9
CN2916300000000,2022-04-01,29,163,MO,Pike County,7323,7162,161,2.2
CN2916500000000,2022-04-01,29,165,MO,Platte County,59464,58390,1074,1.8
CN2916700000000,2022-04-01,29,167,MO,Polk County,14727,14455,272,1.8
CN2916900000000,2022-04-01,29,169,MO,Pulaski County,14454,14121,333,2.3
CN2917100000000,2022-04-01,29,171,MO,Putnam County,2243,2198,45,2
CN2917300000000,2022-04-01,29,173,MO,Ralls County,5444,5347,97,1.8
CN2917500000000,2022-04-01,29,175,MO,Randolph County,10253,10046,207,2
CN2917700000000,2022-04-01,29,177,MO,Ray County,10749,10508,241,2.2
CN2917900000000,2022-04-01,29,179,MO,Reynolds County,2883,2818,65,2.3
CN2918100000000,2022-04-01,29,181,MO,Ripley County,5005,4885,120,2.4
CN2918300000000,2022-04-01,29,183,MO,St. Charles County,228633,224748,3885,1.7
CN2918500000000,2022-04-01,29,185,MO,St. Clair County,3867,3782,85,2.2
CN2918600000000,2022-04-01,29,186,MO,Ste. Genevieve County,9274,9108,166,1.8
CN2918700000000,2022-04-01,29,187,MO,St. Francois County,25537,24832,705,2.8
CN2918900000000,2022-04-01,29,189,MO,St. Louis County,524715,513825,10890,2.1
CN2919500000000,2022-04-01,29,195,MO,Saline County,10482,10306,176,1.7
CN2919700000000,2022-04-01,29,197,MO,Schuyler County,1867,1827,40,2.1
CN2919900000000,2022-04-01,29,199,MO,Scotland County,2296,2248,48,2.1
CN2920100000000,2022-04-01,29,201,MO,Scott County,19935,19548,387,1.9
CN2920300000000,2022-04-01,29,203,MO,Shannon County,3315,3220,95,2.9
CN2920500000000,2022-04-01,29,205,MO,Shelby County,3010,2959,51,1.7
CN2920700000000,2022-04-01,29,207,MO,Stoddard County,13304,13005,299,2.2
CN2920900000000,2022-04-01,29,209,MO,Stone County,13189,12812,377,2.9
CN2921100000000,2022-04-01,29,211,MO,Sullivan County,2570,2507,63,2.5
CN2921300000000,2022-04-01,29,213,MO,Taney County,25306,24553,753,3
CN2921500000000,2022-04-01,29,215,MO,Texas County,9083,8874,209,2.3
CN2921700000000,2022-04-01,29,217,MO,Vernon County,9137,8962,175,1.9
CN2921900000000,2022-04-01,29,219,MO,Warren County,18727,18357,370,2
CN2922100000000,2022-04-01,29,221,MO,Washington County,10152,9880,272,2.7
CN2922300000000,2022-04-01,29,223,MO,Wayne County,4725,4588,137,2.9
CN2922500000000,2022-04-01,29,225,MO,Webster County,17647,17343,304,1.7
CN2922700000000,2022-04-01,29,227,MO,Worth County,1189,1173,16,1.3
CN2922900000000,2022-04-01,29,229,MO,Wright County,7747,7582,165,2.1
CN2951000000000,2022-04-01,29,510,MO,St. Louis city,148167,144221,3946,2.7
CN3000100000000,2022-04-01,30,001,MT,Beaverhead County,5200,5064,136,2.6
CN3000300000000,2022-04-01,30,003,MT,Big Horn County,4802,4586,216,4.5
CN3000500000000,2022-04-01,30,005,MT,Blaine County,2297,2223,74,3.2
CN3000700000000,2022-04-01,30,007,MT,Broadwater County,2763,2674,89,3.2
CN3000900000000,2022-04-01,30,009,MT,Carbon County,5859,5696,163,2.8
CN3001100000000,2022-04-01,30,011,MT,Carter County,702,688,14,2
CN3001300000000,2022-04-01,30,013,MT,Cascade County,39157,38108,1049,2.7
CN3001500000000,2022-04-01,30,015,MT,Chouteau County,2533,2479,54,2.1
CN3001700000000,2022-04-01,30,017,MT,Custer County,6400,6247,153,2.4
CN3001900000000,2022-04-01,30,019,MT,Daniels County,909,892,17,1.9
CN3002100000000,2022-04-01,30,021,MT,Dawson County,4643,4532,111,2.4
CN3002300000000,2022-04-01,30,023,MT,Deer Lodge County,5317,5184,133,2.5
CN3002500000000,2022-04-01,30,025,MT,Fallon County,1678,1650,28,1.7
CN3002700000000,2022-04-01,30,027,MT,Fergus County,6060,5879,181,3
CN3002900000000,2022-04-01,30,029,MT,Flathead County,51975,50301,1674,3.2
CN3003100000000,2022-04-01,30,031,MT,Gallatin County,76845,75404,1441,1.9
CN3003300000000,2022-04-01,30,033,MT,Garfield County,803,785,18,2.2
CN3003500000000,2022-04-01,30,035,MT,Glacier County,5534,5233,301,5.4
CN3003700000000,2022-04-01,30,037,MT,Golden Valley County,386,372,14,3.6
CN3003900000000,2022-04-01,30,039,MT,Granite County,1682,1606,76,4.5
CN3004100000000,2022-04-01,30,041,MT,Hill County,7653,7469,184,2.4
CN3004300000000,2022-04-01,30,043,MT,Jefferson County,6074,5911,163,2.7
CN3004500000000,2022-04-01,30,045,MT,Judith Basin County,991,969,22,2.2
CN3004700000000,2022-04-01,30,047,MT,Lake County,14128,13709,419,3
CN3004900000000,2022-04-01,30,049,MT,Lewis and Clark County,38267,37340,927,2.4
CN3005100000000,2022-04-01,30,051,MT,Liberty County,1014,992,22,2.2
CN3005300000000,2022-04-01,30,053,MT,Lincoln County,8602,8144,458,5.3
CN3005500000000,2022-04-01,30,055,MT,McCone County,1012,996,16,1.6
CN3005700000000,2022-04-01,30,057,MT,Madison County,5703,5592,111,1.9
CN3005900000000,2022-04-01,30,059,MT,Meagher County,1046,1024,22,2.1
CN3006100000000,2022-04-01,30,061,MT,Mineral County,1801,1704,97,5.4
CN3006300000000,2022-04-01,30,063,MT,Missoula County,66334,64557,1777,2.7
CN3006500000000,2022-04-01,30,065,MT,Musselshell County,2406,2343,63,2.6
CN3006700000000,2022-04-01,30,067,MT,Park County,9637,9363,274,2.8
CN3006900000000,2022-04-01,30,069,MT,Petroleum County,285,277,8,2.8
CN3007100000000,2022-04-01,30,071,MT,Phillips County,1863,1794,69,3.7
CN3007300000000,2022-04-01,30,073,MT,Pondera County,2695,2629,66,2.4
CN3007500000000,2022-04-01,30,075,MT,Powder River County,1029,1004,25,2.4
CN3007700000000,2022-04-01,30,077,MT,Powell County,2958,2879,79,2.7
CN3007900000000,2022-04-01,30,079,MT,Prairie County,514,501,13,2.5
CN3008100000000,2022-04-01,30,081,MT,Ravalli County,21796,21208,588,2.7
CN3008300000000,2022-04-01,30,083,MT,Richland County,5782,5609,173,3
CN3008500000000,2022-04-01,30,085,MT,Roosevelt County,4367,4200,167,3.8
CN3008700000000,2022-04-01,30,087,MT,Rosebud County,3699,3572,127,3.4
CN3008900000000,2022-04-01,30,089,MT,Sanders County,5475,5238,237,4.3
CN3009100000000,2022-04-01,30,091,MT,Sheridan County,1786,1746,40,2.2
CN3009300000000,2022-04-01,30,093,MT,Silver Bow County,17709,17186,523,3
CN3009500000000,2022-04-01,30,095,MT,Stillwater County,5624,5493,131,2.3
CN3009700000000,2022-04-01,30,097,MT,Sweet Grass County,1901,1864,37,1.9
CN3009900000000,2022-04-01,30,099,MT,Teton County,2840,2770,70,2.5
CN3010100000000,2022-04-01,30,101,MT,Toole County,2086,2045,41,2
CN3010300000000,2022-04-01,30,103,MT,Treasure County,361,355,6,1.7
CN3010500000000,2022-04-01,30,105,MT,Valley County,4031,3926,105,2.6
CN3010700000000,2022-04-01,30,107,MT,Wheatland County,769,739,30,3.9
CN3010900000000,2022-04-01,30,109,MT,Wibaux County,463,450,13,2.8
CN3011100000000,2022-04-01,30,111,MT,Yellowstone County,87142,85062,2080,2.4
CN3100100000000,2022-04-01,31,001,NE,Adams County,17307,17001,306,1.8
CN3100300000000,2022-04-01,31,003,NE,Antelope County,3698,3642,56,1.5
CN3100500000000,2022-04-01,31,005,NE,Arthur County,238,233,5,2.1
CN3100700000000,2022-04-01,31,007,NE,Banner County,396,386,10,2.5
CN3100900000000,2022-04-01,31,009,NE,Blaine County,263,255,8,3
CN3101100000000,2022-04-01,31,011,NE,Boone County,3062,3016,46,1.5
CN3101300000000,2022-04-01,31,013,NE,Box Butte County,5368,5253,115,2.1
CN3101500000000,2022-04-01,31,015,NE,Boyd County,1077,1056,21,1.9
CN3101700000000,2022-04-01,31,017,NE,Brown County,1448,1418,30,2.1
CN3101900000000,2022-04-01,31,019,NE,Buffalo County,28507,28026,481,1.7
CN3102100000000,2022-04-01,31,021,NE,Burt County,3609,3532,77,2.1
CN3102300000000,2022-04-01,31,023,NE,Butler County,4747,4681,66,1.4
CN3102500000000,2022-04-01,31,025,NE,Cass County,13647,13381,266,1.9
CN3102700000000,2022-04-01,31,027,NE,Cedar County,4649,4577,72,1.5
CN3102900000000,2022-04-01,31,029,NE,Chase County,2318,2281,37,1.6
CN3103100000000,2022-04-01,31,031,NE,Cherry County,3410,3360,50,1.5
CN3103300000000,2022-04-01,31,033,NE,Cheyenne County,4245,4147,98,2.3
CN3103500000000,2022-04-01,31,035,NE,Clay County,3134,3075,59,1.9
CN3103700000000,2022-04-01,31,037,NE,Colfax County,5760,5664,96,1.7
CN3103900000000,2022-04-01,31,039,NE,Cuming County,4909,4839,70,1.4
CN3104100000000,2022-04-01,31,041,NE,Custer County,6432,6336,96,1.5
CN3104300000000,2022-04-01,31,043,NE,Dakota County,11008,10769,239,2.2
CN3104500000000,2022-04-01,31,045,NE,Dawes County,5112,5026,86,1.7
CN3104700000000,2022-04-01,31,047,NE,Dawson County,13743,13456,287,2.1
CN3104900000000,2022-04-01,31,049,NE,Deuel County,1025,1004,21,2
CN3105100000000,2022-04-01,31,051,NE,Dixon County,3061,3008,53,1.7
CN3105300000000,2022-04-01,31,053,NE,Dodge County,20961,20583,378,1.8
CN3105500000000,2022-04-01,31,055,NE,Douglas County,305525,298591,6934,2.3
CN3105700000000,2022-04-01,31,057,NE,Dundy County,1204,1188,16,1.3
CN3105900000000,2022-04-01,31,059,NE,Fillmore County,3385,3335,50,1.5
CN3106100000000,2022-04-01,31,061,NE,Franklin County,1532,1500,32,2.1
CN3106300000000,2022-04-01,31,063,NE,Frontier County,1536,1509,27,1.8
CN3106500000000,2022-04-01,31,065,NE,Furnas County,2587,2547,40,1.5
CN3106700000000,2022-04-01,31,067,NE,Gage County,10936,10726,210,1.9
CN3106900000000,2022-04-01,31,069,NE,Garden County,1141,1120,21,1.8
CN3107100000000,2022-04-01,31,071,NE,Garfield County,1112,1093,19,1.7
CN3107300000000,2022-04-01,31,073,NE,Gosper County,1186,1170,16,1.3
CN3107500000000,2022-04-01,31,075,NE,Grant County,412,406,6,1.5
CN3107700000000,2022-04-01,31,077,NE,Greeley County,1236,1215,21,1.7
CN3107900000000,2022-04-01,31,079,NE,Hall County,32967,32315,652,2
CN3108100000000,2022-04-01,31,081,NE,Hamilton County,4967,4874,93,1.9
CN3108300000000,2022-04-01,31,083,NE,Harlan County,1841,1812,29,1.6
CN3108500000000,2022-04-01,31,085,NE,Hayes County,624,616,8,1.3
CN3108700000000,2022-04-01,31,087,NE,Hitchcock County,1313,1284,29,2.2
CN3108900000000,2022-04-01,31,089,NE,Holt County,5768,5682,86,1.5
CN3109100000000,2022-04-01,31,091,NE,Hooker County,375,367,8,2.1
CN3109300000000,2022-04-01,31,093,NE,Howard County,3512,3458,54,1.5
CN3109500000000,2022-04-01,31,095,NE,Jefferson County,4198,4132,66,1.6
CN3109700000000,2022-04-01,31,097,NE,Johnson County,2009,1963,46,2.3
CN3109900000000,2022-04-01,31,099,NE,Kearney County,3786,3727,59,1.6
CN3110100000000,2022-04-01,31,101,NE,Keith County,4703,4625,78,1.7
CN3110300000000,2022-04-01,31,103,NE,Keya Paha County,549,538,11,2
CN3110500000000,2022-04-01,31,105,NE,Kimball County,1962,1933,29,1.5
CN3110700000000,2022-04-01,31,107,NE,Knox County,4682,4604,78,1.7
CN3110900000000,2022-04-01,31,109,NE,Lancaster County,180294,176910,3384,1.9
CN3111100000000,2022-04-01,31,111,NE,Lincoln County,18559,18223,336,1.8
CN3111300000000,2022-04-01,31,113,NE,Logan County,497,487,10,2
CN3111500000000,2022-04-01,31,115,NE,Loup County,415,405,10,2.4
CN3111700000000,2022-04-01,31,117,NE,McPherson County,442,436,6,1.4
CN3111900000000,2022-04-01,31,119,NE,Madison County,19999,19639,360,1.8
CN3112100000000,2022-04-01,31,121,NE,Merrick County,4223,4161,62,1.5
CN3112300000000,2022-04-01,31,123,NE,Morrill County,2695,2647,48,1.8
CN3112500000000,2022-04-01,31,125,NE,Nance County,1979,1949,30,1.5
CN3112700000000,2022-04-01,31,127,NE,Nemaha County,3665,3604,61,1.7
CN3112900000000,2022-04-01,31,129,NE,Nuckolls County,2524,2484,40,1.6
CN3113100000000,2022-04-01,31,131,NE,Otoe County,8611,8448,163,1.9
CN3113300000000,2022-04-01,31,133,NE,Pawnee County,1483,1459,24,1.6
CN3113500000000,2022-04-01,31,135,NE,Perkins County,1896,1870,26,1.4
CN3113700000000,2022-04-01,31,137,NE,Phelps County,5048,4966,82,1.6
CN3113900000000,2022-04-01,31,139,NE,Pierce County,4246,4182,64,1.5
CN3114100000000,2022-04-01,31,141,NE,Platte County,18512,18196,316,1.7
CN3114300000000,2022-04-01,31,143,NE,Polk County,2955,2907,48,1.6
CN3114500000000,2022-04-01,31,145,NE,Red Willow County,5938,5843,95,1.6
CN3114700000000,2022-04-01,31,147,NE,Richardson County,4200,4130,70,1.7
CN3114900000000,2022-04-01,31,149,NE,Rock County,914,903,11,1.2
CN3115100000000,2022-04-01,31,151,NE,Saline County,7268,7117,151,2.1
CN3115300000000,2022-04-01,31,153,NE,Sarpy County,99629,97733,1896,1.9
CN3115500000000,2022-04-01,31,155,NE,Saunders County,11535,11340,195,1.7
CN3115700000000,2022-04-01,31,157,NE,Scotts Bluff County,17993,17602,391,2.2
CN3115900000000,2022-04-01,31,159,NE,Seward County,8915,8752,163,1.8
CN3116100000000,2022-04-01,31,161,NE,Sheridan County,2818,2768,50,1.8
CN3116300000000,2022-04-01,31,163,NE,Sherman County,1668,1636,32,1.9
CN3116500000000,2022-04-01,31,165,NE,Sioux County,772,759,13,1.7
CN3116700000000,2022-04-01,31,167,NE,Stanton County,3588,3534,54,1.5
CN3116900000000,2022-04-01,31,169,NE,Thayer County,2729,2689,40,1.5
CN3117100000000,2022-04-01,31,171,NE,Thomas County,460,447,13,2.8
CN3117300000000,2022-04-01,31,173,NE,Thurston County,3303,3202,101,3.1
CN3117500000000,2022-04-01,31,175,NE,Valley County,2115,2083,32,1.5
CN3117700000000,2022-04-01,31,177,NE,Washington County,11497,11294,203,1.8
CN3117900000000,2022-04-01,31,179,NE,Wayne County,5867,5769,98,1.7
CN3118100000000,2022-04-01,31,181,NE,Webster County,1695,1668,27,1.6
CN3118300000000,2022-04-01,31,183,NE,Wheeler County,585,579,6,1
CN3118500000000,2022-04-01,31,185,NE,York County,7540,7409,131,1.7
CN3200100000000,2022-04-01,32,001,NV,Churchill County,11310,10957,353,3.1
CN3200300000000,2022-04-01,32,003,NV,Clark County,1126701,1060447,66254,5.9
CN3200500000000,2022-04-01,32,005,NV,Douglas County,21828,21022,806,3.7
CN3200700000000,2022-04-01,32,007,NV,Elko County,25910,25160,750,2.9
CN3200900000000,2022-04-01,32,009,NV,Esmeralda County,464,452,12,2.6
CN3201100000000,2022-04-01,32,011,NV,Eureka County,1191,1166,25,2.1
CN3201300000000,2022-04-01,32,013,NV,Humboldt County,8199,7961,238,2.9
CN3201500000000,2022-04-01,32,015,NV,Lander County,3100,2997,103,3.3
CN3201700000000,2022-04-01,32,017,NV,Lincoln County,2161,2089,72,3.3
CN3201900000000,2022-04-01,32,019,NV,Lyon County,23726,22691,1035,4.4
CN3202100000000,2022-04-01,32,021,NV,Mineral County,1928,1853,75,3.9
CN3202300000000,2022-04-01,32,023,NV,Nye County,17323,16420,903,5.2
CN3202700000000,2022-04-01,32,027,NV,Pershing County,2753,2674,79,2.9
CN3202900000000,2022-04-01,32,029,NV,Storey County,2057,1981,76,3.7
CN3203100000000,2022-04-01,32,031,NV,Washoe County,253742,245588,8154,3.2
CN3203300000000,2022-04-01,32,033,NV,White Pine County,4493,4357,136,3
CN3251000000000,2022-04-01,32,510,NV,Carson City,24895,23966,929,3.7
CN3300100000000,2022-04-01,33,001,NH,Belknap County,30168,29495,673,2.2
CN3300300000000,2022-04-01,33,003,NH,Carroll County,22396,21859,537,2.4
CN3300500000000,2022-04-01,33,005,NH,Cheshire County,39580,38649,931,2.4
CN3300700000000,2022-04-01,33,007,NH,Coos County,13988,13528,460,3.3
CN3300900000000,2022-04-01,33,009,NH,Grafton County,47655,46698,957,2
CN3301100000000,2022-04-01,33,011,NH,Hillsborough County,239728,234314,5414,2.3
CN3301300000000,2022-04-01,33,013,NH,Merrimack County,82196,80614,1582,1.9
CN3301500000000,2022-04-01,33,015,NH,Rockingham County,186340,182094,4246,2.3
CN3301700000000,2022-04-01,33,017,NH,Strafford County,73503,72057,1446,2
CN3301900000000,2022-04-01,33,019,NH,Sullivan County,22586,22117,469,2.1
CN3400100000000,2022-04-01,34,001,NJ,Atlantic County,120428,114183,6245,5.2
CN3400300000000,2022-04-01,34,003,NJ,Bergen County,499992,482883,17109,3.4
CN3400500000000,2022-04-01,34,005,NJ,Burlington County,246611,238638,7973,3.2
CN3400700000000,2022-04-01,34,007,NJ,Camden County,269613,259198,10415,3.9
CN3400900000000,2022-04-01,34,009,NJ,Cape May County,42948,39768,3180,7.4
CN3401100000000,2022-04-01,34,011,NJ,Cumberland County,68871,65540,3331,4.8
CN3401300000000,2022-04-01,34,013,NJ,Essex County,385766,368542,17224,4.5
CN3401500000000,2022-04-01,34,015,NJ,Gloucester County,160713,154989,5724,3.6
CN3401700000000,2022-04-01,34,017,NJ,Hudson County,374344,360778,13566,3.6
CN3401900000000,2022-04-01,34,019,NJ,Hunterdon County,67366,65416,1950,2.9
CN3402100000000,2022-04-01,34,021,NJ,Mercer County,214284,207464,6820,3.2
CN3402300000000,2022-04-01,34,023,NJ,Middlesex County,459244,443884,15360,3.3
CN3402500000000,2022-04-01,34,025,NJ,Monmouth County,344082,332668,11414,3.3
CN3402700000000,2022-04-01,34,027,NJ,Morris County,267154,258969,8185,3.1
CN3402900000000,2022-04-01,34,029,NJ,Ocean County,295049,284122,10927,3.7
CN3403100000000,2022-04-01,34,031,NJ,Passaic County,250957,239455,11502,4.6
CN3403300000000,2022-04-01,34,033,NJ,Salem County,30247,28936,1311,4.3
CN3403500000000,2022-04-01,34,035,NJ,Somerset County,178360,172725,5635,3.2
CN3403700000000,2022-04-01,34,037,NJ,Sussex County,76924,74074,2850,3.7
CN3403900000000,2022-04-01,34,039,NJ,Union County,287989,276946,11043,3.8
CN3404100000000,2022-04-01,34,041,NJ,Warren County,58425,56407,2018,3.5
CN3500100000000,2022-04-01,35,001,NM,Bernalillo County,336132,323904,12228,3.6
CN3500300000000,2022-04-01,35,003,NM,Catron County,1159,1103,56,4.8
CN3500500000000,2022-04-01,35,005,NM,Chaves County,27775,26585,1190,4.3
CN3500600000000,2022-04-01,35,006,NM,Cibola County,8107,7656,451,5.6
CN3500700000000,2022-04-01,35,007,NM,Colfax County,5027,4810,217,4.3
CN3500900000000,2022-04-01,35,009,NM,Curry County,22537,21808,729,3.2
CN3501100000000,2022-04-01,35,011,NM,De Baca County,721,695,26,3.6
CN3501300000000,2022-04-01,35,013,NM,Dona Ana County,99154,94521,4633,4.7
CN3501500000000,2022-04-01,35,015,NM,Eddy County,31191,30100,1091,3.5
CN3501700000000,2022-04-01,35,017,NM,Grant County,11759,11272,487,4.1
CN3501900000000,2022-04-01,35,019,NM,Guadalupe County,1451,1363,88,6.1
CN3502100000000,2022-04-01,35,021,NM,Harding County,276,267,9,3.3
CN3502300000000,2022-04-01,35,023,NM,Hidalgo County,1952,1886,66,3.4
CN3502500000000,2022-04-01,35,025,NM,Lea County,29060,27723,1337,4.6
CN3502700000000,2022-04-01,35,027,NM,Lincoln County,8665,8302,363,4.2
CN3502800000000,2022-04-01,35,028,NM,Los Alamos County,10439,10210,229,2.2
CN3502900000000,2022-04-01,35,029,NM,Luna County,9717,8613,1104,11.4
CN3503100000000,2022-04-01,35,031,NM,McKinley County,22652,21361,1291,5.7
CN3503300000000,2022-04-01,35,033,NM,Mora County,1944,1847,97,5
CN3503500000000,2022-04-01,35,035,NM,Otero County,24839,23802,1037,4.2
CN3503700000000,2022-04-01,35,037,NM,Quay County,3076,2947,129,4.2
CN3503900000000,2022-04-01,35,039,NM,Rio Arriba County,16565,15815,750,4.5
CN3504100000000,2022-04-01,35,041,NM,Roosevelt County,8112,7816,296,3.6
CN3504300000000,2022-04-01,35,043,NM,Sandoval County,67832,65253,2579,3.8
CN3504500000000,2022-04-01,35,045,NM,San Juan County,49220,46960,2260,4.6
CN3504700000000,2022-04-01,35,047,NM,San Miguel County,10362,9885,477,4.6
CN3504900000000,2022-04-01,35,049,NM,Santa Fe County,72436,69842,2594,3.6
CN3505100000000,2022-04-01,35,051,NM,Sierra County,3911,3642,269,6.9
CN3505300000000,2022-04-01,35,053,NM,Socorro County,6134,5874,260,4.2
CN3505500000000,2022-04-01,35,055,NM,Taos County,14777,14025,752,5.1
CN3505700000000,2022-04-01,35,057,NM,Torrance County,5387,5091,296,5.5
CN3505900000000,2022-04-01,35,059,NM,Union County,1498,1454,44,2.9
CN3506100000000,2022-04-01,35,061,NM,Valencia County,31033,29693,1340,4.3
CN3600100000000,2022-04-01,36,001,NY,Albany County,159668,155353,4315,2.7
CN3600300000000,2022-04-01,36,003,NY,Allegany County,19304,18597,707,3.7
CN3600500000000,2022-04-01,36,005,NY,Bronx County,600730,552846,47884,8
CN3600700000000,2022-04-01,36,007,NY,Broome County,82236,79430,2806,3.4
CN3600900000000,2022-04-01,36,009,NY,Cattaraugus County,32345,31127,1218,3.8
CN3601100000000,2022-04-01,36,011,NY,Cayuga County,34968,33805,1163,3.3
CN3601300000000,2022-04-01,36,013,NY,Chautauqua County,52512,50649,1863,3.5
CN3601500000000,2022-04-01,36,015,NY,Chemung County,34723,33570,1153,3.3
CN3601700000000,2022-04-01,36,017,NY,Chenango County,21821,21163,658,3
CN3601900000000,2022-04-01,36,019,NY,Clinton County,35457,34384,1073,3
CN3602100000000,2022-04-01,36,021,NY,Columbia County,30257,29503,754,2.5
CN3602300000000,2022-04-01,36,023,NY,Cortland County,22714,21929,785,3.5
CN3602500000000,2022-04-01,36,025,NY,Delaware County,18651,18035,616,3.3
CN3602700000000,2022-04-01,36,027,NY,Dutchess County,145600,141581,4019,2.8
CN3602900000000,2022-04-01,36,029,NY,Erie County,442239,427647,14592,3.3
CN3603100000000,2022-04-01,36,031,NY,Essex County,15482,14885,597,3.9
CN3603300000000,2022-04-01,36,033,NY,Franklin County,18660,18019,641,3.4
CN3603500000000,2022-04-01,36,035,NY,Fulton County,22329,21532,797,3.6
CN3603700000000,2022-04-01,36,037,NY,Genesee County,29298,28446,852,2.9
CN3603900000000,2022-04-01,36,039,NY,Greene County,19966,19304,662,3.3
CN3604100000000,2022-04-01,36,041,NY,Hamilton County,2056,1942,114,5.5
CN3604300000000,2022-04-01,36,043,NY,Herkimer County,27170,26144,1026,3.8
CN3604500000000,2022-04-01,36,045,NY,Jefferson County,43441,41723,1718,4
CN3604700000000,2022-04-01,36,047,NY,Kings County,1200314,1129820,70494,5.9
CN3604900000000,2022-04-01,36,049,NY,Lewis County,11431,10948,483,4.2
CN3605100000000,2022-04-01,36,051,NY,Livingston County,30307,29373,934,3.1
CN3605300000000,2022-04-01,36,053,NY,Madison County,32508,31513,995,3.1
CN3605500000000,2022-04-01,36,055,NY,Monroe County,365544,354075,11469,3.1
CN3605700000000,2022-04-01,36,057,NY,Montgomery County,22180,21376,804,3.6
CN3605900000000,2022-04-01,36,059,NY,Nassau County,725370,706588,18782,2.6
CN3606100000000,2022-04-01,36,061,NY,New York County,911781,870700,41081,4.5
CN3606300000000,2022-04-01,36,063,NY,Niagara County,97666,94140,3526,3.6
CN3606500000000,2022-04-01,36,065,NY,Oneida County,99398,96146,3252,3.3
CN3606700000000,2022-04-01,36,067,NY,Onondaga County,222221,215358,6863,3.1
CN3606900000000,2022-04-01,36,069,NY,Ontario County,55918,54333,1585,2.8
CN3607100000000,2022-04-01,36,071,NY,Orange County,189185,183530,5655,3
CN3607300000000,2022-04-01,36,073,NY,Orleans County,17132,16550,582,3.4
CN3607500000000,2022-04-01,36,075,NY,Oswego County,52364,50388,1976,3.8
CN3607700000000,2022-04-01,36,077,NY,Otsego County,26887,26080,807,3
CN3607900000000,2022-04-01,36,079,NY,Putnam County,51709,50335,1374,2.7
CN3608100000000,2022-04-01,36,081,NY,Queens County,1133899,1073902,59997,5.3
CN3608300000000,2022-04-01,36,083,NY,Rensselaer County,82308,80080,2228,2.7
CN3608500000000,2022-04-01,36,085,NY,Richmond County,225450,213245,12205,5.4
CN3608700000000,2022-04-01,36,087,NY,Rockland County,158137,154045,4092,2.6
CN3608900000000,2022-04-01,36,089,NY,St. Lawrence County,43523,41914,1609,3.7
CN3609100000000,2022-04-01,36,091,NY,Saratoga County,121783,118920,2863,2.4
CN3609300000000,2022-04-01,36,093,NY,Schenectady County,78098,75719,2379,3
CN3609500000000,2022-04-01,36,095,NY,Schoharie County,14730,14273,457,3.1
CN3609700000000,2022-04-01,36,097,NY,Schuyler County,7963,7669,294,3.7
CN3609900000000,2022-04-01,36,099,NY,Seneca County,14808,14367,441,3
CN3610100000000,2022-04-01,36,101,NY,Steuben County,41152,39753,1399,3.4
CN3610300000000,2022-04-01,36,103,NY,Suffolk County,796255,773845,22410,2.8
CN3610500000000,2022-04-01,36,105,NY,Sullivan County,36902,35766,1136,3.1
CN3610700000000,2022-04-01,36,107,NY,Tioga County,22247,21605,642,2.9
CN3610900000000,2022-04-01,36,109,NY,Tompkins County,51646,50459,1187,2.3
CN3611100000000,2022-04-01,36,111,NY,Ulster County,87252,84725,2527,2.9
CN3611300000000,2022-04-01,36,113,NY,Warren County,30488,29454,1034,3.4
CN3611500000000,2022-04-01,36,115,NY,Washington County,26779,25958,821,3.1
CN3611700000000,2022-04-01,36,117,NY,Wayne County,43478,42185,1293,3
CN3611900000000,2022-04-01,36,119,NY,Westchester County,492448,478321,14127,2.9
CN3612100000000,2022-04-01,36,121,NY,Wyoming County,17388,16812,576,3.3
CN3612300000000,2022-04-01,36,123,NY,Yates County,11596,11288,308,2.7
CN3700100000000,2022-04-01,37,001,NC,Alamance County,83124,80411,2713,3.3
CN3700300000000,2022-04-01,37,003,NC,Alexander County,18111,17599,512,2.8
CN3700500000000,2022-04-01,37,005,NC,Alleghany County,4405,4259,146,3.3
CN3700700000000,2022-04-01,37,007,NC,Anson County,10313,9909,404,3.9
CN3700900000000,2022-04-01,37,009,NC,Ashe County,13097,12731,366,2.8
CN3701100000000,2022-04-01,37,011,NC,Avery County,7498,7272,226,3
CN3701300000000,2022-04-01,37,013,NC,Beaufort County,19923,19227,696,3.5
CN3701500000000,2022-04-01,37,015,NC,Bertie County,7203,6890,313,4.3
CN3701700000000,2022-04-01,37,017,NC,Bladen County,14561,14024,537,3.7
CN3701900000000,2022-04-01,37,019,NC,Brunswick County,57118,54784,2334,4.1
CN3702100000000,2022-04-01,37,021,NC,Buncombe County,141798,137999,3799,2.7
CN3702300000000,2022-04-01,37,023,NC,Burke County,41008,39797,1211,3
CN3702500000000,2022-04-01,37,025,NC,Cabarrus County,115629,112204,3425,3
CN3702700000000,2022-04-01,37,027,NC,Caldwell County,36541,35388,1153,3.2
CN3702900000000,2022-04-01,37,029,NC,Camden County,4731,4566,165,3.5
CN3703100000000,2022-04-01,37,031,NC,Carteret County,32411,31436,975,3
CN3703300000000,2022-04-01,37,033,NC,Caswell County,9646,9317,329,3.4
CN3703500000000,2022-04-01,37,035,NC,Catawba County,79755,77352,2403,3
CN3703700000000,2022-04-01,37,037,NC,Chatham County,37346,36345,1001,2.7
CN3703900000000,2022-04-01,37,039,NC,Cherokee County,11098,10726,372,3.4
CN3704100000000,2022-04-01,37,041,NC,Chowan County,5782,5581,201,3.5
CN3704300000000,2022-04-01,37,043,NC,Clay County,4152,4011,141,3.4
CN3704500000000,2022-04-01,37,045,NC,Cleveland County,49521,47838,1683,3.4
CN3704700000000,2022-04-01,37,047,NC,Columbus County,23462,22549,913,3.9
CN3704900000000,2022-04-01,37,049,NC,Craven County,41990,40667,1323,3.2
CN3705100000000,2022-04-01,37,051,NC,Cumberland County,128226,122451,5775,4.5
CN3705300000000,2022-04-01,37,053,NC,Currituck County,14673,14238,435,3
CN3705500000000,2022-04-01,37,055,NC,Dare County,20009,19260,749,3.7
CN3705700000000,2022-04-01,37,057,NC,Davidson County,81595,79067,2528,3.1
CN3705900000000,2022-04-01,37,059,NC,Davie County,20827,20197,630,3
CN3706100000000,2022-04-01,37,061,NC,Duplin County,25084,24284,800,3.2
CN3706300000000,2022-04-01,37,063,NC,Durham County,178303,173266,5037,2.8
CN3706500000000,2022-04-01,37,065,NC,Edgecombe County,20197,18967,1230,6.1
CN3706700000000,2022-04-01,37,067,NC,Forsyth County,188817,182691,6126,3.2
CN3706900000000,2022-04-01,37,069,NC,Franklin County,33809,32700,1109,3.3
CN3707100000000,2022-04-01,37,071,NC,Gaston County,114196,110489,3707,3.2
CN3707300000000,2022-04-01,37,073,NC,Gates County,5127,4975,152,3
CN3707500000000,2022-04-01,37,075,NC,Graham County,2970,2829,141,4.7
CN3707700000000,2022-04-01,37,077,NC,Granville County,30288,29435,853,2.8
CN3707900000000,2022-04-01,37,079,NC,Greene County,9691,9413,278,2.9
CN3708100000000,2022-04-01,37,081,NC,Guilford County,260998,251636,9362,3.6
CN3708300000000,2022-04-01,37,083,NC,Halifax County,19228,18298,930,4.8
CN3708500000000,2022-04-01,37,085,NC,Harnett County,55105,53140,1965,3.6
CN3708700000000,2022-04-01,37,087,NC,Haywood County,30141,29283,858,2.8
CN3708900000000,2022-04-01,37,089,NC,Henderson County,55448,53889,1559,2.8
CN3709100000000,2022-04-01,37,091,NC,Hertford County,8490,8110,380,4.5
CN3709300000000,2022-04-01,37,093,NC,Hoke County,20364,19504,860,4.2
CN3709500000000,2022-04-01,37,095,NC,Hyde County,1785,1697,88,4.9
CN3709700000000,2022-04-01,37,097,NC,Iredell County,94246,91471,2775,2.9
CN3709900000000,2022-04-01,37,099,NC,Jackson County,19812,19159,653,3.3
CN3710100000000,2022-04-01,37,101,NC,Johnston County,107499,104353,3146,2.9
CN3710300000000,2022-04-01,37,103,NC,Jones County,4333,4205,128,3
CN3710500000000,2022-04-01,37,105,NC,Lee County,26063,25105,958,3.7
CN3710700000000,2022-04-01,37,107,NC,Lenoir County,27661,26731,930,3.4
CN3710900000000,2022-04-01,37,109,NC,Lincoln County,46266,44968,1298,2.8
CN3711100000000,2022-04-01,37,111,NC,McDowell County,20506,19898,608,3
CN3711300000000,2022-04-01,37,113,NC,Macon County,15870,15376,494,3.1
CN3711500000000,2022-04-01,37,115,NC,Madison County,10064,9756,308,3.1
CN3711700000000,2022-04-01,37,117,NC,Martin County,8720,8362,358,4.1
CN3711900000000,2022-04-01,37,119,NC,Mecklenburg County,649564,629479,20085,3.1
CN3712100000000,2022-04-01,37,121,NC,Mitchell County,6022,5804,218,3.6
CN3712300000000,2022-04-01,37,123,NC,Montgomery County,11290,10931,359,3.2
CN3712500000000,2022-04-01,37,125,NC,Moore County,42052,40680,1372,3.3
CN3712700000000,2022-04-01,37,127,NC,Nash County,42143,40255,1888,4.5
CN3712900000000,2022-04-01,37,129,NC,New Hanover County,129539,125782,3757,2.9
CN3713100000000,2022-04-01,37,131,NC,Northampton County,7260,6958,302,4.2
CN3713300000000,2022-04-01,37,133,NC,Onslow County,68163,65595,2568,3.8
CN3713500000000,2022-04-01,37,135,NC,Orange County,81221,79063,2158,2.7
CN3713700000000,2022-04-01,37,137,NC,Pamlico County,5505,5327,178,3.2
CN3713900000000,2022-04-01,37,139,NC,Pasquotank County,16799,16165,634,3.8
CN3714100000000,2022-04-01,37,141,NC,Pender County,30770,29849,921,3
CN3714300000000,2022-04-01,37,143,NC,Perquimans County,5012,4816,196,3.9
CN3714500000000,2022-04-01,37,145,NC,Person County,18756,18127,629,3.4
CN3714700000000,2022-04-01,37,147,NC,Pitt County,88576,85400,3176,3.6
CN3714900000000,2022-04-01,37,149,NC,Polk County,9346,9017,329,3.5
CN3715100000000,2022-04-01,37,151,NC,Randolph County,65581,63547,2034,3.1
CN3715300000000,2022-04-01,37,153,NC,Richmond County,16920,16160,760,4.5
CN3715500000000,2022-04-01,37,155,NC,Robeson County,48488,46136,2352,4.9
CN3715700000000,2022-04-01,37,157,NC,Rockingham County,39603,38182,1421,3.6
CN3715900000000,2022-04-01,37,159,NC,Rowan County,67526,65343,2183,3.2
CN3716100000000,2022-04-01,37,161,NC,Rutherford County,24893,23866,1027,4.1
CN3716300000000,2022-04-01,37,163,NC,Sampson County,29022,28082,940,3.2
CN3716500000000,2022-04-01,37,165,NC,Scotland County,11253,10615,638,5.7
CN3716700000000,2022-04-01,37,167,NC,Stanly County,30900,30002,898,2.9
CN3716900000000,2022-04-01,37,169,NC,Stokes County,21693,21063,630,2.9
CN3717100000000,2022-04-01,37,171,NC,Surry County,32946,31975,971,2.9
CN3717300000000,2022-04-01,37,173,NC,Swain County,7198,6986,212,2.9
CN3717500000000,2022-04-01,37,175,NC,Transylvania County,14643,14203,440,3
CN3717700000000,2022-04-01,37,177,NC,Tyrrell County,1322,1261,61,4.6
CN3717900000000,2022-04-01,37,179,NC,Union County,130002,126349,3653,2.8
CN3718100000000,2022-04-01,37,181,NC,Vance County,16819,15969,850,5.1
CN3718300000000,2022-04-01,37,183,NC,Wake County,627444,610354,17090,2.7
CN3718500000000,2022-04-01,37,185,NC,Warren County,6372,6035,337,5.3
CN3718700000000,2022-04-01,37,187,NC,Washington County,4268,4075,193,4.5
CN3718900000000,2022-04-01,37,189,NC,Watauga County,29359,28498,861,2.9
CN3719100000000,2022-04-01,37,191,NC,Wayne County,51173,49312,1861,3.6
CN3719300000000,2022-04-01,37,193,NC,Wilkes County,27423,26505,918,3.3
CN3719500000000,2022-04-01,37,195,NC,Wilson County,33747,32146,1601,4.7
CN3719700000000,2022-04-01,37,197,NC,Yadkin County,17709,17175,534,3
CN3719900000000,2022-04-01,37,199,NC,Yancey County,8273,8010,263,3.2
CN3800100000000,2022-04-01,38,001,ND,Adams County,954,932,22,2.3
CN3800300000000,2022-04-01,38,003,ND,Barnes County,5311,5197,114,2.1
CN3800500000000,2022-04-01,38,005,ND,Benson County,2337,2269,68,2.9
CN3800700000000,2022-04-01,38,007,ND,Billings County,392,384,8,2
CN3800900000000,2022-04-01,38,009,ND,Bottineau County,2954,2865,89,3
CN3801100000000,2022-04-01,38,011,ND,Bowman County,1548,1522,26,1.7
CN3801300000000,2022-04-01,38,013,ND,Burke County,1060,1037,23,2.2
CN3801500000000,2022-04-01,38,015,ND,Burleigh County,52242,51263,979,1.9
CN3801700000000,2022-04-01,38,017,ND,Cass County,110369,108376,1993,1.8
CN3801900000000,2022-04-01,38,019,ND,Cavalier County,1857,1803,54,2.9
CN3802100000000,2022-04-01,38,021,ND,Dickey County,2241,2201,40,1.8
CN3802300000000,2022-04-01,38,023,ND,Divide County,1444,1428,16,1.1
CN3802500000000,2022-04-01,38,025,ND,Dunn County,3147,3103,44,1.4
CN3802700000000,2022-04-01,38,027,ND,Eddy County,1174,1140,34,2.9
CN3802900000000,2022-04-01,38,029,ND,Emmons County,1470,1402,68,4.6
CN3803100000000,2022-04-01,38,031,ND,Foster County,1528,1489,39,2.6
CN3803300000000,2022-04-01,38,033,ND,Golden Valley County,844,833,11,1.3
CN3803500000000,2022-04-01,38,035,ND,Grand Forks County,37708,37009,699,1.9
CN3803700000000,2022-04-01,38,037,ND,Grant County,1200,1182,18,1.5
CN3803900000000,2022-04-01,38,039,ND,Griggs County,1020,996,24,2.4
CN3804100000000,2022-04-01,38,041,ND,Hettinger County,1402,1381,21,1.5
CN3804300000000,2022-04-01,38,043,ND,Kidder County,1303,1250,53,4.1
CN3804500000000,2022-04-01,38,045,ND,LaMoure County,2121,2081,40,1.9
CN3804700000000,2022-04-01,38,047,ND,Logan County,874,857,17,1.9
CN3804900000000,2022-04-01,38,049,ND,McHenry County,3185,3071,114,3.6
CN3805100000000,2022-04-01,38,051,ND,McIntosh County,1064,1041,23,2.2
CN3805300000000,2022-04-01,38,053,ND,McKenzie County,8761,8586,175,2
CN3805500000000,2022-04-01,38,055,ND,McLean County,4821,4679,142,2.9
CN3805700000000,2022-04-01,38,057,ND,Mercer County,3694,3585,109,3
CN3805900000000,2022-04-01,38,059,ND,Morton County,17192,16776,416,2.4
CN3806100000000,2022-04-01,38,061,ND,Mountrail County,6290,6195,95,1.5
CN3806300000000,2022-04-01,38,063,ND,Nelson County,1454,1407,47,3.2
CN3806500000000,2022-04-01,38,065,ND,Oliver County,882,853,29,3.3
CN3806700000000,2022-04-01,38,067,ND,Pembina County,3211,3097,114,3.6
CN3806900000000,2022-04-01,38,069,ND,Pierce County,1690,1638,52,3.1
CN3807100000000,2022-04-01,38,071,ND,Ramsey County,5666,5533,133,2.3
CN3807300000000,2022-04-01,38,073,ND,Ransom County,2696,2643,53,2
CN3807500000000,2022-04-01,38,075,ND,Renville County,1227,1202,25,2
CN3807700000000,2022-04-01,38,077,ND,Richland County,8813,8644,169,1.9
CN3807900000000,2022-04-01,38,079,ND,Rolette County,4725,4458,267,5.7
CN3808100000000,2022-04-01,38,081,ND,Sargent County,2354,2310,44,1.9
CN3808300000000,2022-04-01,38,083,ND,Sheridan County,661,644,17,2.6
CN3808500000000,2022-04-01,38,085,ND,Sioux County,1214,1192,22,1.8
CN3808700000000,2022-04-01,38,087,ND,Slope County,338,330,8,2.4
CN3808900000000,2022-04-01,38,089,ND,Stark County,17705,17369,336,1.9
CN3809100000000,2022-04-01,38,091,ND,Steele County,940,919,21,2.2
CN3809300000000,2022-04-01,38,093,ND,Stutsman County,10573,10365,208,2
CN3809500000000,2022-04-01,38,095,ND,Towner County,1125,1097,28,2.5
CN3809700000000,2022-04-01,38,097,ND,Traill County,4519,4427,92,2
CN3809900000000,2022-04-01,38,099,ND,Walsh County,5246,5089,157,3
CN3810100000000,2022-04-01,38,101,ND,Ward County,32207,31439,768,2.4
CN3810300000000,2022-04-01,38,103,ND,Wells County,1910,1848,62,3.2
CN3810500000000,2022-04-01,38,105,ND,Williams County,21427,20937,490,2.3
CN3900100000000,2022-04-01,39,001,OH,Adams County,10892,10440,452,4.1
CN3900300000000,2022-04-01,39,003,OH,Allen County,46927,45184,1743,3.7
CN3900500000000,2022-04-01,39,005,OH,Ashland County,26254,25274,980,3.7
CN3900700000000,2022-04-01,39,007,OH,Ashtabula County,42932,41164,1768,4.1
CN3900900000000,2022-04-01,39,009,OH,Athens County,27224,26162,1062,3.9
CN3901100000000,2022-04-01,39,011,OH,Auglaize County,23938,23320,618,2.6
CN3901300000000,2022-04-01,39,013,OH,Belmont County,27332,25978,1354,5
CN3901500000000,2022-04-01,39,015,OH,Brown County,19341,18571,770,4
CN3901700000000,2022-04-01,39,017,OH,Butler County,196275,190014,6261,3.2
CN3901900000000,2022-04-01,39,019,OH,Carroll County,12545,12056,489,3.9
CN3902100000000,2022-04-01,39,021,OH,Champaign County,19218,18559,659,3.4
CN3902300000000,2022-04-01,39,023,OH,Clark County,62677,60301,2376,3.8
CN3902500000000,2022-04-01,39,025,OH,Clermont County,107484,104143,3341,3.1
CN3902700000000,2022-04-01,39,027,OH,Clinton County,17778,17087,691,3.9
CN3902900000000,2022-04-01,39,029,OH,Columbiana County,44757,42887,1870,4.2
CN3903100000000,2022-04-01,39,031,OH,Coshocton County,13598,13003,595,4.4
CN3903300000000,2022-04-01,39,033,OH,Crawford County,17595,16846,749,4.3
CN3903500000000,2022-04-01,39,035,OH,Cuyahoga County,598268,568120,30148,5
CN3903700000000,2022-04-01,39,037,OH,Darke County,25620,24781,839,3.3
CN3903900000000,2022-04-01,39,039,OH,Defiance County,17471,16732,739,4.2
CN3904100000000,2022-04-01,39,041,OH,Delaware County,115552,112516,3036,2.6
CN3904300000000,2022-04-01,39,043,OH,Erie County,36123,34575,1548,4.3
CN3904500000000,2022-04-01,39,045,OH,Fairfield County,80327,77793,2534,3.2
CN3904700000000,2022-04-01,39,047,OH,Fayette County,13725,13238,487,3.5
CN3904900000000,2022-04-01,39,049,OH,Franklin County,710107,687388,22719,3.2
CN3905100000000,2022-04-01,39,051,OH,Fulton County,21629,20848,781,3.6
CN3905300000000,2022-04-01,39,053,OH,Gallia County,12112,11618,494,4.1
CN3905500000000,2022-04-01,39,055,OH,Geauga County,48026,46098,1928,4
CN3905700000000,2022-04-01,39,057,OH,Greene County,81537,78990,2547,3.1
CN3905900000000,2022-04-01,39,059,OH,Guernsey County,17784,16962,822,4.6
CN3906100000000,2022-04-01,39,061,OH,Hamilton County,415741,402252,13489,3.2
CN3906300000000,2022-04-01,39,063,OH,Hancock County,40760,39612,1148,2.8
CN3906500000000,2022-04-01,39,065,OH,Hardin County,13466,12995,471,3.5
CN3906700000000,2022-04-01,39,067,OH,Harrison County,6410,6128,282,4.4
CN3906900000000,2022-04-01,39,069,OH,Henry County,12611,12070,541,4.3
CN3907100000000,2022-04-01,39,071,OH,Highland County,17272,16551,721,4.2
CN3907300000000,2022-04-01,39,073,OH,Hocking County,12965,12471,494,3.8
CN3907500000000,2022-04-01,39,075,OH,Holmes County,21461,20987,474,2.2
CN3907700000000,2022-04-01,39,077,OH,Huron County,27521,26340,1181,4.3
CN3907900000000,2022-04-01,39,079,OH,Jackson County,12243,11714,529,4.3
CN3908100000000,2022-04-01,39,081,OH,Jefferson County,27095,25710,1385,5.1
CN3908300000000,2022-04-01,39,083,OH,Knox County,31111,30185,926,3
CN3908500000000,2022-04-01,39,085,OH,Lake County,124138,118802,5336,4.3
CN3908700000000,2022-04-01,39,087,OH,Lawrence County,23224,22253,971,4.2
CN3908900000000,2022-04-01,39,089,OH,Licking County,91914,89151,2763,3
CN3909100000000,2022-04-01,39,091,OH,Logan County,22150,21463,687,3.1
CN3909300000000,2022-04-01,39,093,OH,Lorain County,153082,145543,7539,4.9
CN3909500000000,2022-04-01,39,095,OH,Lucas County,203268,194969,8299,4.1
CN3909700000000,2022-04-01,39,097,OH,Madison County,20992,20367,625,3
CN3909900000000,2022-04-01,39,099,OH,Mahoning County,98275,93866,4409,4.5
CN3910100000000,2022-04-01,39,101,OH,Marion County,27474,26523,951,3.5
CN3910300000000,2022-04-01,39,103,OH,Medina County,97108,93300,3808,3.9
CN3910500000000,2022-04-01,39,105,OH,Meigs County,8697,8235,462,5.3
CN3910700000000,2022-04-01,39,107,OH,Mercer County,22725,22194,531,2.3
CN3910900000000,2022-04-01,39,109,OH,Miami County,53094,51372,1722,3.2
CN3911100000000,2022-04-01,39,111,OH,Monroe County,5083,4749,334,6.6
CN3911300000000,2022-04-01,39,113,OH,Montgomery County,244326,235136,9190,3.8
CN3911500000000,2022-04-01,39,115,OH,Morgan County,6699,6368,331,4.9
CN3911700000000,2022-04-01,39,117,OH,Morrow County,17008,16410,598,3.5
CN3911900000000,2022-04-01,39,119,OH,Muskingum County,40624,38959,1665,4.1
CN3912100000000,2022-04-01,39,121,OH,Noble County,4574,4320,254,5.6
CN3912300000000,2022-04-01,39,123,OH,Ottawa County,19995,19022,973,4.9
CN3912500000000,2022-04-01,39,125,OH,Paulding County,8625,8317,308,3.6
CN3912700000000,2022-04-01,39,127,OH,Perry County,15944,15319,625,3.9
CN3912900000000,2022-04-01,39,129,OH,Pickaway County,26797,25908,889,3.3
CN3913100000000,2022-04-01,39,131,OH,Pike County,10914,10430,484,4.4
CN3913300000000,2022-04-01,39,133,OH,Portage County,84695,81731,2964,3.5
CN3913500000000,2022-04-01,39,135,OH,Preble County,21864,21178,686,3.1
CN3913700000000,2022-04-01,39,137,OH,Putnam County,18862,18349,513,2.7
CN3913900000000,2022-04-01,39,139,OH,Richland County,50357,48191,2166,4.3
CN3914100000000,2022-04-01,39,141,OH,Ross County,34736,33521,1215,3.5
CN3914300000000,2022-04-01,39,143,OH,Sandusky County,29854,28760,1094,3.7
CN3914500000000,2022-04-01,39,145,OH,Scioto County,29141,27861,1280,4.4
CN3914700000000,2022-04-01,39,147,OH,Seneca County,26255,25368,887,3.4
CN3914900000000,2022-04-01,39,149,OH,Shelby County,23430,22691,739,3.2
CN3915100000000,2022-04-01,39,151,OH,Stark County,180639,173919,6720,3.7
CN3915300000000,2022-04-01,39,153,OH,Summit County,263974,253908,10066,3.8
CN3915500000000,2022-04-01,39,155,OH,Trumbull County,82916,79152,3764,4.5
CN3915700000000,2022-04-01,39,157,OH,Tuscarawas County,44343,42775,1568,3.5
CN3915900000000,2022-04-01,39,159,OH,Union County,30137,29364,773,2.6
CN3916100000000,2022-04-01,39,161,OH,Van Wert County,14375,13923,452,3.1
CN3916300000000,2022-04-01,39,163,OH,Vinton County,5388,5151,237,4.4
CN3916500000000,2022-04-01,39,165,OH,Warren County,122057,118471,3586,2.9
CN3916700000000,2022-04-01,39,167,OH,Washington County,26680,25473,1207,4.5
CN3916900000000,2022-04-01,39,169,OH,Wayne County,60058,58359,1699,2.8
CN3917100000000,2022-04-01,39,171,OH,Williams County,18041,17488,553,3.1
CN3917300000000,2022-04-01,39,173,OH,Wood County,69301,67169,2132,3.1
CN3917500000000,2022-04-01,39,175,OH,Wyandot County,13244,12913,331,2.5
CN4000100000000,2022-04-01,40,001,OK,Adair County,8575,8335,240,2.8
CN4000300000000,2022-04-01,40,003,OK,Alfalfa County,2753,2708,45,1.6
CN4000500000000,2022-04-01,40,005,OK,Atoka County,5136,4976,160,3.1
CN4000700000000,2022-04-01,40,007,OK,Beaver County,2722,2683,39,1.4
CN4000900000000,2022-04-01,40,009,OK,Beckham County,10511,10274,237,2.3
CN4001100000000,2022-04-01,40,011,OK,Blaine County,4376,4297,79,1.8
CN4001300000000,2022-04-01,40,013,OK,Bryan County,22593,22065,528,2.3
CN4001500000000,2022-04-01,40,015,OK,Caddo County,11968,11647,321,2.7
CN4001700000000,2022-04-01,40,017,OK,Canadian County,79602,77881,1721,2.2
CN4001900000000,2022-04-01,40,019,OK,Carter County,21372,20726,646,3
CN4002100000000,2022-04-01,40,021,OK,Cherokee County,20205,19620,585,2.9
CN4002300000000,2022-04-01,40,023,OK,Choctaw County,5897,5688,209,3.5
CN4002500000000,2022-04-01,40,025,OK,Cimarron County,1618,1599,19,1.2
CN4002700000000,2022-04-01,40,027,OK,Cleveland County,146554,143400,3154,2.2
CN4002900000000,2022-04-01,40,029,OK,Coal County,2350,2279,71,3
CN4003100000000,2022-04-01,40,031,OK,Comanche County,46896,45450,1446,3.1
CN4003300000000,2022-04-01,40,033,OK,Cotton County,2676,2611,65,2.4
CN4003500000000,2022-04-01,40,035,OK,Craig County,5893,5744,149,2.5
CN4003700000000,2022-04-01,40,037,OK,Creek County,31220,30264,956,3.1
CN4003900000000,2022-04-01,40,039,OK,Custer County,15000,14653,347,2.3
CN4004100000000,2022-04-01,40,041,OK,Delaware County,19646,19162,484,2.5
CN4004300000000,2022-04-01,40,043,OK,Dewey County,2928,2874,54,1.8
CN4004500000000,2022-04-01,40,045,OK,Ellis County,2127,2089,38,1.8
CN4004700000000,2022-04-01,40,047,OK,Garfield County,26541,25898,643,2.4
CN4004900000000,2022-04-01,40,049,OK,Garvin County,12697,12395,302,2.4
CN4005100000000,2022-04-01,40,051,OK,Grady County,27130,26522,608,2.2
CN4005300000000,2022-04-01,40,053,OK,Grant County,2954,2910,44,1.5
CN4005500000000,2022-04-01,40,055,OK,Greer County,1871,1824,47,2.5
CN4005700000000,2022-04-01,40,057,OK,Harmon County,1194,1168,26,2.2
CN4005900000000,2022-04-01,40,059,OK,Harper County,1838,1806,32,1.7
CN4006100000000,2022-04-01,40,061,OK,Haskell County,4204,4052,152,3.6
CN4006300000000,2022-04-01,40,063,OK,Hughes County,5190,5018,172,3.3
CN4006500000000,2022-04-01,40,065,OK,Jackson County,10701,10454,247,2.3
CN4006700000000,2022-04-01,40,067,OK,Jefferson County,2494,2432,62,2.5
CN4006900000000,2022-04-01,40,069,OK,Johnston County,3728,3619,109,2.9
CN4007100000000,2022-04-01,40,071,OK,Kay County,18271,17730,541,3
CN4007300000000,2022-04-01,40,073,OK,Kingfisher County,8999,8841,158,1.8
CN4007500000000,2022-04-01,40,075,OK,Kiowa County,3677,3580,97,2.6
CN4007700000000,2022-04-01,40,077,OK,Latimer County,3143,3002,141,4.5
CN4007900000000,2022-04-01,40,079,OK,Le Flore County,19406,18807,599,3.1
CN4008100000000,2022-04-01,40,081,OK,Lincoln County,16105,15699,406,2.5
CN4008300000000,2022-04-01,40,083,OK,Logan County,23152,22626,526,2.3
CN4008500000000,2022-04-01,40,085,OK,Love County,5855,5740,115,2
CN4008700000000,2022-04-01,40,087,OK,McClain County,20839,20360,479,2.3
CN4008900000000,2022-04-01,40,089,OK,McCurtain County,16106,15572,534,3.3
CN4009100000000,2022-04-01,40,091,OK,McIntosh County,7244,6945,299,4.1
CN4009300000000,2022-04-01,40,093,OK,Major County,3816,3745,71,1.9
CN4009500000000,2022-04-01,40,095,OK,Marshall County,7447,7260,187,2.5
CN4009700000000,2022-04-01,40,097,OK,Mayes County,19665,19170,495,2.5
CN4009900000000,2022-04-01,40,099,OK,Murray County,6123,5974,149,2.4
CN4010100000000,2022-04-01,40,101,OK,Muskogee County,28501,27665,836,2.9
CN4010300000000,2022-04-01,40,103,OK,Noble County,5781,5679,102,1.8
CN4010500000000,2022-04-01,40,105,OK,Nowata County,4705,4583,122,2.6
CN4010700000000,2022-04-01,40,107,OK,Okfuskee County,4444,4297,147,3.3
CN4010900000000,2022-04-01,40,109,OK,Oklahoma County,393616,383764,9852,2.5
CN4011100000000,2022-04-01,40,111,OK,Okmulgee County,15460,14907,553,3.6
CN4011300000000,2022-04-01,40,113,OK,Osage County,20373,19727,646,3.2
CN4011500000000,2022-04-01,40,115,OK,Ottawa County,15030,14689,341,2.3
CN4011700000000,2022-04-01,40,117,OK,Pawnee County,7330,7112,218,3
CN4011900000000,2022-04-01,40,119,OK,Payne County,38895,38021,874,2.2
CN4012100000000,2022-04-01,40,121,OK,Pittsburg County,16300,15686,614,3.8
CN4012300000000,2022-04-01,40,123,OK,Pontotoc County,19403,18944,459,2.4
CN4012500000000,2022-04-01,40,125,OK,Pottawatomie County,33202,32246,956,2.9
CN4012700000000,2022-04-01,40,127,OK,Pushmataha County,4680,4527,153,3.3
CN4012900000000,2022-04-01,40,129,OK,Roger Mills County,1815,1779,36,2
CN4013100000000,2022-04-01,40,131,OK,Rogers County,45014,43894,1120,2.5
CN4013300000000,2022-04-01,40,133,OK,Seminole County,9242,8925,317,3.4
CN4013500000000,2022-04-01,40,135,OK,Sequoyah County,16726,16236,490,2.9
CN4013700000000,2022-04-01,40,137,OK,Stephens County,19058,18541,517,2.7
CN4013900000000,2022-04-01,40,139,OK,Texas County,12006,11824,182,1.5
CN4014100000000,2022-04-01,40,141,OK,Tillman County,2947,2872,75,2.5
CN4014300000000,2022-04-01,40,143,OK,Tulsa County,323690,315270,8420,2.6
CN4014500000000,2022-04-01,40,145,OK,Wagoner County,38801,37823,978,2.5
CN4014700000000,2022-04-01,40,147,OK,Washington County,22318,21674,644,2.9
CN4014900000000,2022-04-01,40,149,OK,Washita County,5273,5125,148,2.8
CN4015100000000,2022-04-01,40,151,OK,Woods County,4846,4768,78,1.6
CN4015300000000,2022-04-01,40,153,OK,Woodward County,8670,8457,213,2.5
CN4100100000000,2022-04-01,41,001,OR,Baker County,7467,7182,285,3.8
CN4100300000000,2022-04-01,41,003,OR,Benton County,49137,47587,1550,3.2
CN4100500000000,2022-04-01,41,005,OR,Clackamas County,225668,218269,7399,3.3
CN4100700000000,2022-04-01,41,007,OR,Clatsop County,19418,18701,717,3.7
CN4100900000000,2022-04-01,41,009,OR,Columbia County,25004,23965,1039,4.2
CN4101100000000,2022-04-01,41,011,OR,Coos County,26393,25228,1165,4.4
CN4101300000000,2022-04-01,41,013,OR,Crook County,11070,10561,509,4.6
CN4101500000000,2022-04-01,41,015,OR,Curry County,9127,8707,420,4.6
CN4101700000000,2022-04-01,41,017,OR,Deschutes County,102427,98895,3532,3.4
CN4101900000000,2022-04-01,41,019,OR,Douglas County,47588,45453,2135,4.5
CN4102100000000,2022-04-01,41,021,OR,Gilliam County,908,868,40,4.4
CN4102300000000,2022-04-01,41,023,OR,Grant County,3127,2922,205,6.6
CN4102500000000,2022-04-01,41,025,OR,Harney County,3855,3706,149,3.9
CN4102700000000,2022-04-01,41,027,OR,Hood River County,13880,13413,467,3.4
CN4102900000000,2022-04-01,41,029,OR,Jackson County,106123,101858,4265,4
CN4103100000000,2022-04-01,41,031,OR,Jefferson County,10391,9919,472,4.5
CN4103300000000,2022-04-01,41,033,OR,Josephine County,36618,34897,1721,4.7
CN4103500000000,2022-04-01,41,035,OR,Klamath County,29973,28467,1506,5
CN4103700000000,2022-04-01,41,037,OR,Lake County,3678,3518,160,4.4
CN4103900000000,2022-04-01,41,039,OR,Lane County,183794,176718,7076,3.8
CN4104100000000,2022-04-01,41,041,OR,Lincoln County,20765,19855,910,4.4
CN4104300000000,2022-04-01,41,043,OR,Linn County,61435,58969,2466,4
CN4104500000000,2022-04-01,41,045,OR,Malheur County,12797,12349,448,3.5
CN4104700000000,2022-04-01,41,047,OR,Marion County,168613,162324,6289,3.7
CN4104900000000,2022-04-01,41,049,OR,Morrow County,5989,5784,205,3.4
CN4105100000000,2022-04-01,41,051,OR,Multnomah County,465469,450042,15427,3.3
CN4105300000000,2022-04-01,41,053,OR,Polk County,42261,40687,1574,3.7
CN4105500000000,2022-04-01,41,055,OR,Sherman County,943,913,30,3.2
CN4105700000000,2022-04-01,41,057,OR,Tillamook County,12177,11705,472,3.9
CN4105900000000,2022-04-01,41,059,OR,Umatilla County,37677,36197,1480,3.9
CN4106100000000,2022-04-01,41,061,OR,Union County,12207,11698,509,4.2
CN4106300000000,2022-04-01,41,063,OR,Wallowa County,3514,3340,174,5
CN4106500000000,2022-04-01,41,065,OR,Wasco County,12713,12213,500,3.9
CN4106700000000,2022-04-01,41,067,OR,Washington County,333157,323177,9980,3
CN4106900000000,2022-04-01,41,069,OR,Wheeler County,738,717,21,2.8
CN4107100000000,2022-04-01,41,071,OR,Yamhill County,56120,54247,1873,3.3
CN4200100000000,2022-04-01,42,001,PA,Adams County,54626,53034,1592,2.9
CN4200300000000,2022-04-01,42,003,PA,Allegheny County,628462,604485,23977,3.8
CN4200500000000,2022-04-01,42,005,PA,Armstrong County,30883,29444,1439,4.7
CN4200700000000,2022-04-01,42,007,PA,Beaver County,81198,77414,3784,4.7
CN4200900000000,2022-04-01,42,009,PA,Bedford County,24051,23110,941,3.9
CN4201100000000,2022-04-01,42,011,PA,Berks County,212196,203849,8347,3.9
CN4201300000000,2022-04-01,42,013,PA,Blair County,58809,56484,2325,4
CN4201500000000,2022-04-01,42,015,PA,Bradford County,27674,26604,1070,3.9
CN4201700000000,2022-04-01,42,017,PA,Bucks County,348252,336148,12104,3.5
CN4201900000000,2022-04-01,42,019,PA,Butler County,98100,94425,3675,3.7
CN4202100000000,2022-04-01,42,021,PA,Cambria County,55215,52644,2571,4.7
CN4202300000000,2022-04-01,42,023,PA,Cameron County,1943,1847,96,4.9
CN4202500000000,2022-04-01,42,025,PA,Carbon County,32311,30814,1497,4.6
CN4202700000000,2022-04-01,42,027,PA,Centre County,77942,75562,2380,3.1
CN4202900000000,2022-04-01,42,029,PA,Chester County,292114,283647,8467,2.9
CN4203100000000,2022-04-01,42,031,PA,Clarion County,16169,15456,713,4.4
CN4203300000000,2022-04-01,42,033,PA,Clearfield County,35056,33350,1706,4.9
CN4203500000000,2022-04-01,42,035,PA,Clinton County,16992,16179,813,4.8
CN4203700000000,2022-04-01,42,037,PA,Columbia County,33738,32492,1246,3.7
CN4203900000000,2022-04-01,42,039,PA,Crawford County,37686,36082,1604,4.3
CN4204100000000,2022-04-01,42,041,PA,Cumberland County,133622,129558,4064,3
CN4204300000000,2022-04-01,42,043,PA,Dauphin County,144748,139464,5284,3.7
CN4204500000000,2022-04-01,42,045,PA,Delaware County,299841,288378,11463,3.8
CN4204700000000,2022-04-01,42,047,PA,Elk County,14613,13948,665,4.6
CN4204900000000,2022-04-01,42,049,PA,Erie County,125805,120055,5750,4.6
CN4205100000000,2022-04-01,42,051,PA,Fayette County,54582,51653,2929,5.4
CN4205300000000,2022-04-01,42,053,PA,Forest County,1698,1599,99,5.8
CN4205500000000,2022-04-01,42,055,PA,Franklin County,76958,74422,2536,3.3
CN4205700000000,2022-04-01,42,057,PA,Fulton County,7101,6848,253,3.6
CN4205900000000,2022-04-01,42,059,PA,Greene County,15520,14746,774,5
CN4206100000000,2022-04-01,42,061,PA,Huntingdon County,19161,18266,895,4.7
CN4206300000000,2022-04-01,42,063,PA,Indiana County,36384,34764,1620,4.5
CN4206500000000,2022-04-01,42,065,PA,Jefferson County,19275,18419,856,4.4
CN4206700000000,2022-04-01,42,067,PA,Juniata County,12429,11972,457,3.7
CN4206900000000,2022-04-01,42,069,PA,Lackawanna County,104481,100021,4460,4.3
CN4207100000000,2022-04-01,42,071,PA,Lancaster County,287787,278722,9065,3.1
CN4207300000000,2022-04-01,42,073,PA,Lawrence County,39181,37287,1894,4.8
CN4207500000000,2022-04-01,42,075,PA,Lebanon County,72487,70061,2426,3.3
CN4207700000000,2022-04-01,42,077,PA,Lehigh County,196110,188208,7902,4
CN4207900000000,2022-04-01,42,079,PA,Luzerne County,157172,149627,7545,4.8
CN4208100000000,2022-04-01,42,081,PA,Lycoming County,54962,52583,2379,4.3
CN4208300000000,2022-04-01,42,083,PA,McKean County,16772,15963,809,4.8
CN4208500000000,2022-04-01,42,085,PA,Mercer County,47513,45398,2115,4.5
CN4208700000000,2022-04-01,42,087,PA,Mifflin County,20772,19898,874,4.2
CN4208900000000,2022-04-01,42,089,PA,Monroe County,81284,77091,4193,5.2
CN4209100000000,2022-04-01,42,091,PA,Montgomery County,463532,448888,14644,3.2
CN4209300000000,2022-04-01,42,093,PA,Montour County,9190,8934,256,2.8
CN4209500000000,2022-04-01,42,095,PA,Northampton County,163233,157027,6206,3.8
CN4209700000000,2022-04-01,42,097,PA,Northumberland County,41801,39907,1894,4.5
CN4209900000000,2022-04-01,42,099,PA,Perry County,24328,23569,759,3.1
CN4210100000000,2022-04-01,42,101,PA,Philadelphia County/city,727884,691150,36734,5
CN4210300000000,2022-04-01,42,103,PA,Pike County,25526,24173,1353,5.3
CN4210500000000,2022-04-01,42,105,PA,Potter County,6865,6506,359,5.2
CN4210700000000,2022-04-01,42,107,PA,Schuylkill County,65195,62318,2877,4.4
CN4210900000000,2022-04-01,42,109,PA,Snyder County,19649,18904,745,3.8
CN4211100000000,2022-04-01,42,111,PA,Somerset County,31996,30509,1487,4.6
CN4211300000000,2022-04-01,42,113,PA,Sullivan County,2497,2379,118,4.7
CN4211500000000,2022-04-01,42,115,PA,Susquehanna County,19923,19144,779,3.9
CN4211700000000,2022-04-01,42,117,PA,Tioga County,18939,18119,820,4.3
CN4211900000000,2022-04-01,42,119,PA,Union County,19531,18851,680,3.5
CN4212100000000,2022-04-01,42,121,PA,Venango County,21309,20335,974,4.6
CN4212300000000,2022-04-01,42,123,PA,Warren County,17550,16843,707,4
CN4212500000000,2022-04-01,42,125,PA,Washington County,104090,99758,4332,4.2
CN4212700000000,2022-04-01,42,127,PA,Wayne County,22372,21318,1054,4.7
CN4212900000000,2022-04-01,42,129,PA,Westmoreland County,174517,167438,7079,4.1
CN4213100000000,2022-04-01,42,131,PA,Wyoming County,13394,12813,581,4.3
CN4213300000000,2022-04-01,42,133,PA,York County,236967,228885,8082,3.4
CN4400100000000,2022-04-01,44,001,RI,Bristol County,26335,25780,555,2.1
CN4400300000000,2022-04-01,44,003,RI,Kent County,93110,90733,2377,2.6
CN4400500000000,2022-04-01,44,005,RI,Newport County,44852,43747,1105,2.5
CN4400700000000,2022-04-01,44,007,RI,Providence County,332227,322090,10137,3.1
CN4400900000000,2022-04-01,44,009,RI,Washington County,69423,67771,1652,2.4
CN4500100000000,2022-04-01,45,001,SC,Abbeville County,9380,9093,287,3.1
CN4500300000000,2022-04-01,45,003,SC,Aiken County,74323,72438,1885,2.5
CN4500500000000,2022-04-01,45,005,SC,Allendale County,2253,2148,105,4.7
CN4500700000000,2022-04-01,45,007,SC,Anderson County,91345,89210,2135,2.3
CN4500900000000,2022-04-01,45,009,SC,Bamberg County,4505,4304,201,4.5
CN4501100000000,2022-04-01,45,011,SC,Barnwell County,7515,7213,302,4
CN4501300000000,2022-04-01,45,013,SC,Beaufort County,76372,74482,1890,2.5
CN4501500000000,2022-04-01,45,015,SC,Berkeley County,108424,105516,2908,2.7
CN4501700000000,2022-04-01,45,017,SC,Calhoun County,6431,6250,181,2.8
CN4501900000000,2022-04-01,45,019,SC,Charleston County,212712,207829,4883,2.3
CN4502100000000,2022-04-01,45,021,SC,Cherokee County,24226,23460,766,3.2
CN4502300000000,2022-04-01,45,023,SC,Chester County,13230,12774,456,3.4
CN4502500000000,2022-04-01,45,025,SC,Chesterfield County,21145,20527,618,2.9
CN4502700000000,2022-04-01,45,027,SC,Clarendon County,12102,11714,388,3.2
CN4502900000000,2022-04-01,45,029,SC,Colleton County,15774,15322,452,2.9
CN4503100000000,2022-04-01,45,031,SC,Darlington County,29637,28790,847,2.9
CN4503300000000,2022-04-01,45,033,SC,Dillon County,12761,12273,488,3.8
CN4503500000000,2022-04-01,45,035,SC,Dorchester County,78611,76642,1969,2.5
CN4503700000000,2022-04-01,45,037,SC,Edgefield County,10409,10158,251,2.4
CN4503900000000,2022-04-01,45,039,SC,Fairfield County,9274,8876,398,4.3
CN4504100000000,2022-04-01,45,041,SC,Florence County,65692,63974,1718,2.6
CN4504300000000,2022-04-01,45,043,SC,Georgetown County,25908,25142,766,3
CN4504500000000,2022-04-01,45,045,SC,Greenville County,259905,254040,5865,2.3
CN4504700000000,2022-04-01,45,047,SC,Greenwood County,29519,28638,881,3
CN4504900000000,2022-04-01,45,049,SC,Hampton County,7839,7652,187,2.4
CN4505100000000,2022-04-01,45,051,SC,Horry County,150174,145600,4574,3
CN4505300000000,2022-04-01,45,053,SC,Jasper County,13193,12863,330,2.5
CN4505500000000,2022-04-01,45,055,SC,Kershaw County,29481,28684,797,2.7
CN4505700000000,2022-04-01,45,057,SC,Lancaster County,43269,42006,1263,2.9
CN4505900000000,2022-04-01,45,059,SC,Laurens County,30084,29247,837,2.8
CN4506100000000,2022-04-01,45,061,SC,Lee County,6411,6164,247,3.9
CN4506300000000,2022-04-01,45,063,SC,Lexington County,151738,148507,3231,2.1
CN4506500000000,2022-04-01,45,065,SC,McCormick County,3446,3351,95,2.8
CN4506700000000,2022-04-01,45,067,SC,Marion County,12591,12074,517,4.1
CN4506900000000,2022-04-01,45,069,SC,Marlboro County,8188,7762,426,5.2
CN4507100000000,2022-04-01,45,071,SC,Newberry County,19156,18737,419,2.2
CN4507300000000,2022-04-01,45,073,SC,Oconee County,34075,33260,815,2.4
CN4507500000000,2022-04-01,45,075,SC,Orangeburg County,32737,31333,1404,4.3
CN4507700000000,2022-04-01,45,077,SC,Pickens County,57937,56475,1462,2.5
CN4507900000000,2022-04-01,45,079,SC,Richland County,197583,192374,5209,2.6
CN4508100000000,2022-04-01,45,081,SC,Saluda County,8479,8290,189,2.2
CN4508300000000,2022-04-01,45,083,SC,Spartanburg County,153846,149992,3854,2.5
CN4508500000000,2022-04-01,45,085,SC,Sumter County,41929,40651,1278,3
CN4508700000000,2022-04-01,45,087,SC,Union County,11115,10719,396,3.6
CN4508900000000,2022-04-01,45,089,SC,Williamsburg County,10853,10431,422,3.9
CN4509100000000,2022-04-01,45,091,SC,York County,147239,143385,3854,2.6
CN4600300000000,2022-04-01,46,003,SD,Aurora County,1507,1481,26,1.7
CN4600500000000,2022-04-01,46,005,SD,Beadle County,9237,9059,178,1.9
CN4600700000000,2022-04-01,46,007,SD,Bennett County,1060,1023,37,3.5
CN4600900000000,2022-04-01,46,009,SD,Bon Homme County,2858,2808,50,1.7
CN4601100000000,2022-04-01,46,011,SD,Brookings County,19450,19018,432,2.2
CN4601300000000,2022-04-01,46,013,SD,Brown County,20200,19726,474,2.3
CN4601500000000,2022-04-01,46,015,SD,Brule County,2679,2635,44,1.6
CN4601700000000,2022-04-01,46,017,SD,Buffalo County,726,705,21,2.9
CN4601900000000,2022-04-01,46,019,SD,Butte County,4949,4852,97,2
CN4602100000000,2022-04-01,46,021,SD,Campbell County,779,760,19,2.4
CN4602300000000,2022-04-01,46,023,SD,Charles Mix County,3836,3755,81,2.1
CN4602500000000,2022-04-01,46,025,SD,Clark County,2009,1961,48,2.4
CN4602700000000,2022-04-01,46,027,SD,Clay County,7680,7511,169,2.2
CN4602900000000,2022-04-01,46,029,SD,Codington County,15948,15624,324,2
CN4603100000000,2022-04-01,46,031,SD,Corson County,1315,1281,34,2.6
CN4603300000000,2022-04-01,46,033,SD,Custer County,4210,4098,112,2.7
CN4603500000000,2022-04-01,46,035,SD,Davison County,11052,10849,203,1.8
CN4603700000000,2022-04-01,46,037,SD,Day County,2746,2662,84,3.1
CN4603900000000,2022-04-01,46,039,SD,Deuel County,2292,2225,67,2.9
CN4604100000000,2022-04-01,46,041,SD,Dewey County,2243,2165,78,3.5
CN4604300000000,2022-04-01,46,043,SD,Douglas County,1533,1507,26,1.7
CN4604500000000,2022-04-01,46,045,SD,Edmunds County,2042,1999,43,2.1
CN4604700000000,2022-04-01,46,047,SD,Fall River County,3069,2999,70,2.3
CN4604900000000,2022-04-01,46,049,SD,Faulk County,1112,1090,22,2
CN4605100000000,2022-04-01,46,051,SD,Grant County,4452,4334,118,2.7
CN4605300000000,2022-04-01,46,053,SD,Gregory County,2159,2120,39,1.8
CN4605500000000,2022-04-01,46,055,SD,Haakon County,1084,1068,16,1.5
CN4605700000000,2022-04-01,46,057,SD,Hamlin County,3570,3498,72,2
CN4605900000000,2022-04-01,46,059,SD,Hand County,1843,1815,28,1.5
CN4606100000000,2022-04-01,46,061,SD,Hanson County,1805,1761,44,2.4
CN4606300000000,2022-04-01,46,063,SD,Harding County,771,758,13,1.7
CN4606500000000,2022-04-01,46,065,SD,Hughes County,9764,9604,160,1.6
CN4606700000000,2022-04-01,46,067,SD,Hutchinson County,3652,3567,85,2.3
CN4606900000000,2022-04-01,46,069,SD,Hyde County,689,675,14,2
CN4607100000000,2022-04-01,46,071,SD,Jackson County,1235,1201,34,2.8
CN4607300000000,2022-04-01,46,073,SD,Jerauld County,1405,1388,17,1.2
CN4607500000000,2022-04-01,46,075,SD,Jones County,530,517,13,2.5
CN4607700000000,2022-04-01,46,077,SD,Kingsbury County,2916,2864,52,1.8
CN4607900000000,2022-04-01,46,079,SD,Lake County,6709,6575,134,2
CN4608100000000,2022-04-01,46,081,SD,Lawrence County,13910,13650,260,1.9
CN4608300000000,2022-04-01,46,083,SD,Lincoln County,37234,36636,598,1.6
CN4608500000000,2022-04-01,46,085,SD,Lyman County,1706,1670,36,2.1
CN4608700000000,2022-04-01,46,087,SD,McCook County,3128,3079,49,1.6
CN4608900000000,2022-04-01,46,089,SD,McPherson County,1001,974,27,2.7
CN4609100000000,2022-04-01,46,091,SD,Marshall County,2466,2387,79,3.2
CN4609300000000,2022-04-01,46,093,SD,Meade County,14248,13959,289,2
CN4609500000000,2022-04-01,46,095,SD,Mellette County,786,767,19,2.4
CN4609700000000,2022-04-01,46,097,SD,Miner County,1235,1213,22,1.8
CN4609900000000,2022-04-01,46,099,SD,Minnehaha County,115553,113440,2113,1.8
CN4610100000000,2022-04-01,46,101,SD,Moody County,4093,4022,71,1.7
CN4610200000000,2022-04-01,46,102,SD,Oglala Lakota County,3703,3545,158,4.3
CN4610300000000,2022-04-01,46,103,SD,Pennington County,58577,57406,1171,2
CN4610500000000,2022-04-01,46,105,SD,Perkins County,1463,1435,28,1.9
CN4610700000000,2022-04-01,46,107,SD,Potter County,1053,1028,25,2.4
CN4610900000000,2022-04-01,46,109,SD,Roberts County,4642,4478,164,3.5
CN4611100000000,2022-04-01,46,111,SD,Sanborn County,1226,1205,21,1.7
CN4611500000000,2022-04-01,46,115,SD,Spink County,3085,3014,71,2.3
CN4611700000000,2022-04-01,46,117,SD,Stanley County,1928,1894,34,1.8
CN4611900000000,2022-04-01,46,119,SD,Sully County,835,822,13,1.6
CN4612100000000,2022-04-01,46,121,SD,Todd County,2991,2884,107,3.6
CN4612300000000,2022-04-01,46,123,SD,Tripp County,3078,3033,45,1.5
CN4612500000000,2022-04-01,46,125,SD,Turner County,4771,4692,79,1.7
CN4612700000000,2022-04-01,46,127,SD,Union County,8693,8513,180,2.1
CN4612900000000,2022-04-01,46,129,SD,Walworth County,2131,2051,80,3.8
CN4613500000000,2022-04-01,46,135,SD,Yankton County,11627,11427,200,1.7
CN4613700000000,2022-04-01,46,137,SD,Ziebach County,952,924,28,2.9
CN4700100000000,2022-04-01,47,001,TN,Anderson County,35563,34491,1072,3
CN4700300000000,2022-04-01,47,003,TN,Bedford County,21857,21193,664,3
CN4700500000000,2022-04-01,47,005,TN,Benton County,6886,6627,259,3.8
CN4700700000000,2022-04-01,47,007,TN,Bledsoe County,4438,4221,217,4.9
CN4700900000000,2022-04-01,47,009,TN,Blount County,66078,64233,1845,2.8
CN4701100000000,2022-04-01,47,011,TN,Bradley County,50610,49017,1593,3.1
CN4701300000000,2022-04-01,47,013,TN,Campbell County,15069,14513,556,3.7
CN4701500000000,2022-04-01,47,015,TN,Cannon County,6907,6703,204,3
CN4701700000000,2022-04-01,47,017,TN,Carroll County,11833,11412,421,3.6
CN4701900000000,2022-04-01,47,019,TN,Carter County,24402,23606,796,3.3
CN4702100000000,2022-04-01,47,021,TN,Cheatham County,22794,22197,597,2.6
CN4702300000000,2022-04-01,47,023,TN,Chester County,8618,8398,220,2.6
CN4702500000000,2022-04-01,47,025,TN,Claiborne County,13087,12663,424,3.2
CN4702700000000,2022-04-01,47,027,TN,Clay County,2785,2665,120,4.3
CN4702900000000,2022-04-01,47,029,TN,Cocke County,14751,14053,698,4.7
CN4703100000000,2022-04-01,47,031,TN,Coffee County,25381,24602,779,3.1
CN4703300000000,2022-04-01,47,033,TN,Crockett County,6925,6727,198,2.9
CN4703500000000,2022-04-01,47,035,TN,Cumberland County,23248,22397,851,3.7
CN4703700000000,2022-04-01,47,037,TN,Davidson County,415033,404048,10985,2.6
CN4703900000000,2022-04-01,47,039,TN,Decatur County,4402,4233,169,3.8
CN4704100000000,2022-04-01,47,041,TN,DeKalb County,8014,7737,277,3.5
CN4704300000000,2022-04-01,47,043,TN,Dickson County,28045,27278,767,2.7
CN4704500000000,2022-04-01,47,045,TN,Dyer County,16703,16166,537,3.2
CN4704700000000,2022-04-01,47,047,TN,Fayette County,19419,18784,635,3.3
CN4704900000000,2022-04-01,47,049,TN,Fentress County,7748,7498,250,3.2
CN4705100000000,2022-04-01,47,051,TN,Franklin County,19606,18978,628,3.2
CN4705300000000,2022-04-01,47,053,TN,Gibson County,21768,21065,703,3.2
CN4705500000000,2022-04-01,47,055,TN,Giles County,15162,14726,436,2.9
CN4705700000000,2022-04-01,47,057,TN,Grainger County,9805,9471,334,3.4
CN4705900000000,2022-04-01,47,059,TN,Greene County,29266,28277,989,3.4
CN4706100000000,2022-04-01,47,061,TN,Grundy County,4950,4736,214,4.3
CN4706300000000,2022-04-01,47,063,TN,Hamblen County,28279,27332,947,3.3
CN4706500000000,2022-04-01,47,065,TN,Hamilton County,184017,178230,5787,3.1
CN4706700000000,2022-04-01,47,067,TN,Hancock County,2333,2237,96,4.1
CN4706900000000,2022-04-01,47,069,TN,Hardeman County,9068,8722,346,3.8
CN4707100000000,2022-04-01,47,071,TN,Hardin County,10230,9860,370,3.6
CN4707300000000,2022-04-01,47,073,TN,Hawkins County,23385,22567,818,3.5
CN4707500000000,2022-04-01,47,075,TN,Haywood County,7644,7350,294,3.8
CN4707700000000,2022-04-01,47,077,TN,Henderson County,11804,11431,373,3.2
CN4707900000000,2022-04-01,47,079,TN,Henry County,13583,13093,490,3.6
CN4708100000000,2022-04-01,47,081,TN,Hickman County,11813,11498,315,2.7
CN4708300000000,2022-04-01,47,083,TN,Houston County,3217,3094,123,3.8
CN4708500000000,2022-04-01,47,085,TN,Humphreys County,8709,8426,283,3.2
CN4708700000000,2022-04-01,47,087,TN,Jackson County,4864,4701,163,3.4
CN4708900000000,2022-04-01,47,089,TN,Jefferson County,25097,24295,802,3.2
CN4709100000000,2022-04-01,47,091,TN,Johnson County,7672,7443,229,3
CN4709300000000,2022-04-01,47,093,TN,Knox County,253107,246502,6605,2.6
CN4709500000000,2022-04-01,47,095,TN,Lake County,1654,1584,70,4.2
CN4709700000000,2022-04-01,47,097,TN,Lauderdale County,9463,9066,397,4.2
CN4709900000000,2022-04-01,47,099,TN,Lawrence County,19617,19022,595,3
CN4710100000000,2022-04-01,47,101,TN,Lewis County,5632,5446,186,3.3
CN4710300000000,2022-04-01,47,103,TN,Lincoln County,16676,16160,516,3.1
CN4710500000000,2022-04-01,47,105,TN,Loudon County,24584,23854,730,3
CN4710700000000,2022-04-01,47,107,TN,McMinn County,21894,21131,763,3.5
CN4710900000000,2022-04-01,47,109,TN,McNairy County,8490,8154,336,4
CN4711100000000,2022-04-01,47,111,TN,Macon County,11708,11387,321,2.7
CN4711300000000,2022-04-01,47,113,TN,Madison County,49624,48085,1539,3.1
CN4711500000000,2022-04-01,47,115,TN,Marion County,12314,11896,418,3.4
CN4711700000000,2022-04-01,47,117,TN,Marshall County,15703,15226,477,3
CN4711900000000,2022-04-01,47,119,TN,Maury County,53189,51704,1485,2.8
CN4712100000000,2022-04-01,47,121,TN,Meigs County,5192,5003,189,3.6
CN4712300000000,2022-04-01,47,123,TN,Monroe County,21323,20701,622,2.9
CN4712500000000,2022-04-01,47,125,TN,Montgomery County,88586,85582,3004,3.4
CN4712700000000,2022-04-01,47,127,TN,Moore County,3704,3622,82,2.2
CN4712900000000,2022-04-01,47,129,TN,Morgan County,7896,7625,271,3.4
CN4713100000000,2022-04-01,47,131,TN,Obion County,12797,12364,433,3.4
CN4713300000000,2022-04-01,47,133,TN,Overton County,10176,9890,286,2.8
CN4713500000000,2022-04-01,47,135,TN,Perry County,2803,2670,133,4.7
CN4713700000000,2022-04-01,47,137,TN,Pickett County,2221,2151,70,3.2
CN4713900000000,2022-04-01,47,139,TN,Polk County,7109,6868,241,3.4
CN4714100000000,2022-04-01,47,141,TN,Putnam County,36151,35085,1066,2.9
CN4714300000000,2022-04-01,47,143,TN,Rhea County,14443,13947,496,3.4
CN4714500000000,2022-04-01,47,145,TN,Roane County,23931,23135,796,3.3
CN4714700000000,2022-04-01,47,147,TN,Robertson County,39387,38359,1028,2.6
CN4714900000000,2022-04-01,47,149,TN,Rutherford County,196465,191468,4997,2.5
CN4715100000000,2022-04-01,47,151,TN,Scott County,8198,7867,331,4
CN4715300000000,2022-04-01,47,153,TN,Sequatchie County,6193,5967,226,3.6
CN4715500000000,2022-04-01,47,155,TN,Sevier County,55816,54349,1467,2.6
CN4715700000000,2022-04-01,47,157,TN,Shelby County,441509,423402,18107,4.1
CN4715900000000,2022-04-01,47,159,TN,Smith County,9797,9536,261,2.7
CN4716100000000,2022-04-01,47,161,TN,Stewart County,5483,5291,192,3.5
CN4716300000000,2022-04-01,47,163,TN,Sullivan County,69496,67315,2181,3.1
CN4716500000000,2022-04-01,47,165,TN,Sumner County,109368,106561,2807,2.6
CN4716700000000,2022-04-01,47,167,TN,Tipton County,27854,26934,920,3.3
CN4716900000000,2022-04-01,47,169,TN,Trousdale County,5748,5592,156,2.7
CN4717100000000,2022-04-01,47,171,TN,Unicoi County,7141,6874,267,3.7
CN4717300000000,2022-04-01,47,173,TN,Union County,7929,7659,270,3.4
CN4717500000000,2022-04-01,47,175,TN,Van Buren County,2106,2024,82,3.9
CN4717700000000,2022-04-01,47,177,TN,Warren County,16608,15990,618,3.7
CN4717900000000,2022-04-01,47,179,TN,Washington County,62159,60372,1787,2.9
CN4718100000000,2022-04-01,47,181,TN,Wayne County,6549,6303,246,3.8
CN4718300000000,2022-04-01,47,183,TN,Weakley County,15574,15112,462,3
CN4718500000000,2022-04-01,47,185,TN,White County,12223,11850,373,3.1
CN4718700000000,2022-04-01,47,187,TN,Williamson County,138895,135848,3047,2.2
CN4718900000000,2022-04-01,47,189,TN,Wilson County,82320,80309,2011,2.4
CN4800100000000,2022-04-01,48,001,TX,Anderson County,23067,22345,722,3.1
CN4800300000000,2022-04-01,48,003,TX,Andrews County,9383,9100,283,3
CN4800500000000,2022-04-01,48,005,TX,Angelina County,35141,33682,1459,4.2
CN4800700000000,2022-04-01,48,007,TX,Aransas County,9285,8834,451,4.9
CN4800900000000,2022-04-01,48,009,TX,Archer County,4070,3947,123,3
CN4801100000000,2022-04-01,48,011,TX,Armstrong County,967,944,23,2.4
CN4801300000000,2022-04-01,48,013,TX,Atascosa County,22499,21668,831,3.7
CN4801500000000,2022-04-01,48,015,TX,Austin County,14134,13636,498,3.5
CN4801700000000,2022-04-01,48,017,TX,Bailey County,2579,2489,90,3.5
CN4801900000000,2022-04-01,48,019,TX,Bandera County,10583,10246,337,3.2
CN4802100000000,2022-04-01,48,021,TX,Bastrop County,47955,46519,1436,3
CN4802300000000,2022-04-01,48,023,TX,Baylor County,1922,1872,50,2.6
CN4802500000000,2022-04-01,48,025,TX,Bee County,9198,8695,503,5.5
CN4802700000000,2022-04-01,48,027,TX,Bell County,149218,143285,5933,4
CN4802900000000,2022-04-01,48,029,TX,Bexar County,971505,939000,32505,3.3
CN4803100000000,2022-04-01,48,031,TX,Blanco County,7118,6934,184,2.6
CN4803300000000,2022-04-01,48,033,TX,Borden County,697,685,12,1.7
CN4803500000000,2022-04-01,48,035,TX,Bosque County,8715,8426,289,3.3
CN4803700000000,2022-04-01,48,037,TX,Bowie County,38707,37062,1645,4.2
CN4803900000000,2022-04-01,48,039,TX,Brazoria County,183477,175940,7537,4.1
CN4804100000000,2022-04-01,48,041,TX,Brazos County,129781,126268,3513,2.7
CN4804300000000,2022-04-01,48,043,TX,Brewster County,4305,4177,128,3
CN4804500000000,2022-04-01,48,045,TX,Briscoe County,622,604,18,2.9
CN4804700000000,2022-04-01,48,047,TX,Brooks County,2344,2213,131,5.6
CN4804900000000,2022-04-01,48,049,TX,Brown County,15344,14785,559,3.6
CN4805100000000,2022-04-01,48,051,TX,Burleson County,8973,8692,281,3.1
CN4805300000000,2022-04-01,48,053,TX,Burnet County,25566,24887,679,2.7
CN4805500000000,2022-04-01,48,055,TX,Caldwell County,21179,20517,662,3.1
CN4805700000000,2022-04-01,48,057,TX,Calhoun County,12196,11777,419,3.4
CN4805900000000,2022-04-01,48,059,TX,Callahan County,6250,6051,199,3.2
CN4806100000000,2022-04-01,48,061,TX,Cameron County,177081,167651,9430,5.3
CN4806300000000,2022-04-01,48,063,TX,Camp County,5147,4943,204,4
CN4806500000000,2022-04-01,48,065,TX,Carson County,3098,3016,82,2.6
CN4806700000000,2022-04-01,48,067,TX,Cass County,12111,11602,509,4.2
CN4806900000000,2022-04-01,48,069,TX,Castro County,3533,3437,96,2.7
CN4807100000000,2022-04-01,48,071,TX,Chambers County,20879,19864,1015,4.9
CN4807300000000,2022-04-01,48,073,TX,Cherokee County,20872,20067,805,3.9
CN4807500000000,2022-04-01,48,075,TX,Childress County,3194,3110,84,2.6
CN4807700000000,2022-04-01,48,077,TX,Clay County,4960,4784,176,3.5
CN4807900000000,2022-04-01,48,079,TX,Cochran County,1248,1192,56,4.5
CN4808100000000,2022-04-01,48,081,TX,Coke County,1478,1429,49,3.3
CN4808300000000,2022-04-01,48,083,TX,Coleman County,3063,2948,115,3.8
CN4808500000000,2022-04-01,48,085,TX,Collin County,620409,602665,17744,2.9
CN4808700000000,2022-04-01,48,087,TX,Collingsworth County,1129,1096,33,2.9
CN4808900000000,2022-04-01,48,089,TX,Colorado County,10194,9863,331,3.2
CN4809100000000,2022-04-01,48,091,TX,Comal County,81553,79058,2495,3.1
CN4809300000000,2022-04-01,48,093,TX,Comanche County,6372,6176,196,3.1
CN4809500000000,2022-04-01,48,095,TX,Concho County,1442,1402,40,2.8
CN4809700000000,2022-04-01,48,097,TX,Cooke County,20060,19472,588,2.9
CN4809900000000,2022-04-01,48,099,TX,Coryell County,24651,23682,969,3.9
CN4810100000000,2022-04-01,48,101,TX,Cottle County,839,821,18,2.1
CN4810300000000,2022-04-01,48,103,TX,Crane County,1546,1473,73,4.7
CN4810500000000,2022-04-01,48,105,TX,Crockett County,1406,1353,53,3.8
CN4810700000000,2022-04-01,48,107,TX,Crosby County,2539,2449,90,3.5
CN4810900000000,2022-04-01,48,109,TX,Culberson County,1159,1129,30,2.6
CN4811100000000,2022-04-01,48,111,TX,Dallam County,4030,3959,71,1.8
CN4811300000000,2022-04-01,48,113,TX,Dallas County,1408372,1360793,47579,3.4
CN4811500000000,2022-04-01,48,115,TX,Dawson County,4608,4418,190,4.1
CN4811700000000,2022-04-01,48,117,TX,Deaf Smith County,9344,9102,242,2.6
CN4811900000000,2022-04-01,48,119,TX,Delta County,2521,2434,87,3.5
CN4812100000000,2022-04-01,48,121,TX,Denton County,547236,531507,15729,2.9
CN4812300000000,2022-04-01,48,123,TX,DeWitt County,9090,8807,283,3.1
CN4812500000000,2022-04-01,48,125,TX,Dickens County,691,664,27,3.9
CN4812700000000,2022-04-01,48,127,TX,Dimmit County,6106,5881,225,3.7
CN4812900000000,2022-04-01,48,129,TX,Donley County,1548,1501,47,3
CN4813100000000,2022-04-01,48,131,TX,Duval County,5033,4810,223,4.4
CN4813300000000,2022-04-01,48,133,TX,Eastland County,6799,6516,283,4.2
CN4813500000000,2022-04-01,48,135,TX,Ector County,82662,79575,3087,3.7
CN4813700000000,2022-04-01,48,137,TX,Edwards County,1311,1278,33,2.5
CN4813900000000,2022-04-01,48,139,TX,Ellis County,102519,99318,3201,3.1
CN4814100000000,2022-04-01,48,141,TX,El Paso County,369116,354763,14353,3.9
CN4814300000000,2022-04-01,48,143,TX,Erath County,21949,21303,646,2.9
CN4814500000000,2022-04-01,48,145,TX,Falls County,6941,6689,252,3.6
CN4814700000000,2022-04-01,48,147,TX,Fannin County,17419,16915,504,2.9
CN4814900000000,2022-04-01,48,149,TX,Fayette County,11972,11601,371,3.1
CN4815100000000,2022-04-01,48,151,TX,Fisher County,1677,1630,47,2.8
CN4815300000000,2022-04-01,48,153,TX,Floyd County,2601,2507,94,3.6
CN4815500000000,2022-04-01,48,155,TX,Foard County,596,579,17,2.9
CN4815700000000,2022-04-01,48,157,TX,Fort Bend County,416205,401266,14939,3.6
CN4815900000000,2022-04-01,48,159,TX,Franklin County,5408,5268,140,2.6
CN4816100000000,2022-04-01,48,161,TX,Freestone County,6390,6063,327,5.1
CN4816300000000,2022-04-01,48,163,TX,Frio County,9584,9294,290,3
CN4816500000000,2022-04-01,48,165,TX,Gaines County,10424,10146,278,2.7
CN4816700000000,2022-04-01,48,167,TX,Galveston County,168093,161416,6677,4
CN4816900000000,2022-04-01,48,169,TX,Garza County,1923,1868,55,2.9
CN4817100000000,2022-04-01,48,171,TX,Gillespie County,14687,14327,360,2.5
CN4817300000000,2022-04-01,48,173,TX,Glasscock County,940,916,24,2.6
CN4817500000000,2022-04-01,48,175,TX,Goliad County,3206,3084,122,3.8
CN4817700000000,2022-04-01,48,177,TX,Gonzales County,9712,9435,277,2.9
CN4817900000000,2022-04-01,48,179,TX,Gray County,7698,7391,307,4
CN4818100000000,2022-04-01,48,181,TX,Grayson County,65380,63230,2150,3.3
CN4818300000000,2022-04-01,48,183,TX,Gregg County,56811,54611,2200,3.9
CN4818500000000,2022-04-01,48,185,TX,Grimes County,11494,11041,453,3.9
CN4818700000000,2022-04-01,48,187,TX,Guadalupe County,85149,82574,2575,3
CN4818900000000,2022-04-01,48,189,TX,Hale County,12021,11524,497,4.1
CN4819100000000,2022-04-01,48,191,TX,Hall County,1138,1097,41,3.6
CN4819300000000,2022-04-01,48,193,TX,Hamilton County,3927,3812,115,2.9
CN4819500000000,2022-04-01,48,195,TX,Hansford County,2891,2833,58,2
CN4819700000000,2022-04-01,48,197,TX,Hardeman County,1821,1763,58,3.2
CN4819900000000,2022-04-01,48,199,TX,Hardin County,24773,23643,1130,4.6
CN4820100000000,2022-04-01,48,201,TX,Harris County,2324264,2234179,90085,3.9
CN4820300000000,2022-04-01,48,203,TX,Harrison County,29058,27846,1212,4.2
CN4820500000000,2022-04-01,48,205,TX,Hartley County,2732,2689,43,1.6
CN4820700000000,2022-04-01,48,207,TX,Haskell County,2841,2765,76,2.7
CN4820900000000,2022-04-01,48,209,TX,Hays County,137659,133957,3702,2.7
CN4821100000000,2022-04-01,48,211,TX,Hemphill County,1661,1614,47,2.8
CN4821300000000,2022-04-01,48,213,TX,Henderson County,38980,37666,1314,3.4
CN4821500000000,2022-04-01,48,215,TX,Hidalgo County,371549,349287,22262,6
CN4821700000000,2022-04-01,48,217,TX,Hill County,17785,17215,570,3.2
CN4821900000000,2022-04-01,48,219,TX,Hockley County,11132,10766,366,3.3
CN4822100000000,2022-04-01,48,221,TX,Hood County,29724,28717,1007,3.4
CN4822300000000,2022-04-01,48,223,TX,Hopkins County,18449,17901,548,3
CN4822500000000,2022-04-01,48,225,TX,Houston County,10557,10232,325,3.1
CN4822700000000,2022-04-01,48,227,TX,Howard County,13222,12592,630,4.8
CN4822900000000,2022-04-01,48,229,TX,Hudspeth County,1951,1881,70,3.6
CN4823100000000,2022-04-01,48,231,TX,Hunt County,46447,44837,1610,3.5
CN4823300000000,2022-04-01,48,233,TX,Hutchinson County,8467,8133,334,3.9
CN4823500000000,2022-04-01,48,235,TX,Irion County,810,786,24,3
CN4823700000000,2022-04-01,48,237,TX,Jack County,3411,3285,126,3.7
CN4823900000000,2022-04-01,48,239,TX,Jackson County,7237,7015,222,3.1
CN4824100000000,2022-04-01,48,241,TX,Jasper County,12476,11756,720,5.8
CN4824300000000,2022-04-01,48,243,TX,Jeff Davis County,1139,1109,30,2.6
CN4824500000000,2022-04-01,48,245,TX,Jefferson County,100580,94940,5640,5.6
CN4824700000000,2022-04-01,48,247,TX,Jim Hogg County,1836,1739,97,5.3
CN4824900000000,2022-04-01,48,249,TX,Jim Wells County,15247,14443,804,5.3
CN4825100000000,2022-04-01,48,251,TX,Johnson County,88379,85611,2768,3.1
CN4825300000000,2022-04-01,48,253,TX,Jones County,5876,5654,222,3.8
CN4825500000000,2022-04-01,48,255,TX,Karnes County,6715,6505,210,3.1
CN4825700000000,2022-04-01,48,257,TX,Kaufman County,74495,72017,2478,3.3
CN4825900000000,2022-04-01,48,259,TX,Kendall County,23696,23061,635,2.7
CN4826100000000,2022-04-01,48,261,TX,Kenedy County,142,133,9,6.3
CN4826300000000,2022-04-01,48,263,TX,Kent County,547,536,11,2
CN4826500000000,2022-04-01,48,265,TX,Kerr County,22126,21412,714,3.2
CN4826700000000,2022-04-01,48,267,TX,Kimble County,1896,1840,56,3
CN4826900000000,2022-04-01,48,269,TX,King County,708,705,3,0.4
CN4827100000000,2022-04-01,48,271,TX,Kinney County,1309,1254,55,4.2
CN4827300000000,2022-04-01,48,273,TX,Kleberg County,13427,12853,574,4.3
CN4827500000000,2022-04-01,48,275,TX,Knox County,1548,1493,55,3.6
CN4827700000000,2022-04-01,48,277,TX,Lamar County,24668,23741,927,3.8
CN4827900000000,2022-04-01,48,279,TX,Lamb County,5498,5300,198,3.6
CN4828100000000,2022-04-01,48,281,TX,Lampasas County,9457,9147,310,3.3
CN4828300000000,2022-04-01,48,283,TX,La Salle County,4067,3956,111,2.7
CN4828500000000,2022-04-01,48,285,TX,Lavaca County,9165,8876,289,3.2
CN4828700000000,2022-04-01,48,287,TX,Lee County,8600,8307,293,3.4
CN4828900000000,2022-04-01,48,289,TX,Leon County,6088,5810,278,4.6
CN4829100000000,2022-04-01,48,291,TX,Liberty County,35158,33251,1907,5.4
CN4829300000000,2022-04-01,48,293,TX,Limestone County,8372,8026,346,4.1
CN4829500000000,2022-04-01,48,295,TX,Lipscomb County,1500,1460,40,2.7
CN4829700000000,2022-04-01,48,297,TX,Live Oak County,4897,4715,182,3.7
CN4829900000000,2022-04-01,48,299,TX,Llano County,9368,9043,325,3.5
CN4830100000000,2022-04-01,48,301,TX,Loving County,433,428,5,1.2
CN4830300000000,2022-04-01,48,303,TX,Lubbock County,164289,159453,4836,2.9
CN4830500000000,2022-04-01,48,305,TX,Lynn County,3001,2902,99,3.3
CN4830700000000,2022-04-01,48,307,TX,McCulloch County,3120,3001,119,3.8
CN4830900000000,2022-04-01,48,309,TX,McLennan County,127080,123010,4070,3.2
CN4831100000000,2022-04-01,48,311,TX,McMullen County,918,903,15,1.6
CN4831300000000,2022-04-01,48,313,TX,Madison County,4815,4637,178,3.7
CN4831500000000,2022-04-01,48,315,TX,Marion County,4204,4010,194,4.6
CN4831700000000,2022-04-01,48,317,TX,Martin County,2822,2741,81,2.9
CN4831900000000,2022-04-01,48,319,TX,Mason County,1849,1796,53,2.9
CN4832100000000,2022-04-01,48,321,TX,Matagorda County,17166,16233,933,5.4
CN4832300000000,2022-04-01,48,323,TX,Maverick County,23639,21623,2016,8.5
CN4832500000000,2022-04-01,48,325,TX,Medina County,22685,21919,766,3.4
CN4832700000000,2022-04-01,48,327,TX,Menard County,853,823,30,3.5
CN4832900000000,2022-04-01,48,329,TX,Midland County,104387,101485,2902,2.8
CN4833100000000,2022-04-01,48,331,TX,Milam County,10445,10073,372,3.6
CN4833300000000,2022-04-01,48,333,TX,Mills County,1998,1927,71,3.6
CN4833500000000,2022-04-01,48,335,TX,Mitchell County,2361,2258,103,4.4
CN4833700000000,2022-04-01,48,337,TX,Montague County,9262,8981,281,3
CN4833900000000,2022-04-01,48,339,TX,Montgomery County,300036,289299,10737,3.6
CN4834100000000,2022-04-01,48,341,TX,Moore County,11400,11128,272,2.4
CN4834300000000,2022-04-01,48,343,TX,Morris County,4401,4146,255,5.8
CN4834500000000,2022-04-01,48,345,TX,Motley County,534,514,20,3.7
CN4834700000000,2022-04-01,48,347,TX,Nacogdoches County,27899,26852,1047,3.8
CN4834900000000,2022-04-01,48,349,TX,Navarro County,23324,22493,831,3.6
CN4835100000000,2022-04-01,48,351,TX,Newton County,4874,4576,298,6.1
CN4835300000000,2022-04-01,48,353,TX,Nolan County,6789,6555,234,3.4
CN4835500000000,2022-04-01,48,355,TX,Nueces County,163791,156584,7207,4.4
CN4835700000000,2022-04-01,48,357,TX,Ochiltree County,4073,3951,122,3
CN4835900000000,2022-04-01,48,359,TX,Oldham County,974,947,27,2.8
CN4836100000000,2022-04-01,48,361,TX,Orange County,34665,32849,1816,5.2
CN4836300000000,2022-04-01,48,363,TX,Palo Pinto County,13141,12696,445,3.4
CN4836500000000,2022-04-01,48,365,TX,Panola County,9542,9135,407,4.3
CN4836700000000,2022-04-01,48,367,TX,Parker County,74171,71970,2201,3
CN4836900000000,2022-04-01,48,369,TX,Parmer County,5345,5237,108,2
CN4837100000000,2022-04-01,48,371,TX,Pecos County,6420,6169,251,3.9
CN4837300000000,2022-04-01,48,373,TX,Polk County,18546,17571,975,5.3
CN4837500000000,2022-04-01,48,375,TX,Potter County,55447,53846,1601,2.9
CN4837700000000,2022-04-01,48,377,TX,Presidio County,3161,2983,178,5.6
CN4837900000000,2022-04-01,48,379,TX,Rains County,6530,6339,191,2.9
CN4838100000000,2022-04-01,48,381,TX,Randall County,76895,74979,1916,2.5
CN4838300000000,2022-04-01,48,383,TX,Reagan County,1668,1613,55,3.3
CN4838500000000,2022-04-01,48,385,TX,Real County,1108,1062,46,4.2
CN4838700000000,2022-04-01,48,387,TX,Red River County,5249,5003,246,4.7
CN4838900000000,2022-04-01,48,389,TX,Reeves County,8859,8625,234,2.6
CN4839100000000,2022-04-01,48,391,TX,Refugio County,3001,2870,131,4.4
CN4839300000000,2022-04-01,48,393,TX,Roberts County,407,393,14,3.4
CN4839500000000,2022-04-01,48,395,TX,Robertson County,8115,7842,273,3.4
CN4839700000000,2022-04-01,48,397,TX,Rockwall County,58705,56972,1733,3
CN4839900000000,2022-04-01,48,399,TX,Runnels County,4751,4626,125,2.6
CN4840100000000,2022-04-01,48,401,TX,Rusk County,22400,21586,814,3.6
CN4840300000000,2022-04-01,48,403,TX,Sabine County,4026,3783,243,6
CN4840500000000,2022-04-01,48,405,TX,San Augustine County,3068,2896,172,5.6
CN4840700000000,2022-04-01,48,407,TX,San Jacinto County,12134,11614,520,4.3
CN4840900000000,2022-04-01,48,409,TX,San Patricio County,29421,27691,1730,5.9
CN4841100000000,2022-04-01,48,411,TX,San Saba County,2295,2224,71,3.1
CN4841300000000,2022-04-01,48,413,TX,Schleicher County,1277,1237,40,3.1
CN4841500000000,2022-04-01,48,415,TX,Scurry County,6239,6011,228,3.7
CN4841700000000,2022-04-01,48,417,TX,Shackelford County,1813,1767,46,2.5
CN4841900000000,2022-04-01,48,419,TX,Shelby County,11033,10608,425,3.9
CN4842100000000,2022-04-01,48,421,TX,Sherman County,1469,1436,33,2.2
CN4842300000000,2022-04-01,48,423,TX,Smith County,111650,107932,3718,3.3
CN4842500000000,2022-04-01,48,425,TX,Somervell County,4521,4378,143,3.2
CN4842700000000,2022-04-01,48,427,TX,Starr County,25124,22432,2692,10.7
CN4842900000000,2022-04-01,48,429,TX,Stephens County,4143,4005,138,3.3
CN4843100000000,2022-04-01,48,431,TX,Sterling County,586,566,20,3.4
CN4843300000000,2022-04-01,48,433,TX,Stonewall County,601,583,18,3
CN4843500000000,2022-04-01,48,435,TX,Sutton County,1050,991,59,5.6
CN4843700000000,2022-04-01,48,437,TX,Swisher County,2634,2549,85,3.2
CN4843900000000,2022-04-01,48,439,TX,Tarrant County,1130677,1093616,37061,3.3
CN4844100000000,2022-04-01,48,441,TX,Taylor County,68613,66516,2097,3.1
CN4844300000000,2022-04-01,48,443,TX,Terrell County,400,388,12,3
CN4844500000000,2022-04-01,48,445,TX,Terry County,4812,4627,185,3.8
CN4844700000000,2022-04-01,48,447,TX,Throckmorton County,775,757,18,2.3
CN4844900000000,2022-04-01,48,449,TX,Titus County,13654,13147,507,3.7
CN4845100000000,2022-04-01,48,451,TX,Tom Green County,56010,54296,1714,3.1
CN4845300000000,2022-04-01,48,453,TX,Travis County,816384,795957,20427,2.5
CN4845500000000,2022-04-01,48,455,TX,Trinity County,5449,5185,264,4.8
CN4845700000000,2022-04-01,48,457,TX,Tyler County,7210,6809,401,5.6
CN4845900000000,2022-04-01,48,459,TX,Upshur County,17841,17142,699,3.9
CN4846100000000,2022-04-01,48,461,TX,Upton County,2421,2359,62,2.6
CN4846300000000,2022-04-01,48,463,TX,Uvalde County,11340,10904,436,3.8
CN4846500000000,2022-04-01,48,465,TX,Val Verde County,22160,21261,899,4.1
CN4846700000000,2022-04-01,48,467,TX,Van Zandt County,27779,26936,843,3
CN4846900000000,2022-04-01,48,469,TX,Victoria County,41375,39792,1583,3.8
CN4847100000000,2022-04-01,48,471,TX,Walker County,24072,23046,1026,4.3
CN4847300000000,2022-04-01,48,473,TX,Waller County,25446,24449,997,3.9
CN4847500000000,2022-04-01,48,475,TX,Ward County,6017,5803,214,3.6
CN4847700000000,2022-04-01,48,477,TX,Washington County,15425,14874,551,3.6
CN4847900000000,2022-04-01,48,479,TX,Webb County,117364,112704,4660,4
CN4848100000000,2022-04-01,48,481,TX,Wharton County,21813,21069,744,3.4
CN4848300000000,2022-04-01,48,483,TX,Wheeler County,2055,1981,74,3.6
CN4848500000000,2022-04-01,48,485,TX,Wichita County,55556,53569,1987,3.6
CN4848700000000,2022-04-01,48,487,TX,Wilbarger County,5005,4777,228,4.6
CN4848900000000,2022-04-01,48,489,TX,Willacy County,7416,6761,655,8.8
CN4849100000000,2022-04-01,48,491,TX,Williamson County,362263,352821,9442,2.6
CN4849300000000,2022-04-01,48,493,TX,Wilson County,25896,25132,764,3
CN4849500000000,2022-04-01,48,495,TX,Winkler County,3934,3782,152,3.9
CN4849700000000,2022-04-01,48,497,TX,Wise County,34153,33073,1080,3.2
CN4849900000000,2022-04-01,48,499,TX,Wood County,18225,17481,744,4.1
CN4850100000000,2022-04-01,48,501,TX,Yoakum County,3356,3225,131,3.9
CN4850300000000,2022-04-01,48,503,TX,Young County,8162,7890,272,3.3
CN4850500000000,2022-04-01,48,505,TX,Zapata County,4340,4015,325,7.5
CN4850700000000,2022-04-01,48,507,TX,Zavala County,3422,3126,296,8.6
CN4900100000000,2022-04-01,49,001,UT,Beaver County,3064,2993,71,2.3
CN4900300000000,2022-04-01,49,003,UT,Box Elder County,27611,27021,590,2.1
CN4900500000000,2022-04-01,49,005,UT,Cache County,71659,70334,1325,1.8
CN4900700000000,2022-04-01,49,007,UT,Carbon County,8570,8288,282,3.3
CN4900900000000,2022-04-01,49,009,UT,Daggett County,430,413,17,4
CN4901100000000,2022-04-01,49,011,UT,Davis County,181633,177861,3772,2.1
CN4901300000000,2022-04-01,49,013,UT,Duchesne County,7990,7740,250,3.1
CN4901500000000,2022-04-01,49,015,UT,Emery County,4549,4410,139,3.1
CN4901700000000,2022-04-01,49,017,UT,Garfield County,3172,3025,147,4.6
CN4901900000000,2022-04-01,49,019,UT,Grand County,7126,6966,160,2.2
CN4902100000000,2022-04-01,49,021,UT,Iron County,28189,27554,635,2.3
CN4902300000000,2022-04-01,49,023,UT,Juab County,6404,6287,117,1.8
CN4902500000000,2022-04-01,49,025,UT,Kane County,4067,3972,95,2.3
CN4902700000000,2022-04-01,49,027,UT,Millard County,6574,6441,133,2
CN4902900000000,2022-04-01,49,029,UT,Morgan County,5892,5777,115,2
CN4903100000000,2022-04-01,49,031,UT,Piute County,527,511,16,3
CN4903300000000,2022-04-01,49,033,UT,Rich County,1188,1159,29,2.4
CN4903500000000,2022-04-01,49,035,UT,Salt Lake County,665567,650723,14844,2.2
CN4903700000000,2022-04-01,49,037,UT,San Juan County,5647,5425,222,3.9
CN4903900000000,2022-04-01,49,039,UT,Sanpete County,13759,13425,334,2.4
CN4904100000000,2022-04-01,49,041,UT,Sevier County,10358,10094,264,2.5
CN4904300000000,2022-04-01,49,043,UT,Summit County,26140,25581,559,2.1
CN4904500000000,2022-04-01,49,045,UT,Tooele County,37515,36611,904,2.4
CN4904700000000,2022-04-01,49,047,UT,Uintah County,14004,13505,499,3.6
CN4904900000000,2022-04-01,49,049,UT,Utah County,344319,337525,6794,2
CN4905100000000,2022-04-01,49,051,UT,Wasatch County,17595,17189,406,2.3
CN4905300000000,2022-04-01,49,053,UT,Washington County,87085,85038,2047,2.4
CN4905500000000,2022-04-01,49,055,UT,Wayne County,1598,1541,57,3.6
CN4905700000000,2022-04-01,49,057,UT,Weber County,133499,130321,3178,2.4
CN5000100000000,2022-04-01,50,001,VT,Addison County,20880,20411,469,2.2
CN5000300000000,2022-04-01,50,003,VT,Bennington County,17376,16817,559,3.2
CN5000500000000,2022-04-01,50,005,VT,Caledonia County,14378,13965,413,2.9
CN5000700000000,2022-04-01,50,007,VT,Chittenden County,96148,94425,1723,1.8
CN5000900000000,2022-04-01,50,009,VT,Essex County,2613,2519,94,3.6
CN5001100000000,2022-04-01,50,011,VT,Franklin County,27420,26736,684,2.5
CN5001300000000,2022-04-01,50,013,VT,Grand Isle County,4084,3961,123,3
CN5001500000000,2022-04-01,50,015,VT,Lamoille County,13922,13417,505,3.6
CN5001700000000,2022-04-01,50,017,VT,Orange County,15564,15159,405,2.6
CN5001900000000,2022-04-01,50,019,VT,Orleans County,13231,12646,585,4.4
CN5002100000000,2022-04-01,50,021,VT,Rutland County,29469,28597,872,3
CN5002300000000,2022-04-01,50,023,VT,Washington County,33263,32537,726,2.2
CN5002500000000,2022-04-01,50,025,VT,Windham County,20965,20327,638,3
CN5002700000000,2022-04-01,50,027,VT,Windsor County,29104,28465,639,2.2
CN5100100000000,2022-04-01,51,001,VA,Accomack County,15562,15131,431,2.8
CN5100300000000,2022-04-01,51,003,VA,Albemarle County,57944,56719,1225,2.1
CN5100500000000,2022-04-01,51,005,VA,Alleghany County,6650,6467,183,2.8
CN5100700000000,2022-04-01,51,007,VA,Amelia County,6222,6070,152,2.4
CN5100900000000,2022-04-01,51,009,VA,Amherst County,14847,14469,378,2.5
CN5101100000000,2022-04-01,51,011,VA,Appomattox County,7137,6952,185,2.6
CN5101300000000,2022-04-01,51,013,VA,Arlington County,156471,153645,2826,1.8
CN5101500000000,2022-04-01,51,015,VA,Augusta County,38002,37183,819,2.2
CN5101700000000,2022-04-01,51,017,VA,Bath County,2359,2311,48,2
CN5101900000000,2022-04-01,51,019,VA,Bedford County,38589,37679,910,2.4
CN5102100000000,2022-04-01,51,021,VA,Bland County,2789,2721,68,2.4
CN5102300000000,2022-04-01,51,023,VA,Botetourt County,17580,17214,366,2.1
CN5102500000000,2022-04-01,51,025,VA,Brunswick County,5857,5633,224,3.8
CN5102700000000,2022-04-01,51,027,VA,Buchanan County,6356,6101,255,4
CN5102900000000,2022-04-01,51,029,VA,Buckingham County,6400,6201,199,3.1
CN5103100000000,2022-04-01,51,031,VA,Campbell County,25832,25201,631,2.4
CN5103300000000,2022-04-01,51,033,VA,Caroline County,15225,14822,403,2.6
CN5103500000000,2022-04-01,51,035,VA,Carroll County,12801,12432,369,2.9
CN5103600000000,2022-04-01,51,036,VA,Charles City County,3563,3470,93,2.6
CN5103700000000,2022-04-01,51,037,VA,Charlotte County,5520,5385,135,2.4
CN5104100000000,2022-04-01,51,041,VA,Chesterfield County,192165,187768,4397,2.3
CN5104300000000,2022-04-01,51,043,VA,Clarke County,7630,7467,163,2.1
CN5104500000000,2022-04-01,51,045,VA,Craig County,2299,2243,56,2.4
CN5104700000000,2022-04-01,51,047,VA,Culpeper County,25430,24830,600,2.4
CN5104900000000,2022-04-01,51,049,VA,Cumberland County,4753,4629,124,2.6
CN5105100000000,2022-04-01,51,051,VA,Dickenson County,4518,4360,158,3.5
CN5105300000000,2022-04-01,51,053,VA,Dinwiddie County,13668,13304,364,2.7
CN5105700000000,2022-04-01,51,057,VA,Essex County,5427,5265,162,3
CN5105900000000,2022-04-01,51,059,VA,Fairfax County,636555,623305,13250,2.1
CN5106100000000,2022-04-01,51,061,VA,Fauquier County,37520,36729,791,2.1
CN5106300000000,2022-04-01,51,063,VA,Floyd County,8594,8421,173,2
CN5106500000000,2022-04-01,51,065,VA,Fluvanna County,14199,13904,295,2.1
CN5106700000000,2022-04-01,51,067,VA,Franklin County,26326,25695,631,2.4
CN5106900000000,2022-04-01,51,069,VA,Frederick County,51251,50233,1018,2
CN5107100000000,2022-04-01,51,071,VA,Giles County,8240,8044,196,2.4
CN5107300000000,2022-04-01,51,073,VA,Gloucester County,19468,19028,440,2.3
CN5107500000000,2022-04-01,51,075,VA,Goochland County,11746,11484,262,2.2
CN5107700000000,2022-04-01,51,077,VA,Grayson County,7984,7811,173,2.2
CN5107900000000,2022-04-01,51,079,VA,Greene County,10632,10421,211,2
CN5108100000000,2022-04-01,51,081,VA,Greensville County,4341,4227,114,2.6
CN5108300000000,2022-04-01,51,083,VA,Halifax County,15418,14913,505,3.3
CN5108500000000,2022-04-01,51,085,VA,Hanover County,59615,58428,1187,2
CN5108700000000,2022-04-01,51,087,VA,Henrico County,184093,179703,4390,2.4
CN5108900000000,2022-04-01,51,089,VA,Henry County,23975,23290,685,2.9
CN5109100000000,2022-04-01,51,091,VA,Highland County,1322,1297,25,1.9
CN5109300000000,2022-04-01,51,093,VA,Isle of Wight County,19639,19187,452,2.3
CN5109500000000,2022-04-01,51,095,VA,James City County,36950,36038,912,2.5
CN5109700000000,2022-04-01,51,097,VA,King and Queen County,3873,3788,85,2.2
CN5109900000000,2022-04-01,51,099,VA,King George County,14358,14049,309,2.2
CN5110100000000,2022-04-01,51,101,VA,King William County,9503,9292,211,2.2
CN5110300000000,2022-04-01,51,103,VA,Lancaster County,5344,5141,203,3.8
CN5110500000000,2022-04-01,51,105,VA,Lee County,8206,7954,252,3.1
CN5110700000000,2022-04-01,51,107,VA,Loudoun County,231207,226666,4541,2
CN5110900000000,2022-04-01,51,109,VA,Louisa County,20621,20162,459,2.2
CN5111100000000,2022-04-01,51,111,VA,Lunenburg County,5128,4993,135,2.6
CN5111300000000,2022-04-01,51,113,VA,Madison County,7547,7406,141,1.9
CN5111500000000,2022-04-01,51,115,VA,Mathews County,4088,3987,101,2.5
CN5111700000000,2022-04-01,51,117,VA,Mecklenburg County,12905,12513,392,3
CN5111900000000,2022-04-01,51,119,VA,Middlesex County,5216,5095,121,2.3
CN5112100000000,2022-04-01,51,121,VA,Montgomery County,52843,51748,1095,2.1
CN5112500000000,2022-04-01,51,125,VA,Nelson County,7359,7194,165,2.2
CN5112700000000,2022-04-01,51,127,VA,New Kent County,13154,12883,271,2.1
CN5113100000000,2022-04-01,51,131,VA,Northampton County,5398,5236,162,3
CN5113300000000,2022-04-01,51,133,VA,Northumberland County,5522,5309,213,3.9
CN5113500000000,2022-04-01,51,135,VA,Nottoway County,7202,7023,179,2.5
CN5113700000000,2022-04-01,51,137,VA,Orange County,17830,17407,423,2.4
CN5113900000000,2022-04-01,51,139,VA,Page County,12139,11801,338,2.8
CN5114100000000,2022-04-01,51,141,VA,Patrick County,7188,6972,216,3
CN5114300000000,2022-04-01,51,143,VA,Pittsylvania County,30342,29571,771,2.5
CN5114500000000,2022-04-01,51,145,VA,Powhatan County,14574,14267,307,2.1
CN5114700000000,2022-04-01,51,147,VA,Prince Edward County,9982,9682,300,3
CN5114900000000,2022-04-01,51,149,VA,Prince George County,15245,14828,417,2.7
CN5115300000000,2022-04-01,51,153,VA,Prince William County,249750,244074,5676,2.3
CN5115500000000,2022-04-01,51,155,VA,Pulaski County,16944,16523,421,2.5
CN5115700000000,2022-04-01,51,157,VA,Rappahannock County,3699,3617,82,2.2
CN5115900000000,2022-04-01,51,159,VA,Richmond County,3983,3874,109,2.7
CN5116100000000,2022-04-01,51,161,VA,Roanoke County,49634,48583,1051,2.1
CN5116300000000,2022-04-01,51,163,VA,Rockbridge County,10658,10407,251,2.4
CN5116500000000,2022-04-01,51,165,VA,Rockingham County,43092,42210,882,2
CN5116700000000,2022-04-01,51,167,VA,Russell County,10937,10606,331,3
CN5116900000000,2022-04-01,51,169,VA,Scott County,9177,8939,238,2.6
CN5117100000000,2022-04-01,51,171,VA,Shenandoah County,21977,21467,510,2.3
CN5117300000000,2022-04-01,51,173,VA,Smyth County,13756,13406,350,2.5
CN5117500000000,2022-04-01,51,175,VA,Southampton County,8833,8615,218,2.5
CN5117700000000,2022-04-01,51,177,VA,Spotsylvania County,69027,67368,1659,2.4
CN5117900000000,2022-04-01,51,179,VA,Stafford County,75245,73468,1777,2.4
CN5118100000000,2022-04-01,51,181,VA,Surry County,3568,3476,92,2.6
CN5118300000000,2022-04-01,51,183,VA,Sussex County,3628,3503,125,3.4
CN5118500000000,2022-04-01,51,185,VA,Tazewell County,15361,14838,523,3.4
CN5118700000000,2022-04-01,51,187,VA,Warren County,20660,20160,500,2.4
CN5119100000000,2022-04-01,51,191,VA,Washington County,26330,25704,626,2.4
CN5119300000000,2022-04-01,51,193,VA,Westmoreland County,9586,9345,241,2.5
CN5119500000000,2022-04-01,51,195,VA,Wise County,12842,12409,433,3.4
CN5119700000000,2022-04-01,51,197,VA,Wythe County,14120,13780,340,2.4
CN5119900000000,2022-04-01,51,199,VA,York County,33141,32384,757,2.3
CN5151000000000,2022-04-01,51,510,VA,Alexandria city,100532,98440,2092,2.1
CN5152000000000,2022-04-01,51,520,VA,Bristol city,7568,7354,214,2.8
CN5153000000000,2022-04-01,51,530,VA,Buena Vista city,3012,2937,75,2.5
CN5154000000000,2022-04-01,51,540,VA,Charlottesville city,25706,25144,562,2.2
CN5155000000000,2022-04-01,51,550,VA,Chesapeake city,123734,120718,3016,2.4
CN5157000000000,2022-04-01,51,570,VA,Colonial Heights city,8457,8241,216,2.6
CN5158000000000,2022-04-01,51,580,VA,Covington city,2291,2209,82,3.6
CN5159000000000,2022-04-01,51,590,VA,Danville city,18741,18029,712,3.8
CN5159500000000,2022-04-01,51,595,VA,Emporia city,2354,2255,99,4.2
CN5160000000000,2022-04-01,51,600,VA,Fairfax city,12869,12604,265,2.1
CN5161000000000,2022-04-01,51,610,VA,Falls Church city,8533,8379,154,1.8
CN5162000000000,2022-04-01,51,620,VA,Franklin city,3434,3324,110,3.2
CN5163000000000,2022-04-01,51,630,VA,Fredericksburg city,14288,13889,399,2.8
CN5164000000000,2022-04-01,51,640,VA,Galax city,2841,2765,76,2.7
CN5165000000000,2022-04-01,51,650,VA,Hampton city,64252,62170,2082,3.2
CN5166000000000,2022-04-01,51,660,VA,Harrisonburg city,24985,24345,640,2.6
CN5167000000000,2022-04-01,51,670,VA,Hopewell city,9554,9188,366,3.8
CN5167800000000,2022-04-01,51,678,VA,Lexington city,2165,2099,66,3
CN5168000000000,2022-04-01,51,680,VA,Lynchburg city,35646,34576,1070,3
CN5168300000000,2022-04-01,51,683,VA,Manassas city,21653,21184,469,2.2
CN5168500000000,2022-04-01,51,685,VA,Manassas Park city,9766,9555,211,2.2
CN5169000000000,2022-04-01,51,690,VA,Martinsville city,5568,5357,211,3.8
CN5170000000000,2022-04-01,51,700,VA,Newport News city,88251,85535,2716,3.1
CN5171000000000,2022-04-01,51,710,VA,Norfolk city,109961,106695,3266,3
CN5172000000000,2022-04-01,51,720,VA,Norton city,1604,1555,49,3.1
CN5173000000000,2022-04-01,51,730,VA,Petersburg city,12488,11881,607,4.9
CN5173500000000,2022-04-01,51,735,VA,Poquoson city,6353,6228,125,2
CN5174000000000,2022-04-01,51,740,VA,Portsmouth city,44031,42558,1473,3.3
CN5175000000000,2022-04-01,51,750,VA,Radford city,9113,8882,231,2.5
CN5176000000000,2022-04-01,51,760,VA,Richmond city,119892,116402,3490,2.9
CN5177000000000,2022-04-01,51,770,VA,Roanoke city,48818,47502,1316,2.7
CN5177500000000,2022-04-01,51,775,VA,Salem city,12834,12528,306,2.4
CN5179000000000,2022-04-01,51,790,VA,Staunton city,12373,12088,285,2.3
CN5180000000000,2022-04-01,51,800,VA,Suffolk city,45536,44338,1198,2.6
CN5181000000000,2022-04-01,51,810,VA,Virginia Beach city,231663,226289,5374,2.3
CN5182000000000,2022-04-01,51,820,VA,Waynesboro city,10744,10483,261,2.4
CN5183000000000,2022-04-01,51,830,VA,Williamsburg city,6769,6562,207,3.1
CN5184000000000,2022-04-01,51,840,VA,Winchester city,15009,14675,334,2.2
CN5300100000000,2022-04-01,53,001,WA,Adams County,9576,9151,425,4.4
CN5300300000000,2022-04-01,53,003,WA,Asotin County,10529,10155,374,3.6
CN5300500000000,2022-04-01,53,005,WA,Benton County,104280,99417,4863,4.7
CN5300700000000,2022-04-01,53,007,WA,Chelan County,42740,40743,1997,4.7
CN5300900000000,2022-04-01,53,009,WA,Clallam County,28611,27016,1595,5.6
CN5301100000000,2022-04-01,53,011,WA,Clark County,246152,235293,10859,4.4
CN5301300000000,2022-04-01,53,013,WA,Columbia County,1770,1670,100,5.6
CN5301500000000,2022-04-01,53,015,WA,Cowlitz County,48150,45531,2619,5.4
CN5301700000000,2022-04-01,53,017,WA,Douglas County,21320,20264,1056,5
CN5301900000000,2022-04-01,53,019,WA,Ferry County,2251,2058,193,8.6
CN5302100000000,2022-04-01,53,021,WA,Franklin County,43801,41234,2567,5.9
CN5302300000000,2022-04-01,53,023,WA,Garfield County,781,725,56,7.2
CN5302500000000,2022-04-01,53,025,WA,Grant County,47631,44970,2661,5.6
CN5302700000000,2022-04-01,53,027,WA,Grays Harbor County,28671,26859,1812,6.3
CN5302900000000,2022-04-01,53,029,WA,Island County,36189,34522,1667,4.6
CN5303100000000,2022-04-01,53,031,WA,Jefferson County,12352,11709,643,5.2
CN5303300000000,2022-04-01,53,033,WA,King County,1313816,1284826,28990,2.2
CN5303500000000,2022-04-01,53,035,WA,Kitsap County,127272,121877,5395,4.2
CN5303700000000,2022-04-01,53,037,WA,Kittitas County,22946,21755,1191,5.2
CN5303900000000,2022-04-01,53,039,WA,Klickitat County,9602,9075,527,5.5
CN5304100000000,2022-04-01,53,041,WA,Lewis County,34397,32380,2017,5.9
CN5304300000000,2022-04-01,53,043,WA,Lincoln County,4520,4302,218,4.8
CN5304500000000,2022-04-01,53,045,WA,Mason County,24948,23459,1489,6
CN5304700000000,2022-04-01,53,047,WA,Okanogan County,18835,17666,1169,6.2
CN5304900000000,2022-04-01,53,049,WA,Pacific County,8518,7996,522,6.1
CN5305100000000,2022-04-01,53,051,WA,Pend Oreille County,5106,4775,331,6.5
CN5305300000000,2022-04-01,53,053,WA,Pierce County,449998,428054,21944,4.9
CN5305500000000,2022-04-01,53,055,WA,San Juan County,8220,7887,333,4.1
CN5305700000000,2022-04-01,53,057,WA,Skagit County,60901,57876,3025,5
CN5305900000000,2022-04-01,53,059,WA,Skamania County,5485,5218,267,4.9
CN5306100000000,2022-04-01,53,061,WA,Snohomish County,447674,436491,11183,2.5
CN5306300000000,2022-04-01,53,063,WA,Spokane County,260876,249690,11186,4.3
CN5306500000000,2022-04-01,53,065,WA,Stevens County,19061,17830,1231,6.5
CN5306700000000,2022-04-01,53,067,WA,Thurston County,146902,140469,6433,4.4
CN5306900000000,2022-04-01,53,069,WA,Wahkiakum County,1320,1231,89,6.7
CN5307100000000,2022-04-01,53,071,WA,Walla Walla County,30278,28996,1282,4.2
CN5307300000000,2022-04-01,53,073,WA,Whatcom County,114164,109061,5103,4.5
CN5307500000000,2022-04-01,53,075,WA,Whitman County,23337,22328,1009,4.3
CN5307700000000,2022-04-01,53,077,WA,Yakima County,128384,120555,7829,6.1
CN5400100000000,2022-04-01,54,001,WV,Barbour County,7444,7165,279,3.7
CN5400300000000,2022-04-01,54,003,WV,Berkeley County,59803,58265,1538,2.6
CN5400500000000,2022-04-01,54,005,WV,Boone County,7064,6755,309,4.4
CN5400700000000,2022-04-01,54,007,WV,Braxton County,4958,4667,291,5.9
CN5400900000000,2022-04-01,54,009,WV,Brooke County,9885,9469,416,4.2
CN5401100000000,2022-04-01,54,011,WV,Cabell County,41513,40142,1371,3.3
CN5401300000000,2022-04-01,54,013,WV,Calhoun County,2454,2274,180,7.3
CN5401500000000,2022-04-01,54,015,WV,Clay County,2956,2784,172,5.8
CN5401700000000,2022-04-01,54,017,WV,Doddridge County,3754,3653,101,2.7
CN5401900000000,2022-04-01,54,019,WV,Fayette County,15479,14781,698,4.5
CN5402100000000,2022-04-01,54,021,WV,Gilmer County,2415,2298,117,4.8
CN5402300000000,2022-04-01,54,023,WV,Grant County,5828,5622,206,3.5
CN5402500000000,2022-04-01,54,025,WV,Greenbrier County,15369,14875,494,3.2
CN5402700000000,2022-04-01,54,027,WV,Hampshire County,11045,10790,255,2.3
CN5402900000000,2022-04-01,54,029,WV,Hancock County,13074,12473,601,4.6
CN5403100000000,2022-04-01,54,031,WV,Hardy County,5559,5343,216,3.9
CN5403300000000,2022-04-01,54,033,WV,Harrison County,33664,32522,1142,3.4
CN5403500000000,2022-04-01,54,035,WV,Jackson County,11835,11359,476,4
CN5403700000000,2022-04-01,54,037,WV,Jefferson County,30876,30212,664,2.2
CN5403900000000,2022-04-01,54,039,WV,Kanawha County,79734,76872,2862,3.6
CN5404100000000,2022-04-01,54,041,WV,Lewis County,6298,6017,281,4.5
CN5404300000000,2022-04-01,54,043,WV,Lincoln County,7073,6732,341,4.8
CN5404500000000,2022-04-01,54,045,WV,Logan County,11385,10935,450,4
CN5404700000000,2022-04-01,54,047,WV,McDowell County,4092,3858,234,5.7
CN5404900000000,2022-04-01,54,049,WV,Marion County,25341,24293,1048,4.1
CN5405100000000,2022-04-01,54,051,WV,Marshall County,13166,12500,666,5.1
CN5405300000000,2022-04-01,54,053,WV,Mason County,10291,9904,387,3.8
CN5405500000000,2022-04-01,54,055,WV,Mercer County,20491,19669,822,4
CN5405700000000,2022-04-01,54,057,WV,Mineral County,12430,12003,427,3.4
CN5405900000000,2022-04-01,54,059,WV,Mingo County,6248,5923,325,5.2
CN5406100000000,2022-04-01,54,061,WV,Monongalia County,55920,54096,1824,3.3
CN5406300000000,2022-04-01,54,063,WV,Monroe County,6038,5876,162,2.7
CN5406500000000,2022-04-01,54,065,WV,Morgan County,8590,8374,216,2.5
CN5406700000000,2022-04-01,54,067,WV,Nicholas County,8853,8473,380,4.3
CN5406900000000,2022-04-01,54,069,WV,Ohio County,20018,19247,771,3.9
CN5407100000000,2022-04-01,54,071,WV,Pendleton County,3808,3724,84,2.2
CN5407300000000,2022-04-01,54,073,WV,Pleasants County,2611,2481,130,5
CN5407500000000,2022-04-01,54,075,WV,Pocahontas County,3691,3438,253,6.9
CN5407700000000,2022-04-01,54,077,WV,Preston County,15587,14989,598,3.8
CN5407900000000,2022-04-01,54,079,WV,Putnam County,26971,26151,820,3
CN5408100000000,2022-04-01,54,081,WV,Raleigh County,29122,28117,1005,3.5
CN5408300000000,2022-04-01,54,083,WV,Randolph County,11738,11174,564,4.8
CN5408500000000,2022-04-01,54,085,WV,Ritchie County,4221,4062,159,3.8
CN5408700000000,2022-04-01,54,087,WV,Roane County,5017,4694,323,6.4
CN5408900000000,2022-04-01,54,089,WV,Summers County,4540,4378,162,3.6
CN5409100000000,2022-04-01,54,091,WV,Taylor County,7922,7622,300,3.8
CN5409300000000,2022-04-01,54,093,WV,Tucker County,3536,3396,140,4
CN5409500000000,2022-04-01,54,095,WV,Tyler County,2925,2764,161,5.5
CN5409700000000,2022-04-01,54,097,WV,Upshur County,9672,9238,434,4.5
CN5409900000000,2022-04-01,54,099,WV,Wayne County,15566,15012,554,3.6
CN5410100000000,2022-04-01,54,101,WV,Webster County,3110,2980,130,4.2
CN5410300000000,2022-04-01,54,103,WV,Wetzel County,6570,6226,344,5.2
CN5410500000000,2022-04-01,54,105,WV,Wirt County,2241,2111,130,5.8
CN5410700000000,2022-04-01,54,107,WV,Wood County,36414,35017,1397,3.8
CN5410900000000,2022-04-01,54,109,WV,Wyoming County,7044,6771,273,3.9
CN5500100000000,2022-04-01,55,001,WI,Adams County,7786,7458,328,4.2
CN5500300000000,2022-04-01,55,003,WI,Ashland County,7364,7034,330,4.5
CN5500500000000,2022-04-01,55,005,WI,Barron County,23822,22919,903,3.8
CN5500700000000,2022-04-01,55,007,WI,Bayfield County,7361,6917,444,6
CN5500900000000,2022-04-01,55,009,WI,Brown County,139269,135940,3329,2.4
CN5501100000000,2022-04-01,55,011,WI,Buffalo County,6392,6151,241,3.8
CN5501300000000,2022-04-01,55,013,WI,Burnett County,7218,6820,398,5.5
CN5501500000000,2022-04-01,55,015,WI,Calumet County,27313,26757,556,2
CN5501700000000,2022-04-01,55,017,WI,Chippewa County,33933,32744,1189,3.5
CN5501900000000,2022-04-01,55,019,WI,Clark County,18070,17588,482,2.7
CN5502100000000,2022-04-01,55,021,WI,Columbia County,31663,30899,764,2.4
CN5502300000000,2022-04-01,55,023,WI,Crawford County,7256,7003,253,3.5
CN5502500000000,2022-04-01,55,025,WI,Dane County,326608,320421,6187,1.9
CN5502700000000,2022-04-01,55,027,WI,Dodge County,47173,46054,1119,2.4
CN5502900000000,2022-04-01,55,029,WI,Door County,14531,14037,494,3.4
CN5503100000000,2022-04-01,55,031,WI,Douglas County,22605,21571,1034,4.6
CN5503300000000,2022-04-01,55,033,WI,Dunn County,24413,23643,770,3.2
CN5503500000000,2022-04-01,55,035,WI,Eau Claire County,59649,58269,1380,2.3
CN5503700000000,2022-04-01,55,037,WI,Florence County,2154,2059,95,4.4
CN5503900000000,2022-04-01,55,039,WI,Fond du Lac County,55767,54551,1216,2.2
CN5504100000000,2022-04-01,55,041,WI,Forest County,3908,3701,207,5.3
CN5504300000000,2022-04-01,55,043,WI,Grant County,27810,27148,662,2.4
CN5504500000000,2022-04-01,55,045,WI,Green County,20817,20419,398,1.9
CN5504700000000,2022-04-01,55,047,WI,Green Lake County,9104,8842,262,2.9
CN5504900000000,2022-04-01,55,049,WI,Iowa County,13755,13413,342,2.5
CN5505100000000,2022-04-01,55,051,WI,Iron County,2514,2344,170,6.8
CN5505300000000,2022-04-01,55,053,WI,Jackson County,9486,9129,357,3.8
CN5505500000000,2022-04-01,55,055,WI,Jefferson County,45650,44535,1115,2.4
CN5505700000000,2022-04-01,55,057,WI,Juneau County,13211,12827,384,2.9
CN5505900000000,2022-04-01,55,059,WI,Kenosha County,88689,85864,2825,3.2
CN5506100000000,2022-04-01,55,061,WI,Kewaunee County,10875,10634,241,2.2
CN5506300000000,2022-04-01,55,063,WI,La Crosse County,65982,64529,1453,2.2
CN5506500000000,2022-04-01,55,065,WI,Lafayette County,10415,10218,197,1.9
CN5506700000000,2022-04-01,55,067,WI,Langlade County,9388,9035,353,3.8
CN5506900000000,2022-04-01,55,069,WI,Lincoln County,14665,14210,455,3.1
CN5507100000000,2022-04-01,55,071,WI,Manitowoc County,40600,39585,1015,2.5
CN5507300000000,2022-04-01,55,073,WI,Marathon County,72927,71188,1739,2.4
CN5507500000000,2022-04-01,55,075,WI,Marinette County,19082,18366,716,3.8
CN5507700000000,2022-04-01,55,077,WI,Marquette County,7677,7457,220,2.9
CN5507800000000,2022-04-01,55,078,WI,Menominee County,1521,1438,83,5.5
CN5507900000000,2022-04-01,55,079,WI,Milwaukee County,454131,438043,16088,3.5
CN5508100000000,2022-04-01,55,081,WI,Monroe County,23344,22782,562,2.4
CN5508300000000,2022-04-01,55,083,WI,Oconto County,20607,19943,664,3.2
CN5508500000000,2022-04-01,55,085,WI,Oneida County,17518,16870,648,3.7
CN5508700000000,2022-04-01,55,087,WI,Outagamie County,102630,100223,2407,2.3
CN5508900000000,2022-04-01,55,089,WI,Ozaukee County,48426,47397,1029,2.1
CN5509100000000,2022-04-01,55,091,WI,Pepin County,4158,4038,120,2.9
CN5509300000000,2022-04-01,55,093,WI,Pierce County,24423,23626,797,3.3
CN5509500000000,2022-04-01,55,095,WI,Polk County,24508,23414,1094,4.5
CN5509700000000,2022-04-01,55,097,WI,Portage County,37723,36660,1063,2.8
CN5509900000000,2022-04-01,55,099,WI,Price County,6319,6082,237,3.8
CN5510100000000,2022-04-01,55,101,WI,Racine County,96867,93605,3262,3.4
CN5510300000000,2022-04-01,55,103,WI,Richland County,8954,8722,232,2.6
CN5510500000000,2022-04-01,55,105,WI,Rock County,84853,82068,2785,3.3
CN5510700000000,2022-04-01,55,107,WI,Rusk County,6631,6347,284,4.3
CN5510900000000,2022-04-01,55,109,WI,St. Croix County,49365,47837,1528,3.1
CN5511100000000,2022-04-01,55,111,WI,Sauk County,33952,33018,934,2.8
CN5511300000000,2022-04-01,55,113,WI,Sawyer County,7855,7438,417,5.3
CN5511500000000,2022-04-01,55,115,WI,Shawano County,20705,20107,598,2.9
CN5511700000000,2022-04-01,55,117,WI,Sheboygan County,60480,59143,1337,2.2
CN5511900000000,2022-04-01,55,119,WI,Taylor County,10926,10515,411,3.8
CN5512100000000,2022-04-01,55,121,WI,Trempealeau County,15259,14782,477,3.1
CN5512300000000,2022-04-01,55,123,WI,Vernon County,15397,15023,374,2.4
CN5512500000000,2022-04-01,55,125,WI,Vilas County,9838,9319,519,5.3
CN5512700000000,2022-04-01,55,127,WI,Walworth County,57090,55527,1563,2.7
CN5512900000000,2022-04-01,55,129,WI,Washburn County,7770,7436,334,4.3
CN5513100000000,2022-04-01,55,131,WI,Washington County,75684,74013,1671,2.2
CN5513300000000,2022-04-01,55,133,WI,Waukesha County,220695,215768,4927,2.2
CN5513500000000,2022-04-01,55,135,WI,Waupaca County,25333,24573,760,3
CN5513700000000,2022-04-01,55,137,WI,Waushara County,11198,10856,342,3.1
CN5513900000000,2022-04-01,55,139,WI,Winnebago County,90745,88624,2121,2.3
CN5514100000000,2022-04-01,55,141,WI,Wood County,33636,32602,1034,3.1
CN5600100000000,2022-04-01,56,001,WY,Albany County,21446,20901,545,2.5
CN5600300000000,2022-04-01,56,003,WY,Big Horn County,5200,4990,210,4
CN5600500000000,2022-04-01,56,005,WY,Campbell County,22328,21600,728,3.3
CN5600700000000,2022-04-01,56,007,WY,Carbon County,7369,7112,257,3.5
CN5600900000000,2022-04-01,56,009,WY,Converse County,7590,7358,232,3.1
CN5601100000000,2022-04-01,56,011,WY,Crook County,3920,3819,101,2.6
CN5601300000000,2022-04-01,56,013,WY,Fremont County,18813,18114,699,3.7
CN5601500000000,2022-04-01,56,015,WY,Goshen County,6558,6400,158,2.4
CN5601700000000,2022-04-01,56,017,WY,Hot Springs County,2248,2190,58,2.6
CN5601900000000,2022-04-01,56,019,WY,Johnson County,4174,4037,137,3.3
CN5602100000000,2022-04-01,56,021,WY,Laramie County,48112,46570,1542,3.2
CN5602300000000,2022-04-01,56,023,WY,Lincoln County,9340,9040,300,3.2
CN5602500000000,2022-04-01,56,025,WY,Natrona County,38796,37272,1524,3.9
CN5602700000000,2022-04-01,56,027,WY,Niobrara County,1235,1210,25,2
CN5602900000000,2022-04-01,56,029,WY,Park County,14858,14328,530,3.6
CN5603100000000,2022-04-01,56,031,WY,Platte County,4525,4390,135,3
CN5603300000000,2022-04-01,56,033,WY,Sheridan County,15938,15458,480,3
CN5603500000000,2022-04-01,56,035,WY,Sublette County,3863,3698,165,4.3
CN5603700000000,2022-04-01,56,037,WY,Sweetwater County,19423,18702,721,3.7
CN5603900000000,2022-04-01,56,039,WY,Teton County,15310,14639,671,4.4
CN5604100000000,2022-04-01,56,041,WY,Uinta County,8604,8313,291,3.4
CN5604300000000,2022-04-01,56,043,WY,Washakie County,3833,3678,155,4
CN5604500000000,2022-04-01,56,045,WY,Weston County,3814,3708,106,2.8
CN7200100000000,2022-04-01,72,001,PR,Adjuntas Municipio,4420,4071,349,7.9
CN7200300000000,2022-04-01,72,003,PR,Aguada Municipio,13577,12595,982,7.2
CN7200500000000,2022-04-01,72,005,PR,Aguadilla Municipio,16322,15156,1166,7.1
CN7200700000000,2022-04-01,72,007,PR,Aguas Buenas Municipio,7151,6697,454,6.3
CN7200900000000,2022-04-01,72,009,PR,Aibonito Municipio,6822,6386,436,6.4
CN7201100000000,2022-04-01,72,011,PR,Anasco Municipio,10120,9553,567,5.6
CN7201300000000,2022-04-01,72,013,PR,Arecibo Municipio,26202,24464,1738,6.6
CN7201500000000,2022-04-01,72,015,PR,Arroyo Municipio,5083,4636,447,8.8
CN7201700000000,2022-04-01,72,017,PR,Barceloneta Municipio,6481,5977,504,7.8
CN7201900000000,2022-04-01,72,019,PR,Barranquitas Municipio,7878,7370,508,6.4
CN7202100000000,2022-04-01,72,021,PR,Bayamon Municipio,71076,67779,3297,4.6
CN7202300000000,2022-04-01,72,023,PR,Cabo Rojo Municipio,15339,14382,957,6.2
CN7202500000000,2022-04-01,72,025,PR,Caguas Municipio,52350,49970,2380,4.5
CN7202700000000,2022-04-01,72,027,PR,Camuy Municipio,10567,9848,719,6.8
CN7202900000000,2022-04-01,72,029,PR,Canovanas Municipio,17864,17077,787,4.4
CN7203100000000,2022-04-01,72,031,PR,Carolina Municipio,67347,64270,3077,4.6
CN7203300000000,2022-04-01,72,033,PR,Catano Municipio,8512,8088,424,5
CN7203500000000,2022-04-01,72,035,PR,Cayey Municipio,17732,16908,824,4.6
CN7203700000000,2022-04-01,72,037,PR,Ceiba Municipio,3943,3673,270,6.8
CN7203900000000,2022-04-01,72,039,PR,Ciales Municipio,3983,3636,347,8.7
CN7204100000000,2022-04-01,72,041,PR,Cidra Municipio,16915,16194,721,4.3
CN7204300000000,2022-04-01,72,043,PR,Coamo Municipio,11102,10349,753,6.8
CN7204500000000,2022-04-01,72,045,PR,Comerio Municipio,5311,4984,327,6.2
CN7204700000000,2022-04-01,72,047,PR,Corozal Municipio,9585,8961,624,6.5
CN7204900000000,2022-04-01,72,049,PR,Culebra Municipio,1014,989,25,2.5
CN7205100000000,2022-04-01,72,051,PR,Dorado Municipio,14782,14181,601,4.1
CN7205300000000,2022-04-01,72,053,PR,Fajardo Municipio,11505,10811,694,6
CN7205400000000,2022-04-01,72,054,PR,Florida Municipio,3567,3308,259,7.3
CN7205500000000,2022-04-01,72,055,PR,Guanica Municipio,4139,3710,429,10.4
CN7205700000000,2022-04-01,72,057,PR,Guayama Municipio,11773,11081,692,5.9
CN7205900000000,2022-04-01,72,059,PR,Guayanilla Municipio,5400,4880,520,9.6
CN7206100000000,2022-04-01,72,061,PR,Guaynabo Municipio,41800,40525,1275,3.1
CN7206300000000,2022-04-01,72,063,PR,Gurabo Municipio,20624,19857,767,3.7
CN7206500000000,2022-04-01,72,065,PR,Hatillo Municipio,15766,13701,2065,13.1
CN7206700000000,2022-04-01,72,067,PR,Hormigueros Municipio,6138,5757,381,6.2
CN7206900000000,2022-04-01,72,069,PR,Humacao Municipio,18982,17766,1216,6.4
CN7207100000000,2022-04-01,72,071,PR,Isabela Municipio,13381,12548,833,6.2
CN7207300000000,2022-04-01,72,073,PR,Jayuya Municipio,4686,4359,327,7
CN7207500000000,2022-04-01,72,075,PR,Juana Diaz Municipio,16984,15906,1078,6.3
CN7207700000000,2022-04-01,72,077,PR,Juncos Municipio,13635,12814,821,6
CN7207900000000,2022-04-01,72,079,PR,Lajas Municipio,5655,5126,529,9.4
CN7208100000000,2022-04-01,72,081,PR,Lares Municipio,7576,6687,889,11.7
CN7208300000000,2022-04-01,72,083,PR,Las Marias Municipio,2866,2582,284,9.9
CN7208500000000,2022-04-01,72,085,PR,Las Piedras Municipio,12552,11844,708,5.6
CN7208700000000,2022-04-01,72,087,PR,Loiza Municipio,9111,8591,520,5.7
CN7208900000000,2022-04-01,72,089,PR,Luquillo Municipio,6691,6321,370,5.5
CN7209100000000,2022-04-01,72,091,PR,Manati Municipio,12278,11563,715,5.8
CN7209300000000,2022-04-01,72,093,PR,Maricao Municipio,2154,1898,256,11.9
CN7209500000000,2022-04-01,72,095,PR,Maunabo Municipio,3213,2780,433,13.5
CN7209700000000,2022-04-01,72,097,PR,Mayaguez Municipio,24284,22653,1631,6.7
CN7209900000000,2022-04-01,72,099,PR,Moca Municipio,11882,10945,937,7.9
CN7210100000000,2022-04-01,72,101,PR,Morovis Municipio,8795,8228,567,6.4
CN7210300000000,2022-04-01,72,103,PR,Naguabo Municipio,9080,8522,558,6.1
CN7210500000000,2022-04-01,72,105,PR,Naranjito Municipio,7740,7227,513,6.6
CN7210700000000,2022-04-01,72,107,PR,Orocovis Municipio,5269,4865,404,7.7
CN7210900000000,2022-04-01,72,109,PR,Patillas Municipio,4615,4091,524,11.4
CN7211100000000,2022-04-01,72,111,PR,Penuelas Municipio,6249,5661,588,9.4
CN7211300000000,2022-04-01,72,113,PR,Ponce Municipio,49354,46057,3297,6.7
CN7211500000000,2022-04-01,72,115,PR,Quebradillas Municipio,6645,6150,495,7.4
CN7211700000000,2022-04-01,72,117,PR,Rincon Municipio,5370,4866,504,9.4
CN7211900000000,2022-04-01,72,119,PR,Rio Grande Municipio,18633,17653,980,5.3
CN7212100000000,2022-04-01,72,121,PR,Sabana Grande Municipio,6493,6010,483,7.4
CN7212300000000,2022-04-01,72,123,PR,Salinas Municipio,7425,6851,574,7.7
CN7212500000000,2022-04-01,72,125,PR,San German Municipio,10669,9830,839,7.9
CN7212700000000,2022-04-01,72,127,PR,San Juan Municipio,146490,140553,5937,4.1
CN7212900000000,2022-04-01,72,129,PR,San Lorenzo Municipio,12642,11925,717,5.7
CN7213100000000,2022-04-01,72,131,PR,San Sebastian Municipio,11226,10087,1139,10.1
CN7213300000000,2022-04-01,72,133,PR,Santa Isabel Municipio,8851,8195,656,7.4
CN7213500000000,2022-04-01,72,135,PR,Toa Alta Municipio,30670,29340,1330,4.3
CN7213700000000,2022-04-01,72,137,PR,Toa Baja Municipio,31905,30448,1457,4.6
CN7213900000000,2022-04-01,72,139,PR,Trujillo Alto Municipio,29851,28785,1066,3.6
CN7214100000000,2022-04-01,72,141,PR,Utuado Municipio,7361,6787,574,7.8
CN7214300000000,2022-04-01,72,143,PR,Vega Alta Municipio,10859,10076,783,7.2
CN7214500000000,2022-04-01,72,145,PR,Vega Baja Municipio,14304,13288,1016,7.1
CN7214700000000,2022-04-01,72,147,PR,Vieques Municipio,2874,2677,197,6.9
CN7214900000000,2022-04-01,72,149,PR,Villalba Municipio,7915,7082,833,10.5
CN7215100000000,2022-04-01,72,151,PR,Yabucoa Municipio,9361,8590,771,8.2
CN7215300000000,2022-04-01,72,153,PR,Yauco Municipio,10467,9330,1137,10.9
CN0100100000000,2022-05-01,01,001,AL,Autauga County,26719,26196,523,2
CN0100300000000,2022-05-01,01,003,AL,Baldwin County,103596,101523,2073,2
CN0100500000000,2022-05-01,01,005,AL,Barbour County,8262,8008,254,3.1
CN0100700000000,2022-05-01,01,007,AL,Bibb County,8727,8549,178,2
CN0100900000000,2022-05-01,01,009,AL,Blount County,25777,25280,497,1.9
CN0101100000000,2022-05-01,01,011,AL,Bullock County,4432,4322,110,2.5
CN0101300000000,2022-05-01,01,013,AL,Butler County,8780,8530,250,2.8
CN0101500000000,2022-05-01,01,015,AL,Calhoun County,46195,44982,1213,2.6
CN0101700000000,2022-05-01,01,017,AL,Chambers County,15905,15558,347,2.2
CN0101900000000,2022-05-01,01,019,AL,Cherokee County,11828,11593,235,2
CN0102100000000,2022-05-01,01,021,AL,Chilton County,20187,19795,392,1.9
CN0102300000000,2022-05-01,01,023,AL,Choctaw County,4321,4173,148,3.4
CN0102500000000,2022-05-01,01,025,AL,Clarke County,7666,7375,291,3.8
CN0102700000000,2022-05-01,01,027,AL,Clay County,6123,6005,118,1.9
CN0102900000000,2022-05-01,01,029,AL,Cleburne County,6109,5977,132,2.2
CN0103100000000,2022-05-01,01,031,AL,Coffee County,21507,21044,463,2.2
CN0103300000000,2022-05-01,01,033,AL,Colbert County,23896,23258,638,2.7
CN0103500000000,2022-05-01,01,035,AL,Conecuh County,4244,4121,123,2.9
CN0103700000000,2022-05-01,01,037,AL,Coosa County,4436,4338,98,2.2
CN0103900000000,2022-05-01,01,039,AL,Covington County,15116,14779,337,2.2
CN0104100000000,2022-05-01,01,041,AL,Crenshaw County,5817,5692,125,2.1
CN0104300000000,2022-05-01,01,043,AL,Cullman County,39927,39217,710,1.8
CN0104500000000,2022-05-01,01,045,AL,Dale County,21014,20538,476,2.3
CN0104700000000,2022-05-01,01,047,AL,Dallas County,13747,13197,550,4
CN0104900000000,2022-05-01,01,049,AL,DeKalb County,30924,30297,627,2
CN0105100000000,2022-05-01,01,051,AL,Elmore County,38189,37493,696,1.8
CN0105300000000,2022-05-01,01,053,AL,Escambia County,14224,13883,341,2.4
CN0105500000000,2022-05-01,01,055,AL,Etowah County,39508,38470,1038,2.6
CN0105700000000,2022-05-01,01,057,AL,Fayette County,6706,6547,159,2.4
CN0105900000000,2022-05-01,01,059,AL,Franklin County,14541,14261,280,1.9
CN0106100000000,2022-05-01,01,061,AL,Geneva County,11089,10854,235,2.1
CN0106300000000,2022-05-01,01,063,AL,Greene County,2713,2613,100,3.7
CN0106500000000,2022-05-01,01,065,AL,Hale County,5743,5551,192,3.3
CN0106700000000,2022-05-01,01,067,AL,Henry County,7011,6848,163,2.3
CN0106900000000,2022-05-01,01,069,AL,Houston County,47964,46908,1056,2.2
CN0107100000000,2022-05-01,01,071,AL,Jackson County,23284,22741,543,2.3
CN0107300000000,2022-05-01,01,073,AL,Jefferson County,324658,317576,7082,2.2
CN0107500000000,2022-05-01,01,075,AL,Lamar County,5707,5579,128,2.2
CN0107700000000,2022-05-01,01,077,AL,Lauderdale County,43086,42098,988,2.3
CN0107900000000,2022-05-01,01,079,AL,Lawrence County,14667,14364,303,2.1
CN0108100000000,2022-05-01,01,081,AL,Lee County,79015,77428,1587,2
CN0108300000000,2022-05-01,01,083,AL,Limestone County,48262,47389,873,1.8
CN0108500000000,2022-05-01,01,085,AL,Lowndes County,3436,3297,139,4
CN0108700000000,2022-05-01,01,087,AL,Macon County,7807,7550,257,3.3
CN0108900000000,2022-05-01,01,089,AL,Madison County,199474,195839,3635,1.8
CN0109100000000,2022-05-01,01,091,AL,Marengo County,7617,7411,206,2.7
CN0109300000000,2022-05-01,01,093,AL,Marion County,13871,13588,283,2
CN0109500000000,2022-05-01,01,095,AL,Marshall County,45437,44635,802,1.8
CN0109700000000,2022-05-01,01,097,AL,Mobile County,191853,186543,5310,2.8
CN0109900000000,2022-05-01,01,099,AL,Monroe County,7365,7122,243,3.3
CN0110100000000,2022-05-01,01,101,AL,Montgomery County,106839,104092,2747,2.6
CN0110300000000,2022-05-01,01,103,AL,Morgan County,60811,59713,1098,1.8
CN0110500000000,2022-05-01,01,105,AL,Perry County,3068,2946,122,4
CN0110700000000,2022-05-01,01,107,AL,Pickens County,7524,7314,210,2.8
CN0110900000000,2022-05-01,01,109,AL,Pike County,15976,15613,363,2.3
CN0111100000000,2022-05-01,01,111,AL,Randolph County,9691,9483,208,2.1
CN0111300000000,2022-05-01,01,113,AL,Russell County,23596,23087,509,2.2
CN0111500000000,2022-05-01,01,115,AL,St. Clair County,42389,41586,803,1.9
CN0111700000000,2022-05-01,01,117,AL,Shelby County,122044,120125,1919,1.6
CN0111900000000,2022-05-01,01,119,AL,Sumter County,4421,4282,139,3.1
CN0112100000000,2022-05-01,01,121,AL,Talladega County,36058,35112,946,2.6
CN0112300000000,2022-05-01,01,123,AL,Tallapoosa County,17711,17281,430,2.4
CN0112500000000,2022-05-01,01,125,AL,Tuscaloosa County,102705,100446,2259,2.2
CN0112700000000,2022-05-01,01,127,AL,Walker County,25657,25053,604,2.4
CN0112900000000,2022-05-01,01,129,AL,Washington County,6488,6286,202,3.1
CN0113100000000,2022-05-01,01,131,AL,Wilcox County,2454,2300,154,6.3
CN0113300000000,2022-05-01,01,133,AL,Winston County,10316,10098,218,2.1
CN0201300000000,2022-05-01,02,013,AK,Aleutians East Borough,1503,1455,48,3.2
CN0201600000000,2022-05-01,02,016,AK,Aleutians West Census Area,2884,2747,137,4.8
CN0202000000000,2022-05-01,02,020,AK,Anchorage Borough/municipality,152447,147371,5076,3.3
CN0205000000000,2022-05-01,02,050,AK,Bethel Census Area,6373,5786,587,9.2
CN0206000000000,2022-05-01,02,060,AK,Bristol Bay Borough,450,435,15,3.3
CN0206300000000,2022-05-01,02,063,AK,Chugach Census Area,3436,3343,93,2.7
CN0206600000000,2022-05-01,02,066,AK,Copper River Census Area,1404,1296,108,7.7
CN0206800000000,2022-05-01,02,068,AK,Denali Borough,1263,1209,54,4.3
CN0207000000000,2022-05-01,02,070,AK,Dillingham Census Area,1657,1562,95,5.7
CN0209000000000,2022-05-01,02,090,AK,Fairbanks North Star Borough,45082,43422,1660,3.7
CN0210000000000,2022-05-01,02,100,AK,Haines Borough,1124,1066,58,5.2
CN0210500000000,2022-05-01,02,105,AK,Hoonah-Angoon Census Area,1400,1347,53,3.8
CN0211000000000,2022-05-01,02,110,AK,Juneau Borough/city,18051,17578,473,2.6
CN0212200000000,2022-05-01,02,122,AK,Kenai Peninsula Borough,28905,27744,1161,4
CN0213000000000,2022-05-01,02,130,AK,Ketchikan Gateway Borough,7010,6770,240,3.4
CN0215000000000,2022-05-01,02,150,AK,Kodiak Island Borough,5843,5603,240,4.1
CN0215800000000,2022-05-01,02,158,AK,Kusilvak Census Area,2276,1996,280,12.3
CN0216400000000,2022-05-01,02,164,AK,Lake and Peninsula Borough,699,664,35,5
CN0217000000000,2022-05-01,02,170,AK,Matanuska-Susitna Borough,50235,48041,2194,4.4
CN0218000000000,2022-05-01,02,180,AK,Nome Census Area,4134,3845,289,7
CN0218500000000,2022-05-01,02,185,AK,North Slope Borough,2890,2741,149,5.2
CN0218800000000,2022-05-01,02,188,AK,Northwest Arctic Borough,2753,2505,248,9
CN0219500000000,2022-05-01,02,195,AK,Petersburg Borough,1426,1346,80,5.6
CN0219800000000,2022-05-01,02,198,AK,Prince of Wales-Hyder Census Area,2777,2637,140,5
CN0222000000000,2022-05-01,02,220,AK,Sitka Borough/city,4639,4514,125,2.7
CN0223000000000,2022-05-01,02,230,AK,Skagway Municipality,920,893,27,2.9
CN0224000000000,2022-05-01,02,240,AK,Southeast Fairbanks Census Area,3257,3099,158,4.9
CN0227500000000,2022-05-01,02,275,AK,Wrangell Borough/city,891,849,42,4.7
CN0228200000000,2022-05-01,02,282,AK,Yakutat Borough/city,326,312,14,4.3
CN0229000000000,2022-05-01,02,290,AK,Yukon-Koyukuk Census Area,2394,2208,186,7.8
CN0400100000000,2022-05-01,04,001,AZ,Apache County,18291,16946,1345,7.4
CN0400300000000,2022-05-01,04,003,AZ,Cochise County,48391,46325,2066,4.3
CN0400500000000,2022-05-01,04,005,AZ,Coconino County,73395,70338,3057,4.2
CN0400700000000,2022-05-01,04,007,AZ,Gila County,20225,19399,826,4.1
CN0400900000000,2022-05-01,04,009,AZ,Graham County,16251,15666,585,3.6
CN0401100000000,2022-05-01,04,011,AZ,Greenlee County,4643,4510,133,2.9
CN0401200000000,2022-05-01,04,012,AZ,La Paz County,8113,7709,404,5
CN0401300000000,2022-05-01,04,013,AZ,Maricopa County,2381030,2303514,77516,3.3
CN0401500000000,2022-05-01,04,015,AZ,Mohave County,89506,85692,3814,4.3
CN0401700000000,2022-05-01,04,017,AZ,Navajo County,39203,37299,1904,4.9
CN0401900000000,2022-05-01,04,019,AZ,Pima County,490664,472413,18251,3.7
CN0402100000000,2022-05-01,04,021,AZ,Pinal County,196344,188936,7408,3.8
CN0402300000000,2022-05-01,04,023,AZ,Santa Cruz County,18678,17588,1090,5.8
CN0402500000000,2022-05-01,04,025,AZ,Yavapai County,107688,104077,3611,3.4
CN0402700000000,2022-05-01,04,027,AZ,Yuma County,91484,80365,11119,12.2
CN0500100000000,2022-05-01,05,001,AR,Arkansas County,9163,8858,305,3.3
CN0500300000000,2022-05-01,05,003,AR,Ashley County,6878,6541,337,4.9
CN0500500000000,2022-05-01,05,005,AR,Baxter County,16782,16242,540,3.2
CN0500700000000,2022-05-01,05,007,AR,Benton County,151542,148065,3477,2.3
CN0500900000000,2022-05-01,05,009,AR,Boone County,16032,15611,421,2.6
CN0501100000000,2022-05-01,05,011,AR,Bradley County,4097,3917,180,4.4
CN0501300000000,2022-05-01,05,013,AR,Calhoun County,2379,2302,77,3.2
CN0501500000000,2022-05-01,05,015,AR,Carroll County,12560,12229,331,2.6
CN0501700000000,2022-05-01,05,017,AR,Chicot County,2960,2772,188,6.4
CN0501900000000,2022-05-01,05,019,AR,Clark County,8576,8214,362,4.2
CN0502100000000,2022-05-01,05,021,AR,Clay County,5454,5260,194,3.6
CN0502300000000,2022-05-01,05,023,AR,Cleburne County,9093,8729,364,4
CN0502500000000,2022-05-01,05,025,AR,Cleveland County,3079,2967,112,3.6
CN0502700000000,2022-05-01,05,027,AR,Columbia County,8991,8614,377,4.2
CN0502900000000,2022-05-01,05,029,AR,Conway County,8531,8232,299,3.5
CN0503100000000,2022-05-01,05,031,AR,Craighead County,57525,55994,1531,2.7
CN0503300000000,2022-05-01,05,033,AR,Crawford County,26398,25570,828,3.1
CN0503500000000,2022-05-01,05,035,AR,Crittenden County,20600,19840,760,3.7
CN0503700000000,2022-05-01,05,037,AR,Cross County,7034,6808,226,3.2
CN0503900000000,2022-05-01,05,039,AR,Dallas County,2738,2633,105,3.8
CN0504100000000,2022-05-01,05,041,AR,Desha County,4910,4663,247,5
CN0504300000000,2022-05-01,05,043,AR,Drew County,7235,6920,315,4.4
CN0504500000000,2022-05-01,05,045,AR,Faulkner County,63288,61485,1803,2.8
CN0504700000000,2022-05-01,05,047,AR,Franklin County,7417,7171,246,3.3
CN0504900000000,2022-05-01,05,049,AR,Fulton County,5120,4950,170,3.3
CN0505100000000,2022-05-01,05,051,AR,Garland County,42583,41091,1492,3.5
CN0505300000000,2022-05-01,05,053,AR,Grant County,8454,8204,250,3
CN0505500000000,2022-05-01,05,055,AR,Greene County,19653,19080,573,2.9
CN0505700000000,2022-05-01,05,057,AR,Hempstead County,9364,9087,277,3
CN0505900000000,2022-05-01,05,059,AR,Hot Spring County,13875,13434,441,3.2
CN0506100000000,2022-05-01,05,061,AR,Howard County,5441,5276,165,3
CN0506300000000,2022-05-01,05,063,AR,Independence County,16734,16202,532,3.2
CN0506500000000,2022-05-01,05,065,AR,Izard County,4508,4294,214,4.7
CN0506700000000,2022-05-01,05,067,AR,Jackson County,5474,5227,247,4.5
CN0506900000000,2022-05-01,05,069,AR,Jefferson County,25808,24560,1248,4.8
CN0507100000000,2022-05-01,05,071,AR,Johnson County,10312,9869,443,4.3
CN0507300000000,2022-05-01,05,073,AR,Lafayette County,2323,2220,103,4.4
CN0507500000000,2022-05-01,05,075,AR,Lawrence County,6829,6595,234,3.4
CN0507700000000,2022-05-01,05,077,AR,Lee County,2550,2444,106,4.2
CN0507900000000,2022-05-01,05,079,AR,Lincoln County,3689,3526,163,4.4
CN0508100000000,2022-05-01,05,081,AR,Little River County,5238,5038,200,3.8
CN0508300000000,2022-05-01,05,083,AR,Logan County,8323,8005,318,3.8
CN0508500000000,2022-05-01,05,085,AR,Lonoke County,34226,33287,939,2.7
CN0508700000000,2022-05-01,05,087,AR,Madison County,7685,7501,184,2.4
CN0508900000000,2022-05-01,05,089,AR,Marion County,6397,6181,216,3.4
CN0509100000000,2022-05-01,05,091,AR,Miller County,18820,18137,683,3.6
CN0509300000000,2022-05-01,05,093,AR,Mississippi County,16196,15300,896,5.5
CN0509500000000,2022-05-01,05,095,AR,Monroe County,2495,2389,106,4.2
CN0509700000000,2022-05-01,05,097,AR,Montgomery County,2855,2726,129,4.5
CN0509900000000,2022-05-01,05,099,AR,Nevada County,3472,3341,131,3.8
CN0510100000000,2022-05-01,05,101,AR,Newton County,3208,3116,92,2.9
CN0510300000000,2022-05-01,05,103,AR,Ouachita County,9768,9401,367,3.8
CN0510500000000,2022-05-01,05,105,AR,Perry County,4218,4065,153,3.6
CN0510700000000,2022-05-01,05,107,AR,Phillips County,5616,5293,323,5.8
CN0510900000000,2022-05-01,05,109,AR,Pike County,4121,3976,145,3.5
CN0511100000000,2022-05-01,05,111,AR,Poinsett County,9884,9558,326,3.3
CN0511300000000,2022-05-01,05,113,AR,Polk County,7807,7547,260,3.3
CN0511500000000,2022-05-01,05,115,AR,Pope County,27803,26766,1037,3.7
CN0511700000000,2022-05-01,05,117,AR,Prairie County,3503,3410,93,2.7
CN0511900000000,2022-05-01,05,119,AR,Pulaski County,190165,183848,6317,3.3
CN0512100000000,2022-05-01,05,121,AR,Randolph County,7268,7038,230,3.2
CN0512300000000,2022-05-01,05,123,AR,St. Francis County,7697,7362,335,4.4
CN0512500000000,2022-05-01,05,125,AR,Saline County,60226,58632,1594,2.6
CN0512700000000,2022-05-01,05,127,AR,Scott County,4103,3987,116,2.8
CN0512900000000,2022-05-01,05,129,AR,Searcy County,2939,2815,124,4.2
CN0513100000000,2022-05-01,05,131,AR,Sebastian County,55599,53921,1678,3
CN0513300000000,2022-05-01,05,133,AR,Sevier County,5371,5172,199,3.7
CN0513500000000,2022-05-01,05,135,AR,Sharp County,5982,5748,234,3.9
CN0513700000000,2022-05-01,05,137,AR,Stone County,4583,4408,175,3.8
CN0513900000000,2022-05-01,05,139,AR,Union County,14912,14246,666,4.5
CN0514100000000,2022-05-01,05,141,AR,Van Buren County,6017,5782,235,3.9
CN0514300000000,2022-05-01,05,143,AR,Washington County,133979,130911,3068,2.3
CN0514500000000,2022-05-01,05,145,AR,White County,34639,33435,1204,3.5
CN0514700000000,2022-05-01,05,147,AR,Woodruff County,2757,2660,97,3.5
CN0514900000000,2022-05-01,05,149,AR,Yell County,7880,7587,293,3.7
CN0600100000000,2022-05-01,06,001,CA,Alameda County,820999,798394,22605,2.8
CN0600300000000,2022-05-01,06,003,CA,Alpine County,473,446,27,5.7
CN0600500000000,2022-05-01,06,005,CA,Amador County,14348,13835,513,3.6
CN0600700000000,2022-05-01,06,007,CA,Butte County,92259,88834,3425,3.7
CN0600900000000,2022-05-01,06,009,CA,Calaveras County,22131,21446,685,3.1
CN0601100000000,2022-05-01,06,011,CA,Colusa County,10081,9018,1063,10.5
CN0601300000000,2022-05-01,06,013,CA,Contra Costa County,548152,531859,16293,3
CN0601500000000,2022-05-01,06,015,CA,Del Norte County,9249,8819,430,4.6
CN0601700000000,2022-05-01,06,017,CA,El Dorado County,92875,90249,2626,2.8
CN0601900000000,2022-05-01,06,019,CA,Fresno County,454048,428416,25632,5.6
CN0602100000000,2022-05-01,06,021,CA,Glenn County,12774,12180,594,4.7
CN0602300000000,2022-05-01,06,023,CA,Humboldt County,59512,57494,2018,3.4
CN0602500000000,2022-05-01,06,025,CA,Imperial County,68393,59991,8402,12.3
CN0602700000000,2022-05-01,06,027,CA,Inyo County,8132,7869,263,3.2
CN0602900000000,2022-05-01,06,029,CA,Kern County,385892,360874,25018,6.5
CN0603100000000,2022-05-01,06,031,CA,Kings County,56112,52646,3466,6.2
CN0603300000000,2022-05-01,06,033,CA,Lake County,28520,27368,1152,4
CN0603500000000,2022-05-01,06,035,CA,Lassen County,8795,8486,309,3.5
CN0603700000000,2022-05-01,06,037,CA,Los Angeles County,4987130,4763298,223832,4.5
CN0603900000000,2022-05-01,06,039,CA,Madera County,62967,59548,3419,5.4
CN0604100000000,2022-05-01,06,041,CA,Marin County,131391,128499,2892,2.2
CN0604300000000,2022-05-01,06,043,CA,Mariposa County,7449,7185,264,3.5
CN0604500000000,2022-05-01,06,045,CA,Mendocino County,37054,35795,1259,3.4
CN0604700000000,2022-05-01,06,047,CA,Merced County,115487,107448,8039,7
CN0604900000000,2022-05-01,06,049,CA,Modoc County,3186,3051,135,4.2
CN0605100000000,2022-05-01,06,051,CA,Mono County,8675,8417,258,3
CN0605300000000,2022-05-01,06,053,CA,Monterey County,225165,214488,10677,4.7
CN0605500000000,2022-05-01,06,055,CA,Napa County,71825,69975,1850,2.6
CN0605700000000,2022-05-01,06,057,CA,Nevada County,47513,46137,1376,2.9
CN0605900000000,2022-05-01,06,059,CA,Orange County,1583335,1540960,42375,2.7
CN0606100000000,2022-05-01,06,061,CA,Placer County,192939,188029,4910,2.5
CN0606300000000,2022-05-01,06,063,CA,Plumas County,7523,7157,366,4.9
CN0606500000000,2022-05-01,06,065,CA,Riverside County,1143750,1104293,39457,3.4
CN0606700000000,2022-05-01,06,067,CA,Sacramento County,724228,700526,23702,3.3
CN0606900000000,2022-05-01,06,069,CA,San Benito County,32188,30752,1436,4.5
CN0607100000000,2022-05-01,06,071,CA,San Bernardino County,1001750,967237,34513,3.4
CN0607300000000,2022-05-01,06,073,CA,San Diego County,1581087,1535400,45687,2.9
CN0607500000000,2022-05-01,06,075,CA,San Francisco County/city,569225,557058,12167,2.1
CN0607700000000,2022-05-01,06,077,CA,San Joaquin County,346015,330800,15215,4.4
CN0607900000000,2022-05-01,06,079,CA,San Luis Obispo County,138744,135252,3492,2.5
CN0608100000000,2022-05-01,06,081,CA,San Mateo County,450751,441575,9176,2
CN0608300000000,2022-05-01,06,083,CA,Santa Barbara County,227066,220794,6272,2.8
CN0608500000000,2022-05-01,06,085,CA,Santa Clara County,1030884,1007850,23034,2.2
CN0608700000000,2022-05-01,06,087,CA,Santa Cruz County,134342,128836,5506,4.1
CN0608900000000,2022-05-01,06,089,CA,Shasta County,72761,69957,2804,3.9
CN0609100000000,2022-05-01,06,091,CA,Sierra County,1307,1262,45,3.4
CN0609300000000,2022-05-01,06,093,CA,Siskiyou County,16551,15766,785,4.7
CN0609500000000,2022-05-01,06,095,CA,Solano County,201347,194172,7175,3.6
CN0609700000000,2022-05-01,06,097,CA,Sonoma County,247569,241054,6515,2.6
CN0609900000000,2022-05-01,06,099,CA,Stanislaus County,242013,230442,11571,4.8
CN0610100000000,2022-05-01,06,101,CA,Sutter County,46543,43775,2768,5.9
CN0610300000000,2022-05-01,06,103,CA,Tehama County,25626,24567,1059,4.1
CN0610500000000,2022-05-01,06,105,CA,Trinity County,4558,4393,165,3.6
CN0610700000000,2022-05-01,06,107,CA,Tulare County,210264,195459,14805,7
CN0610900000000,2022-05-01,06,109,CA,Tuolumne County,19883,19137,746,3.8
CN0611100000000,2022-05-01,06,111,CA,Ventura County,414031,401782,12249,3
CN0611300000000,2022-05-01,06,113,CA,Yolo County,108538,104833,3705,3.4
CN0611500000000,2022-05-01,06,115,CA,Yuba County,31515,30056,1459,4.6
CN0800100000000,2022-05-01,08,001,CO,Adams County,281784,273404,8380,3
CN0800300000000,2022-05-01,08,003,CO,Alamosa County,8245,7996,249,3
CN0800500000000,2022-05-01,08,005,CO,Arapahoe County,375268,364891,10377,2.8
CN0800700000000,2022-05-01,08,007,CO,Archuleta County,6954,6750,204,2.9
CN0800900000000,2022-05-01,08,009,CO,Baca County,2042,2009,33,1.6
CN0801100000000,2022-05-01,08,011,CO,Bent County,1738,1680,58,3.3
CN0801300000000,2022-05-01,08,013,CO,Boulder County,201483,196896,4587,2.3
CN0801400000000,2022-05-01,08,014,CO,Broomfield County/city,42499,41526,973,2.3
CN0801500000000,2022-05-01,08,015,CO,Chaffee County,9633,9407,226,2.3
CN0801700000000,2022-05-01,08,017,CO,Cheyenne County,1056,1039,17,1.6
CN0801900000000,2022-05-01,08,019,CO,Clear Creek County,6153,5994,159,2.6
CN0802100000000,2022-05-01,08,021,CO,Conejos County,3998,3882,116,2.9
CN0802300000000,2022-05-01,08,023,CO,Costilla County,1767,1697,70,4
CN0802500000000,2022-05-01,08,025,CO,Crowley County,1366,1320,46,3.4
CN0802700000000,2022-05-01,08,027,CO,Custer County,2380,2315,65,2.7
CN0802900000000,2022-05-01,08,029,CO,Delta County,13376,12946,430,3.2
CN0803100000000,2022-05-01,08,031,CO,Denver County/city,436137,424186,11951,2.7
CN0803300000000,2022-05-01,08,033,CO,Dolores County,1133,1103,30,2.6
CN0803500000000,2022-05-01,08,035,CO,Douglas County,207818,203180,4638,2.2
CN0803700000000,2022-05-01,08,037,CO,Eagle County,32062,31108,954,3
CN0803900000000,2022-05-01,08,039,CO,Elbert County,15988,15635,353,2.2
CN0804100000000,2022-05-01,08,041,CO,El Paso County,358040,347728,10312,2.9
CN0804300000000,2022-05-01,08,043,CO,Fremont County,14431,13846,585,4.1
CN0804500000000,2022-05-01,08,045,CO,Garfield County,29042,28206,836,2.9
CN0804700000000,2022-05-01,08,047,CO,Gilpin County,3931,3834,97,2.5
CN0804900000000,2022-05-01,08,049,CO,Grand County,8398,8178,220,2.6
CN0805100000000,2022-05-01,08,051,CO,Gunnison County,10842,10550,292,2.7
CN0805300000000,2022-05-01,08,053,CO,Hinsdale County,432,421,11,2.5
CN0805500000000,2022-05-01,08,055,CO,Huerfano County,2417,2304,113,4.7
CN0805700000000,2022-05-01,08,057,CO,Jackson County,970,949,21,2.2
CN0805900000000,2022-05-01,08,059,CO,Jefferson County,343059,334499,8560,2.5
CN0806100000000,2022-05-01,08,061,CO,Kiowa County,878,864,14,1.6
CN0806300000000,2022-05-01,08,063,CO,Kit Carson County,4037,3967,70,1.7
CN0806500000000,2022-05-01,08,065,CO,Lake County,4542,4427,115,2.5
CN0806700000000,2022-05-01,08,067,CO,La Plata County,30548,29742,806,2.6
CN0806900000000,2022-05-01,08,069,CO,Larimer County,211467,206334,5133,2.4
CN0807100000000,2022-05-01,08,071,CO,Las Animas County,6112,5868,244,4
CN0807300000000,2022-05-01,08,073,CO,Lincoln County,2222,2167,55,2.5
CN0807500000000,2022-05-01,08,075,CO,Logan County,10175,9922,253,2.5
CN0807700000000,2022-05-01,08,077,CO,Mesa County,76886,74649,2237,2.9
CN0807900000000,2022-05-01,08,079,CO,Mineral County,403,391,12,3
CN0808100000000,2022-05-01,08,081,CO,Moffat County,6728,6550,178,2.6
CN0808300000000,2022-05-01,08,083,CO,Montezuma County,12393,11991,402,3.2
CN0808500000000,2022-05-01,08,085,CO,Montrose County,21161,20519,642,3
CN0808700000000,2022-05-01,08,087,CO,Morgan County,15398,14927,471,3.1
CN0808900000000,2022-05-01,08,089,CO,Otero County,7791,7500,291,3.7
CN0809100000000,2022-05-01,08,091,CO,Ouray County,2457,2377,80,3.3
CN0809300000000,2022-05-01,08,093,CO,Park County,11603,11337,266,2.3
CN0809500000000,2022-05-01,08,095,CO,Phillips County,2363,2317,46,1.9
CN0809700000000,2022-05-01,08,097,CO,Pitkin County,10100,9646,454,4.5
CN0809900000000,2022-05-01,08,099,CO,Prowers County,6068,5906,162,2.7
CN0810100000000,2022-05-01,08,101,CO,Pueblo County,76550,73547,3003,3.9
CN0810300000000,2022-05-01,08,103,CO,Rio Blanco County,2838,2741,97,3.4
CN0810500000000,2022-05-01,08,105,CO,Rio Grande County,5268,5082,186,3.5
CN0810700000000,2022-05-01,08,107,CO,Routt County,14568,14165,403,2.8
CN0810900000000,2022-05-01,08,109,CO,Saguache County,3389,3284,105,3.1
CN0811100000000,2022-05-01,08,111,CO,San Juan County,502,489,13,2.6
CN0811300000000,2022-05-01,08,113,CO,San Miguel County,4602,4348,254,5.5
CN0811500000000,2022-05-01,08,115,CO,Sedgwick County,1063,1039,24,2.3
CN0811700000000,2022-05-01,08,117,CO,Summit County,19653,19195,458,2.3
CN0811900000000,2022-05-01,08,119,CO,Teller County,13390,13023,367,2.7
CN0812100000000,2022-05-01,08,121,CO,Washington County,2762,2700,62,2.2
CN0812300000000,2022-05-01,08,123,CO,Weld County,168854,163993,4861,2.9
CN0812500000000,2022-05-01,08,125,CO,Yuma County,5584,5480,104,1.9
CN0900100000000,2022-05-01,09,001,CT,Fairfield County,491525,471097,20428,4.2
CN0900300000000,2022-05-01,09,003,CT,Hartford County,486020,465334,20686,4.3
CN0900500000000,2022-05-01,09,005,CT,Litchfield County,107191,103224,3967,3.7
CN0900700000000,2022-05-01,09,007,CT,Middlesex County,95655,92240,3415,3.6
CN0900900000000,2022-05-01,09,009,CT,New Haven County,475593,455132,20461,4.3
CN0901100000000,2022-05-01,09,011,CT,New London County,135979,130149,5830,4.3
CN0901300000000,2022-05-01,09,013,CT,Tolland County,87774,84526,3248,3.7
CN0901500000000,2022-05-01,09,015,CT,Windham County,65152,62313,2839,4.4
CN1000100000000,2022-05-01,10,001,DE,Kent County,80351,76584,3767,4.7
CN1000300000000,2022-05-01,10,003,DE,New Castle County,302308,290183,12125,4
CN1000500000000,2022-05-01,10,005,DE,Sussex County,112316,108031,4285,3.8
CN1100100000000,2022-05-01,11,001,DC,District of Columbia,387666,370956,16710,4.3
CN1200100000000,2022-05-01,12,001,FL,Alachua County,139827,136030,3797,2.7
CN1200300000000,2022-05-01,12,003,FL,Baker County,12600,12271,329,2.6
CN1200500000000,2022-05-01,12,005,FL,Bay County,88365,86227,2138,2.4
CN1200700000000,2022-05-01,12,007,FL,Bradford County,10980,10661,319,2.9
CN1200900000000,2022-05-01,12,009,FL,Brevard County,295209,287269,7940,2.7
CN1201100000000,2022-05-01,12,011,FL,Broward County,1065995,1037185,28810,2.7
CN1201300000000,2022-05-01,12,013,FL,Calhoun County,4887,4740,147,3
CN1201500000000,2022-05-01,12,015,FL,Charlotte County,76763,74480,2283,3
CN1201700000000,2022-05-01,12,017,FL,Citrus County,49772,47902,1870,3.8
CN1201900000000,2022-05-01,12,019,FL,Clay County,112633,109828,2805,2.5
CN1202100000000,2022-05-01,12,021,FL,Collier County,190922,186281,4641,2.4
CN1202300000000,2022-05-01,12,023,FL,Columbia County,29632,28720,912,3.1
CN1202700000000,2022-05-01,12,027,FL,DeSoto County,14259,13835,424,3
CN1202900000000,2022-05-01,12,029,FL,Dixie County,5931,5750,181,3.1
CN1203100000000,2022-05-01,12,031,FL,Duval County,510632,496010,14622,2.9
CN1203300000000,2022-05-01,12,033,FL,Escambia County,149408,145170,4238,2.8
CN1203500000000,2022-05-01,12,035,FL,Flagler County,50181,48618,1563,3.1
CN1203700000000,2022-05-01,12,037,FL,Franklin County,4934,4817,117,2.4
CN1203900000000,2022-05-01,12,039,FL,Gadsden County,18987,18309,678,3.6
CN1204100000000,2022-05-01,12,041,FL,Gilchrist County,7341,7133,208,2.8
CN1204300000000,2022-05-01,12,043,FL,Glades County,5195,5042,153,2.9
CN1204500000000,2022-05-01,12,045,FL,Gulf County,5448,5326,122,2.2
CN1204700000000,2022-05-01,12,047,FL,Hamilton County,4137,3979,158,3.8
CN1204900000000,2022-05-01,12,049,FL,Hardee County,8779,8472,307,3.5
CN1205100000000,2022-05-01,12,051,FL,Hendry County,15657,15042,615,3.9
CN1205300000000,2022-05-01,12,053,FL,Hernando County,76706,74138,2568,3.3
CN1205500000000,2022-05-01,12,055,FL,Highlands County,36169,34806,1363,3.8
CN1205700000000,2022-05-01,12,057,FL,Hillsborough County,801518,780641,20877,2.6
CN1205900000000,2022-05-01,12,059,FL,Holmes County,7060,6855,205,2.9
CN1206100000000,2022-05-01,12,061,FL,Indian River County,68299,66092,2207,3.2
CN1206300000000,2022-05-01,12,063,FL,Jackson County,16790,16268,522,3.1
CN1206500000000,2022-05-01,12,065,FL,Jefferson County,5710,5532,178,3.1
CN1206700000000,2022-05-01,12,067,FL,Lafayette County,2826,2741,85,3
CN1206900000000,2022-05-01,12,069,FL,Lake County,170193,165333,4860,2.9
CN1207100000000,2022-05-01,12,071,FL,Lee County,373187,363218,9969,2.7
CN1207300000000,2022-05-01,12,073,FL,Leon County,159005,154462,4543,2.9
CN1207500000000,2022-05-01,12,075,FL,Levy County,17143,16579,564,3.3
CN1207700000000,2022-05-01,12,077,FL,Liberty County,2640,2560,80,3
CN1207900000000,2022-05-01,12,079,FL,Madison County,7912,7659,253,3.2
CN1208100000000,2022-05-01,12,081,FL,Manatee County,187008,182053,4955,2.6
CN1208300000000,2022-05-01,12,083,FL,Marion County,148254,143431,4823,3.3
CN1208500000000,2022-05-01,12,085,FL,Martin County,76345,74438,1907,2.5
CN1208600000000,2022-05-01,12,086,FL,Miami-Dade County,1362628,1328690,33938,2.5
CN1208700000000,2022-05-01,12,087,FL,Monroe County,49477,48635,842,1.7
CN1208900000000,2022-05-01,12,089,FL,Nassau County,44553,43504,1049,2.4
CN1209100000000,2022-05-01,12,091,FL,Okaloosa County,104437,102067,2370,2.3
CN1209300000000,2022-05-01,12,093,FL,Okeechobee County,17650,17116,534,3
CN1209500000000,2022-05-01,12,095,FL,Orange County,787836,766429,21407,2.7
CN1209700000000,2022-05-01,12,097,FL,Osceola County,196080,189788,6292,3.2
CN1209900000000,2022-05-01,12,099,FL,Palm Beach County,766194,745412,20782,2.7
CN1210100000000,2022-05-01,12,101,FL,Pasco County,257396,250005,7391,2.9
CN1210300000000,2022-05-01,12,103,FL,Pinellas County,508885,496311,12574,2.5
CN1210500000000,2022-05-01,12,105,FL,Polk County,337649,326677,10972,3.2
CN1210700000000,2022-05-01,12,107,FL,Putnam County,27656,26602,1054,3.8
CN1210900000000,2022-05-01,12,109,FL,St. Johns County,149354,146069,3285,2.2
CN1211100000000,2022-05-01,12,111,FL,St. Lucie County,155824,150813,5011,3.2
CN1211300000000,2022-05-01,12,113,FL,Santa Rosa County,87705,85540,2165,2.5
CN1211500000000,2022-05-01,12,115,FL,Sarasota County,196649,191487,5162,2.6
CN1211700000000,2022-05-01,12,117,FL,Seminole County,262535,255978,6557,2.5
CN1211900000000,2022-05-01,12,119,FL,Sumter County,37255,35848,1407,3.8
CN1212100000000,2022-05-01,12,121,FL,Suwannee County,17554,17001,553,3.2
CN1212300000000,2022-05-01,12,123,FL,Taylor County,8203,7950,253,3.1
CN1212500000000,2022-05-01,12,125,FL,Union County,4487,4368,119,2.7
CN1212700000000,2022-05-01,12,127,FL,Volusia County,264735,256961,7774,2.9
CN1212900000000,2022-05-01,12,129,FL,Wakulla County,15849,15471,378,2.4
CN1213100000000,2022-05-01,12,131,FL,Walton County,35477,34655,822,2.3
CN1213300000000,2022-05-01,12,133,FL,Washington County,9797,9497,300,3.1
CN1300100000000,2022-05-01,13,001,GA,Appling County,9551,9249,302,3.2
CN1300300000000,2022-05-01,13,003,GA,Atkinson County,4500,4390,110,2.4
CN1300500000000,2022-05-01,13,005,GA,Bacon County,4957,4827,130,2.6
CN1300700000000,2022-05-01,13,007,GA,Baker County,1167,1126,41,3.5
CN1300900000000,2022-05-01,13,009,GA,Baldwin County,17708,17053,655,3.7
CN1301100000000,2022-05-01,13,011,GA,Banks County,11025,10795,230,2.1
CN1301300000000,2022-05-01,13,013,GA,Barrow County,42993,41980,1013,2.4
CN1301500000000,2022-05-01,13,015,GA,Bartow County,52231,50821,1410,2.7
CN1301700000000,2022-05-01,13,017,GA,Ben Hill County,5646,5430,216,3.8
CN1301900000000,2022-05-01,13,019,GA,Berrien County,7929,7695,234,3
CN1302100000000,2022-05-01,13,021,GA,Bibb County,65332,63068,2264,3.5
CN1302300000000,2022-05-01,13,023,GA,Bleckley County,4627,4444,183,4
CN1302500000000,2022-05-01,13,025,GA,Brantley County,7481,7240,241,3.2
CN1302700000000,2022-05-01,13,027,GA,Brooks County,6861,6665,196,2.9
CN1302900000000,2022-05-01,13,029,GA,Bryan County,20177,19683,494,2.4
CN1303100000000,2022-05-01,13,031,GA,Bulloch County,38360,37114,1246,3.2
CN1303300000000,2022-05-01,13,033,GA,Burke County,9096,8647,449,4.9
CN1303500000000,2022-05-01,13,035,GA,Butts County,11324,11025,299,2.6
CN1303700000000,2022-05-01,13,037,GA,Calhoun County,2263,2201,62,2.7
CN1303900000000,2022-05-01,13,039,GA,Camden County,21946,21311,635,2.9
CN1304300000000,2022-05-01,13,043,GA,Candler County,6206,6067,139,2.2
CN1304500000000,2022-05-01,13,045,GA,Carroll County,57234,55555,1679,2.9
CN1304700000000,2022-05-01,13,047,GA,Catoosa County,33105,32266,839,2.5
CN1304900000000,2022-05-01,13,049,GA,Charlton County,5121,4971,150,2.9
CN1305100000000,2022-05-01,13,051,GA,Chatham County,144232,140103,4129,2.9
CN1305300000000,2022-05-01,13,053,GA,Chattahoochee County,1909,1826,83,4.3
CN1305500000000,2022-05-01,13,055,GA,Chattooga County,9232,8900,332,3.6
CN1305700000000,2022-05-01,13,057,GA,Cherokee County,142489,139281,3208,2.3
CN1305900000000,2022-05-01,13,059,GA,Clarke County,57741,55931,1810,3.1
CN1306100000000,2022-05-01,13,061,GA,Clay County,874,825,49,5.6
CN1306300000000,2022-05-01,13,063,GA,Clayton County,139585,134596,4989,3.6
CN1306500000000,2022-05-01,13,065,GA,Clinch County,3184,3102,82,2.6
CN1306700000000,2022-05-01,13,067,GA,Cobb County,430388,419913,10475,2.4
CN1306900000000,2022-05-01,13,069,GA,Coffee County,18761,18155,606,3.2
CN1307100000000,2022-05-01,13,071,GA,Colquitt County,22451,21855,596,2.7
CN1307300000000,2022-05-01,13,073,GA,Columbia County,76061,74034,2027,2.7
CN1307500000000,2022-05-01,13,075,GA,Cook County,8315,8066,249,3
CN1307700000000,2022-05-01,13,077,GA,Coweta County,77593,75627,1966,2.5
CN1307900000000,2022-05-01,13,079,GA,Crawford County,5402,5245,157,2.9
CN1308100000000,2022-05-01,13,081,GA,Crisp County,9718,9345,373,3.8
CN1308300000000,2022-05-01,13,083,GA,Dade County,8001,7800,201,2.5
CN1308500000000,2022-05-01,13,085,GA,Dawson County,13445,13122,323,2.4
CN1308700000000,2022-05-01,13,087,GA,Decatur County,12053,11699,354,2.9
CN1308900000000,2022-05-01,13,089,GA,DeKalb County,403757,391980,11777,2.9
CN1309100000000,2022-05-01,13,091,GA,Dodge County,6941,6675,266,3.8
CN1309300000000,2022-05-01,13,093,GA,Dooly County,4764,4588,176,3.7
CN1309500000000,2022-05-01,13,095,GA,Dougherty County,36277,34865,1412,3.9
CN1309700000000,2022-05-01,13,097,GA,Douglas County,74851,72598,2253,3
CN1309900000000,2022-05-01,13,099,GA,Early County,4468,4322,146,3.3
CN1310100000000,2022-05-01,13,101,GA,Echols County,1946,1898,48,2.5
CN1310300000000,2022-05-01,13,103,GA,Effingham County,33706,32889,817,2.4
CN1310500000000,2022-05-01,13,105,GA,Elbert County,7883,7617,266,3.4
CN1310700000000,2022-05-01,13,107,GA,Emanuel County,8716,8403,313,3.6
CN1310900000000,2022-05-01,13,109,GA,Evans County,5089,4945,144,2.8
CN1311100000000,2022-05-01,13,111,GA,Fannin County,11987,11681,306,2.6
CN1311300000000,2022-05-01,13,113,GA,Fayette County,59449,57952,1497,2.5
CN1311500000000,2022-05-01,13,115,GA,Floyd County,43102,41788,1314,3
CN1311700000000,2022-05-01,13,117,GA,Forsyth County,130088,127168,2920,2.2
CN1311900000000,2022-05-01,13,119,GA,Franklin County,10082,9778,304,3
CN1312100000000,2022-05-01,13,121,GA,Fulton County,573708,556882,16826,2.9
CN1312300000000,2022-05-01,13,123,GA,Gilmer County,12528,12157,371,3
CN1312500000000,2022-05-01,13,125,GA,Glascock County,1278,1243,35,2.7
CN1312700000000,2022-05-01,13,127,GA,Glynn County,39711,38530,1181,3
CN1312900000000,2022-05-01,13,129,GA,Gordon County,28865,28026,839,2.9
CN1313100000000,2022-05-01,13,131,GA,Grady County,11150,10838,312,2.8
CN1313300000000,2022-05-01,13,133,GA,Greene County,7392,7171,221,3
CN1313500000000,2022-05-01,13,135,GA,Gwinnett County,500021,487284,12737,2.5
CN1313700000000,2022-05-01,13,137,GA,Habersham County,18798,18253,545,2.9
CN1313900000000,2022-05-01,13,139,GA,Hall County,107415,104972,2443,2.3
CN1314100000000,2022-05-01,13,141,GA,Hancock County,2554,2443,111,4.3
CN1314300000000,2022-05-01,13,143,GA,Haralson County,13002,12625,377,2.9
CN1314500000000,2022-05-01,13,145,GA,Harris County,16759,16325,434,2.6
CN1314700000000,2022-05-01,13,147,GA,Hart County,12222,11888,334,2.7
CN1314900000000,2022-05-01,13,149,GA,Heard County,5329,5183,146,2.7
CN1315100000000,2022-05-01,13,151,GA,Henry County,120253,116692,3561,3
CN1315300000000,2022-05-01,13,153,GA,Houston County,70764,68708,2056,2.9
CN1315500000000,2022-05-01,13,155,GA,Irwin County,3633,3506,127,3.5
CN1315700000000,2022-05-01,13,157,GA,Jackson County,46031,45113,918,2
CN1315900000000,2022-05-01,13,159,GA,Jasper County,7221,7044,177,2.5
CN1316100000000,2022-05-01,13,161,GA,Jeff Davis County,6241,6042,199,3.2
CN1316300000000,2022-05-01,13,163,GA,Jefferson County,6652,6397,255,3.8
CN1316500000000,2022-05-01,13,165,GA,Jenkins County,3336,3206,130,3.9
CN1316700000000,2022-05-01,13,167,GA,Johnson County,4032,3926,106,2.6
CN1316900000000,2022-05-01,13,169,GA,Jones County,13369,12994,375,2.8
CN1317100000000,2022-05-01,13,171,GA,Lamar County,8370,8110,260,3.1
CN1317300000000,2022-05-01,13,173,GA,Lanier County,3798,3675,123,3.2
CN1317500000000,2022-05-01,13,175,GA,Laurens County,19150,18484,666,3.5
CN1317700000000,2022-05-01,13,177,GA,Lee County,15025,14617,408,2.7
CN1317900000000,2022-05-01,13,179,GA,Liberty County,25840,25029,811,3.1
CN1318100000000,2022-05-01,13,181,GA,Lincoln County,3555,3444,111,3.1
CN1318300000000,2022-05-01,13,183,GA,Long County,8465,8208,257,3
CN1318500000000,2022-05-01,13,185,GA,Lowndes County,50543,48988,1555,3.1
CN1318700000000,2022-05-01,13,187,GA,Lumpkin County,18717,18282,435,2.3
CN1318900000000,2022-05-01,13,189,GA,McDuffie County,8405,8070,335,4
CN1319100000000,2022-05-01,13,191,GA,McIntosh County,6288,6092,196,3.1
CN1319300000000,2022-05-01,13,193,GA,Macon County,4632,4459,173,3.7
CN1319500000000,2022-05-01,13,195,GA,Madison County,13350,12983,367,2.7
CN1319700000000,2022-05-01,13,197,GA,Marion County,3238,3134,104,3.2
CN1319900000000,2022-05-01,13,199,GA,Meriwether County,8990,8683,307,3.4
CN1320100000000,2022-05-01,13,201,GA,Miller County,2942,2868,74,2.5
CN1320500000000,2022-05-01,13,205,GA,Mitchell County,8335,8038,297,3.6
CN1320700000000,2022-05-01,13,207,GA,Monroe County,12845,12502,343,2.7
CN1320900000000,2022-05-01,13,209,GA,Montgomery County,3865,3728,137,3.5
CN1321100000000,2022-05-01,13,211,GA,Morgan County,9766,9519,247,2.5
CN1321300000000,2022-05-01,13,213,GA,Murray County,15362,14787,575,3.7
CN1321500000000,2022-05-01,13,215,GA,Muscogee County,74765,71942,2823,3.8
CN1321700000000,2022-05-01,13,217,GA,Newton County,54120,52451,1669,3.1
CN1321900000000,2022-05-01,13,219,GA,Oconee County,19994,19538,456,2.3
CN1322100000000,2022-05-01,13,221,GA,Oglethorpe County,6955,6773,182,2.6
CN1322300000000,2022-05-01,13,223,GA,Paulding County,91245,88986,2259,2.5
CN1322500000000,2022-05-01,13,225,GA,Peach County,11946,11528,418,3.5
CN1322700000000,2022-05-01,13,227,GA,Pickens County,15893,15494,399,2.5
CN1322900000000,2022-05-01,13,229,GA,Pierce County,8996,8758,238,2.6
CN1323100000000,2022-05-01,13,231,GA,Pike County,9204,8975,229,2.5
CN1323300000000,2022-05-01,13,233,GA,Polk County,18509,17985,524,2.8
CN1323500000000,2022-05-01,13,235,GA,Pulaski County,4054,3922,132,3.3
CN1323700000000,2022-05-01,13,237,GA,Putnam County,8855,8559,296,3.3
CN1323900000000,2022-05-01,13,239,GA,Quitman County,741,709,32,4.3
CN1324100000000,2022-05-01,13,241,GA,Rabun County,7832,7619,213,2.7
CN1324300000000,2022-05-01,13,243,GA,Randolph County,2403,2303,100,4.2
CN1324500000000,2022-05-01,13,245,GA,Richmond County,82573,79404,3169,3.8
CN1324700000000,2022-05-01,13,247,GA,Rockdale County,45062,43636,1426,3.2
CN1324900000000,2022-05-01,13,249,GA,Schley County,2166,2089,77,3.6
CN1325100000000,2022-05-01,13,251,GA,Screven County,5066,4873,193,3.8
CN1325300000000,2022-05-01,13,253,GA,Seminole County,3170,3071,99,3.1
CN1325500000000,2022-05-01,13,255,GA,Spalding County,29270,28376,894,3.1
CN1325700000000,2022-05-01,13,257,GA,Stephens County,10765,10429,336,3.1
CN1325900000000,2022-05-01,13,259,GA,Stewart County,2575,2493,82,3.2
CN1326100000000,2022-05-01,13,261,GA,Sumter County,12308,11846,462,3.8
CN1326300000000,2022-05-01,13,263,GA,Talbot County,2803,2714,89,3.2
CN1326500000000,2022-05-01,13,265,GA,Taliaferro County,545,525,20,3.7
CN1326700000000,2022-05-01,13,267,GA,Tattnall County,9652,9378,274,2.8
CN1326900000000,2022-05-01,13,269,GA,Taylor County,2624,2512,112,4.3
CN1327100000000,2022-05-01,13,271,GA,Telfair County,3728,3544,184,4.9
CN1327300000000,2022-05-01,13,273,GA,Terrell County,3478,3338,140,4
CN1327500000000,2022-05-01,13,275,GA,Thomas County,17145,16564,581,3.4
CN1327700000000,2022-05-01,13,277,GA,Tift County,21321,20780,541,2.5
CN1327900000000,2022-05-01,13,279,GA,Toombs County,12121,11714,407,3.4
CN1328100000000,2022-05-01,13,281,GA,Towns County,3922,3760,162,4.1
CN1328300000000,2022-05-01,13,283,GA,Treutlen County,2624,2531,93,3.5
CN1328500000000,2022-05-01,13,285,GA,Troup County,36722,35730,992,2.7
CN1328700000000,2022-05-01,13,287,GA,Turner County,3207,3092,115,3.6
CN1328900000000,2022-05-01,13,289,GA,Twiggs County,2722,2609,113,4.2
CN1329100000000,2022-05-01,13,291,GA,Union County,11649,11359,290,2.5
CN1329300000000,2022-05-01,13,293,GA,Upson County,11775,11441,334,2.8
CN1329500000000,2022-05-01,13,295,GA,Walker County,30972,30117,855,2.8
CN1329700000000,2022-05-01,13,297,GA,Walton County,47942,46669,1273,2.7
CN1329900000000,2022-05-01,13,299,GA,Ware County,15973,15543,430,2.7
CN1330100000000,2022-05-01,13,301,GA,Warren County,2685,2594,91,3.4
CN1330300000000,2022-05-01,13,303,GA,Washington County,6975,6718,257,3.7
CN1330500000000,2022-05-01,13,305,GA,Wayne County,12007,11651,356,3
CN1330700000000,2022-05-01,13,307,GA,Webster County,1006,969,37,3.7
CN1330900000000,2022-05-01,13,309,GA,Wheeler County,1692,1613,79,4.7
CN1331100000000,2022-05-01,13,311,GA,White County,17065,16683,382,2.2
CN1331300000000,2022-05-01,13,313,GA,Whitfield County,43198,41473,1725,4
CN1331500000000,2022-05-01,13,315,GA,Wilcox County,2746,2651,95,3.5
CN1331700000000,2022-05-01,13,317,GA,Wilkes County,3764,3624,140,3.7
CN1331900000000,2022-05-01,13,319,GA,Wilkinson County,3876,3753,123,3.2
CN1332100000000,2022-05-01,13,321,GA,Worth County,8805,8556,249,2.8
CN1500100000000,2022-05-01,15,001,HI,Hawaii County,93792,90676,3116,3.3
CN1500300000000,2022-05-01,15,003,HI,Honolulu County/city,456871,442258,14613,3.2
CN1500700000000,2022-05-01,15,007,HI,Kauai County,36407,35186,1221,3.4
CN1500900000000,2022-05-01,15,009,HI,Maui County,86724,83942,2782,3.2
CN1600100000000,2022-05-01,16,001,ID,Ada County,277898,272253,5645,2
CN1600300000000,2022-05-01,16,003,ID,Adams County,1795,1697,98,5.5
CN1600500000000,2022-05-01,16,005,ID,Bannock County,44592,43528,1064,2.4
CN1600700000000,2022-05-01,16,007,ID,Bear Lake County,3318,3236,82,2.5
CN1600900000000,2022-05-01,16,009,ID,Benewah County,4138,3969,169,4.1
CN1601100000000,2022-05-01,16,011,ID,Bingham County,25092,24547,545,2.2
CN1601300000000,2022-05-01,16,013,ID,Blaine County,12939,12635,304,2.3
CN1601500000000,2022-05-01,16,015,ID,Boise County,3858,3725,133,3.4
CN1601700000000,2022-05-01,16,017,ID,Bonner County,22046,21340,706,3.2
CN1601900000000,2022-05-01,16,019,ID,Bonneville County,63638,62344,1294,2
CN1602100000000,2022-05-01,16,021,ID,Boundary County,5942,5740,202,3.4
CN1602300000000,2022-05-01,16,023,ID,Butte County,1525,1486,39,2.6
CN1602500000000,2022-05-01,16,025,ID,Camas County,715,700,15,2.1
CN1602700000000,2022-05-01,16,027,ID,Canyon County,114110,111248,2862,2.5
CN1602900000000,2022-05-01,16,029,ID,Caribou County,4240,4137,103,2.4
CN1603100000000,2022-05-01,16,031,ID,Cassia County,12930,12639,291,2.3
CN1603300000000,2022-05-01,16,033,ID,Clark County,408,396,12,2.9
CN1603500000000,2022-05-01,16,035,ID,Clearwater County,3055,2915,140,4.6
CN1603700000000,2022-05-01,16,037,ID,Custer County,2281,2214,67,2.9
CN1603900000000,2022-05-01,16,039,ID,Elmore County,12252,11930,322,2.6
CN1604100000000,2022-05-01,16,041,ID,Franklin County,7761,7618,143,1.8
CN1604300000000,2022-05-01,16,043,ID,Fremont County,8621,8442,179,2.1
CN1604500000000,2022-05-01,16,045,ID,Gem County,9047,8796,251,2.8
CN1604700000000,2022-05-01,16,047,ID,Gooding County,8553,8373,180,2.1
CN1604900000000,2022-05-01,16,049,ID,Idaho County,6997,6729,268,3.8
CN1605100000000,2022-05-01,16,051,ID,Jefferson County,15469,15186,283,1.8
CN1605300000000,2022-05-01,16,053,ID,Jerome County,12628,12347,281,2.2
CN1605500000000,2022-05-01,16,055,ID,Kootenai County,85446,83148,2298,2.7
CN1605700000000,2022-05-01,16,057,ID,Latah County,20638,20164,474,2.3
CN1605900000000,2022-05-01,16,059,ID,Lemhi County,3830,3700,130,3.4
CN1606100000000,2022-05-01,16,061,ID,Lewis County,1706,1646,60,3.5
CN1606300000000,2022-05-01,16,063,ID,Lincoln County,2699,2621,78,2.9
CN1606500000000,2022-05-01,16,065,ID,Madison County,24440,24060,380,1.6
CN1606700000000,2022-05-01,16,067,ID,Minidoka County,12176,11910,266,2.2
CN1606900000000,2022-05-01,16,069,ID,Nez Perce County,21819,21342,477,2.2
CN1607100000000,2022-05-01,16,071,ID,Oneida County,2733,2687,46,1.7
CN1607300000000,2022-05-01,16,073,ID,Owyhee County,5638,5469,169,3
CN1607500000000,2022-05-01,16,075,ID,Payette County,12387,12053,334,2.7
CN1607700000000,2022-05-01,16,077,ID,Power County,4350,4236,114,2.6
CN1607900000000,2022-05-01,16,079,ID,Shoshone County,5423,5187,236,4.4
CN1608100000000,2022-05-01,16,081,ID,Teton County,7565,7360,205,2.7
CN1608300000000,2022-05-01,16,083,ID,Twin Falls County,43383,42378,1005,2.3
CN1608500000000,2022-05-01,16,085,ID,Valley County,5715,5497,218,3.8
CN1608700000000,2022-05-01,16,087,ID,Washington County,4975,4838,137,2.8
CN1700100000000,2022-05-01,17,001,IL,Adams County,30784,29800,984,3.2
CN1700300000000,2022-05-01,17,003,IL,Alexander County,1814,1705,109,6
CN1700500000000,2022-05-01,17,005,IL,Bond County,7458,7198,260,3.5
CN1700700000000,2022-05-01,17,007,IL,Boone County,24816,23184,1632,6.6
CN1700900000000,2022-05-01,17,009,IL,Brown County,3043,2970,73,2.4
CN1701100000000,2022-05-01,17,011,IL,Bureau County,16256,15576,680,4.2
CN1701300000000,2022-05-01,17,013,IL,Calhoun County,2174,2092,82,3.8
CN1701500000000,2022-05-01,17,015,IL,Carroll County,7385,7139,246,3.3
CN1701700000000,2022-05-01,17,017,IL,Cass County,5658,5430,228,4
CN1701900000000,2022-05-01,17,019,IL,Champaign County,110330,106280,4050,3.7
CN1702100000000,2022-05-01,17,021,IL,Christian County,13253,12584,669,5
CN1702300000000,2022-05-01,17,023,IL,Clark County,7379,7099,280,3.8
CN1702500000000,2022-05-01,17,025,IL,Clay County,5708,5471,237,4.2
CN1702700000000,2022-05-01,17,027,IL,Clinton County,19941,19377,564,2.8
CN1702900000000,2022-05-01,17,029,IL,Coles County,21953,21031,922,4.2
CN1703100000000,2022-05-01,17,031,IL,Cook County,2685045,2555555,129490,4.8
CN1703300000000,2022-05-01,17,033,IL,Crawford County,8274,7947,327,4
CN1703500000000,2022-05-01,17,035,IL,Cumberland County,5821,5644,177,3
CN1703700000000,2022-05-01,17,037,IL,DeKalb County,53677,51489,2188,4.1
CN1703900000000,2022-05-01,17,039,IL,De Witt County,7250,6980,270,3.7
CN1704100000000,2022-05-01,17,041,IL,Douglas County,10162,9838,324,3.2
CN1704300000000,2022-05-01,17,043,IL,DuPage County,523914,505636,18278,3.5
CN1704500000000,2022-05-01,17,045,IL,Edgar County,9133,8828,305,3.3
CN1704700000000,2022-05-01,17,047,IL,Edwards County,2381,2274,107,4.5
CN1704900000000,2022-05-01,17,049,IL,Effingham County,19727,19194,533,2.7
CN1705100000000,2022-05-01,17,051,IL,Fayette County,9671,9284,387,4
CN1705300000000,2022-05-01,17,053,IL,Ford County,6307,6070,237,3.8
CN1705500000000,2022-05-01,17,055,IL,Franklin County,15761,14983,778,4.9
CN1705700000000,2022-05-01,17,057,IL,Fulton County,14626,14007,619,4.2
CN1705900000000,2022-05-01,17,059,IL,Gallatin County,1970,1873,97,4.9
CN1706100000000,2022-05-01,17,061,IL,Greene County,5867,5640,227,3.9
CN1706300000000,2022-05-01,17,063,IL,Grundy County,26411,25213,1198,4.5
CN1706500000000,2022-05-01,17,065,IL,Hamilton County,4251,4108,143,3.4
CN1706700000000,2022-05-01,17,067,IL,Hancock County,8000,7717,283,3.5
CN1706900000000,2022-05-01,17,069,IL,Hardin County,1444,1375,69,4.8
CN1707100000000,2022-05-01,17,071,IL,Henderson County,3514,3395,119,3.4
CN1707300000000,2022-05-01,17,073,IL,Henry County,23543,22572,971,4.1
CN1707500000000,2022-05-01,17,075,IL,Iroquois County,12537,12028,509,4.1
CN1707700000000,2022-05-01,17,077,IL,Jackson County,26656,25518,1138,4.3
CN1707900000000,2022-05-01,17,079,IL,Jasper County,4815,4649,166,3.4
CN1708100000000,2022-05-01,17,081,IL,Jefferson County,16285,15559,726,4.5
CN1708300000000,2022-05-01,17,083,IL,Jersey County,10605,10249,356,3.4
CN1708500000000,2022-05-01,17,085,IL,Jo Daviess County,10534,10202,332,3.2
CN1708700000000,2022-05-01,17,087,IL,Johnson County,4082,3868,214,5.2
CN1708900000000,2022-05-01,17,089,IL,Kane County,262860,252030,10830,4.1
CN1709100000000,2022-05-01,17,091,IL,Kankakee County,51854,49310,2544,4.9
CN1709300000000,2022-05-01,17,093,IL,Kendall County,72981,70315,2666,3.7
CN1709500000000,2022-05-01,17,095,IL,Knox County,19991,19011,980,4.9
CN1709700000000,2022-05-01,17,097,IL,Lake County,360856,347309,13547,3.8
CN1709900000000,2022-05-01,17,099,IL,LaSalle County,51743,49417,2326,4.5
CN1710100000000,2022-05-01,17,101,IL,Lawrence County,5103,4822,281,5.5
CN1710300000000,2022-05-01,17,103,IL,Lee County,16643,16014,629,3.8
CN1710500000000,2022-05-01,17,105,IL,Livingston County,15444,14865,579,3.7
CN1710700000000,2022-05-01,17,107,IL,Logan County,11639,11194,445,3.8
CN1710900000000,2022-05-01,17,109,IL,McDonough County,13030,12517,513,3.9
CN1711100000000,2022-05-01,17,111,IL,McHenry County,170997,164635,6362,3.7
CN1711300000000,2022-05-01,17,113,IL,McLean County,87980,84879,3101,3.5
CN1711500000000,2022-05-01,17,115,IL,Macon County,45140,42691,2449,5.4
CN1711700000000,2022-05-01,17,117,IL,Macoupin County,22126,21329,797,3.6
CN1711900000000,2022-05-01,17,119,IL,Madison County,131455,126676,4779,3.6
CN1712100000000,2022-05-01,17,121,IL,Marion County,16548,15796,752,4.5
CN1712300000000,2022-05-01,17,123,IL,Marshall County,5067,4843,224,4.4
CN1712500000000,2022-05-01,17,125,IL,Mason County,5874,5634,240,4.1
CN1712700000000,2022-05-01,17,127,IL,Massac County,5368,5121,247,4.6
CN1712900000000,2022-05-01,17,129,IL,Menard County,6166,5958,208,3.4
CN1713100000000,2022-05-01,17,131,IL,Mercer County,7464,7203,261,3.5
CN1713300000000,2022-05-01,17,133,IL,Monroe County,18729,18208,521,2.8
CN1713500000000,2022-05-01,17,135,IL,Montgomery County,11179,10697,482,4.3
CN1713700000000,2022-05-01,17,137,IL,Morgan County,15566,14963,603,3.9
CN1713900000000,2022-05-01,17,139,IL,Moultrie County,7417,7184,233,3.1
CN1714100000000,2022-05-01,17,141,IL,Ogle County,23830,22739,1091,4.6
CN1714300000000,2022-05-01,17,143,IL,Peoria County,81655,77662,3993,4.9
CN1714500000000,2022-05-01,17,145,IL,Perry County,7807,7424,383,4.9
CN1714700000000,2022-05-01,17,147,IL,Piatt County,8646,8370,276,3.2
CN1714900000000,2022-05-01,17,149,IL,Pike County,6796,6536,260,3.8
CN1715100000000,2022-05-01,17,151,IL,Pope County,1766,1692,74,4.2
CN1715300000000,2022-05-01,17,153,IL,Pulaski County,1646,1540,106,6.4
CN1715500000000,2022-05-01,17,155,IL,Putnam County,2951,2820,131,4.4
CN1715700000000,2022-05-01,17,157,IL,Randolph County,13421,12948,473,3.5
CN1715900000000,2022-05-01,17,159,IL,Richland County,7153,6893,260,3.6
CN1716100000000,2022-05-01,17,161,IL,Rock Island County,66892,64227,2665,4
CN1716300000000,2022-05-01,17,163,IL,St. Clair County,123499,118321,5178,4.2
CN1716500000000,2022-05-01,17,165,IL,Saline County,9256,8802,454,4.9
CN1716700000000,2022-05-01,17,167,IL,Sangamon County,97356,93548,3808,3.9
CN1716900000000,2022-05-01,17,169,IL,Schuyler County,3155,3043,112,3.5
CN1717100000000,2022-05-01,17,171,IL,Scott County,2257,2169,88,3.9
CN1717300000000,2022-05-01,17,173,IL,Shelby County,10026,9617,409,4.1
CN1717500000000,2022-05-01,17,175,IL,Stark County,2344,2249,95,4.1
CN1717700000000,2022-05-01,17,177,IL,Stephenson County,20642,19767,875,4.2
CN1717900000000,2022-05-01,17,179,IL,Tazewell County,61326,58965,2361,3.8
CN1718100000000,2022-05-01,17,181,IL,Union County,7027,6699,328,4.7
CN1718300000000,2022-05-01,17,183,IL,Vermilion County,31812,30305,1507,4.7
CN1718500000000,2022-05-01,17,185,IL,Wabash County,5709,5515,194,3.4
CN1718700000000,2022-05-01,17,187,IL,Warren County,7710,7406,304,3.9
CN1718900000000,2022-05-01,17,189,IL,Washington County,9710,9473,237,2.4
CN1719100000000,2022-05-01,17,191,IL,Wayne County,6880,6625,255,3.7
CN1719300000000,2022-05-01,17,193,IL,White County,6042,5814,228,3.8
CN1719500000000,2022-05-01,17,195,IL,Whiteside County,27187,26148,1039,3.8
CN1719700000000,2022-05-01,17,197,IL,Will County,370628,354758,15870,4.3
CN1719900000000,2022-05-01,17,199,IL,Williamson County,30448,29184,1264,4.2
CN1720100000000,2022-05-01,17,201,IL,Winnebago County,132090,123997,8093,6.1
CN1720300000000,2022-05-01,17,203,IL,Woodford County,18048,17471,577,3.2
CN1800100000000,2022-05-01,18,001,IN,Adams County,17243,16877,366,2.1
CN1800300000000,2022-05-01,18,003,IN,Allen County,189382,184285,5097,2.7
CN1800500000000,2022-05-01,18,005,IN,Bartholomew County,44345,43361,984,2.2
CN1800700000000,2022-05-01,18,007,IN,Benton County,4470,4369,101,2.3
CN1800900000000,2022-05-01,18,009,IN,Blackford County,4824,4663,161,3.3
CN1801100000000,2022-05-01,18,011,IN,Boone County,38158,37413,745,2
CN1801300000000,2022-05-01,18,013,IN,Brown County,7805,7559,246,3.2
CN1801500000000,2022-05-01,18,015,IN,Carroll County,10023,9760,263,2.6
CN1801700000000,2022-05-01,18,017,IN,Cass County,17457,16968,489,2.8
CN1801900000000,2022-05-01,18,019,IN,Clark County,62886,61277,1609,2.6
CN1802100000000,2022-05-01,18,021,IN,Clay County,11784,11408,376,3.2
CN1802300000000,2022-05-01,18,023,IN,Clinton County,17312,16896,416,2.4
CN1802500000000,2022-05-01,18,025,IN,Crawford County,4816,4666,150,3.1
CN1802700000000,2022-05-01,18,027,IN,Daviess County,16694,16319,375,2.2
CN1802900000000,2022-05-01,18,029,IN,Dearborn County,25985,25362,623,2.4
CN1803100000000,2022-05-01,18,031,IN,Decatur County,14602,14247,355,2.4
CN1803300000000,2022-05-01,18,033,IN,DeKalb County,22591,22040,551,2.4
CN1803500000000,2022-05-01,18,035,IN,Delaware County,51531,49776,1755,3.4
CN1803700000000,2022-05-01,18,037,IN,Dubois County,22229,21757,472,2.1
CN1803900000000,2022-05-01,18,039,IN,Elkhart County,120404,117853,2551,2.1
CN1804100000000,2022-05-01,18,041,IN,Fayette County,8430,8067,363,4.3
CN1804300000000,2022-05-01,18,043,IN,Floyd County,42415,41396,1019,2.4
CN1804500000000,2022-05-01,18,045,IN,Fountain County,8052,7846,206,2.6
CN1804700000000,2022-05-01,18,047,IN,Franklin County,11426,11140,286,2.5
CN1804900000000,2022-05-01,18,049,IN,Fulton County,9701,9436,265,2.7
CN1805100000000,2022-05-01,18,051,IN,Gibson County,19925,19497,428,2.1
CN1805300000000,2022-05-01,18,053,IN,Grant County,32347,31376,971,3
CN1805500000000,2022-05-01,18,055,IN,Greene County,13635,13143,492,3.6
CN1805700000000,2022-05-01,18,057,IN,Hamilton County,195293,191277,4016,2.1
CN1805900000000,2022-05-01,18,059,IN,Hancock County,42772,41701,1071,2.5
CN1806100000000,2022-05-01,18,061,IN,Harrison County,20504,20028,476,2.3
CN1806300000000,2022-05-01,18,063,IN,Hendricks County,95259,93044,2215,2.3
CN1806500000000,2022-05-01,18,065,IN,Henry County,22241,21614,627,2.8
CN1806700000000,2022-05-01,18,067,IN,Howard County,33704,32314,1390,4.1
CN1806900000000,2022-05-01,18,069,IN,Huntington County,18709,18283,426,2.3
CN1807100000000,2022-05-01,18,071,IN,Jackson County,23667,23040,627,2.6
CN1807300000000,2022-05-01,18,073,IN,Jasper County,16046,15563,483,3
CN1807500000000,2022-05-01,18,075,IN,Jay County,8887,8655,232,2.6
CN1807700000000,2022-05-01,18,077,IN,Jefferson County,15190,14799,391,2.6
CN1807900000000,2022-05-01,18,079,IN,Jennings County,13725,13306,419,3.1
CN1808100000000,2022-05-01,18,081,IN,Johnson County,86962,84977,1985,2.3
CN1808300000000,2022-05-01,18,083,IN,Knox County,18077,17606,471,2.6
CN1808500000000,2022-05-01,18,085,IN,Kosciusko County,40784,39847,937,2.3
CN1808700000000,2022-05-01,18,087,IN,LaGrange County,21953,21547,406,1.8
CN1808900000000,2022-05-01,18,089,IN,Lake County,227957,218375,9582,4.2
CN1809100000000,2022-05-01,18,091,IN,LaPorte County,47269,45693,1576,3.3
CN1809300000000,2022-05-01,18,093,IN,Lawrence County,20953,20307,646,3.1
CN1809500000000,2022-05-01,18,095,IN,Madison County,60200,58328,1872,3.1
CN1809700000000,2022-05-01,18,097,IN,Marion County,507070,491824,15246,3
CN1809900000000,2022-05-01,18,099,IN,Marshall County,23074,22553,521,2.3
CN1810100000000,2022-05-01,18,101,IN,Martin County,5544,5402,142,2.6
CN1810300000000,2022-05-01,18,103,IN,Miami County,14430,13897,533,3.7
CN1810500000000,2022-05-01,18,105,IN,Monroe County,71810,69836,1974,2.7
CN1810700000000,2022-05-01,18,107,IN,Montgomery County,19012,18553,459,2.4
CN1810900000000,2022-05-01,18,109,IN,Morgan County,37308,36311,997,2.7
CN1811100000000,2022-05-01,18,111,IN,Newton County,6779,6556,223,3.3
CN1811300000000,2022-05-01,18,113,IN,Noble County,22318,21758,560,2.5
CN1811500000000,2022-05-01,18,115,IN,Ohio County,3209,3143,66,2.1
CN1811700000000,2022-05-01,18,117,IN,Orange County,8355,8091,264,3.2
CN1811900000000,2022-05-01,18,119,IN,Owen County,9441,9171,270,2.9
CN1812100000000,2022-05-01,18,121,IN,Parke County,7153,6946,207,2.9
CN1812300000000,2022-05-01,18,123,IN,Perry County,8715,8475,240,2.8
CN1812500000000,2022-05-01,18,125,IN,Pike County,5923,5749,174,2.9
CN1812700000000,2022-05-01,18,127,IN,Porter County,85960,83389,2571,3
CN1812900000000,2022-05-01,18,129,IN,Posey County,13101,12794,307,2.3
CN1813100000000,2022-05-01,18,131,IN,Pulaski County,6676,6518,158,2.4
CN1813300000000,2022-05-01,18,133,IN,Putnam County,16938,16428,510,3
CN1813500000000,2022-05-01,18,135,IN,Randolph County,11726,11410,316,2.7
CN1813700000000,2022-05-01,18,137,IN,Ripley County,12969,12605,364,2.8
CN1813900000000,2022-05-01,18,139,IN,Rush County,9032,8821,211,2.3
CN1814100000000,2022-05-01,18,141,IN,St. Joseph County,132658,128578,4080,3.1
CN1814300000000,2022-05-01,18,143,IN,Scott County,10612,10263,349,3.3
CN1814500000000,2022-05-01,18,145,IN,Shelby County,23704,23145,559,2.4
CN1814700000000,2022-05-01,18,147,IN,Spencer County,11015,10750,265,2.4
CN1814900000000,2022-05-01,18,149,IN,Starke County,9594,9284,310,3.2
CN1815100000000,2022-05-01,18,151,IN,Steuben County,20338,19930,408,2
CN1815300000000,2022-05-01,18,153,IN,Sullivan County,8104,7830,274,3.4
CN1815500000000,2022-05-01,18,155,IN,Switzerland County,4741,4612,129,2.7
CN1815700000000,2022-05-01,18,157,IN,Tippecanoe County,98138,95440,2698,2.7
CN1815900000000,2022-05-01,18,159,IN,Tipton County,9094,8876,218,2.4
CN1816100000000,2022-05-01,18,161,IN,Union County,3608,3526,82,2.3
CN1816300000000,2022-05-01,18,163,IN,Vanderburgh County,92880,90215,2665,2.9
CN1816500000000,2022-05-01,18,165,IN,Vermillion County,6641,6429,212,3.2
CN1816700000000,2022-05-01,18,167,IN,Vigo County,46327,44835,1492,3.2
CN1816900000000,2022-05-01,18,169,IN,Wabash County,14767,14393,374,2.5
CN1817100000000,2022-05-01,18,171,IN,Warren County,4154,4053,101,2.4
CN1817300000000,2022-05-01,18,173,IN,Warrick County,32454,31668,786,2.4
CN1817500000000,2022-05-01,18,175,IN,Washington County,13825,13494,331,2.4
CN1817700000000,2022-05-01,18,177,IN,Wayne County,29881,28985,896,3
CN1817900000000,2022-05-01,18,179,IN,Wells County,14382,14074,308,2.1
CN1818100000000,2022-05-01,18,181,IN,White County,13788,13480,308,2.2
CN1818300000000,2022-05-01,18,183,IN,Whitley County,17924,17516,408,2.3
CN1900100000000,2022-05-01,19,001,IA,Adair County,4297,4224,73,1.7
CN1900300000000,2022-05-01,19,003,IA,Adams County,2108,2078,30,1.4
CN1900500000000,2022-05-01,19,005,IA,Allamakee County,7139,6961,178,2.5
CN1900700000000,2022-05-01,19,007,IA,Appanoose County,6081,5938,143,2.4
CN1900900000000,2022-05-01,19,009,IA,Audubon County,3080,3024,56,1.8
CN1901100000000,2022-05-01,19,011,IA,Benton County,13098,12793,305,2.3
CN1901300000000,2022-05-01,19,013,IA,Black Hawk County,68017,66302,1715,2.5
CN1901500000000,2022-05-01,19,015,IA,Boone County,14935,14648,287,1.9
CN1901700000000,2022-05-01,19,017,IA,Bremer County,14036,13772,264,1.9
CN1901900000000,2022-05-01,19,019,IA,Buchanan County,11333,11078,255,2.3
CN1902100000000,2022-05-01,19,021,IA,Buena Vista County,11692,11431,261,2.2
CN1902300000000,2022-05-01,19,023,IA,Butler County,8138,7965,173,2.1
CN1902500000000,2022-05-01,19,025,IA,Calhoun County,4230,4139,91,2.2
CN1902700000000,2022-05-01,19,027,IA,Carroll County,10781,10597,184,1.7
CN1902900000000,2022-05-01,19,029,IA,Cass County,6855,6717,138,2
CN1903100000000,2022-05-01,19,031,IA,Cedar County,10571,10354,217,2.1
CN1903300000000,2022-05-01,19,033,IA,Cerro Gordo County,22418,21895,523,2.3
CN1903500000000,2022-05-01,19,035,IA,Cherokee County,6153,6032,121,2
CN1903700000000,2022-05-01,19,037,IA,Chickasaw County,6591,6454,137,2.1
CN1903900000000,2022-05-01,19,039,IA,Clarke County,4973,4850,123,2.5
CN1904100000000,2022-05-01,19,041,IA,Clay County,8533,8339,194,2.3
CN1904300000000,2022-05-01,19,043,IA,Clayton County,9622,9387,235,2.4
CN1904500000000,2022-05-01,19,045,IA,Clinton County,22149,21504,645,2.9
CN1904700000000,2022-05-01,19,047,IA,Crawford County,7862,7610,252,3.2
CN1904900000000,2022-05-01,19,049,IA,Dallas County,53869,52943,926,1.7
CN1905100000000,2022-05-01,19,051,IA,Davis County,4268,4192,76,1.8
CN1905300000000,2022-05-01,19,053,IA,Decatur County,4278,4178,100,2.3
CN1905500000000,2022-05-01,19,055,IA,Delaware County,10493,10302,191,1.8
CN1905700000000,2022-05-01,19,057,IA,Des Moines County,18300,17591,709,3.9
CN1905900000000,2022-05-01,19,059,IA,Dickinson County,10981,10728,253,2.3
CN1906100000000,2022-05-01,19,061,IA,Dubuque County,56081,54820,1261,2.2
CN1906300000000,2022-05-01,19,063,IA,Emmet County,5053,4901,152,3
CN1906500000000,2022-05-01,19,065,IA,Fayette County,10341,10085,256,2.5
CN1906700000000,2022-05-01,19,067,IA,Floyd County,8313,8128,185,2.2
CN1906900000000,2022-05-01,19,069,IA,Franklin County,5582,5468,114,2
CN1907100000000,2022-05-01,19,071,IA,Fremont County,3774,3704,70,1.9
CN1907300000000,2022-05-01,19,073,IA,Greene County,5356,5256,100,1.9
CN1907500000000,2022-05-01,19,075,IA,Grundy County,6410,6283,127,2
CN1907700000000,2022-05-01,19,077,IA,Guthrie County,5617,5491,126,2.2
CN1907900000000,2022-05-01,19,079,IA,Hamilton County,6917,6736,181,2.6
CN1908100000000,2022-05-01,19,081,IA,Hancock County,5714,5603,111,1.9
CN1908300000000,2022-05-01,19,083,IA,Hardin County,7901,7711,190,2.4
CN1908500000000,2022-05-01,19,085,IA,Harrison County,7126,6965,161,2.3
CN1908700000000,2022-05-01,19,087,IA,Henry County,9561,9288,273,2.9
CN1908900000000,2022-05-01,19,089,IA,Howard County,5250,5133,117,2.2
CN1909100000000,2022-05-01,19,091,IA,Humboldt County,4923,4824,99,2
CN1909300000000,2022-05-01,19,093,IA,Ida County,4007,3943,64,1.6
CN1909500000000,2022-05-01,19,095,IA,Iowa County,9669,9473,196,2
CN1909700000000,2022-05-01,19,097,IA,Jackson County,10706,10434,272,2.5
CN1909900000000,2022-05-01,19,099,IA,Jasper County,18675,18227,448,2.4
CN1910100000000,2022-05-01,19,101,IA,Jefferson County,10043,9817,226,2.3
CN1910300000000,2022-05-01,19,103,IA,Johnson County,85572,83854,1718,2
CN1910500000000,2022-05-01,19,105,IA,Jones County,10373,10120,253,2.4
CN1910700000000,2022-05-01,19,107,IA,Keokuk County,5168,5048,120,2.3
CN1910900000000,2022-05-01,19,109,IA,Kossuth County,8348,8183,165,2
CN1911100000000,2022-05-01,19,111,IA,Lee County,14990,14483,507,3.4
CN1911300000000,2022-05-01,19,113,IA,Linn County,120939,117822,3117,2.6
CN1911500000000,2022-05-01,19,115,IA,Louisa County,5910,5763,147,2.5
CN1911700000000,2022-05-01,19,117,IA,Lucas County,4712,4624,88,1.9
CN1911900000000,2022-05-01,19,119,IA,Lyon County,7111,7005,106,1.5
CN1912100000000,2022-05-01,19,121,IA,Madison County,8714,8505,209,2.4
CN1912300000000,2022-05-01,19,123,IA,Mahaska County,12185,11936,249,2
CN1912500000000,2022-05-01,19,125,IA,Marion County,19115,18774,341,1.8
CN1912700000000,2022-05-01,19,127,IA,Marshall County,17246,16543,703,4.1
CN1912900000000,2022-05-01,19,129,IA,Mills County,7106,6968,138,1.9
CN1913100000000,2022-05-01,19,131,IA,Mitchell County,5929,5830,99,1.7
CN1913300000000,2022-05-01,19,133,IA,Monona County,4454,4354,100,2.2
CN1913500000000,2022-05-01,19,135,IA,Monroe County,4040,3954,86,2.1
CN1913700000000,2022-05-01,19,137,IA,Montgomery County,5003,4901,102,2
CN1913900000000,2022-05-01,19,139,IA,Muscatine County,21356,20822,534,2.5
CN1914100000000,2022-05-01,19,141,IA,O'Brien County,8194,8056,138,1.7
CN1914300000000,2022-05-01,19,143,IA,Osceola County,3628,3573,55,1.5
CN1914500000000,2022-05-01,19,145,IA,Page County,6546,6406,140,2.1
CN1914700000000,2022-05-01,19,147,IA,Palo Alto County,4576,4471,105,2.3
CN1914900000000,2022-05-01,19,149,IA,Plymouth County,14795,14555,240,1.6
CN1915100000000,2022-05-01,19,151,IA,Pocahontas County,4255,4179,76,1.8
CN1915300000000,2022-05-01,19,153,IA,Polk County,275649,269230,6419,2.3
CN1915500000000,2022-05-01,19,155,IA,Pottawattamie County,47608,46543,1065,2.2
CN1915700000000,2022-05-01,19,157,IA,Poweshiek County,10535,10306,229,2.2
CN1915900000000,2022-05-01,19,159,IA,Ringgold County,2386,2336,50,2.1
CN1916100000000,2022-05-01,19,161,IA,Sac County,5329,5230,99,1.9
CN1916300000000,2022-05-01,19,163,IA,Scott County,88259,85878,2381,2.7
CN1916500000000,2022-05-01,19,165,IA,Shelby County,6497,6379,118,1.8
CN1916700000000,2022-05-01,19,167,IA,Sioux County,22704,22385,319,1.4
CN1916900000000,2022-05-01,19,169,IA,Story County,60169,59125,1044,1.7
CN1917100000000,2022-05-01,19,171,IA,Tama County,9129,8912,217,2.4
CN1917300000000,2022-05-01,19,173,IA,Taylor County,3143,3090,53,1.7
CN1917500000000,2022-05-01,19,175,IA,Union County,6101,5964,137,2.2
CN1917700000000,2022-05-01,19,177,IA,Van Buren County,3704,3610,94,2.5
CN1917900000000,2022-05-01,19,179,IA,Wapello County,16817,16374,443,2.6
CN1918100000000,2022-05-01,19,181,IA,Warren County,29233,28634,599,2
CN1918300000000,2022-05-01,19,183,IA,Washington County,11582,11344,238,2.1
CN1918500000000,2022-05-01,19,185,IA,Wayne County,2897,2836,61,2.1
CN1918700000000,2022-05-01,19,187,IA,Webster County,18820,18366,454,2.4
CN1918900000000,2022-05-01,19,189,IA,Winnebago County,4961,4837,124,2.5
CN1919100000000,2022-05-01,19,191,IA,Winneshiek County,11670,11398,272,2.3
CN1919300000000,2022-05-01,19,193,IA,Woodbury County,55984,54722,1262,2.3
CN1919500000000,2022-05-01,19,195,IA,Worth County,3998,3908,90,2.3
CN1919700000000,2022-05-01,19,197,IA,Wright County,6610,6460,150,2.3
CN2000100000000,2022-05-01,20,001,KS,Allen County,6310,6142,168,2.7
CN2000300000000,2022-05-01,20,003,KS,Anderson County,4361,4269,92,2.1
CN2000500000000,2022-05-01,20,005,KS,Atchison County,6798,6581,217,3.2
CN2000700000000,2022-05-01,20,007,KS,Barber County,2293,2249,44,1.9
CN2000900000000,2022-05-01,20,009,KS,Barton County,13142,12830,312,2.4
CN2001100000000,2022-05-01,20,011,KS,Bourbon County,6253,6057,196,3.1
CN2001300000000,2022-05-01,20,013,KS,Brown County,5065,4957,108,2.1
CN2001500000000,2022-05-01,20,015,KS,Butler County,32623,31805,818,2.5
CN2001700000000,2022-05-01,20,017,KS,Chase County,1386,1357,29,2.1
CN2001900000000,2022-05-01,20,019,KS,Chautauqua County,1422,1385,37,2.6
CN2002100000000,2022-05-01,20,021,KS,Cherokee County,9949,9721,228,2.3
CN2002300000000,2022-05-01,20,023,KS,Cheyenne County,1246,1215,31,2.5
CN2002500000000,2022-05-01,20,025,KS,Clark County,1081,1061,20,1.9
CN2002700000000,2022-05-01,20,027,KS,Clay County,3679,3596,83,2.3
CN2002900000000,2022-05-01,20,029,KS,Cloud County,3797,3707,90,2.4
CN2003100000000,2022-05-01,20,031,KS,Coffey County,3757,3638,119,3.2
CN2003300000000,2022-05-01,20,033,KS,Comanche County,881,864,17,1.9
CN2003500000000,2022-05-01,20,035,KS,Cowley County,16477,16045,432,2.6
CN2003700000000,2022-05-01,20,037,KS,Crawford County,19155,18661,494,2.6
CN2003900000000,2022-05-01,20,039,KS,Decatur County,1187,1159,28,2.4
CN2004100000000,2022-05-01,20,041,KS,Dickinson County,8592,8370,222,2.6
CN2004300000000,2022-05-01,20,043,KS,Doniphan County,4012,3920,92,2.3
CN2004500000000,2022-05-01,20,045,KS,Douglas County,66598,65050,1548,2.3
CN2004700000000,2022-05-01,20,047,KS,Edwards County,1350,1321,29,2.1
CN2004900000000,2022-05-01,20,049,KS,Elk County,1192,1164,28,2.3
CN2005100000000,2022-05-01,20,051,KS,Ellis County,17058,16760,298,1.7
CN2005300000000,2022-05-01,20,053,KS,Ellsworth County,2552,2497,55,2.2
CN2005500000000,2022-05-01,20,055,KS,Finney County,20506,20121,385,1.9
CN2005700000000,2022-05-01,20,057,KS,Ford County,17782,17429,353,2
CN2005900000000,2022-05-01,20,059,KS,Franklin County,14844,14502,342,2.3
CN2006100000000,2022-05-01,20,061,KS,Geary County,11399,11011,388,3.4
CN2006300000000,2022-05-01,20,063,KS,Gove County,1360,1334,26,1.9
CN2006500000000,2022-05-01,20,065,KS,Graham County,1183,1159,24,2
CN2006700000000,2022-05-01,20,067,KS,Grant County,2784,2714,70,2.5
CN2006900000000,2022-05-01,20,069,KS,Gray County,3093,3035,58,1.9
CN2007100000000,2022-05-01,20,071,KS,Greeley County,777,765,12,1.5
CN2007300000000,2022-05-01,20,073,KS,Greenwood County,3044,2975,69,2.3
CN2007500000000,2022-05-01,20,075,KS,Hamilton County,1613,1589,24,1.5
CN2007700000000,2022-05-01,20,077,KS,Harper County,2795,2742,53,1.9
CN2007900000000,2022-05-01,20,079,KS,Harvey County,17096,16657,439,2.6
CN2008100000000,2022-05-01,20,081,KS,Haskell County,2125,2087,38,1.8
CN2008300000000,2022-05-01,20,083,KS,Hodgeman County,986,966,20,2
CN2008500000000,2022-05-01,20,085,KS,Jackson County,7271,7117,154,2.1
CN2008700000000,2022-05-01,20,087,KS,Jefferson County,10360,10112,248,2.4
CN2008900000000,2022-05-01,20,089,KS,Jewell County,1212,1184,28,2.3
CN2009100000000,2022-05-01,20,091,KS,Johnson County,347886,340543,7343,2.1
CN2009300000000,2022-05-01,20,093,KS,Kearny County,2006,1969,37,1.8
CN2009500000000,2022-05-01,20,095,KS,Kingman County,3244,3169,75,2.3
CN2009700000000,2022-05-01,20,097,KS,Kiowa County,1209,1185,24,2
CN2009900000000,2022-05-01,20,099,KS,Labette County,9443,9188,255,2.7
CN2010100000000,2022-05-01,20,101,KS,Lane County,698,678,20,2.9
CN2010300000000,2022-05-01,20,103,KS,Leavenworth County,37186,36205,981,2.6
CN2010500000000,2022-05-01,20,105,KS,Lincoln County,1676,1635,41,2.4
CN2010700000000,2022-05-01,20,107,KS,Linn County,4349,4187,162,3.7
CN2010900000000,2022-05-01,20,109,KS,Logan County,1599,1573,26,1.6
CN2011100000000,2022-05-01,20,111,KS,Lyon County,17194,16810,384,2.2
CN2011300000000,2022-05-01,20,113,KS,McPherson County,17413,17091,322,1.8
CN2011500000000,2022-05-01,20,115,KS,Marion County,6056,5902,154,2.5
CN2011700000000,2022-05-01,20,117,KS,Marshall County,5319,5229,90,1.7
CN2011900000000,2022-05-01,20,119,KS,Meade County,2073,2036,37,1.8
CN2012100000000,2022-05-01,20,121,KS,Miami County,17925,17511,414,2.3
CN2012300000000,2022-05-01,20,123,KS,Mitchell County,3415,3351,64,1.9
CN2012500000000,2022-05-01,20,125,KS,Montgomery County,14656,14248,408,2.8
CN2012700000000,2022-05-01,20,127,KS,Morris County,3058,2989,69,2.3
CN2012900000000,2022-05-01,20,129,KS,Morton County,1116,1088,28,2.5
CN2013100000000,2022-05-01,20,131,KS,Nemaha County,5542,5447,95,1.7
CN2013300000000,2022-05-01,20,133,KS,Neosho County,5998,5799,199,3.3
CN2013500000000,2022-05-01,20,135,KS,Ness County,1316,1290,26,2
CN2013700000000,2022-05-01,20,137,KS,Norton County,2622,2575,47,1.8
CN2013900000000,2022-05-01,20,139,KS,Osage County,8044,7830,214,2.7
CN2014100000000,2022-05-01,20,141,KS,Osborne County,1877,1842,35,1.9
CN2014300000000,2022-05-01,20,143,KS,Ottawa County,2987,2920,67,2.2
CN2014500000000,2022-05-01,20,145,KS,Pawnee County,2673,2615,58,2.2
CN2014700000000,2022-05-01,20,147,KS,Phillips County,2690,2640,50,1.9
CN2014900000000,2022-05-01,20,149,KS,Pottawatomie County,12552,12278,274,2.2
CN2015100000000,2022-05-01,20,151,KS,Pratt County,4902,4806,96,2
CN2015300000000,2022-05-01,20,153,KS,Rawlins County,1487,1461,26,1.7
CN2015500000000,2022-05-01,20,155,KS,Reno County,29375,28588,787,2.7
CN2015700000000,2022-05-01,20,157,KS,Republic County,2329,2282,47,2
CN2015900000000,2022-05-01,20,159,KS,Rice County,5279,5163,116,2.2
CN2016100000000,2022-05-01,20,161,KS,Riley County,34708,33868,840,2.4
CN2016300000000,2022-05-01,20,163,KS,Rooks County,2400,2342,58,2.4
CN2016500000000,2022-05-01,20,165,KS,Rush County,1615,1583,32,2
CN2016700000000,2022-05-01,20,167,KS,Russell County,3274,3201,73,2.2
CN2016900000000,2022-05-01,20,169,KS,Saline County,30137,29481,656,2.2
CN2017100000000,2022-05-01,20,171,KS,Scott County,2711,2667,44,1.6
CN2017300000000,2022-05-01,20,173,KS,Sedgwick County,255144,247751,7393,2.9
CN2017500000000,2022-05-01,20,175,KS,Seward County,9715,9484,231,2.4
CN2017700000000,2022-05-01,20,177,KS,Shawnee County,91898,89604,2294,2.5
CN2017900000000,2022-05-01,20,179,KS,Sheridan County,1442,1413,29,2
CN2018100000000,2022-05-01,20,181,KS,Sherman County,2776,2718,58,2.1
CN2018300000000,2022-05-01,20,183,KS,Smith County,1916,1876,40,2.1
CN2018500000000,2022-05-01,20,185,KS,Stafford County,1850,1809,41,2.2
CN2018700000000,2022-05-01,20,187,KS,Stanton County,1059,1039,20,1.9
CN2018900000000,2022-05-01,20,189,KS,Stevens County,2867,2815,52,1.8
CN2019100000000,2022-05-01,20,191,KS,Sumner County,10701,10398,303,2.8
CN2019300000000,2022-05-01,20,193,KS,Thomas County,4178,4103,75,1.8
CN2019500000000,2022-05-01,20,195,KS,Trego County,1381,1350,31,2.2
CN2019700000000,2022-05-01,20,197,KS,Wabaunsee County,3704,3615,89,2.4
CN2019900000000,2022-05-01,20,199,KS,Wallace County,839,822,17,2
CN2020100000000,2022-05-01,20,201,KS,Washington County,2960,2907,53,1.8
CN2020300000000,2022-05-01,20,203,KS,Wichita County,1136,1116,20,1.8
CN2020500000000,2022-05-01,20,205,KS,Wilson County,3731,3624,107,2.9
CN2020700000000,2022-05-01,20,207,KS,Woodson County,1511,1458,53,3.5
CN2020900000000,2022-05-01,20,209,KS,Wyandotte County,77512,75142,2370,3.1
CN2100100000000,2022-05-01,21,001,KY,Adair County,7207,6921,286,4
CN2100300000000,2022-05-01,21,003,KY,Allen County,8916,8605,311,3.5
CN2100500000000,2022-05-01,21,005,KY,Anderson County,11922,11575,347,2.9
CN2100700000000,2022-05-01,21,007,KY,Ballard County,3501,3326,175,5
CN2100900000000,2022-05-01,21,009,KY,Barren County,18022,17354,668,3.7
CN2101100000000,2022-05-01,21,011,KY,Bath County,4717,4512,205,4.3
CN2101300000000,2022-05-01,21,013,KY,Bell County,8062,7686,376,4.7
CN2101500000000,2022-05-01,21,015,KY,Boone County,72832,70737,2095,2.9
CN2101700000000,2022-05-01,21,017,KY,Bourbon County,9471,9155,316,3.3
CN2101900000000,2022-05-01,21,019,KY,Boyd County,17378,16590,788,4.5
CN2102100000000,2022-05-01,21,021,KY,Boyle County,12707,12249,458,3.6
CN2102300000000,2022-05-01,21,023,KY,Bracken County,3791,3661,130,3.4
CN2102500000000,2022-05-01,21,025,KY,Breathitt County,3222,3009,213,6.6
CN2102700000000,2022-05-01,21,027,KY,Breckinridge County,7947,7600,347,4.4
CN2102900000000,2022-05-01,21,029,KY,Bullitt County,43989,41632,2357,5.4
CN2103100000000,2022-05-01,21,031,KY,Butler County,5008,4830,178,3.6
CN2103300000000,2022-05-01,21,033,KY,Caldwell County,6103,5915,188,3.1
CN2103500000000,2022-05-01,21,035,KY,Calloway County,17417,16780,637,3.7
CN2103700000000,2022-05-01,21,037,KY,Campbell County,51236,49650,1586,3.1
CN2103900000000,2022-05-01,21,039,KY,Carlisle County,2250,2173,77,3.4
CN2104100000000,2022-05-01,21,041,KY,Carroll County,5583,5422,161,2.9
CN2104300000000,2022-05-01,21,043,KY,Carter County,9686,9122,564,5.8
CN2104500000000,2022-05-01,21,045,KY,Casey County,6693,6463,230,3.4
CN2104700000000,2022-05-01,21,047,KY,Christian County,24856,23692,1164,4.7
CN2104900000000,2022-05-01,21,049,KY,Clark County,17291,16717,574,3.3
CN2105100000000,2022-05-01,21,051,KY,Clay County,5046,4783,263,5.2
CN2105300000000,2022-05-01,21,053,KY,Clinton County,3658,3491,167,4.6
CN2105500000000,2022-05-01,21,055,KY,Crittenden County,3802,3656,146,3.8
CN2105700000000,2022-05-01,21,057,KY,Cumberland County,3414,3324,90,2.6
CN2105900000000,2022-05-01,21,059,KY,Daviess County,46527,44774,1753,3.8
CN2106100000000,2022-05-01,21,061,KY,Edmonson County,4744,4537,207,4.4
CN2106300000000,2022-05-01,21,063,KY,Elliott County,1858,1733,125,6.7
CN2106500000000,2022-05-01,21,065,KY,Estill County,5190,4954,236,4.5
CN2106700000000,2022-05-01,21,067,KY,Fayette County,175938,170876,5062,2.9
CN2106900000000,2022-05-01,21,069,KY,Fleming County,5969,5729,240,4
CN2107100000000,2022-05-01,21,071,KY,Floyd County,10824,10252,572,5.3
CN2107300000000,2022-05-01,21,073,KY,Franklin County,25033,24229,804,3.2
CN2107500000000,2022-05-01,21,075,KY,Fulton County,2107,2021,86,4.1
CN2107700000000,2022-05-01,21,077,KY,Gallatin County,4026,3894,132,3.3
CN2107900000000,2022-05-01,21,079,KY,Garrard County,7895,7611,284,3.6
CN2108100000000,2022-05-01,21,081,KY,Grant County,11791,11384,407,3.5
CN2108300000000,2022-05-01,21,083,KY,Graves County,15495,14841,654,4.2
CN2108500000000,2022-05-01,21,085,KY,Grayson County,10450,9984,466,4.5
CN2108700000000,2022-05-01,21,087,KY,Green County,5108,4926,182,3.6
CN2108900000000,2022-05-01,21,089,KY,Greenup County,13049,12383,666,5.1
CN2109100000000,2022-05-01,21,091,KY,Hancock County,3850,3718,132,3.4
CN2109300000000,2022-05-01,21,093,KY,Hardin County,47370,45400,1970,4.2
CN2109500000000,2022-05-01,21,095,KY,Harlan County,6357,5991,366,5.8
CN2109700000000,2022-05-01,21,097,KY,Harrison County,8768,8511,257,2.9
CN2109900000000,2022-05-01,21,099,KY,Hart County,7711,7437,274,3.6
CN2110100000000,2022-05-01,21,101,KY,Henderson County,20773,20040,733,3.5
CN2110300000000,2022-05-01,21,103,KY,Henry County,8154,7872,282,3.5
CN2110500000000,2022-05-01,21,105,KY,Hickman County,1637,1574,63,3.8
CN2110700000000,2022-05-01,21,107,KY,Hopkins County,18371,17611,760,4.1
CN2110900000000,2022-05-01,21,109,KY,Jackson County,4161,3937,224,5.4
CN2111100000000,2022-05-01,21,111,KY,Jefferson County,399970,383148,16822,4.2
CN2111300000000,2022-05-01,21,113,KY,Jessamine County,26649,25863,786,2.9
CN2111500000000,2022-05-01,21,115,KY,Johnson County,6619,6258,361,5.5
CN2111700000000,2022-05-01,21,117,KY,Kenton County,88586,85904,2682,3
CN2111900000000,2022-05-01,21,119,KY,Knott County,4205,3969,236,5.6
CN2112100000000,2022-05-01,21,121,KY,Knox County,9758,9267,491,5
CN2112300000000,2022-05-01,21,123,KY,Larue County,5811,5541,270,4.6
CN2112500000000,2022-05-01,21,125,KY,Laurel County,24691,23713,978,4
CN2112700000000,2022-05-01,21,127,KY,Lawrence County,5682,5419,263,4.6
CN2112900000000,2022-05-01,21,129,KY,Lee County,2078,1973,105,5.1
CN2113100000000,2022-05-01,21,131,KY,Leslie County,2483,2331,152,6.1
CN2113300000000,2022-05-01,21,133,KY,Letcher County,5940,5612,328,5.5
CN2113500000000,2022-05-01,21,135,KY,Lewis County,4501,4229,272,6
CN2113700000000,2022-05-01,21,137,KY,Lincoln County,9304,8903,401,4.3
CN2113900000000,2022-05-01,21,139,KY,Livingston County,3640,3485,155,4.3
CN2114100000000,2022-05-01,21,141,KY,Logan County,12358,11963,395,3.2
CN2114300000000,2022-05-01,21,143,KY,Lyon County,3251,3138,113,3.5
CN2114500000000,2022-05-01,21,145,KY,McCracken County,30050,28884,1166,3.9
CN2114700000000,2022-05-01,21,147,KY,McCreary County,4686,4467,219,4.7
CN2114900000000,2022-05-01,21,149,KY,McLean County,3997,3834,163,4.1
CN2115100000000,2022-05-01,21,151,KY,Madison County,47069,45519,1550,3.3
CN2115300000000,2022-05-01,21,153,KY,Magoffin County,3190,2874,316,9.9
CN2115500000000,2022-05-01,21,155,KY,Marion County,9244,8943,301,3.3
CN2115700000000,2022-05-01,21,157,KY,Marshall County,14828,14283,545,3.7
CN2115900000000,2022-05-01,21,159,KY,Martin County,2276,2123,153,6.7
CN2116100000000,2022-05-01,21,161,KY,Mason County,6490,6227,263,4.1
CN2116300000000,2022-05-01,21,163,KY,Meade County,11715,11157,558,4.8
CN2116500000000,2022-05-01,21,165,KY,Menifee County,2388,2269,119,5
CN2116700000000,2022-05-01,21,167,KY,Mercer County,10060,9715,345,3.4
CN2116900000000,2022-05-01,21,169,KY,Metcalfe County,3938,3767,171,4.3
CN2117100000000,2022-05-01,21,171,KY,Monroe County,4599,4469,130,2.8
CN2117300000000,2022-05-01,21,173,KY,Montgomery County,12007,11522,485,4
CN2117500000000,2022-05-01,21,175,KY,Morgan County,4085,3891,194,4.7
CN2117700000000,2022-05-01,21,177,KY,Muhlenberg County,10005,9483,522,5.2
CN2117900000000,2022-05-01,21,179,KY,Nelson County,23788,22810,978,4.1
CN2118100000000,2022-05-01,21,181,KY,Nicholas County,3310,3172,138,4.2
CN2118300000000,2022-05-01,21,183,KY,Ohio County,9073,8664,409,4.5
CN2118500000000,2022-05-01,21,185,KY,Oldham County,33563,32485,1078,3.2
CN2118700000000,2022-05-01,21,187,KY,Owen County,5251,5096,155,3
CN2118900000000,2022-05-01,21,189,KY,Owsley County,1066,995,71,6.7
CN2119100000000,2022-05-01,21,191,KY,Pendleton County,6978,6763,215,3.1
CN2119300000000,2022-05-01,21,193,KY,Perry County,7899,7527,372,4.7
CN2119500000000,2022-05-01,21,195,KY,Pike County,18928,18003,925,4.9
CN2119700000000,2022-05-01,21,197,KY,Powell County,5247,5063,184,3.5
CN2119900000000,2022-05-01,21,199,KY,Pulaski County,25332,24248,1084,4.3
CN2120100000000,2022-05-01,21,201,KY,Robertson County,815,780,35,4.3
CN2120300000000,2022-05-01,21,203,KY,Rockcastle County,6510,6236,274,4.2
CN2120500000000,2022-05-01,21,205,KY,Rowan County,10240,9816,424,4.1
CN2120700000000,2022-05-01,21,207,KY,Russell County,6281,6009,272,4.3
CN2120900000000,2022-05-01,21,209,KY,Scott County,30370,29526,844,2.8
CN2121100000000,2022-05-01,21,211,KY,Shelby County,26086,25125,961,3.7
CN2121300000000,2022-05-01,21,213,KY,Simpson County,8794,8535,259,2.9
CN2121500000000,2022-05-01,21,215,KY,Spencer County,10785,10271,514,4.8
CN2121700000000,2022-05-01,21,217,KY,Taylor County,12211,11787,424,3.5
CN2121900000000,2022-05-01,21,219,KY,Todd County,5587,5420,167,3
CN2122100000000,2022-05-01,21,221,KY,Trigg County,6025,5776,249,4.1
CN2122300000000,2022-05-01,21,223,KY,Trimble County,3857,3686,171,4.4
CN2122500000000,2022-05-01,21,225,KY,Union County,5797,5573,224,3.9
CN2122700000000,2022-05-01,21,227,KY,Warren County,65863,63720,2143,3.3
CN2122900000000,2022-05-01,21,229,KY,Washington County,6135,5951,184,3
CN2123100000000,2022-05-01,21,231,KY,Wayne County,7014,6680,334,4.8
CN2123300000000,2022-05-01,21,233,KY,Webster County,5204,5018,186,3.6
CN2123500000000,2022-05-01,21,235,KY,Whitley County,13661,13091,570,4.2
CN2123700000000,2022-05-01,21,237,KY,Wolfe County,2319,2208,111,4.8
CN2123900000000,2022-05-01,21,239,KY,Woodford County,14854,14426,428,2.9
CN2200100000000,2022-05-01,22,001,LA,Acadia Parish,23934,23112,822,3.4
CN2200300000000,2022-05-01,22,003,LA,Allen Parish,8156,7832,324,4
CN2200500000000,2022-05-01,22,005,LA,Ascension Parish,67034,65106,1928,2.9
CN2200700000000,2022-05-01,22,007,LA,Assumption Parish,8871,8480,391,4.4
CN2200900000000,2022-05-01,22,009,LA,Avoyelles Parish,14447,13876,571,4
CN2201100000000,2022-05-01,22,011,LA,Beauregard Parish,15033,14579,454,3
CN2201300000000,2022-05-01,22,013,LA,Bienville Parish,5238,5025,213,4.1
CN2201500000000,2022-05-01,22,015,LA,Bossier Parish,58106,56457,1649,2.8
CN2201700000000,2022-05-01,22,017,LA,Caddo Parish,101986,97949,4037,4
CN2201900000000,2022-05-01,22,019,LA,Calcasieu Parish,92120,88985,3135,3.4
CN2202100000000,2022-05-01,22,021,LA,Caldwell Parish,3681,3546,135,3.7
CN2202300000000,2022-05-01,22,023,LA,Cameron Parish,3414,3325,89,2.6
CN2202500000000,2022-05-01,22,025,LA,Catahoula Parish,3513,3369,144,4.1
CN2202700000000,2022-05-01,22,027,LA,Claiborne Parish,5422,5225,197,3.6
CN2202900000000,2022-05-01,22,029,LA,Concordia Parish,7130,6824,306,4.3
CN2203100000000,2022-05-01,22,031,LA,De Soto Parish,10918,10517,401,3.7
CN2203300000000,2022-05-01,22,033,LA,East Baton Rouge Parish,233832,226081,7751,3.3
CN2203500000000,2022-05-01,22,035,LA,East Carroll Parish,1625,1504,121,7.4
CN2203700000000,2022-05-01,22,037,LA,East Feliciana Parish,7942,7693,249,3.1
CN2203900000000,2022-05-01,22,039,LA,Evangeline Parish,12239,11769,470,3.8
CN2204100000000,2022-05-01,22,041,LA,Franklin Parish,7530,7186,344,4.6
CN2204300000000,2022-05-01,22,043,LA,Grant Parish,8316,8056,260,3.1
CN2204500000000,2022-05-01,22,045,LA,Iberia Parish,27832,26712,1120,4
CN2204700000000,2022-05-01,22,047,LA,Iberville Parish,13905,13309,596,4.3
CN2204900000000,2022-05-01,22,049,LA,Jackson Parish,6953,6748,205,2.9
CN2205100000000,2022-05-01,22,051,LA,Jefferson Parish,210949,203714,7235,3.4
CN2205300000000,2022-05-01,22,053,LA,Jefferson Davis Parish,12294,11869,425,3.5
CN2205500000000,2022-05-01,22,055,LA,Lafayette Parish,116992,113485,3507,3
CN2205700000000,2022-05-01,22,057,LA,Lafourche Parish,40875,39557,1318,3.2
CN2205900000000,2022-05-01,22,059,LA,LaSalle Parish,6795,6625,170,2.5
CN2206100000000,2022-05-01,22,061,LA,Lincoln Parish,21404,20684,720,3.4
CN2206300000000,2022-05-01,22,063,LA,Livingston Parish,71966,70023,1943,2.7
CN2206500000000,2022-05-01,22,065,LA,Madison Parish,3492,3328,164,4.7
CN2206700000000,2022-05-01,22,067,LA,Morehouse Parish,9939,9438,501,5
CN2206900000000,2022-05-01,22,069,LA,Natchitoches Parish,16750,16158,592,3.5
CN2207100000000,2022-05-01,22,071,LA,Orleans Parish,177158,169618,7540,4.3
CN2207300000000,2022-05-01,22,073,LA,Ouachita Parish,70735,68198,2537,3.6
CN2207500000000,2022-05-01,22,075,LA,Plaquemines Parish,9821,9523,298,3
CN2207700000000,2022-05-01,22,077,LA,Pointe Coupee Parish,9863,9505,358,3.6
CN2207900000000,2022-05-01,22,079,LA,Rapides Parish,55905,54194,1711,3.1
CN2208100000000,2022-05-01,22,081,LA,Red River Parish,3746,3628,118,3.2
CN2208300000000,2022-05-01,22,083,LA,Richland Parish,8186,7862,324,4
CN2208500000000,2022-05-01,22,085,LA,Sabine Parish,9271,8986,285,3.1
CN2208700000000,2022-05-01,22,087,LA,St. Bernard Parish,20124,19369,755,3.8
CN2208900000000,2022-05-01,22,089,LA,St. Charles Parish,24847,24054,793,3.2
CN2209100000000,2022-05-01,22,091,LA,St. Helena Parish,4281,4069,212,5
CN2209300000000,2022-05-01,22,093,LA,St. James Parish,8880,8493,387,4.4
CN2209500000000,2022-05-01,22,095,LA,St. John the Baptist Parish,19104,18170,934,4.9
CN2209700000000,2022-05-01,22,097,LA,St. Landry Parish,32266,30887,1379,4.3
CN2209900000000,2022-05-01,22,099,LA,St. Martin Parish,22033,21256,777,3.5
CN2210100000000,2022-05-01,22,101,LA,St. Mary Parish,19229,18436,793,4.1
CN2210300000000,2022-05-01,22,103,LA,St. Tammany Parish,120351,117043,3308,2.7
CN2210500000000,2022-05-01,22,105,LA,Tangipahoa Parish,56624,54317,2307,4.1
CN2210700000000,2022-05-01,22,107,LA,Tensas Parish,1349,1285,64,4.7
CN2210900000000,2022-05-01,22,109,LA,Terrebonne Parish,44855,43192,1663,3.7
CN2211100000000,2022-05-01,22,111,LA,Union Parish,9207,8892,315,3.4
CN2211300000000,2022-05-01,22,113,LA,Vermilion Parish,24335,23521,814,3.3
CN2211500000000,2022-05-01,22,115,LA,Vernon Parish,16149,15561,588,3.6
CN2211700000000,2022-05-01,22,117,LA,Washington Parish,16805,16111,694,4.1
CN2211900000000,2022-05-01,22,119,LA,Webster Parish,14157,13617,540,3.8
CN2212100000000,2022-05-01,22,121,LA,West Baton Rouge Parish,14013,13579,434,3.1
CN2212300000000,2022-05-01,22,123,LA,West Carroll Parish,3599,3422,177,4.9
CN2212500000000,2022-05-01,22,125,LA,West Feliciana Parish,5454,5327,127,2.3
CN2212700000000,2022-05-01,22,127,LA,Winn Parish,4604,4428,176,3.8
CN2300100000000,2022-05-01,23,001,ME,Androscoggin County,52394,50923,1471,2.8
CN2300300000000,2022-05-01,23,003,ME,Aroostook County,28556,27269,1287,4.5
CN2300500000000,2022-05-01,23,005,ME,Cumberland County,160911,157120,3791,2.4
CN2300700000000,2022-05-01,23,007,ME,Franklin County,13294,12782,512,3.9
CN2300900000000,2022-05-01,23,009,ME,Hancock County,28630,27783,847,3
CN2301100000000,2022-05-01,23,011,ME,Kennebec County,60437,58820,1617,2.7
CN2301300000000,2022-05-01,23,013,ME,Knox County,19873,19320,553,2.8
CN2301500000000,2022-05-01,23,015,ME,Lincoln County,16574,16130,444,2.7
CN2301700000000,2022-05-01,23,017,ME,Oxford County,25673,24871,802,3.1
CN2301900000000,2022-05-01,23,019,ME,Penobscot County,74171,72003,2168,2.9
CN2302100000000,2022-05-01,23,021,ME,Piscataquis County,7322,7032,290,4
CN2302300000000,2022-05-01,23,023,ME,Sagadahoc County,18882,18437,445,2.4
CN2302500000000,2022-05-01,23,025,ME,Somerset County,21853,21030,823,3.8
CN2302700000000,2022-05-01,23,027,ME,Waldo County,20212,19633,579,2.9
CN2302900000000,2022-05-01,23,029,ME,Washington County,13401,12846,555,4.1
CN2303100000000,2022-05-01,23,031,ME,York County,111033,108296,2737,2.5
CN2400100000000,2022-05-01,24,001,MD,Allegany County,31279,30123,1156,3.7
CN2400300000000,2022-05-01,24,003,MD,Anne Arundel County,311843,303390,8453,2.7
CN2400500000000,2022-05-01,24,005,MD,Baltimore County,441428,427425,14003,3.2
CN2400900000000,2022-05-01,24,009,MD,Calvert County,48988,47593,1395,2.8
CN2401100000000,2022-05-01,24,011,MD,Caroline County,17350,16853,497,2.9
CN2401300000000,2022-05-01,24,013,MD,Carroll County,94472,92091,2381,2.5
CN2401500000000,2022-05-01,24,015,MD,Cecil County,53396,51740,1656,3.1
CN2401700000000,2022-05-01,24,017,MD,Charles County,85553,82775,2778,3.2
CN2401900000000,2022-05-01,24,019,MD,Dorchester County,15880,15355,525,3.3
CN2402100000000,2022-05-01,24,021,MD,Frederick County,135174,131309,3865,2.9
CN2402300000000,2022-05-01,24,023,MD,Garrett County,15110,14662,448,3
CN2402500000000,2022-05-01,24,025,MD,Harford County,138797,134863,3934,2.8
CN2402700000000,2022-05-01,24,027,MD,Howard County,186647,181841,4806,2.6
CN2402900000000,2022-05-01,24,029,MD,Kent County,9902,9581,321,3.2
CN2403100000000,2022-05-01,24,031,MD,Montgomery County,547211,531788,15423,2.8
CN2403300000000,2022-05-01,24,033,MD,Prince George's County,492221,475293,16928,3.4
CN2403500000000,2022-05-01,24,035,MD,Queen Anne's County,28163,27446,717,2.5
CN2403700000000,2022-05-01,24,037,MD,St. Mary's County,57839,56169,1670,2.9
CN2403900000000,2022-05-01,24,039,MD,Somerset County,9107,8720,387,4.2
CN2404100000000,2022-05-01,24,041,MD,Talbot County,17810,17271,539,3
CN2404300000000,2022-05-01,24,043,MD,Washington County,71921,69648,2273,3.2
CN2404500000000,2022-05-01,24,045,MD,Wicomico County,51339,49514,1825,3.6
CN2404700000000,2022-05-01,24,047,MD,Worcester County,25287,24267,1020,4
CN2451000000000,2022-05-01,24,510,MD,Baltimore city,271157,260293,10864,4
CN2500100000000,2022-05-01,25,001,MA,Barnstable County,111472,106816,4656,4.2
CN2500300000000,2022-05-01,25,003,MA,Berkshire County,61595,59079,2516,4.1
CN2500500000000,2022-05-01,25,005,MA,Bristol County,297894,285381,12513,4.2
CN2500700000000,2022-05-01,25,007,MA,Dukes County,9481,9033,448,4.7
CN2500900000000,2022-05-01,25,009,MA,Essex County,418755,402911,15844,3.8
CN2501100000000,2022-05-01,25,011,MA,Franklin County,40187,38911,1276,3.2
CN2501300000000,2022-05-01,25,013,MA,Hampden County,221896,211590,10306,4.6
CN2501500000000,2022-05-01,25,015,MA,Hampshire County,88652,85862,2790,3.1
CN2501700000000,2022-05-01,25,017,MA,Middlesex County,905016,877642,27374,3
CN2501900000000,2022-05-01,25,019,MA,Nantucket County/town,7774,7412,362,4.7
CN2502100000000,2022-05-01,25,021,MA,Norfolk County,390461,377611,12850,3.3
CN2502300000000,2022-05-01,25,023,MA,Plymouth County,281860,271159,10701,3.8
CN2502500000000,2022-05-01,25,025,MA,Suffolk County,450486,434372,16114,3.6
CN2502700000000,2022-05-01,25,027,MA,Worcester County,441372,424985,16387,3.7
CN2600100000000,2022-05-01,26,001,MI,Alcona County,3947,3709,238,6
CN2600300000000,2022-05-01,26,003,MI,Alger County,3217,3000,217,6.7
CN2600500000000,2022-05-01,26,005,MI,Allegan County,62848,60609,2239,3.6
CN2600700000000,2022-05-01,26,007,MI,Alpena County,13510,12898,612,4.5
CN2600900000000,2022-05-01,26,009,MI,Antrim County,10260,9709,551,5.4
CN2601100000000,2022-05-01,26,011,MI,Arenac County,5868,5494,374,6.4
CN2601300000000,2022-05-01,26,013,MI,Baraga County,3098,2881,217,7
CN2601500000000,2022-05-01,26,015,MI,Barry County,32173,30983,1190,3.7
CN2601700000000,2022-05-01,26,017,MI,Bay County,49332,46932,2400,4.9
CN2601900000000,2022-05-01,26,019,MI,Benzie County,8885,8449,436,4.9
CN2602100000000,2022-05-01,26,021,MI,Berrien County,72379,69244,3135,4.3
CN2602300000000,2022-05-01,26,023,MI,Branch County,19908,19107,801,4
CN2602500000000,2022-05-01,26,025,MI,Calhoun County,60586,57756,2830,4.7
CN2602700000000,2022-05-01,26,027,MI,Cass County,23717,22709,1008,4.3
CN2602900000000,2022-05-01,26,029,MI,Charlevoix County,12938,12368,570,4.4
CN2603100000000,2022-05-01,26,031,MI,Cheboygan County,10513,9907,606,5.8
CN2603300000000,2022-05-01,26,033,MI,Chippewa County,16139,15214,925,5.7
CN2603500000000,2022-05-01,26,035,MI,Clare County,11584,10850,734,6.3
CN2603700000000,2022-05-01,26,037,MI,Clinton County,40798,39046,1752,4.3
CN2603900000000,2022-05-01,26,039,MI,Crawford County,5636,5300,336,6
CN2604100000000,2022-05-01,26,041,MI,Delta County,16802,15919,883,5.3
CN2604300000000,2022-05-01,26,043,MI,Dickinson County,12448,11935,513,4.1
CN2604500000000,2022-05-01,26,045,MI,Eaton County,56928,53985,2943,5.2
CN2604700000000,2022-05-01,26,047,MI,Emmet County,16985,16146,839,4.9
CN2604900000000,2022-05-01,26,049,MI,Genesee County,179373,169780,9593,5.3
CN2605100000000,2022-05-01,26,051,MI,Gladwin County,10019,9466,553,5.5
CN2605300000000,2022-05-01,26,053,MI,Gogebic County,5724,5416,308,5.4
CN2605500000000,2022-05-01,26,055,MI,Grand Traverse County,50306,48475,1831,3.6
CN2605700000000,2022-05-01,26,057,MI,Gratiot County,17599,16792,807,4.6
CN2605900000000,2022-05-01,26,059,MI,Hillsdale County,20448,19516,932,4.6
CN2606100000000,2022-05-01,26,061,MI,Houghton County,15505,14670,835,5.4
CN2606300000000,2022-05-01,26,063,MI,Huron County,15365,14704,661,4.3
CN2606500000000,2022-05-01,26,065,MI,Ingham County,148178,140967,7211,4.9
CN2606700000000,2022-05-01,26,067,MI,Ionia County,30708,29510,1198,3.9
CN2606900000000,2022-05-01,26,069,MI,Iosco County,10380,9802,578,5.6
CN2607100000000,2022-05-01,26,071,MI,Iron County,4726,4458,268,5.7
CN2607300000000,2022-05-01,26,073,MI,Isabella County,32543,30933,1610,4.9
CN2607500000000,2022-05-01,26,075,MI,Jackson County,74755,71471,3284,4.4
CN2607700000000,2022-05-01,26,077,MI,Kalamazoo County,133003,127685,5318,4
CN2607900000000,2022-05-01,26,079,MI,Kalkaska County,7950,7529,421,5.3
CN2608100000000,2022-05-01,26,081,MI,Kent County,363578,350816,12762,3.5
CN2608300000000,2022-05-01,26,083,MI,Keweenaw County,869,812,57,6.6
CN2608500000000,2022-05-01,26,085,MI,Lake County,3935,3681,254,6.5
CN2608700000000,2022-05-01,26,087,MI,Lapeer County,39829,38291,1538,3.9
CN2608900000000,2022-05-01,26,089,MI,Leelanau County,10510,10092,418,4
CN2609100000000,2022-05-01,26,091,MI,Lenawee County,45337,43321,2016,4.4
CN2609300000000,2022-05-01,26,093,MI,Livingston County,102328,99383,2945,2.9
CN2609500000000,2022-05-01,26,095,MI,Luce County,2111,1979,132,6.3
CN2609700000000,2022-05-01,26,097,MI,Mackinac County,5541,5241,300,5.4
CN2609900000000,2022-05-01,26,099,MI,Macomb County,437096,421283,15813,3.6
CN2610100000000,2022-05-01,26,101,MI,Manistee County,10078,9542,536,5.3
CN2610300000000,2022-05-01,26,103,MI,Marquette County,31156,29599,1557,5
CN2610500000000,2022-05-01,26,105,MI,Mason County,13481,12847,634,4.7
CN2610700000000,2022-05-01,26,107,MI,Mecosta County,18411,17411,1000,5.4
CN2610900000000,2022-05-01,26,109,MI,Menominee County,10863,10406,457,4.2
CN2611100000000,2022-05-01,26,111,MI,Midland County,40401,38694,1707,4.2
CN2611300000000,2022-05-01,26,113,MI,Missaukee County,6941,6627,314,4.5
CN2611500000000,2022-05-01,26,115,MI,Monroe County,75646,72110,3536,4.7
CN2611700000000,2022-05-01,26,117,MI,Montcalm County,28023,26824,1199,4.3
CN2611900000000,2022-05-01,26,119,MI,Montmorency County,3063,2842,221,7.2
CN2612100000000,2022-05-01,26,121,MI,Muskegon County,77625,73887,3738,4.8
CN2612300000000,2022-05-01,26,123,MI,Newaygo County,23534,22476,1058,4.5
CN2612500000000,2022-05-01,26,125,MI,Oakland County,661424,641443,19981,3
CN2612700000000,2022-05-01,26,127,MI,Oceana County,11718,11005,713,6.1
CN2612900000000,2022-05-01,26,129,MI,Ogemaw County,8507,7999,508,6
CN2613100000000,2022-05-01,26,131,MI,Ontonagon County,2018,1850,168,8.3
CN2613300000000,2022-05-01,26,133,MI,Osceola County,11452,10951,501,4.4
CN2613500000000,2022-05-01,26,135,MI,Oscoda County,2919,2720,199,6.8
CN2613700000000,2022-05-01,26,137,MI,Otsego County,11751,11159,592,5
CN2613900000000,2022-05-01,26,139,MI,Ottawa County,163671,158091,5580,3.4
CN2614100000000,2022-05-01,26,141,MI,Presque Isle County,4969,4665,304,6.1
CN2614300000000,2022-05-01,26,143,MI,Roscommon County,8233,7581,652,7.9
CN2614500000000,2022-05-01,26,145,MI,Saginaw County,83065,78604,4461,5.4
CN2614700000000,2022-05-01,26,147,MI,St. Clair County,73811,71102,2709,3.7
CN2614900000000,2022-05-01,26,149,MI,St. Joseph County,28561,27357,1204,4.2
CN2615100000000,2022-05-01,26,151,MI,Sanilac County,19016,18090,926,4.9
CN2615300000000,2022-05-01,26,153,MI,Schoolcraft County,3180,2955,225,7.1
CN2615500000000,2022-05-01,26,155,MI,Shiawassee County,32764,31157,1607,4.9
CN2615700000000,2022-05-01,26,157,MI,Tuscola County,23125,21943,1182,5.1
CN2615900000000,2022-05-01,26,159,MI,Van Buren County,34454,32866,1588,4.6
CN2616100000000,2022-05-01,26,161,MI,Washtenaw County,195415,187873,7542,3.9
CN2616300000000,2022-05-01,26,163,MI,Wayne County,780511,745345,35166,4.5
CN2616500000000,2022-05-01,26,165,MI,Wexford County,15062,14383,679,4.5
CN2700100000000,2022-05-01,27,001,MN,Aitkin County,7473,7209,264,3.5
CN2700300000000,2022-05-01,27,003,MN,Anoka County,198710,194495,4215,2.1
CN2700500000000,2022-05-01,27,005,MN,Becker County,19307,18887,420,2.2
CN2700700000000,2022-05-01,27,007,MN,Beltrami County,24878,24166,712,2.9
CN2700900000000,2022-05-01,27,009,MN,Benton County,21475,20929,546,2.5
CN2701100000000,2022-05-01,27,011,MN,Big Stone County,2402,2344,58,2.4
CN2701300000000,2022-05-01,27,013,MN,Blue Earth County,39722,38995,727,1.8
CN2701500000000,2022-05-01,27,015,MN,Brown County,13779,13494,285,2.1
CN2701700000000,2022-05-01,27,017,MN,Carlton County,17531,16983,548,3.1
CN2701900000000,2022-05-01,27,019,MN,Carver County,59290,58271,1019,1.7
CN2702100000000,2022-05-01,27,021,MN,Cass County,14827,14386,441,3
CN2702300000000,2022-05-01,27,023,MN,Chippewa County,6506,6386,120,1.8
CN2702500000000,2022-05-01,27,025,MN,Chisago County,29830,29156,674,2.3
CN2702700000000,2022-05-01,27,027,MN,Clay County,37477,36796,681,1.8
CN2702900000000,2022-05-01,27,029,MN,Clearwater County,4516,4247,269,6
CN2703100000000,2022-05-01,27,031,MN,Cook County,2775,2692,83,3
CN2703300000000,2022-05-01,27,033,MN,Cottonwood County,6595,6449,146,2.2
CN2703500000000,2022-05-01,27,035,MN,Crow Wing County,33855,33061,794,2.3
CN2703700000000,2022-05-01,27,037,MN,Dakota County,242468,237751,4717,1.9
CN2703900000000,2022-05-01,27,039,MN,Dodge County,11744,11528,216,1.8
CN2704100000000,2022-05-01,27,041,MN,Douglas County,21718,21345,373,1.7
CN2704300000000,2022-05-01,27,043,MN,Faribault County,6894,6725,169,2.5
CN2704500000000,2022-05-01,27,045,MN,Fillmore County,11220,11012,208,1.9
CN2704700000000,2022-05-01,27,047,MN,Freeborn County,15868,15543,325,2
CN2704900000000,2022-05-01,27,049,MN,Goodhue County,26602,26083,519,2
CN2705100000000,2022-05-01,27,051,MN,Grant County,3302,3231,71,2.2
CN2705300000000,2022-05-01,27,053,MN,Hennepin County,705667,690806,14861,2.1
CN2705500000000,2022-05-01,27,055,MN,Houston County,10317,10154,163,1.6
CN2705700000000,2022-05-01,27,057,MN,Hubbard County,10214,9879,335,3.3
CN2705900000000,2022-05-01,27,059,MN,Isanti County,21596,21099,497,2.3
CN2706100000000,2022-05-01,27,061,MN,Itasca County,21823,20899,924,4.2
CN2706300000000,2022-05-01,27,063,MN,Jackson County,5438,5271,167,3.1
CN2706500000000,2022-05-01,27,065,MN,Kanabec County,9113,8863,250,2.7
CN2706700000000,2022-05-01,27,067,MN,Kandiyohi County,23028,22543,485,2.1
CN2706900000000,2022-05-01,27,069,MN,Kittson County,2220,2169,51,2.3
CN2707100000000,2022-05-01,27,071,MN,Koochiching County,5862,5593,269,4.6
CN2707300000000,2022-05-01,27,073,MN,Lac qui Parle County,3385,3318,67,2
CN2707500000000,2022-05-01,27,075,MN,Lake County,5520,5244,276,5
CN2707700000000,2022-05-01,27,077,MN,Lake of the Woods County,2334,2265,69,3
CN2707900000000,2022-05-01,27,079,MN,Le Sueur County,15717,15365,352,2.2
CN2708100000000,2022-05-01,27,081,MN,Lincoln County,3017,2965,52,1.7
CN2708300000000,2022-05-01,27,083,MN,Lyon County,14445,14164,281,1.9
CN2708500000000,2022-05-01,27,085,MN,McLeod County,19281,18882,399,2.1
CN2708700000000,2022-05-01,27,087,MN,Mahnomen County,2227,2146,81,3.6
CN2708900000000,2022-05-01,27,089,MN,Marshall County,5307,5144,163,3.1
CN2709100000000,2022-05-01,27,091,MN,Martin County,9587,9341,246,2.6
CN2709300000000,2022-05-01,27,093,MN,Meeker County,13418,13172,246,1.8
CN2709500000000,2022-05-01,27,095,MN,Mille Lacs County,12521,12152,369,2.9
CN2709700000000,2022-05-01,27,097,MN,Morrison County,17148,16639,509,3
CN2709900000000,2022-05-01,27,099,MN,Mower County,20760,20337,423,2
CN2710100000000,2022-05-01,27,101,MN,Murray County,4652,4551,101,2.2
CN2710300000000,2022-05-01,27,103,MN,Nicollet County,20343,20025,318,1.6
CN2710500000000,2022-05-01,27,105,MN,Nobles County,10960,10747,213,1.9
CN2710700000000,2022-05-01,27,107,MN,Norman County,3086,3005,81,2.6
CN2710900000000,2022-05-01,27,109,MN,Olmsted County,90655,89075,1580,1.7
CN2711100000000,2022-05-01,27,111,MN,Otter Tail County,31415,30756,659,2.1
CN2711300000000,2022-05-01,27,113,MN,Pennington County,8768,8564,204,2.3
CN2711500000000,2022-05-01,27,115,MN,Pine County,14435,13984,451,3.1
CN2711700000000,2022-05-01,27,117,MN,Pipestone County,4616,4540,76,1.6
CN2711900000000,2022-05-01,27,119,MN,Polk County,15829,15450,379,2.4
CN2712100000000,2022-05-01,27,121,MN,Pope County,6488,6378,110,1.7
CN2712300000000,2022-05-01,27,123,MN,Ramsey County,285851,279274,6577,2.3
CN2712500000000,2022-05-01,27,125,MN,Red Lake County,2169,2100,69,3.2
CN2712700000000,2022-05-01,27,127,MN,Redwood County,7540,7394,146,1.9
CN2712900000000,2022-05-01,27,129,MN,Renville County,8032,7815,217,2.7
CN2713100000000,2022-05-01,27,131,MN,Rice County,37540,36822,718,1.9
CN2713300000000,2022-05-01,27,133,MN,Rock County,5971,5903,68,1.1
CN2713500000000,2022-05-01,27,135,MN,Roseau County,7959,7781,178,2.2
CN2713700000000,2022-05-01,27,137,MN,St. Louis County,100214,97288,2926,2.9
CN2713900000000,2022-05-01,27,139,MN,Scott County,84385,82877,1508,1.8
CN2714100000000,2022-05-01,27,141,MN,Sherburne County,52955,51877,1078,2
CN2714300000000,2022-05-01,27,143,MN,Sibley County,7936,7761,175,2.2
CN2714500000000,2022-05-01,27,145,MN,Stearns County,89102,87191,1911,2.1
CN2714700000000,2022-05-01,27,147,MN,Steele County,19216,18813,403,2.1
CN2714900000000,2022-05-01,27,149,MN,Stevens County,5351,5259,92,1.7
CN2715100000000,2022-05-01,27,151,MN,Swift County,4732,4618,114,2.4
CN2715300000000,2022-05-01,27,153,MN,Todd County,13456,13145,311,2.3
CN2715500000000,2022-05-01,27,155,MN,Traverse County,1624,1594,30,1.8
CN2715700000000,2022-05-01,27,157,MN,Wabasha County,11974,11742,232,1.9
CN2715900000000,2022-05-01,27,159,MN,Wadena County,6002,5827,175,2.9
CN2716100000000,2022-05-01,27,161,MN,Waseca County,8524,8289,235,2.8
CN2716300000000,2022-05-01,27,163,MN,Washington County,144968,142281,2687,1.9
CN2716500000000,2022-05-01,27,165,MN,Watonwan County,6394,6253,141,2.2
CN2716700000000,2022-05-01,27,167,MN,Wilkin County,3341,3282,59,1.8
CN2716900000000,2022-05-01,27,169,MN,Winona County,28122,27609,513,1.8
CN2717100000000,2022-05-01,27,171,MN,Wright County,76341,74940,1401,1.8
CN2717300000000,2022-05-01,27,173,MN,Yellow Medicine County,4988,4878,110,2.2
CN2800100000000,2022-05-01,28,001,MS,Adams County,10617,10096,521,4.9
CN2800300000000,2022-05-01,28,003,MS,Alcorn County,15196,14695,501,3.3
CN2800500000000,2022-05-01,28,005,MS,Amite County,4415,4211,204,4.6
CN2800700000000,2022-05-01,28,007,MS,Attala County,7031,6753,278,4
CN2800900000000,2022-05-01,28,009,MS,Benton County,3046,2913,133,4.4
CN2801100000000,2022-05-01,28,011,MS,Bolivar County,11469,10964,505,4.4
CN2801300000000,2022-05-01,28,013,MS,Calhoun County,5693,5502,191,3.4
CN2801500000000,2022-05-01,28,015,MS,Carroll County,3462,3320,142,4.1
CN2801700000000,2022-05-01,28,017,MS,Chickasaw County,6811,6559,252,3.7
CN2801900000000,2022-05-01,28,019,MS,Choctaw County,3680,3547,133,3.6
CN2802100000000,2022-05-01,28,021,MS,Claiborne County,2925,2683,242,8.3
CN2802300000000,2022-05-01,28,023,MS,Clarke County,5730,5461,269,4.7
CN2802500000000,2022-05-01,28,025,MS,Clay County,8762,8423,339,3.9
CN2802700000000,2022-05-01,28,027,MS,Coahoma County,7740,7325,415,5.4
CN2802900000000,2022-05-01,28,029,MS,Copiah County,10806,10348,458,4.2
CN2803100000000,2022-05-01,28,031,MS,Covington County,8231,7941,290,3.5
CN2803300000000,2022-05-01,28,033,MS,DeSoto County,93702,90824,2878,3.1
CN2803500000000,2022-05-01,28,035,MS,Forrest County,33240,32023,1217,3.7
CN2803700000000,2022-05-01,28,037,MS,Franklin County,2717,2589,128,4.7
CN2803900000000,2022-05-01,28,039,MS,George County,8955,8519,436,4.9
CN2804100000000,2022-05-01,28,041,MS,Greene County,4292,4040,252,5.9
CN2804300000000,2022-05-01,28,043,MS,Grenada County,8934,8628,306,3.4
CN2804500000000,2022-05-01,28,045,MS,Hancock County,19172,18440,732,3.8
CN2804700000000,2022-05-01,28,047,MS,Harrison County,87633,84470,3163,3.6
CN2804900000000,2022-05-01,28,049,MS,Hinds County,101241,97265,3976,3.9
CN2805100000000,2022-05-01,28,051,MS,Holmes County,5105,4786,319,6.2
CN2805300000000,2022-05-01,28,053,MS,Humphreys County,2083,1946,137,6.6
CN2805500000000,2022-05-01,28,055,MS,Issaquena County,343,318,25,7.3
CN2805700000000,2022-05-01,28,057,MS,Itawamba County,10356,10028,328,3.2
CN2805900000000,2022-05-01,28,059,MS,Jackson County,58584,56171,2413,4.1
CN2806100000000,2022-05-01,28,061,MS,Jasper County,5903,5631,272,4.6
CN2806300000000,2022-05-01,28,063,MS,Jefferson County,1942,1675,267,13.7
CN2806500000000,2022-05-01,28,065,MS,Jefferson Davis County,3835,3648,187,4.9
CN2806700000000,2022-05-01,28,067,MS,Jones County,25097,24109,988,3.9
CN2806900000000,2022-05-01,28,069,MS,Kemper County,3338,3151,187,5.6
CN2807100000000,2022-05-01,28,071,MS,Lafayette County,27811,26942,869,3.1
CN2807300000000,2022-05-01,28,073,MS,Lamar County,31544,30605,939,3
CN2807500000000,2022-05-01,28,075,MS,Lauderdale County,29063,27917,1146,3.9
CN2807700000000,2022-05-01,28,077,MS,Lawrence County,4848,4632,216,4.5
CN2807900000000,2022-05-01,28,079,MS,Leake County,8091,7776,315,3.9
CN2808100000000,2022-05-01,28,081,MS,Lee County,40868,39592,1276,3.1
CN2808300000000,2022-05-01,28,083,MS,Leflore County,9674,9180,494,5.1
CN2808500000000,2022-05-01,28,085,MS,Lincoln County,15027,14499,528,3.5
CN2808700000000,2022-05-01,28,087,MS,Lowndes County,24495,23525,970,4
CN2808900000000,2022-05-01,28,089,MS,Madison County,53107,51508,1599,3
CN2809100000000,2022-05-01,28,091,MS,Marion County,10272,9908,364,3.5
CN2809300000000,2022-05-01,28,093,MS,Marshall County,14293,13758,535,3.7
CN2809500000000,2022-05-01,28,095,MS,Monroe County,15843,15291,552,3.5
CN2809700000000,2022-05-01,28,097,MS,Montgomery County,3972,3812,160,4
CN2809900000000,2022-05-01,28,099,MS,Neshoba County,10167,9756,411,4
CN2810100000000,2022-05-01,28,101,MS,Newton County,8131,7810,321,3.9
CN2810300000000,2022-05-01,28,103,MS,Noxubee County,3537,3339,198,5.6
CN2810500000000,2022-05-01,28,105,MS,Oktibbeha County,22023,21152,871,4
CN2810700000000,2022-05-01,28,107,MS,Panola County,12450,11902,548,4.4
CN2810900000000,2022-05-01,28,109,MS,Pearl River County,23534,22644,890,3.8
CN2811100000000,2022-05-01,28,111,MS,Perry County,4261,4070,191,4.5
CN2811300000000,2022-05-01,28,113,MS,Pike County,14292,13629,663,4.6
CN2811500000000,2022-05-01,28,115,MS,Pontotoc County,15023,14562,461,3.1
CN2811700000000,2022-05-01,28,117,MS,Prentiss County,11470,11124,346,3
CN2811900000000,2022-05-01,28,119,MS,Quitman County,2441,2311,130,5.3
CN2812100000000,2022-05-01,28,121,MS,Rankin County,76060,73948,2112,2.8
CN2812300000000,2022-05-01,28,123,MS,Scott County,12212,11821,391,3.2
CN2812500000000,2022-05-01,28,125,MS,Sharkey County,1388,1314,74,5.3
CN2812700000000,2022-05-01,28,127,MS,Simpson County,10602,10233,369,3.5
CN2812900000000,2022-05-01,28,129,MS,Smith County,6847,6613,234,3.4
CN2813100000000,2022-05-01,28,131,MS,Stone County,6976,6695,281,4
CN2813300000000,2022-05-01,28,133,MS,Sunflower County,7448,7039,409,5.5
CN2813500000000,2022-05-01,28,135,MS,Tallahatchie County,4819,4630,189,3.9
CN2813700000000,2022-05-01,28,137,MS,Tate County,12256,11795,461,3.8
CN2813900000000,2022-05-01,28,139,MS,Tippah County,9719,9413,306,3.1
CN2814100000000,2022-05-01,28,141,MS,Tishomingo County,8622,8330,292,3.4
CN2814300000000,2022-05-01,28,143,MS,Tunica County,4222,4045,177,4.2
CN2814500000000,2022-05-01,28,145,MS,Union County,14768,14384,384,2.6
CN2814700000000,2022-05-01,28,147,MS,Walthall County,4976,4745,231,4.6
CN2814900000000,2022-05-01,28,149,MS,Warren County,19221,18415,806,4.2
CN2815100000000,2022-05-01,28,151,MS,Washington County,14991,14167,824,5.5
CN2815300000000,2022-05-01,28,153,MS,Wayne County,7218,6879,339,4.7
CN2815500000000,2022-05-01,28,155,MS,Webster County,3959,3820,139,3.5
CN2815700000000,2022-05-01,28,157,MS,Wilkinson County,2636,2461,175,6.6
CN2815900000000,2022-05-01,28,159,MS,Winston County,7201,6891,310,4.3
CN2816100000000,2022-05-01,28,161,MS,Yalobusha County,4779,4604,175,3.7
CN2816300000000,2022-05-01,28,163,MS,Yazoo County,9020,8631,389,4.3
CN2900100000000,2022-05-01,29,001,MO,Adair County,10109,9799,310,3.1
CN2900300000000,2022-05-01,29,003,MO,Andrew County,9445,9271,174,1.8
CN2900500000000,2022-05-01,29,005,MO,Atchison County,2646,2592,54,2
CN2900700000000,2022-05-01,29,007,MO,Audrain County,10100,9793,307,3
CN2900900000000,2022-05-01,29,009,MO,Barry County,14594,14240,354,2.4
CN2901100000000,2022-05-01,29,011,MO,Barton County,5287,5170,117,2.2
CN2901300000000,2022-05-01,29,013,MO,Bates County,7701,7511,190,2.5
CN2901500000000,2022-05-01,29,015,MO,Benton County,7401,7179,222,3
CN2901700000000,2022-05-01,29,017,MO,Bollinger County,5364,5241,123,2.3
CN2901900000000,2022-05-01,29,019,MO,Boone County,100066,98112,1954,2
CN2902100000000,2022-05-01,29,021,MO,Buchanan County,42171,41245,926,2.2
CN2902300000000,2022-05-01,29,023,MO,Butler County,18069,17613,456,2.5
CN2902500000000,2022-05-01,29,025,MO,Caldwell County,4278,4184,94,2.2
CN2902700000000,2022-05-01,29,027,MO,Callaway County,21753,21273,480,2.2
CN2902900000000,2022-05-01,29,029,MO,Camden County,19778,19284,494,2.5
CN2903100000000,2022-05-01,29,031,MO,Cape Girardeau County,40745,39882,863,2.1
CN2903300000000,2022-05-01,29,033,MO,Carroll County,4515,4411,104,2.3
CN2903500000000,2022-05-01,29,035,MO,Carter County,2540,2466,74,2.9
CN2903700000000,2022-05-01,29,037,MO,Cass County,54810,53632,1178,2.1
CN2903900000000,2022-05-01,29,039,MO,Cedar County,5809,5664,145,2.5
CN2904100000000,2022-05-01,29,041,MO,Chariton County,3764,3695,69,1.8
CN2904300000000,2022-05-01,29,043,MO,Christian County,47343,46465,878,1.9
CN2904500000000,2022-05-01,29,045,MO,Clark County,3063,2983,80,2.6
CN2904700000000,2022-05-01,29,047,MO,Clay County,137919,135053,2866,2.1
CN2904900000000,2022-05-01,29,049,MO,Clinton County,10608,10374,234,2.2
CN2905100000000,2022-05-01,29,051,MO,Cole County,39364,38651,713,1.8
CN2905300000000,2022-05-01,29,053,MO,Cooper County,7201,7044,157,2.2
CN2905500000000,2022-05-01,29,055,MO,Crawford County,10796,10511,285,2.6
CN2905700000000,2022-05-01,29,057,MO,Dade County,3551,3478,73,2.1
CN2905900000000,2022-05-01,29,059,MO,Dallas County,7282,7090,192,2.6
CN2906100000000,2022-05-01,29,061,MO,Daviess County,4116,4030,86,2.1
CN2906300000000,2022-05-01,29,063,MO,DeKalb County,4069,3988,81,2
CN2906500000000,2022-05-01,29,065,MO,Dent County,6141,5960,181,2.9
CN2906700000000,2022-05-01,29,067,MO,Douglas County,5178,5049,129,2.5
CN2906900000000,2022-05-01,29,069,MO,Dunklin County,11216,10823,393,3.5
CN2907100000000,2022-05-01,29,071,MO,Franklin County,53058,51953,1105,2.1
CN2907300000000,2022-05-01,29,073,MO,Gasconade County,7659,7511,148,1.9
CN2907500000000,2022-05-01,29,075,MO,Gentry County,3316,3255,61,1.8
CN2907700000000,2022-05-01,29,077,MO,Greene County,154914,151871,3043,2
CN2907900000000,2022-05-01,29,079,MO,Grundy County,4195,4095,100,2.4
CN2908100000000,2022-05-01,29,081,MO,Harrison County,3821,3741,80,2.1
CN2908300000000,2022-05-01,29,083,MO,Henry County,10228,10000,228,2.2
CN2908500000000,2022-05-01,29,085,MO,Hickory County,4228,4133,95,2.2
CN2908700000000,2022-05-01,29,087,MO,Holt County,2533,2491,42,1.7
CN2908900000000,2022-05-01,29,089,MO,Howard County,4786,4683,103,2.2
CN2909100000000,2022-05-01,29,091,MO,Howell County,15987,15553,434,2.7
CN2909300000000,2022-05-01,29,093,MO,Iron County,3476,3358,118,3.4
CN2909500000000,2022-05-01,29,095,MO,Jackson County,357826,348904,8922,2.5
CN2909700000000,2022-05-01,29,097,MO,Jasper County,56916,55653,1263,2.2
CN2909900000000,2022-05-01,29,099,MO,Jefferson County,118131,115626,2505,2.1
CN2910100000000,2022-05-01,29,101,MO,Johnson County,23156,22574,582,2.5
CN2910300000000,2022-05-01,29,103,MO,Knox County,1763,1724,39,2.2
CN2910500000000,2022-05-01,29,105,MO,Laclede County,16591,16218,373,2.2
CN2910700000000,2022-05-01,29,107,MO,Lafayette County,16787,16408,379,2.3
CN2910900000000,2022-05-01,29,109,MO,Lawrence County,17372,16996,376,2.2
CN2911100000000,2022-05-01,29,111,MO,Lewis County,4879,4782,97,2
CN2911300000000,2022-05-01,29,113,MO,Lincoln County,29348,28697,651,2.2
CN2911500000000,2022-05-01,29,115,MO,Linn County,5184,5058,126,2.4
CN2911700000000,2022-05-01,29,117,MO,Livingston County,7300,7170,130,1.8
CN2911900000000,2022-05-01,29,119,MO,McDonald County,11041,10789,252,2.3
CN2912100000000,2022-05-01,29,121,MO,Macon County,7373,7216,157,2.1
CN2912300000000,2022-05-01,29,123,MO,Madison County,5431,5296,135,2.5
CN2912500000000,2022-05-01,29,125,MO,Maries County,3908,3818,90,2.3
CN2912700000000,2022-05-01,29,127,MO,Marion County,13818,13517,301,2.2
CN2912900000000,2022-05-01,29,129,MO,Mercer County,1818,1782,36,2
CN2913100000000,2022-05-01,29,131,MO,Miller County,13065,12787,278,2.1
CN2913300000000,2022-05-01,29,133,MO,Mississippi County,5281,5129,152,2.9
CN2913500000000,2022-05-01,29,135,MO,Moniteau County,7189,7045,144,2
CN2913700000000,2022-05-01,29,137,MO,Monroe County,3892,3802,90,2.3
CN2913900000000,2022-05-01,29,139,MO,Montgomery County,5881,5755,126,2.1
CN2914100000000,2022-05-01,29,141,MO,Morgan County,8537,8323,214,2.5
CN2914300000000,2022-05-01,29,143,MO,New Madrid County,8276,8064,212,2.6
CN2914500000000,2022-05-01,29,145,MO,Newton County,27043,26428,615,2.3
CN2914700000000,2022-05-01,29,147,MO,Nodaway County,10884,10632,252,2.3
CN2914900000000,2022-05-01,29,149,MO,Oregon County,3866,3762,104,2.7
CN2915100000000,2022-05-01,29,151,MO,Osage County,7145,7017,128,1.8
CN2915300000000,2022-05-01,29,153,MO,Ozark County,3594,3491,103,2.9
CN2915500000000,2022-05-01,29,155,MO,Pemiscot County,5858,5668,190,3.2
CN2915700000000,2022-05-01,29,157,MO,Perry County,9637,9431,206,2.1
CN2915900000000,2022-05-01,29,159,MO,Pettis County,20168,19719,449,2.2
CN2916100000000,2022-05-01,29,161,MO,Phelps County,20110,19633,477,2.4
CN2916300000000,2022-05-01,29,163,MO,Pike County,7354,7187,167,2.3
CN2916500000000,2022-05-01,29,165,MO,Platte County,59781,58581,1200,2
CN2916700000000,2022-05-01,29,167,MO,Polk County,14816,14474,342,2.3
CN2916900000000,2022-05-01,29,169,MO,Pulaski County,14516,14117,399,2.7
CN2917100000000,2022-05-01,29,171,MO,Putnam County,2258,2211,47,2.1
CN2917300000000,2022-05-01,29,173,MO,Ralls County,5459,5348,111,2
CN2917500000000,2022-05-01,29,175,MO,Randolph County,10366,10119,247,2.4
CN2917700000000,2022-05-01,29,177,MO,Ray County,10812,10546,266,2.5
CN2917900000000,2022-05-01,29,179,MO,Reynolds County,2935,2861,74,2.5
CN2918100000000,2022-05-01,29,181,MO,Ripley County,5136,4996,140,2.7
CN2918300000000,2022-05-01,29,183,MO,St. Charles County,229761,225368,4393,1.9
CN2918500000000,2022-05-01,29,185,MO,St. Clair County,3881,3784,97,2.5
CN2918600000000,2022-05-01,29,186,MO,Ste. Genevieve County,9403,9211,192,2
CN2918700000000,2022-05-01,29,187,MO,St. Francois County,25650,24908,742,2.9
CN2918900000000,2022-05-01,29,189,MO,St. Louis County,527272,515353,11919,2.3
CN2919500000000,2022-05-01,29,195,MO,Saline County,10412,10181,231,2.2
CN2919700000000,2022-05-01,29,197,MO,Schuyler County,1867,1822,45,2.4
CN2919900000000,2022-05-01,29,199,MO,Scotland County,2355,2307,48,2
CN2920100000000,2022-05-01,29,201,MO,Scott County,20088,19657,431,2.1
CN2920300000000,2022-05-01,29,203,MO,Shannon County,3331,3231,100,3
CN2920500000000,2022-05-01,29,205,MO,Shelby County,3040,2985,55,1.8
CN2920700000000,2022-05-01,29,207,MO,Stoddard County,13320,12996,324,2.4
CN2920900000000,2022-05-01,29,209,MO,Stone County,13572,13195,377,2.8
CN2921100000000,2022-05-01,29,211,MO,Sullivan County,2547,2486,61,2.4
CN2921300000000,2022-05-01,29,213,MO,Taney County,26061,25299,762,2.9
CN2921500000000,2022-05-01,29,215,MO,Texas County,9241,9000,241,2.6
CN2921700000000,2022-05-01,29,217,MO,Vernon County,9257,9033,224,2.4
CN2921900000000,2022-05-01,29,219,MO,Warren County,18828,18416,412,2.2
CN2922100000000,2022-05-01,29,221,MO,Washington County,10223,9934,289,2.8
CN2922300000000,2022-05-01,29,223,MO,Wayne County,4813,4668,145,3
CN2922500000000,2022-05-01,29,225,MO,Webster County,17718,17353,365,2.1
CN2922700000000,2022-05-01,29,227,MO,Worth County,1182,1165,17,1.4
CN2922900000000,2022-05-01,29,229,MO,Wright County,7872,7677,195,2.5
CN2951000000000,2022-05-01,29,510,MO,St. Louis city,148673,144633,4040,2.7
CN3000100000000,2022-05-01,30,001,MT,Beaverhead County,5125,5011,114,2.2
CN3000300000000,2022-05-01,30,003,MT,Big Horn County,4766,4582,184,3.9
CN3000500000000,2022-05-01,30,005,MT,Blaine County,2246,2183,63,2.8
CN3000700000000,2022-05-01,30,007,MT,Broadwater County,2758,2682,76,2.8
CN3000900000000,2022-05-01,30,009,MT,Carbon County,5852,5703,149,2.5
CN3001100000000,2022-05-01,30,011,MT,Carter County,647,634,13,2
CN3001300000000,2022-05-01,30,013,MT,Cascade County,39129,38199,930,2.4
CN3001500000000,2022-05-01,30,015,MT,Chouteau County,2494,2439,55,2.2
CN3001700000000,2022-05-01,30,017,MT,Custer County,6598,6480,118,1.8
CN3001900000000,2022-05-01,30,019,MT,Daniels County,879,865,14,1.6
CN3002100000000,2022-05-01,30,021,MT,Dawson County,4624,4520,104,2.2
CN3002300000000,2022-05-01,30,023,MT,Deer Lodge County,5422,5313,109,2
CN3002500000000,2022-05-01,30,025,MT,Fallon County,1677,1650,27,1.6
CN3002700000000,2022-05-01,30,027,MT,Fergus County,6019,5878,141,2.3
CN3002900000000,2022-05-01,30,029,MT,Flathead County,52811,51359,1452,2.7
CN3003100000000,2022-05-01,30,031,MT,Gallatin County,77418,75958,1460,1.9
CN3003300000000,2022-05-01,30,033,MT,Garfield County,754,736,18,2.4
CN3003500000000,2022-05-01,30,035,MT,Glacier County,5620,5369,251,4.5
CN3003700000000,2022-05-01,30,037,MT,Golden Valley County,378,364,14,3.7
CN3003900000000,2022-05-01,30,039,MT,Granite County,1679,1621,58,3.5
CN3004100000000,2022-05-01,30,041,MT,Hill County,7653,7483,170,2.2
CN3004300000000,2022-05-01,30,043,MT,Jefferson County,6096,5956,140,2.3
CN3004500000000,2022-05-01,30,045,MT,Judith Basin County,960,941,19,2
CN3004700000000,2022-05-01,30,047,MT,Lake County,14344,13988,356,2.5
CN3004900000000,2022-05-01,30,049,MT,Lewis and Clark County,38689,37870,819,2.1
CN3005100000000,2022-05-01,30,051,MT,Liberty County,953,932,21,2.2
CN3005300000000,2022-05-01,30,053,MT,Lincoln County,8690,8301,389,4.5
CN3005500000000,2022-05-01,30,055,MT,McCone County,967,952,15,1.6
CN3005700000000,2022-05-01,30,057,MT,Madison County,4512,4395,117,2.6
CN3005900000000,2022-05-01,30,059,MT,Meagher County,945,926,19,2
CN3006100000000,2022-05-01,30,061,MT,Mineral County,1829,1751,78,4.3
CN3006300000000,2022-05-01,30,063,MT,Missoula County,67084,65517,1567,2.3
CN3006500000000,2022-05-01,30,065,MT,Musselshell County,2352,2297,55,2.3
CN3006700000000,2022-05-01,30,067,MT,Park County,10207,9974,233,2.3
CN3006900000000,2022-05-01,30,069,MT,Petroleum County,266,258,8,3
CN3007100000000,2022-05-01,30,071,MT,Phillips County,1807,1752,55,3
CN3007300000000,2022-05-01,30,073,MT,Pondera County,2604,2547,57,2.2
CN3007500000000,2022-05-01,30,075,MT,Powder River County,986,965,21,2.1
CN3007700000000,2022-05-01,30,077,MT,Powell County,3006,2934,72,2.4
CN3007900000000,2022-05-01,30,079,MT,Prairie County,487,474,13,2.7
CN3008100000000,2022-05-01,30,081,MT,Ravalli County,21847,21329,518,2.4
CN3008300000000,2022-05-01,30,083,MT,Richland County,5806,5649,157,2.7
CN3008500000000,2022-05-01,30,085,MT,Roosevelt County,4371,4225,146,3.3
CN3008700000000,2022-05-01,30,087,MT,Rosebud County,3707,3599,108,2.9
CN3008900000000,2022-05-01,30,089,MT,Sanders County,5487,5293,194,3.5
CN3009100000000,2022-05-01,30,091,MT,Sheridan County,1768,1740,28,1.6
CN3009300000000,2022-05-01,30,093,MT,Silver Bow County,17792,17347,445,2.5
CN3009500000000,2022-05-01,30,095,MT,Stillwater County,5566,5452,114,2
CN3009700000000,2022-05-01,30,097,MT,Sweet Grass County,1880,1845,35,1.9
CN3009900000000,2022-05-01,30,099,MT,Teton County,2783,2716,67,2.4
CN3010100000000,2022-05-01,30,101,MT,Toole County,2091,2051,40,1.9
CN3010300000000,2022-05-01,30,103,MT,Treasure County,345,339,6,1.7
CN3010500000000,2022-05-01,30,105,MT,Valley County,3999,3915,84,2.1
CN3010700000000,2022-05-01,30,107,MT,Wheatland County,734,713,21,2.9
CN3010900000000,2022-05-01,30,109,MT,Wibaux County,460,448,12,2.6
CN3011100000000,2022-05-01,30,111,MT,Yellowstone County,87939,86072,1867,2.1
CN3100100000000,2022-05-01,31,001,NE,Adams County,17432,17073,359,2.1
CN3100300000000,2022-05-01,31,003,NE,Antelope County,3736,3677,59,1.6
CN3100500000000,2022-05-01,31,005,NE,Arthur County,234,228,6,2.6
CN3100700000000,2022-05-01,31,007,NE,Banner County,394,385,9,2.3
CN3100900000000,2022-05-01,31,009,NE,Blaine County,259,250,9,3.5
CN3101100000000,2022-05-01,31,011,NE,Boone County,3085,3033,52,1.7
CN3101300000000,2022-05-01,31,013,NE,Box Butte County,5380,5260,120,2.2
CN3101500000000,2022-05-01,31,015,NE,Boyd County,1072,1051,21,2
CN3101700000000,2022-05-01,31,017,NE,Brown County,1470,1439,31,2.1
CN3101900000000,2022-05-01,31,019,NE,Buffalo County,28586,28062,524,1.8
CN3102100000000,2022-05-01,31,021,NE,Burt County,3650,3577,73,2
CN3102300000000,2022-05-01,31,023,NE,Butler County,4794,4714,80,1.7
CN3102500000000,2022-05-01,31,025,NE,Cass County,13719,13437,282,2.1
CN3102700000000,2022-05-01,31,027,NE,Cedar County,4747,4667,80,1.7
CN3102900000000,2022-05-01,31,029,NE,Chase County,2326,2286,40,1.7
CN3103100000000,2022-05-01,31,031,NE,Cherry County,3465,3409,56,1.6
CN3103300000000,2022-05-01,31,033,NE,Cheyenne County,4257,4161,96,2.3
CN3103500000000,2022-05-01,31,035,NE,Clay County,3144,3080,64,2
CN3103700000000,2022-05-01,31,037,NE,Colfax County,5813,5710,103,1.8
CN3103900000000,2022-05-01,31,039,NE,Cuming County,4939,4855,84,1.7
CN3104100000000,2022-05-01,31,041,NE,Custer County,6489,6382,107,1.6
CN3104300000000,2022-05-01,31,043,NE,Dakota County,11053,10817,236,2.1
CN3104500000000,2022-05-01,31,045,NE,Dawes County,5178,5078,100,1.9
CN3104700000000,2022-05-01,31,047,NE,Dawson County,13864,13569,295,2.1
CN3104900000000,2022-05-01,31,049,NE,Deuel County,1065,1045,20,1.9
CN3105100000000,2022-05-01,31,051,NE,Dixon County,3065,3009,56,1.8
CN3105300000000,2022-05-01,31,053,NE,Dodge County,20928,20517,411,2
CN3105500000000,2022-05-01,31,055,NE,Douglas County,307108,299994,7114,2.3
CN3105700000000,2022-05-01,31,057,NE,Dundy County,1200,1180,20,1.7
CN3105900000000,2022-05-01,31,059,NE,Fillmore County,3386,3332,54,1.6
CN3106100000000,2022-05-01,31,061,NE,Franklin County,1542,1508,34,2.2
CN3106300000000,2022-05-01,31,063,NE,Frontier County,1543,1512,31,2
CN3106500000000,2022-05-01,31,065,NE,Furnas County,2582,2538,44,1.7
CN3106700000000,2022-05-01,31,067,NE,Gage County,10991,10758,233,2.1
CN3106900000000,2022-05-01,31,069,NE,Garden County,1132,1111,21,1.9
CN3107100000000,2022-05-01,31,071,NE,Garfield County,1166,1146,20,1.7
CN3107300000000,2022-05-01,31,073,NE,Gosper County,1241,1222,19,1.5
CN3107500000000,2022-05-01,31,075,NE,Grant County,419,413,6,1.4
CN3107700000000,2022-05-01,31,077,NE,Greeley County,1262,1235,27,2.1
CN3107900000000,2022-05-01,31,079,NE,Hall County,33201,32324,877,2.6
CN3108100000000,2022-05-01,31,081,NE,Hamilton County,4975,4866,109,2.2
CN3108300000000,2022-05-01,31,083,NE,Harlan County,1885,1854,31,1.6
CN3108500000000,2022-05-01,31,085,NE,Hayes County,615,606,9,1.5
CN3108700000000,2022-05-01,31,087,NE,Hitchcock County,1334,1305,29,2.2
CN3108900000000,2022-05-01,31,089,NE,Holt County,5817,5727,90,1.5
CN3109100000000,2022-05-01,31,091,NE,Hooker County,464,453,11,2.4
CN3109300000000,2022-05-01,31,093,NE,Howard County,3549,3450,99,2.8
CN3109500000000,2022-05-01,31,095,NE,Jefferson County,4246,4180,66,1.6
CN3109700000000,2022-05-01,31,097,NE,Johnson County,2018,1971,47,2.3
CN3109900000000,2022-05-01,31,099,NE,Kearney County,3788,3721,67,1.8
CN3110100000000,2022-05-01,31,101,NE,Keith County,4799,4719,80,1.7
CN3110300000000,2022-05-01,31,103,NE,Keya Paha County,565,555,10,1.8
CN3110500000000,2022-05-01,31,105,NE,Kimball County,1975,1945,30,1.5
CN3110700000000,2022-05-01,31,107,NE,Knox County,4775,4695,80,1.7
CN3110900000000,2022-05-01,31,109,NE,Lancaster County,180760,177051,3709,2.1
CN3111100000000,2022-05-01,31,111,NE,Lincoln County,18644,18292,352,1.9
CN3111300000000,2022-05-01,31,113,NE,Logan County,498,488,10,2
CN3111500000000,2022-05-01,31,115,NE,Loup County,417,407,10,2.4
CN3111700000000,2022-05-01,31,117,NE,McPherson County,441,434,7,1.6
CN3111900000000,2022-05-01,31,119,NE,Madison County,20029,19675,354,1.8
CN3112100000000,2022-05-01,31,121,NE,Merrick County,4241,4152,89,2.1
CN3112300000000,2022-05-01,31,123,NE,Morrill County,2705,2655,50,1.8
CN3112500000000,2022-05-01,31,125,NE,Nance County,1987,1953,34,1.7
CN3112700000000,2022-05-01,31,127,NE,Nemaha County,3700,3617,83,2.2
CN3112900000000,2022-05-01,31,129,NE,Nuckolls County,2529,2482,47,1.9
CN3113100000000,2022-05-01,31,131,NE,Otoe County,8704,8527,177,2
CN3113300000000,2022-05-01,31,133,NE,Pawnee County,1512,1489,23,1.5
CN3113500000000,2022-05-01,31,135,NE,Perkins County,1899,1868,31,1.6
CN3113700000000,2022-05-01,31,137,NE,Phelps County,5069,4980,89,1.8
CN3113900000000,2022-05-01,31,139,NE,Pierce County,4283,4210,73,1.7
CN3114100000000,2022-05-01,31,141,NE,Platte County,18630,18282,348,1.9
CN3114300000000,2022-05-01,31,143,NE,Polk County,2993,2940,53,1.8
CN3114500000000,2022-05-01,31,145,NE,Red Willow County,5966,5856,110,1.8
CN3114700000000,2022-05-01,31,147,NE,Richardson County,4216,4142,74,1.8
CN3114900000000,2022-05-01,31,149,NE,Rock County,898,885,13,1.4
CN3115100000000,2022-05-01,31,151,NE,Saline County,7307,7144,163,2.2
CN3115300000000,2022-05-01,31,153,NE,Sarpy County,100193,98168,2025,2
CN3115500000000,2022-05-01,31,155,NE,Saunders County,11609,11396,213,1.8
CN3115700000000,2022-05-01,31,157,NE,Scotts Bluff County,18093,17682,411,2.3
CN3115900000000,2022-05-01,31,159,NE,Seward County,8940,8751,189,2.1
CN3116100000000,2022-05-01,31,161,NE,Sheridan County,2838,2784,54,1.9
CN3116300000000,2022-05-01,31,163,NE,Sherman County,1688,1652,36,2.1
CN3116500000000,2022-05-01,31,165,NE,Sioux County,766,753,13,1.7
CN3116700000000,2022-05-01,31,167,NE,Stanton County,3599,3542,57,1.6
CN3116900000000,2022-05-01,31,169,NE,Thayer County,2723,2680,43,1.6
CN3117100000000,2022-05-01,31,171,NE,Thomas County,452,443,9,2
CN3117300000000,2022-05-01,31,173,NE,Thurston County,3329,3223,106,3.2
CN3117500000000,2022-05-01,31,175,NE,Valley County,2167,2128,39,1.8
CN3117700000000,2022-05-01,31,177,NE,Washington County,11556,11330,226,2
CN3117900000000,2022-05-01,31,179,NE,Wayne County,5805,5685,120,2.1
CN3118100000000,2022-05-01,31,181,NE,Webster County,1721,1687,34,2
CN3118300000000,2022-05-01,31,183,NE,Wheeler County,583,576,7,1.2
CN3118500000000,2022-05-01,31,185,NE,York County,7555,7409,146,1.9
CN3200100000000,2022-05-01,32,001,NV,Churchill County,11191,10830,361,3.2
CN3200300000000,2022-05-01,32,003,NV,Clark County,1139989,1073030,66959,5.9
CN3200500000000,2022-05-01,32,005,NV,Douglas County,22067,21227,840,3.8
CN3200700000000,2022-05-01,32,007,NV,Elko County,25934,25175,759,2.9
CN3200900000000,2022-05-01,32,009,NV,Esmeralda County,445,432,13,2.9
CN3201100000000,2022-05-01,32,011,NV,Eureka County,1098,1070,28,2.6
CN3201300000000,2022-05-01,32,013,NV,Humboldt County,7966,7724,242,3
CN3201500000000,2022-05-01,32,015,NV,Lander County,3049,2943,106,3.5
CN3201700000000,2022-05-01,32,017,NV,Lincoln County,2123,2049,74,3.5
CN3201900000000,2022-05-01,32,019,NV,Lyon County,23804,22739,1065,4.5
CN3202100000000,2022-05-01,32,021,NV,Mineral County,1885,1807,78,4.1
CN3202300000000,2022-05-01,32,023,NV,Nye County,17547,16604,943,5.4
CN3202700000000,2022-05-01,32,027,NV,Pershing County,2607,2520,87,3.3
CN3202900000000,2022-05-01,32,029,NV,Storey County,2088,2005,83,4
CN3203100000000,2022-05-01,32,031,NV,Washoe County,256155,247761,8394,3.3
CN3203300000000,2022-05-01,32,033,NV,White Pine County,4476,4348,128,2.9
CN3251000000000,2022-05-01,32,510,NV,Carson City,25078,24147,931,3.7
CN3300100000000,2022-05-01,33,001,NH,Belknap County,30718,30068,650,2.1
CN3300300000000,2022-05-01,33,003,NH,Carroll County,22854,22355,499,2.2
CN3300500000000,2022-05-01,33,005,NH,Cheshire County,39231,38351,880,2.2
CN3300700000000,2022-05-01,33,007,NH,Coos County,14175,13806,369,2.6
CN3300900000000,2022-05-01,33,009,NH,Grafton County,47848,46871,977,2
CN3301100000000,2022-05-01,33,011,NH,Hillsborough County,239571,234448,5123,2.1
CN3301300000000,2022-05-01,33,013,NH,Merrimack County,82040,80460,1580,1.9
CN3301500000000,2022-05-01,33,015,NH,Rockingham County,187506,183501,4005,2.1
CN3301700000000,2022-05-01,33,017,NH,Strafford County,74097,72673,1424,1.9
CN3301900000000,2022-05-01,33,019,NH,Sullivan County,22601,22141,460,2
CN3400100000000,2022-05-01,34,001,NJ,Atlantic County,122071,116202,5869,4.8
CN3400300000000,2022-05-01,34,003,NJ,Bergen County,500649,484212,16437,3.3
CN3400500000000,2022-05-01,34,005,NJ,Burlington County,247151,239356,7795,3.2
CN3400700000000,2022-05-01,34,007,NJ,Camden County,269667,259502,10165,3.8
CN3400900000000,2022-05-01,34,009,NJ,Cape May County,46778,44232,2546,5.4
CN3401100000000,2022-05-01,34,011,NJ,Cumberland County,70163,67005,3158,4.5
CN3401300000000,2022-05-01,34,013,NJ,Essex County,386581,369917,16664,4.3
CN3401500000000,2022-05-01,34,015,NJ,Gloucester County,160852,155280,5572,3.5
CN3401700000000,2022-05-01,34,017,NJ,Hudson County,374765,361594,13171,3.5
CN3401900000000,2022-05-01,34,019,NJ,Hunterdon County,67963,66049,1914,2.8
CN3402100000000,2022-05-01,34,021,NJ,Mercer County,214788,208152,6636,3.1
CN3402300000000,2022-05-01,34,023,NJ,Middlesex County,461820,447016,14804,3.2
CN3402500000000,2022-05-01,34,025,NJ,Monmouth County,346460,335448,11012,3.2
CN3402700000000,2022-05-01,34,027,NJ,Morris County,267997,260073,7924,3
CN3402900000000,2022-05-01,34,029,NJ,Ocean County,296707,286276,10431,3.5
CN3403100000000,2022-05-01,34,031,NJ,Passaic County,250963,240170,10793,4.3
CN3403300000000,2022-05-01,34,033,NJ,Salem County,30571,29259,1312,4.3
CN3403500000000,2022-05-01,34,035,NJ,Somerset County,178923,173509,5414,3
CN3403700000000,2022-05-01,34,037,NJ,Sussex County,77285,74621,2664,3.4
CN3403900000000,2022-05-01,34,039,NJ,Union County,288478,277937,10541,3.7
CN3404100000000,2022-05-01,34,041,NJ,Warren County,58805,56907,1898,3.2
CN3500100000000,2022-05-01,35,001,NM,Bernalillo County,334938,323210,11728,3.5
CN3500300000000,2022-05-01,35,003,NM,Catron County,1169,1113,56,4.8
CN3500500000000,2022-05-01,35,005,NM,Chaves County,27738,26639,1099,4
CN3500600000000,2022-05-01,35,006,NM,Cibola County,8147,7728,419,5.1
CN3500700000000,2022-05-01,35,007,NM,Colfax County,5234,5029,205,3.9
CN3500900000000,2022-05-01,35,009,NM,Curry County,22644,21958,686,3
CN3501100000000,2022-05-01,35,011,NM,De Baca County,712,690,22,3.1
CN3501300000000,2022-05-01,35,013,NM,Dona Ana County,99372,95084,4288,4.3
CN3501500000000,2022-05-01,35,015,NM,Eddy County,31197,30187,1010,3.2
CN3501700000000,2022-05-01,35,017,NM,Grant County,11661,11213,448,3.8
CN3501900000000,2022-05-01,35,019,NM,Guadalupe County,1425,1346,79,5.5
CN3502100000000,2022-05-01,35,021,NM,Harding County,287,278,9,3.1
CN3502300000000,2022-05-01,35,023,NM,Hidalgo County,1977,1913,64,3.2
CN3502500000000,2022-05-01,35,025,NM,Lea County,29104,27880,1224,4.2
CN3502700000000,2022-05-01,35,027,NM,Lincoln County,8796,8455,341,3.9
CN3502800000000,2022-05-01,35,028,NM,Los Alamos County,10441,10224,217,2.1
CN3502900000000,2022-05-01,35,029,NM,Luna County,9924,8967,957,9.6
CN3503100000000,2022-05-01,35,031,NM,McKinley County,22528,21332,1196,5.3
CN3503300000000,2022-05-01,35,033,NM,Mora County,1954,1820,134,6.9
CN3503500000000,2022-05-01,35,035,NM,Otero County,24860,23875,985,4
CN3503700000000,2022-05-01,35,037,NM,Quay County,3055,2934,121,4
CN3503900000000,2022-05-01,35,039,NM,Rio Arriba County,16574,15866,708,4.3
CN3504100000000,2022-05-01,35,041,NM,Roosevelt County,8108,7824,284,3.5
CN3504300000000,2022-05-01,35,043,NM,Sandoval County,67615,65162,2453,3.6
CN3504500000000,2022-05-01,35,045,NM,San Juan County,49241,47103,2138,4.3
CN3504700000000,2022-05-01,35,047,NM,San Miguel County,10232,9760,472,4.6
CN3504900000000,2022-05-01,35,049,NM,Santa Fe County,72544,70061,2483,3.4
CN3505100000000,2022-05-01,35,051,NM,Sierra County,3974,3720,254,6.4
CN3505300000000,2022-05-01,35,053,NM,Socorro County,6099,5858,241,4
CN3505500000000,2022-05-01,35,055,NM,Taos County,14424,13680,744,5.2
CN3505700000000,2022-05-01,35,057,NM,Torrance County,5370,5093,277,5.2
CN3505900000000,2022-05-01,35,059,NM,Union County,1494,1452,42,2.8
CN3506100000000,2022-05-01,35,061,NM,Valencia County,30922,29649,1273,4.1
CN3600100000000,2022-05-01,36,001,NY,Albany County,160015,155584,4431,2.8
CN3600300000000,2022-05-01,36,003,NY,Allegany County,19295,18646,649,3.4
CN3600500000000,2022-05-01,36,005,NY,Bronx County,599022,554713,44309,7.4
CN3600700000000,2022-05-01,36,007,NY,Broome County,83156,80438,2718,3.3
CN3600900000000,2022-05-01,36,009,NY,Cattaraugus County,33012,31877,1135,3.4
CN3601100000000,2022-05-01,36,011,NY,Cayuga County,35912,34852,1060,3
CN3601300000000,2022-05-01,36,013,NY,Chautauqua County,53481,51742,1739,3.3
CN3601500000000,2022-05-01,36,015,NY,Chemung County,35064,33921,1143,3.3
CN3601700000000,2022-05-01,36,017,NY,Chenango County,22156,21534,622,2.8
CN3601900000000,2022-05-01,36,019,NY,Clinton County,35742,34718,1024,2.9
CN3602100000000,2022-05-01,36,021,NY,Columbia County,30850,30114,736,2.4
CN3602300000000,2022-05-01,36,023,NY,Cortland County,22626,21930,696,3.1
CN3602500000000,2022-05-01,36,025,NY,Delaware County,19071,18482,589,3.1
CN3602700000000,2022-05-01,36,027,NY,Dutchess County,146327,142254,4073,2.8
CN3602900000000,2022-05-01,36,029,NY,Erie County,446193,432147,14046,3.1
CN3603100000000,2022-05-01,36,031,NY,Essex County,16007,15514,493,3.1
CN3603300000000,2022-05-01,36,033,NY,Franklin County,18839,18246,593,3.1
CN3603500000000,2022-05-01,36,035,NY,Fulton County,22582,21807,775,3.4
CN3603700000000,2022-05-01,36,037,NY,Genesee County,29761,28967,794,2.7
CN3603900000000,2022-05-01,36,039,NY,Greene County,20236,19619,617,3
CN3604100000000,2022-05-01,36,041,NY,Hamilton County,2168,2086,82,3.8
CN3604300000000,2022-05-01,36,043,NY,Herkimer County,27402,26511,891,3.3
CN3604500000000,2022-05-01,36,045,NY,Jefferson County,44457,42977,1480,3.3
CN3604700000000,2022-05-01,36,047,NY,Kings County,1201794,1134909,66885,5.6
CN3604900000000,2022-05-01,36,049,NY,Lewis County,11667,11292,375,3.2
CN3605100000000,2022-05-01,36,051,NY,Livingston County,30468,29573,895,2.9
CN3605300000000,2022-05-01,36,053,NY,Madison County,32675,31755,920,2.8
CN3605500000000,2022-05-01,36,055,NY,Monroe County,367067,355647,11420,3.1
CN3605700000000,2022-05-01,36,057,NY,Montgomery County,22331,21561,770,3.4
CN3605900000000,2022-05-01,36,059,NY,Nassau County,731194,711944,19250,2.6
CN3606100000000,2022-05-01,36,061,NY,New York County,914778,874887,39891,4.4
CN3606300000000,2022-05-01,36,063,NY,Niagara County,98361,95158,3203,3.3
CN3606500000000,2022-05-01,36,065,NY,Oneida County,100494,97364,3130,3.1
CN3606700000000,2022-05-01,36,067,NY,Onondaga County,223381,216620,6761,3
CN3606900000000,2022-05-01,36,069,NY,Ontario County,56176,54675,1501,2.7
CN3607100000000,2022-05-01,36,071,NY,Orange County,190646,185086,5560,2.9
CN3607300000000,2022-05-01,36,073,NY,Orleans County,17196,16638,558,3.2
CN3607500000000,2022-05-01,36,075,NY,Oswego County,52598,50729,1869,3.6
CN3607700000000,2022-05-01,36,077,NY,Otsego County,27762,27006,756,2.7
CN3607900000000,2022-05-01,36,079,NY,Putnam County,51955,50566,1389,2.7
CN3608100000000,2022-05-01,36,081,NY,Queens County,1135313,1078354,56959,5
CN3608300000000,2022-05-01,36,083,NY,Rensselaer County,82483,80265,2218,2.7
CN3608500000000,2022-05-01,36,085,NY,Richmond County,225403,213636,11767,5.2
CN3608700000000,2022-05-01,36,087,NY,Rockland County,159842,155693,4149,2.6
CN3608900000000,2022-05-01,36,089,NY,St. Lawrence County,43616,42101,1515,3.5
CN3609100000000,2022-05-01,36,091,NY,Saratoga County,122196,119311,2885,2.4
CN3609300000000,2022-05-01,36,093,NY,Schenectady County,78227,75859,2368,3
CN3609500000000,2022-05-01,36,095,NY,Schoharie County,14785,14348,437,3
CN3609700000000,2022-05-01,36,097,NY,Schuyler County,8191,7937,254,3.1
CN3609900000000,2022-05-01,36,099,NY,Seneca County,14938,14531,407,2.7
CN3610100000000,2022-05-01,36,101,NY,Steuben County,41685,40379,1306,3.1
CN3610300000000,2022-05-01,36,103,NY,Suffolk County,801516,779189,22327,2.8
CN3610500000000,2022-05-01,36,105,NY,Sullivan County,37435,36353,1082,2.9
CN3610700000000,2022-05-01,36,107,NY,Tioga County,22475,21863,612,2.7
CN3610900000000,2022-05-01,36,109,NY,Tompkins County,51045,49785,1260,2.5
CN3611100000000,2022-05-01,36,111,NY,Ulster County,88477,86023,2454,2.8
CN3611300000000,2022-05-01,36,113,NY,Warren County,31106,30173,933,3
CN3611500000000,2022-05-01,36,115,NY,Washington County,27396,26617,779,2.8
CN3611700000000,2022-05-01,36,117,NY,Wayne County,43605,42401,1204,2.8
CN3611900000000,2022-05-01,36,119,NY,Westchester County,498180,483989,14191,2.8
CN3612100000000,2022-05-01,36,121,NY,Wyoming County,17620,17137,483,2.7
CN3612300000000,2022-05-01,36,123,NY,Yates County,11722,11429,293,2.5
CN3700100000000,2022-05-01,37,001,NC,Alamance County,83334,80293,3041,3.6
CN3700300000000,2022-05-01,37,003,NC,Alexander County,18169,17585,584,3.2
CN3700500000000,2022-05-01,37,005,NC,Alleghany County,4602,4433,169,3.7
CN3700700000000,2022-05-01,37,007,NC,Anson County,10388,9955,433,4.2
CN3700900000000,2022-05-01,37,009,NC,Ashe County,13169,12745,424,3.2
CN3701100000000,2022-05-01,37,011,NC,Avery County,7820,7556,264,3.4
CN3701300000000,2022-05-01,37,013,NC,Beaufort County,20140,19360,780,3.9
CN3701500000000,2022-05-01,37,015,NC,Bertie County,7249,6900,349,4.8
CN3701700000000,2022-05-01,37,017,NC,Bladen County,14691,14095,596,4.1
CN3701900000000,2022-05-01,37,019,NC,Brunswick County,57865,55280,2585,4.5
CN3702100000000,2022-05-01,37,021,NC,Buncombe County,142619,138371,4248,3
CN3702300000000,2022-05-01,37,023,NC,Burke County,41131,39738,1393,3.4
CN3702500000000,2022-05-01,37,025,NC,Cabarrus County,116213,112406,3807,3.3
CN3702700000000,2022-05-01,37,027,NC,Caldwell County,36648,35329,1319,3.6
CN3702900000000,2022-05-01,37,029,NC,Camden County,4766,4576,190,4
CN3703100000000,2022-05-01,37,031,NC,Carteret County,32792,31690,1102,3.4
CN3703300000000,2022-05-01,37,033,NC,Caswell County,9648,9272,376,3.9
CN3703500000000,2022-05-01,37,035,NC,Catawba County,79899,77196,2703,3.4
CN3703700000000,2022-05-01,37,037,NC,Chatham County,37621,36461,1160,3.1
CN3703900000000,2022-05-01,37,039,NC,Cherokee County,11359,10922,437,3.8
CN3704100000000,2022-05-01,37,041,NC,Chowan County,5849,5618,231,3.9
CN3704300000000,2022-05-01,37,043,NC,Clay County,4240,4071,169,4
CN3704500000000,2022-05-01,37,045,NC,Cleveland County,49429,47575,1854,3.8
CN3704700000000,2022-05-01,37,047,NC,Columbus County,23616,22647,969,4.1
CN3704900000000,2022-05-01,37,049,NC,Craven County,42345,40825,1520,3.6
CN3705100000000,2022-05-01,37,051,NC,Cumberland County,128354,122145,6209,4.8
CN3705300000000,2022-05-01,37,053,NC,Currituck County,14707,14219,488,3.3
CN3705500000000,2022-05-01,37,055,NC,Dare County,20922,20172,750,3.6
CN3705700000000,2022-05-01,37,057,NC,Davidson County,81676,78865,2811,3.4
CN3705900000000,2022-05-01,37,059,NC,Davie County,20860,20155,705,3.4
CN3706100000000,2022-05-01,37,061,NC,Duplin County,25403,24481,922,3.6
CN3706300000000,2022-05-01,37,063,NC,Durham County,179252,173639,5613,3.1
CN3706500000000,2022-05-01,37,065,NC,Edgecombe County,20258,19016,1242,6.1
CN3706700000000,2022-05-01,37,067,NC,Forsyth County,189056,182169,6887,3.6
CN3706900000000,2022-05-01,37,069,NC,Franklin County,33958,32731,1227,3.6
CN3707100000000,2022-05-01,37,071,NC,Gaston County,114731,110663,4068,3.5
CN3707300000000,2022-05-01,37,073,NC,Gates County,5155,4976,179,3.5
CN3707500000000,2022-05-01,37,075,NC,Graham County,3040,2891,149,4.9
CN3707700000000,2022-05-01,37,077,NC,Granville County,30446,29497,949,3.1
CN3707900000000,2022-05-01,37,079,NC,Greene County,9787,9468,319,3.3
CN3708100000000,2022-05-01,37,081,NC,Guilford County,261486,251195,10291,3.9
CN3708300000000,2022-05-01,37,083,NC,Halifax County,19403,18413,990,5.1
CN3708500000000,2022-05-01,37,085,NC,Harnett County,55240,53023,2217,4
CN3708700000000,2022-05-01,37,087,NC,Haywood County,30345,29369,976,3.2
CN3708900000000,2022-05-01,37,089,NC,Henderson County,55859,54063,1796,3.2
CN3709100000000,2022-05-01,37,091,NC,Hertford County,8520,8100,420,4.9
CN3709300000000,2022-05-01,37,093,NC,Hoke County,20421,19471,950,4.7
CN3709500000000,2022-05-01,37,095,NC,Hyde County,1834,1749,85,4.6
CN3709700000000,2022-05-01,37,097,NC,Iredell County,94798,91644,3154,3.3
CN3709900000000,2022-05-01,37,099,NC,Jackson County,20115,19348,767,3.8
CN3710100000000,2022-05-01,37,101,NC,Johnston County,108061,104504,3557,3.3
CN3710300000000,2022-05-01,37,103,NC,Jones County,4386,4239,147,3.4
CN3710500000000,2022-05-01,37,105,NC,Lee County,26290,25226,1064,4
CN3710700000000,2022-05-01,37,107,NC,Lenoir County,27668,26681,987,3.6
CN3710900000000,2022-05-01,37,109,NC,Lincoln County,46510,45056,1454,3.1
CN3711100000000,2022-05-01,37,111,NC,McDowell County,20490,19792,698,3.4
CN3711300000000,2022-05-01,37,113,NC,Macon County,16207,15647,560,3.5
CN3711500000000,2022-05-01,37,115,NC,Madison County,10137,9787,350,3.5
CN3711700000000,2022-05-01,37,117,NC,Martin County,8790,8411,379,4.3
CN3711900000000,2022-05-01,37,119,NC,Mecklenburg County,652056,630415,21641,3.3
CN3712100000000,2022-05-01,37,121,NC,Mitchell County,5993,5752,241,4
CN3712300000000,2022-05-01,37,123,NC,Montgomery County,11438,11017,421,3.7
CN3712500000000,2022-05-01,37,125,NC,Moore County,42497,40931,1566,3.7
CN3712700000000,2022-05-01,37,127,NC,Nash County,42370,40335,2035,4.8
CN3712900000000,2022-05-01,37,129,NC,New Hanover County,130226,126041,4185,3.2
CN3713100000000,2022-05-01,37,131,NC,Northampton County,7346,7010,336,4.6
CN3713300000000,2022-05-01,37,133,NC,Onslow County,68704,65798,2906,4.2
CN3713500000000,2022-05-01,37,135,NC,Orange County,81804,79240,2564,3.1
CN3713700000000,2022-05-01,37,137,NC,Pamlico County,5561,5355,206,3.7
CN3713900000000,2022-05-01,37,139,NC,Pasquotank County,16888,16177,711,4.2
CN3714100000000,2022-05-01,37,141,NC,Pender County,30991,29950,1041,3.4
CN3714300000000,2022-05-01,37,143,NC,Perquimans County,5052,4834,218,4.3
CN3714500000000,2022-05-01,37,145,NC,Person County,18887,18182,705,3.7
CN3714700000000,2022-05-01,37,147,NC,Pitt County,88528,84951,3577,4
CN3714900000000,2022-05-01,37,149,NC,Polk County,9454,9095,359,3.8
CN3715100000000,2022-05-01,37,151,NC,Randolph County,65807,63485,2322,3.5
CN3715300000000,2022-05-01,37,153,NC,Richmond County,17032,16224,808,4.7
CN3715500000000,2022-05-01,37,155,NC,Robeson County,48690,46174,2516,5.2
CN3715700000000,2022-05-01,37,157,NC,Rockingham County,39705,38139,1566,3.9
CN3715900000000,2022-05-01,37,159,NC,Rowan County,67884,65472,2412,3.6
CN3716100000000,2022-05-01,37,161,NC,Rutherford County,25096,23946,1150,4.6
CN3716300000000,2022-05-01,37,163,NC,Sampson County,29268,28214,1054,3.6
CN3716500000000,2022-05-01,37,165,NC,Scotland County,11240,10554,686,6.1
CN3716700000000,2022-05-01,37,167,NC,Stanly County,31061,30061,1000,3.2
CN3716900000000,2022-05-01,37,169,NC,Stokes County,21744,21016,728,3.3
CN3717100000000,2022-05-01,37,171,NC,Surry County,33012,31863,1149,3.5
CN3717300000000,2022-05-01,37,173,NC,Swain County,7287,7056,231,3.2
CN3717500000000,2022-05-01,37,175,NC,Transylvania County,14781,14269,512,3.5
CN3717700000000,2022-05-01,37,177,NC,Tyrrell County,1383,1323,60,4.3
CN3717900000000,2022-05-01,37,179,NC,Union County,130732,126613,4119,3.2
CN3718100000000,2022-05-01,37,181,NC,Vance County,16879,15956,923,5.5
CN3718300000000,2022-05-01,37,183,NC,Wake County,629872,610686,19186,3
CN3718500000000,2022-05-01,37,185,NC,Warren County,6462,6102,360,5.6
CN3718700000000,2022-05-01,37,187,NC,Washington County,4353,4145,208,4.8
CN3718900000000,2022-05-01,37,189,NC,Watauga County,29261,28251,1010,3.5
CN3719100000000,2022-05-01,37,191,NC,Wayne County,51287,49229,2058,4
CN3719300000000,2022-05-01,37,193,NC,Wilkes County,27700,26639,1061,3.8
CN3719500000000,2022-05-01,37,195,NC,Wilson County,33938,32252,1686,5
CN3719700000000,2022-05-01,37,197,NC,Yadkin County,17755,17154,601,3.4
CN3719900000000,2022-05-01,37,199,NC,Yancey County,8309,8010,299,3.6
CN3800100000000,2022-05-01,38,001,ND,Adams County,936,917,19,2
CN3800300000000,2022-05-01,38,003,ND,Barnes County,5293,5197,96,1.8
CN3800500000000,2022-05-01,38,005,ND,Benson County,2349,2293,56,2.4
CN3800700000000,2022-05-01,38,007,ND,Billings County,459,450,9,2
CN3800900000000,2022-05-01,38,009,ND,Bottineau County,3074,3003,71,2.3
CN3801100000000,2022-05-01,38,011,ND,Bowman County,1554,1530,24,1.5
CN3801300000000,2022-05-01,38,013,ND,Burke County,1052,1033,19,1.8
CN3801500000000,2022-05-01,38,015,ND,Burleigh County,52866,52028,838,1.6
CN3801700000000,2022-05-01,38,017,ND,Cass County,110967,109321,1646,1.5
CN3801900000000,2022-05-01,38,019,ND,Cavalier County,1882,1842,40,2.1
CN3802100000000,2022-05-01,38,021,ND,Dickey County,2265,2228,37,1.6
CN3802300000000,2022-05-01,38,023,ND,Divide County,1440,1422,18,1.3
CN3802500000000,2022-05-01,38,025,ND,Dunn County,3230,3189,41,1.3
CN3802700000000,2022-05-01,38,027,ND,Eddy County,1187,1160,27,2.3
CN3802900000000,2022-05-01,38,029,ND,Emmons County,1472,1428,44,3
CN3803100000000,2022-05-01,38,031,ND,Foster County,1550,1521,29,1.9
CN3803300000000,2022-05-01,38,033,ND,Golden Valley County,836,824,12,1.4
CN3803500000000,2022-05-01,38,035,ND,Grand Forks County,37829,37219,610,1.6
CN3803700000000,2022-05-01,38,037,ND,Grant County,1200,1183,17,1.4
CN3803900000000,2022-05-01,38,039,ND,Griggs County,1032,1013,19,1.8
CN3804100000000,2022-05-01,38,041,ND,Hettinger County,1407,1389,18,1.3
CN3804300000000,2022-05-01,38,043,ND,Kidder County,1276,1235,41,3.2
CN3804500000000,2022-05-01,38,045,ND,LaMoure County,2141,2111,30,1.4
CN3804700000000,2022-05-01,38,047,ND,Logan County,864,852,12,1.4
CN3804900000000,2022-05-01,38,049,ND,McHenry County,3177,3099,78,2.5
CN3805100000000,2022-05-01,38,051,ND,McIntosh County,1066,1047,19,1.8
CN3805300000000,2022-05-01,38,053,ND,McKenzie County,8839,8700,139,1.6
CN3805500000000,2022-05-01,38,055,ND,McLean County,4862,4743,119,2.4
CN3805700000000,2022-05-01,38,057,ND,Mercer County,3768,3683,85,2.3
CN3805900000000,2022-05-01,38,059,ND,Morton County,17304,16968,336,1.9
CN3806100000000,2022-05-01,38,061,ND,Mountrail County,6365,6279,86,1.4
CN3806300000000,2022-05-01,38,063,ND,Nelson County,1486,1452,34,2.3
CN3806500000000,2022-05-01,38,065,ND,Oliver County,879,859,20,2.3
CN3806700000000,2022-05-01,38,067,ND,Pembina County,3266,3177,89,2.7
CN3806900000000,2022-05-01,38,069,ND,Pierce County,1701,1665,36,2.1
CN3807100000000,2022-05-01,38,071,ND,Ramsey County,5732,5616,116,2
CN3807300000000,2022-05-01,38,073,ND,Ransom County,2715,2674,41,1.5
CN3807500000000,2022-05-01,38,075,ND,Renville County,1238,1216,22,1.8
CN3807700000000,2022-05-01,38,077,ND,Richland County,8858,8716,142,1.6
CN3807900000000,2022-05-01,38,079,ND,Rolette County,4735,4543,192,4.1
CN3808100000000,2022-05-01,38,081,ND,Sargent County,2340,2304,36,1.5
CN3808300000000,2022-05-01,38,083,ND,Sheridan County,663,650,13,2
CN3808500000000,2022-05-01,38,085,ND,Sioux County,1237,1208,29,2.3
CN3808700000000,2022-05-01,38,087,ND,Slope County,329,322,7,2.1
CN3808900000000,2022-05-01,38,089,ND,Stark County,18008,17721,287,1.6
CN3809100000000,2022-05-01,38,091,ND,Steele County,947,930,17,1.8
CN3809300000000,2022-05-01,38,093,ND,Stutsman County,10598,10418,180,1.7
CN3809500000000,2022-05-01,38,095,ND,Towner County,1131,1107,24,2.1
CN3809700000000,2022-05-01,38,097,ND,Traill County,4551,4475,76,1.7
CN3809900000000,2022-05-01,38,099,ND,Walsh County,5281,5161,120,2.3
CN3810100000000,2022-05-01,38,101,ND,Ward County,32696,32066,630,1.9
CN3810300000000,2022-05-01,38,103,ND,Wells County,1927,1884,43,2.2
CN3810500000000,2022-05-01,38,105,ND,Williams County,21755,21357,398,1.8
CN3900100000000,2022-05-01,39,001,OH,Adams County,10911,10485,426,3.9
CN3900300000000,2022-05-01,39,003,OH,Allen County,46975,45295,1680,3.6
CN3900500000000,2022-05-01,39,005,OH,Ashland County,26116,25305,811,3.1
CN3900700000000,2022-05-01,39,007,OH,Ashtabula County,43483,41891,1592,3.7
CN3900900000000,2022-05-01,39,009,OH,Athens County,25611,24484,1127,4.4
CN3901100000000,2022-05-01,39,011,OH,Auglaize County,24177,23533,644,2.7
CN3901300000000,2022-05-01,39,013,OH,Belmont County,27444,26254,1190,4.3
CN3901500000000,2022-05-01,39,015,OH,Brown County,19403,18685,718,3.7
CN3901700000000,2022-05-01,39,017,OH,Butler County,197232,190956,6276,3.2
CN3901900000000,2022-05-01,39,019,OH,Carroll County,12637,12186,451,3.6
CN3902100000000,2022-05-01,39,021,OH,Champaign County,19349,18729,620,3.2
CN3902300000000,2022-05-01,39,023,OH,Clark County,63003,60798,2205,3.5
CN3902500000000,2022-05-01,39,025,OH,Clermont County,107986,104673,3313,3.1
CN3902700000000,2022-05-01,39,027,OH,Clinton County,17856,17189,667,3.7
CN3902900000000,2022-05-01,39,029,OH,Columbiana County,44941,43124,1817,4
CN3903100000000,2022-05-01,39,031,OH,Coshocton County,13725,13135,590,4.3
CN3903300000000,2022-05-01,39,033,OH,Crawford County,17724,17007,717,4
CN3903500000000,2022-05-01,39,035,OH,Cuyahoga County,602258,571287,30971,5.1
CN3903700000000,2022-05-01,39,037,OH,Darke County,25721,24950,771,3
CN3903900000000,2022-05-01,39,039,OH,Defiance County,17543,16949,594,3.4
CN3904100000000,2022-05-01,39,041,OH,Delaware County,116179,112999,3180,2.7
CN3904300000000,2022-05-01,39,043,OH,Erie County,37978,36461,1517,4
CN3904500000000,2022-05-01,39,045,OH,Fairfield County,80675,78163,2512,3.1
CN3904700000000,2022-05-01,39,047,OH,Fayette County,13802,13353,449,3.3
CN3904900000000,2022-05-01,39,049,OH,Franklin County,712685,690150,22535,3.2
CN3905100000000,2022-05-01,39,051,OH,Fulton County,21762,20963,799,3.7
CN3905300000000,2022-05-01,39,053,OH,Gallia County,12180,11693,487,4
CN3905500000000,2022-05-01,39,055,OH,Geauga County,48370,46396,1974,4.1
CN3905700000000,2022-05-01,39,057,OH,Greene County,82203,79524,2679,3.3
CN3905900000000,2022-05-01,39,059,OH,Guernsey County,17763,17026,737,4.1
CN3906100000000,2022-05-01,39,061,OH,Hamilton County,417885,404195,13690,3.3
CN3906300000000,2022-05-01,39,063,OH,Hancock County,40674,39402,1272,3.1
CN3906500000000,2022-05-01,39,065,OH,Hardin County,13643,13153,490,3.6
CN3906700000000,2022-05-01,39,067,OH,Harrison County,6469,6194,275,4.3
CN3906900000000,2022-05-01,39,069,OH,Henry County,12752,12290,462,3.6
CN3907100000000,2022-05-01,39,071,OH,Highland County,17310,16630,680,3.9
CN3907300000000,2022-05-01,39,073,OH,Hocking County,12962,12524,438,3.4
CN3907500000000,2022-05-01,39,075,OH,Holmes County,21844,21320,524,2.4
CN3907700000000,2022-05-01,39,077,OH,Huron County,27966,26893,1073,3.8
CN3907900000000,2022-05-01,39,079,OH,Jackson County,12371,11853,518,4.2
CN3908100000000,2022-05-01,39,081,OH,Jefferson County,27220,25918,1302,4.8
CN3908300000000,2022-05-01,39,083,OH,Knox County,31153,30215,938,3
CN3908500000000,2022-05-01,39,085,OH,Lake County,124967,119495,5472,4.4
CN3908700000000,2022-05-01,39,087,OH,Lawrence County,23356,22430,926,4
CN3908900000000,2022-05-01,39,089,OH,Licking County,92350,89579,2771,3
CN3909100000000,2022-05-01,39,091,OH,Logan County,22507,21834,673,3
CN3909300000000,2022-05-01,39,093,OH,Lorain County,154178,146423,7755,5
CN3909500000000,2022-05-01,39,095,OH,Lucas County,203558,195626,7932,3.9
CN3909700000000,2022-05-01,39,097,OH,Madison County,21095,20495,600,2.8
CN3909900000000,2022-05-01,39,099,OH,Mahoning County,98408,94273,4135,4.2
CN3910100000000,2022-05-01,39,101,OH,Marion County,27512,26576,936,3.4
CN3910300000000,2022-05-01,39,103,OH,Medina County,97903,93871,4032,4.1
CN3910500000000,2022-05-01,39,105,OH,Meigs County,8652,8236,416,4.8
CN3910700000000,2022-05-01,39,107,OH,Mercer County,23059,22504,555,2.4
CN3910900000000,2022-05-01,39,109,OH,Miami County,53371,51722,1649,3.1
CN3911100000000,2022-05-01,39,111,OH,Monroe County,5064,4809,255,5
CN3911300000000,2022-05-01,39,113,OH,Montgomery County,245623,236593,9030,3.7
CN3911500000000,2022-05-01,39,115,OH,Morgan County,6740,6463,277,4.1
CN3911700000000,2022-05-01,39,117,OH,Morrow County,17053,16491,562,3.3
CN3911900000000,2022-05-01,39,119,OH,Muskingum County,40735,39272,1463,3.6
CN3912100000000,2022-05-01,39,121,OH,Noble County,4573,4336,237,5.2
CN3912300000000,2022-05-01,39,123,OH,Ottawa County,20905,20116,789,3.8
CN3912500000000,2022-05-01,39,125,OH,Paulding County,8758,8495,263,3
CN3912700000000,2022-05-01,39,127,OH,Perry County,15974,15397,577,3.6
CN3912900000000,2022-05-01,39,129,OH,Pickaway County,26926,26047,879,3.3
CN3913100000000,2022-05-01,39,131,OH,Pike County,11057,10595,462,4.2
CN3913300000000,2022-05-01,39,133,OH,Portage County,85230,82415,2815,3.3
CN3913500000000,2022-05-01,39,135,OH,Preble County,22014,21369,645,2.9
CN3913700000000,2022-05-01,39,137,OH,Putnam County,19031,18554,477,2.5
CN3913900000000,2022-05-01,39,139,OH,Richland County,50614,48655,1959,3.9
CN3914100000000,2022-05-01,39,141,OH,Ross County,35317,34164,1153,3.3
CN3914300000000,2022-05-01,39,143,OH,Sandusky County,30233,28957,1276,4.2
CN3914500000000,2022-05-01,39,145,OH,Scioto County,29166,27903,1263,4.3
CN3914700000000,2022-05-01,39,147,OH,Seneca County,26525,25534,991,3.7
CN3914900000000,2022-05-01,39,149,OH,Shelby County,23567,22834,733,3.1
CN3915100000000,2022-05-01,39,151,OH,Stark County,182020,175594,6426,3.5
CN3915300000000,2022-05-01,39,153,OH,Summit County,265484,255982,9502,3.6
CN3915500000000,2022-05-01,39,155,OH,Trumbull County,82992,79491,3501,4.2
CN3915700000000,2022-05-01,39,157,OH,Tuscarawas County,44724,43311,1413,3.2
CN3915900000000,2022-05-01,39,159,OH,Union County,30336,29543,793,2.6
CN3916100000000,2022-05-01,39,161,OH,Van Wert County,14478,14052,426,2.9
CN3916300000000,2022-05-01,39,163,OH,Vinton County,5432,5215,217,4
CN3916500000000,2022-05-01,39,165,OH,Warren County,122652,119067,3585,2.9
CN3916700000000,2022-05-01,39,167,OH,Washington County,26808,25714,1094,4.1
CN3916900000000,2022-05-01,39,169,OH,Wayne County,60637,58944,1693,2.8
CN3917100000000,2022-05-01,39,171,OH,Williams County,18135,17594,541,3
CN3917300000000,2022-05-01,39,173,OH,Wood County,69609,67421,2188,3.1
CN3917500000000,2022-05-01,39,175,OH,Wyandot County,13343,13005,338,2.5
CN4000100000000,2022-05-01,40,001,OK,Adair County,8647,8376,271,3.1
CN4000300000000,2022-05-01,40,003,OK,Alfalfa County,2796,2740,56,2
CN4000500000000,2022-05-01,40,005,OK,Atoka County,5260,5066,194,3.7
CN4000700000000,2022-05-01,40,007,OK,Beaver County,2735,2690,45,1.6
CN4000900000000,2022-05-01,40,009,OK,Beckham County,10578,10310,268,2.5
CN4001100000000,2022-05-01,40,011,OK,Blaine County,4432,4326,106,2.4
CN4001300000000,2022-05-01,40,013,OK,Bryan County,22906,22287,619,2.7
CN4001500000000,2022-05-01,40,015,OK,Caddo County,12026,11654,372,3.1
CN4001700000000,2022-05-01,40,017,OK,Canadian County,80312,78313,1999,2.5
CN4001900000000,2022-05-01,40,019,OK,Carter County,21699,20920,779,3.6
CN4002100000000,2022-05-01,40,021,OK,Cherokee County,20265,19559,706,3.5
CN4002300000000,2022-05-01,40,023,OK,Choctaw County,6045,5782,263,4.4
CN4002500000000,2022-05-01,40,025,OK,Cimarron County,1611,1588,23,1.4
CN4002700000000,2022-05-01,40,027,OK,Cleveland County,147956,144302,3654,2.5
CN4002900000000,2022-05-01,40,029,OK,Coal County,2392,2319,73,3.1
CN4003100000000,2022-05-01,40,031,OK,Comanche County,47449,45736,1713,3.6
CN4003300000000,2022-05-01,40,033,OK,Cotton County,2701,2625,76,2.8
CN4003500000000,2022-05-01,40,035,OK,Craig County,5912,5743,169,2.9
CN4003700000000,2022-05-01,40,037,OK,Creek County,31608,30507,1101,3.5
CN4003900000000,2022-05-01,40,039,OK,Custer County,15216,14820,396,2.6
CN4004100000000,2022-05-01,40,041,OK,Delaware County,20107,19543,564,2.8
CN4004300000000,2022-05-01,40,043,OK,Dewey County,2972,2911,61,2.1
CN4004500000000,2022-05-01,40,045,OK,Ellis County,2146,2099,47,2.2
CN4004700000000,2022-05-01,40,047,OK,Garfield County,26854,26100,754,2.8
CN4004900000000,2022-05-01,40,049,OK,Garvin County,12734,12387,347,2.7
CN4005100000000,2022-05-01,40,051,OK,Grady County,27409,26678,731,2.7
CN4005300000000,2022-05-01,40,053,OK,Grant County,2831,2780,51,1.8
CN4005500000000,2022-05-01,40,055,OK,Greer County,1891,1833,58,3.1
CN4005700000000,2022-05-01,40,057,OK,Harmon County,1225,1193,32,2.6
CN4005900000000,2022-05-01,40,059,OK,Harper County,1845,1809,36,2
CN4006100000000,2022-05-01,40,061,OK,Haskell County,4248,4061,187,4.4
CN4006300000000,2022-05-01,40,063,OK,Hughes County,5194,5003,191,3.7
CN4006500000000,2022-05-01,40,065,OK,Jackson County,10811,10507,304,2.8
CN4006700000000,2022-05-01,40,067,OK,Jefferson County,2522,2455,67,2.7
CN4006900000000,2022-05-01,40,069,OK,Johnston County,3813,3675,138,3.6
CN4007100000000,2022-05-01,40,071,OK,Kay County,18627,17984,643,3.5
CN4007300000000,2022-05-01,40,073,OK,Kingfisher County,9081,8905,176,1.9
CN4007500000000,2022-05-01,40,075,OK,Kiowa County,3734,3609,125,3.3
CN4007700000000,2022-05-01,40,077,OK,Latimer County,3218,3043,175,5.4
CN4007900000000,2022-05-01,40,079,OK,Le Flore County,19638,18954,684,3.5
CN4008100000000,2022-05-01,40,081,OK,Lincoln County,16298,15812,486,3
CN4008300000000,2022-05-01,40,083,OK,Logan County,23361,22758,603,2.6
CN4008500000000,2022-05-01,40,085,OK,Love County,5858,5734,124,2.1
CN4008700000000,2022-05-01,40,087,OK,McClain County,21028,20487,541,2.6
CN4008900000000,2022-05-01,40,089,OK,McCurtain County,16225,15581,644,4
CN4009100000000,2022-05-01,40,091,OK,McIntosh County,7325,6977,348,4.8
CN4009300000000,2022-05-01,40,093,OK,Major County,3888,3794,94,2.4
CN4009500000000,2022-05-01,40,095,OK,Marshall County,7559,7348,211,2.8
CN4009700000000,2022-05-01,40,097,OK,Mayes County,19908,19326,582,2.9
CN4009900000000,2022-05-01,40,099,OK,Murray County,6182,6002,180,2.9
CN4010100000000,2022-05-01,40,101,OK,Muskogee County,28890,27935,955,3.3
CN4010300000000,2022-05-01,40,103,OK,Noble County,5825,5701,124,2.1
CN4010500000000,2022-05-01,40,105,OK,Nowata County,4756,4617,139,2.9
CN4010700000000,2022-05-01,40,107,OK,Okfuskee County,4472,4300,172,3.8
CN4010900000000,2022-05-01,40,109,OK,Oklahoma County,397733,386284,11449,2.9
CN4011100000000,2022-05-01,40,111,OK,Okmulgee County,15643,15009,634,4.1
CN4011300000000,2022-05-01,40,113,OK,Osage County,20604,19854,750,3.6
CN4011500000000,2022-05-01,40,115,OK,Ottawa County,15142,14722,420,2.8
CN4011700000000,2022-05-01,40,117,OK,Pawnee County,7417,7167,250,3.4
CN4011900000000,2022-05-01,40,119,OK,Payne County,38661,37665,996,2.6
CN4012100000000,2022-05-01,40,121,OK,Pittsburg County,16546,15847,699,4.2
CN4012300000000,2022-05-01,40,123,OK,Pontotoc County,19645,19086,559,2.8
CN4012500000000,2022-05-01,40,125,OK,Pottawatomie County,33548,32437,1111,3.3
CN4012700000000,2022-05-01,40,127,OK,Pushmataha County,4693,4521,172,3.7
CN4012900000000,2022-05-01,40,129,OK,Roger Mills County,1836,1796,40,2.2
CN4013100000000,2022-05-01,40,131,OK,Rogers County,45508,44181,1327,2.9
CN4013300000000,2022-05-01,40,133,OK,Seminole County,9345,8983,362,3.9
CN4013500000000,2022-05-01,40,135,OK,Sequoyah County,16945,16375,570,3.4
CN4013700000000,2022-05-01,40,137,OK,Stephens County,19342,18761,581,3
CN4013900000000,2022-05-01,40,139,OK,Texas County,12102,11893,209,1.7
CN4014100000000,2022-05-01,40,141,OK,Tillman County,2972,2889,83,2.8
CN4014300000000,2022-05-01,40,143,OK,Tulsa County,327606,317804,9802,3
CN4014500000000,2022-05-01,40,145,OK,Wagoner County,39272,38106,1166,3
CN4014700000000,2022-05-01,40,147,OK,Washington County,22421,21683,738,3.3
CN4014900000000,2022-05-01,40,149,OK,Washita County,5346,5182,164,3.1
CN4015100000000,2022-05-01,40,151,OK,Woods County,4841,4752,89,1.8
CN4015300000000,2022-05-01,40,153,OK,Woodward County,8749,8505,244,2.8
CN4100100000000,2022-05-01,41,001,OR,Baker County,7427,7157,270,3.6
CN4100300000000,2022-05-01,41,003,OR,Benton County,48868,47490,1378,2.8
CN4100500000000,2022-05-01,41,005,OR,Clackamas County,225005,217984,7021,3.1
CN4100700000000,2022-05-01,41,007,OR,Clatsop County,19667,18995,672,3.4
CN4100900000000,2022-05-01,41,009,OR,Columbia County,24912,23925,987,4
CN4101100000000,2022-05-01,41,011,OR,Coos County,26500,25371,1129,4.3
CN4101300000000,2022-05-01,41,013,OR,Crook County,11117,10650,467,4.2
CN4101500000000,2022-05-01,41,015,OR,Curry County,9187,8800,387,4.2
CN4101700000000,2022-05-01,41,017,OR,Deschutes County,102301,99009,3292,3.2
CN4101900000000,2022-05-01,41,019,OR,Douglas County,47355,45367,1988,4.2
CN4102100000000,2022-05-01,41,021,OR,Gilliam County,887,854,33,3.7
CN4102300000000,2022-05-01,41,023,OR,Grant County,3172,3007,165,5.2
CN4102500000000,2022-05-01,41,025,OR,Harney County,3864,3730,134,3.5
CN4102700000000,2022-05-01,41,027,OR,Hood River County,13615,13213,402,3
CN4102900000000,2022-05-01,41,029,OR,Jackson County,106120,102156,3964,3.7
CN4103100000000,2022-05-01,41,031,OR,Jefferson County,10321,9898,423,4.1
CN4103300000000,2022-05-01,41,033,OR,Josephine County,36572,34930,1642,4.5
CN4103500000000,2022-05-01,41,035,OR,Klamath County,30096,28757,1339,4.4
CN4103700000000,2022-05-01,41,037,OR,Lake County,3690,3537,153,4.1
CN4103900000000,2022-05-01,41,039,OR,Lane County,183480,176811,6669,3.6
CN4104100000000,2022-05-01,41,041,OR,Lincoln County,20863,19991,872,4.2
CN4104300000000,2022-05-01,41,043,OR,Linn County,61122,58831,2291,3.7
CN4104500000000,2022-05-01,41,045,OR,Malheur County,12687,12243,444,3.5
CN4104700000000,2022-05-01,41,047,OR,Marion County,168114,162290,5824,3.5
CN4104900000000,2022-05-01,41,049,OR,Morrow County,5976,5780,196,3.3
CN4105100000000,2022-05-01,41,051,OR,Multnomah County,464273,449393,14880,3.2
CN4105300000000,2022-05-01,41,053,OR,Polk County,42141,40680,1461,3.5
CN4105500000000,2022-05-01,41,055,OR,Sherman County,956,929,27,2.8
CN4105700000000,2022-05-01,41,057,OR,Tillamook County,12201,11758,443,3.6
CN4105900000000,2022-05-01,41,059,OR,Umatilla County,37793,36447,1346,3.6
CN4106100000000,2022-05-01,41,061,OR,Union County,12111,11662,449,3.7
CN4106300000000,2022-05-01,41,063,OR,Wallowa County,3618,3464,154,4.3
CN4106500000000,2022-05-01,41,065,OR,Wasco County,12761,12290,471,3.7
CN4106700000000,2022-05-01,41,067,OR,Washington County,332096,322656,9440,2.8
CN4106900000000,2022-05-01,41,069,OR,Wheeler County,752,731,21,2.8
CN4107100000000,2022-05-01,41,071,OR,Yamhill County,55876,54105,1771,3.2
CN4200100000000,2022-05-01,42,001,PA,Adams County,55136,53403,1733,3.1
CN4200300000000,2022-05-01,42,003,PA,Allegheny County,634592,609293,25299,4
CN4200500000000,2022-05-01,42,005,PA,Armstrong County,31264,29820,1444,4.6
CN4200700000000,2022-05-01,42,007,PA,Beaver County,82063,78093,3970,4.8
CN4200900000000,2022-05-01,42,009,PA,Bedford County,24750,23815,935,3.8
CN4201100000000,2022-05-01,42,011,PA,Berks County,215132,206295,8837,4.1
CN4201300000000,2022-05-01,42,013,PA,Blair County,59843,57441,2402,4
CN4201500000000,2022-05-01,42,015,PA,Bradford County,28466,27359,1107,3.9
CN4201700000000,2022-05-01,42,017,PA,Bucks County,351763,339024,12739,3.6
CN4201900000000,2022-05-01,42,019,PA,Butler County,99162,95425,3737,3.8
CN4202100000000,2022-05-01,42,021,PA,Cambria County,55893,53232,2661,4.8
CN4202300000000,2022-05-01,42,023,PA,Cameron County,1979,1880,99,5
CN4202500000000,2022-05-01,42,025,PA,Carbon County,32591,31053,1538,4.7
CN4202700000000,2022-05-01,42,027,PA,Centre County,78679,75983,2696,3.4
CN4202900000000,2022-05-01,42,029,PA,Chester County,297375,288356,9019,3
CN4203100000000,2022-05-01,42,031,PA,Clarion County,16346,15582,764,4.7
CN4203300000000,2022-05-01,42,033,PA,Clearfield County,35426,33746,1680,4.7
CN4203500000000,2022-05-01,42,035,PA,Clinton County,17123,16305,818,4.8
CN4203700000000,2022-05-01,42,037,PA,Columbia County,34001,32641,1360,4
CN4203900000000,2022-05-01,42,039,PA,Crawford County,38723,37094,1629,4.2
CN4204100000000,2022-05-01,42,041,PA,Cumberland County,135061,130590,4471,3.3
CN4204300000000,2022-05-01,42,043,PA,Dauphin County,145774,140188,5586,3.8
CN4204500000000,2022-05-01,42,045,PA,Delaware County,302328,290322,12006,4
CN4204700000000,2022-05-01,42,047,PA,Elk County,14884,14199,685,4.6
CN4204900000000,2022-05-01,42,049,PA,Erie County,126901,121212,5689,4.5
CN4205100000000,2022-05-01,42,051,PA,Fayette County,55178,52204,2974,5.4
CN4205300000000,2022-05-01,42,053,PA,Forest County,1727,1631,96,5.6
CN4205500000000,2022-05-01,42,055,PA,Franklin County,78544,75788,2756,3.5
CN4205700000000,2022-05-01,42,057,PA,Fulton County,7295,7022,273,3.7
CN4205900000000,2022-05-01,42,059,PA,Greene County,15594,14804,790,5.1
CN4206100000000,2022-05-01,42,061,PA,Huntingdon County,19575,18667,908,4.6
CN4206300000000,2022-05-01,42,063,PA,Indiana County,36304,34557,1747,4.8
CN4206500000000,2022-05-01,42,065,PA,Jefferson County,19648,18800,848,4.3
CN4206700000000,2022-05-01,42,067,PA,Juniata County,12574,12103,471,3.7
CN4206900000000,2022-05-01,42,069,PA,Lackawanna County,105148,100518,4630,4.4
CN4207100000000,2022-05-01,42,071,PA,Lancaster County,292510,282566,9944,3.4
CN4207300000000,2022-05-01,42,073,PA,Lawrence County,39726,37920,1806,4.5
CN4207500000000,2022-05-01,42,075,PA,Lebanon County,73730,71090,2640,3.6
CN4207700000000,2022-05-01,42,077,PA,Lehigh County,197715,189491,8224,4.2
CN4207900000000,2022-05-01,42,079,PA,Luzerne County,158145,150410,7735,4.9
CN4208100000000,2022-05-01,42,081,PA,Lycoming County,55292,52859,2433,4.4
CN4208300000000,2022-05-01,42,083,PA,McKean County,17140,16332,808,4.7
CN4208500000000,2022-05-01,42,085,PA,Mercer County,48123,45940,2183,4.5
CN4208700000000,2022-05-01,42,087,PA,Mifflin County,21157,20249,908,4.3
CN4208900000000,2022-05-01,42,089,PA,Monroe County,82276,77891,4385,5.3
CN4209100000000,2022-05-01,42,091,PA,Montgomery County,467948,452260,15688,3.4
CN4209300000000,2022-05-01,42,093,PA,Montour County,9267,8972,295,3.2
CN4209500000000,2022-05-01,42,095,PA,Northampton County,164618,158094,6524,4
CN4209700000000,2022-05-01,42,097,PA,Northumberland County,42988,41050,1938,4.5
CN4209900000000,2022-05-01,42,099,PA,Perry County,24758,23945,813,3.3
CN4210100000000,2022-05-01,42,101,PA,Philadelphia County/city,730441,692291,38150,5.2
CN4210300000000,2022-05-01,42,103,PA,Pike County,25943,24604,1339,5.2
CN4210500000000,2022-05-01,42,105,PA,Potter County,7127,6761,366,5.1
CN4210700000000,2022-05-01,42,107,PA,Schuylkill County,66164,63113,3051,4.6
CN4210900000000,2022-05-01,42,109,PA,Snyder County,19902,19111,791,4
CN4211100000000,2022-05-01,42,111,PA,Somerset County,32905,31299,1606,4.9
CN4211300000000,2022-05-01,42,113,PA,Sullivan County,2588,2456,132,5.1
CN4211500000000,2022-05-01,42,115,PA,Susquehanna County,20463,19676,787,3.8
CN4211700000000,2022-05-01,42,117,PA,Tioga County,19345,18527,818,4.2
CN4211900000000,2022-05-01,42,119,PA,Union County,19946,19203,743,3.7
CN4212100000000,2022-05-01,42,121,PA,Venango County,21723,20742,981,4.5
CN4212300000000,2022-05-01,42,123,PA,Warren County,17959,17241,718,4
CN4212500000000,2022-05-01,42,125,PA,Washington County,105212,100738,4474,4.3
CN4212700000000,2022-05-01,42,127,PA,Wayne County,22800,21752,1048,4.6
CN4212900000000,2022-05-01,42,129,PA,Westmoreland County,176415,169129,7286,4.1
CN4213100000000,2022-05-01,42,131,PA,Wyoming County,13573,12983,590,4.3
CN4213300000000,2022-05-01,42,133,PA,York County,239605,230922,8683,3.6
CN4400100000000,2022-05-01,44,001,RI,Bristol County,26477,25906,571,2.2
CN4400300000000,2022-05-01,44,003,RI,Kent County,93559,91178,2381,2.5
CN4400500000000,2022-05-01,44,005,RI,Newport County,45019,43960,1059,2.4
CN4400700000000,2022-05-01,44,007,RI,Providence County,334174,323670,10504,3.1
CN4400900000000,2022-05-01,44,009,RI,Washington County,69955,68328,1627,2.3
CN4500100000000,2022-05-01,45,001,SC,Abbeville County,9396,9072,324,3.4
CN4500300000000,2022-05-01,45,003,SC,Aiken County,73622,71477,2145,2.9
CN4500500000000,2022-05-01,45,005,SC,Allendale County,2289,2176,113,4.9
CN4500700000000,2022-05-01,45,007,SC,Anderson County,91488,89001,2487,2.7
CN4500900000000,2022-05-01,45,009,SC,Bamberg County,4603,4378,225,4.9
CN4501100000000,2022-05-01,45,011,SC,Barnwell County,7520,7200,320,4.3
CN4501300000000,2022-05-01,45,013,SC,Beaufort County,77142,75023,2119,2.7
CN4501500000000,2022-05-01,45,015,SC,Berkeley County,109075,105779,3296,3
CN4501700000000,2022-05-01,45,017,SC,Calhoun County,6473,6269,204,3.2
CN4501900000000,2022-05-01,45,019,SC,Charleston County,214424,209012,5412,2.5
CN4502100000000,2022-05-01,45,021,SC,Cherokee County,24105,23141,964,4
CN4502300000000,2022-05-01,45,023,SC,Chester County,13299,12806,493,3.7
CN4502500000000,2022-05-01,45,025,SC,Chesterfield County,21439,20781,658,3.1
CN4502700000000,2022-05-01,45,027,SC,Clarendon County,12223,11800,423,3.5
CN4502900000000,2022-05-01,45,029,SC,Colleton County,15866,15367,499,3.1
CN4503100000000,2022-05-01,45,031,SC,Darlington County,30143,29190,953,3.2
CN4503300000000,2022-05-01,45,033,SC,Dillon County,12952,12421,531,4.1
CN4503500000000,2022-05-01,45,035,SC,Dorchester County,79120,76889,2231,2.8
CN4503700000000,2022-05-01,45,037,SC,Edgefield County,10411,10110,301,2.9
CN4503900000000,2022-05-01,45,039,SC,Fairfield County,9252,8868,384,4.2
CN4504100000000,2022-05-01,45,041,SC,Florence County,66688,64750,1938,2.9
CN4504300000000,2022-05-01,45,043,SC,Georgetown County,26402,25546,856,3.2
CN4504500000000,2022-05-01,45,045,SC,Greenville County,259987,253290,6697,2.6
CN4504700000000,2022-05-01,45,047,SC,Greenwood County,29560,28571,989,3.3
CN4504900000000,2022-05-01,45,049,SC,Hampton County,7952,7739,213,2.7
CN4505100000000,2022-05-01,45,051,SC,Horry County,152340,147345,4995,3.3
CN4505300000000,2022-05-01,45,053,SC,Jasper County,13457,13081,376,2.8
CN4505500000000,2022-05-01,45,055,SC,Kershaw County,29522,28652,870,2.9
CN4505700000000,2022-05-01,45,057,SC,Lancaster County,43505,42131,1374,3.2
CN4505900000000,2022-05-01,45,059,SC,Laurens County,30187,29255,932,3.1
CN4506100000000,2022-05-01,45,061,SC,Lee County,6439,6167,272,4.2
CN4506300000000,2022-05-01,45,063,SC,Lexington County,151784,148110,3674,2.4
CN4506500000000,2022-05-01,45,065,SC,McCormick County,3433,3326,107,3.1
CN4506700000000,2022-05-01,45,067,SC,Marion County,12714,12170,544,4.3
CN4506900000000,2022-05-01,45,069,SC,Marlboro County,8232,7789,443,5.4
CN4507100000000,2022-05-01,45,071,SC,Newberry County,19367,18885,482,2.5
CN4507300000000,2022-05-01,45,073,SC,Oconee County,34183,33261,922,2.7
CN4507500000000,2022-05-01,45,075,SC,Orangeburg County,33102,31538,1564,4.7
CN4507700000000,2022-05-01,45,077,SC,Pickens County,58146,56365,1781,3.1
CN4507900000000,2022-05-01,45,079,SC,Richland County,197163,191119,6044,3.1
CN4508100000000,2022-05-01,45,081,SC,Saluda County,8650,8441,209,2.4
CN4508300000000,2022-05-01,45,083,SC,Spartanburg County,154142,149697,4445,2.9
CN4508500000000,2022-05-01,45,085,SC,Sumter County,42006,40559,1447,3.4
CN4508700000000,2022-05-01,45,087,SC,Union County,11131,10710,421,3.8
CN4508900000000,2022-05-01,45,089,SC,Williamsburg County,10974,10530,444,4
CN4509100000000,2022-05-01,45,091,SC,York County,147867,143631,4236,2.9
CN4600300000000,2022-05-01,46,003,SD,Aurora County,1515,1486,29,1.9
CN4600500000000,2022-05-01,46,005,SD,Beadle County,9369,9201,168,1.8
CN4600700000000,2022-05-01,46,007,SD,Bennett County,1073,1042,31,2.9
CN4600900000000,2022-05-01,46,009,SD,Bon Homme County,2922,2870,52,1.8
CN4601100000000,2022-05-01,46,011,SD,Brookings County,19123,18777,346,1.8
CN4601300000000,2022-05-01,46,013,SD,Brown County,20319,19892,427,2.1
CN4601500000000,2022-05-01,46,015,SD,Brule County,2705,2658,47,1.7
CN4601700000000,2022-05-01,46,017,SD,Buffalo County,724,702,22,3
CN4601900000000,2022-05-01,46,019,SD,Butte County,5004,4912,92,1.8
CN4602100000000,2022-05-01,46,021,SD,Campbell County,813,796,17,2.1
CN4602300000000,2022-05-01,46,023,SD,Charles Mix County,3908,3826,82,2.1
CN4602500000000,2022-05-01,46,025,SD,Clark County,1996,1955,41,2.1
CN4602700000000,2022-05-01,46,027,SD,Clay County,6977,6828,149,2.1
CN4602900000000,2022-05-01,46,029,SD,Codington County,16055,15760,295,1.8
CN4603100000000,2022-05-01,46,031,SD,Corson County,1310,1273,37,2.8
CN4603300000000,2022-05-01,46,033,SD,Custer County,4284,4178,106,2.5
CN4603500000000,2022-05-01,46,035,SD,Davison County,11133,10941,192,1.7
CN4603700000000,2022-05-01,46,037,SD,Day County,2777,2708,69,2.5
CN4603900000000,2022-05-01,46,039,SD,Deuel County,2325,2269,56,2.4
CN4604100000000,2022-05-01,46,041,SD,Dewey County,2247,2180,67,3
CN4604300000000,2022-05-01,46,043,SD,Douglas County,1560,1536,24,1.5
CN4604500000000,2022-05-01,46,045,SD,Edmunds County,2044,2009,35,1.7
CN4604700000000,2022-05-01,46,047,SD,Fall River County,3162,3091,71,2.2
CN4604900000000,2022-05-01,46,049,SD,Faulk County,1119,1096,23,2.1
CN4605100000000,2022-05-01,46,051,SD,Grant County,4464,4383,81,1.8
CN4605300000000,2022-05-01,46,053,SD,Gregory County,2214,2175,39,1.8
CN4605500000000,2022-05-01,46,055,SD,Haakon County,1108,1091,17,1.5
CN4605700000000,2022-05-01,46,057,SD,Hamlin County,3625,3567,58,1.6
CN4605900000000,2022-05-01,46,059,SD,Hand County,1857,1826,31,1.7
CN4606100000000,2022-05-01,46,061,SD,Hanson County,1811,1771,40,2.2
CN4606300000000,2022-05-01,46,063,SD,Harding County,777,764,13,1.7
CN4606500000000,2022-05-01,46,065,SD,Hughes County,10026,9865,161,1.6
CN4606700000000,2022-05-01,46,067,SD,Hutchinson County,3696,3623,73,2
CN4606900000000,2022-05-01,46,069,SD,Hyde County,682,667,15,2.2
CN4607100000000,2022-05-01,46,071,SD,Jackson County,1307,1278,29,2.2
CN4607300000000,2022-05-01,46,073,SD,Jerauld County,1380,1361,19,1.4
CN4607500000000,2022-05-01,46,075,SD,Jones County,551,539,12,2.2
CN4607700000000,2022-05-01,46,077,SD,Kingsbury County,2982,2930,52,1.7
CN4607900000000,2022-05-01,46,079,SD,Lake County,6728,6594,134,2
CN4608100000000,2022-05-01,46,081,SD,Lawrence County,14144,13885,259,1.8
CN4608300000000,2022-05-01,46,083,SD,Lincoln County,37439,36840,599,1.6
CN4608500000000,2022-05-01,46,085,SD,Lyman County,1774,1739,35,2
CN4608700000000,2022-05-01,46,087,SD,McCook County,3139,3088,51,1.6
CN4608900000000,2022-05-01,46,089,SD,McPherson County,1000,976,24,2.4
CN4609100000000,2022-05-01,46,091,SD,Marshall County,2573,2508,65,2.5
CN4609300000000,2022-05-01,46,093,SD,Meade County,14596,14306,290,2
CN4609500000000,2022-05-01,46,095,SD,Mellette County,774,756,18,2.3
CN4609700000000,2022-05-01,46,097,SD,Miner County,1248,1226,22,1.8
CN4609900000000,2022-05-01,46,099,SD,Minnehaha County,116088,114094,1994,1.7
CN4610100000000,2022-05-01,46,101,SD,Moody County,4103,4034,69,1.7
CN4610200000000,2022-05-01,46,102,SD,Oglala Lakota County,3753,3613,140,3.7
CN4610300000000,2022-05-01,46,103,SD,Pennington County,60074,58906,1168,1.9
CN4610500000000,2022-05-01,46,105,SD,Perkins County,1465,1437,28,1.9
CN4610700000000,2022-05-01,46,107,SD,Potter County,1093,1071,22,2
CN4610900000000,2022-05-01,46,109,SD,Roberts County,4634,4517,117,2.5
CN4611100000000,2022-05-01,46,111,SD,Sanborn County,1256,1233,23,1.8
CN4611500000000,2022-05-01,46,115,SD,Spink County,3162,3088,74,2.3
CN4611700000000,2022-05-01,46,117,SD,Stanley County,1968,1937,31,1.6
CN4611900000000,2022-05-01,46,119,SD,Sully County,848,833,15,1.8
CN4612100000000,2022-05-01,46,121,SD,Todd County,2954,2868,86,2.9
CN4612300000000,2022-05-01,46,123,SD,Tripp County,3151,3104,47,1.5
CN4612500000000,2022-05-01,46,125,SD,Turner County,4789,4707,82,1.7
CN4612700000000,2022-05-01,46,127,SD,Union County,8687,8514,173,2
CN4612900000000,2022-05-01,46,129,SD,Walworth County,2142,2078,64,3
CN4613500000000,2022-05-01,46,135,SD,Yankton County,11753,11550,203,1.7
CN4613700000000,2022-05-01,46,137,SD,Ziebach County,954,930,24,2.5
CN4700100000000,2022-05-01,47,001,TN,Anderson County,35484,34366,1118,3.2
CN4700300000000,2022-05-01,47,003,TN,Bedford County,21877,21187,690,3.2
CN4700500000000,2022-05-01,47,005,TN,Benton County,6965,6700,265,3.8
CN4700700000000,2022-05-01,47,007,TN,Bledsoe County,4453,4235,218,4.9
CN4700900000000,2022-05-01,47,009,TN,Blount County,65943,63990,1953,3
CN4701100000000,2022-05-01,47,011,TN,Bradley County,50414,48768,1646,3.3
CN4701300000000,2022-05-01,47,013,TN,Campbell County,15049,14460,589,3.9
CN4701500000000,2022-05-01,47,015,TN,Cannon County,6896,6692,204,3
CN4701700000000,2022-05-01,47,017,TN,Carroll County,11750,11318,432,3.7
CN4701900000000,2022-05-01,47,019,TN,Carter County,24270,23419,851,3.5
CN4702100000000,2022-05-01,47,021,TN,Cheatham County,22772,22182,590,2.6
CN4702300000000,2022-05-01,47,023,TN,Chester County,8605,8363,242,2.8
CN4702500000000,2022-05-01,47,025,TN,Claiborne County,13054,12600,454,3.5
CN4702700000000,2022-05-01,47,027,TN,Clay County,2796,2678,118,4.2
CN4702900000000,2022-05-01,47,029,TN,Cocke County,14821,14152,669,4.5
CN4703100000000,2022-05-01,47,031,TN,Coffee County,25488,24660,828,3.2
CN4703300000000,2022-05-01,47,033,TN,Crockett County,6898,6694,204,3
CN4703500000000,2022-05-01,47,035,TN,Cumberland County,23459,22566,893,3.8
CN4703700000000,2022-05-01,47,037,TN,Davidson County,414820,403646,11174,2.7
CN4703900000000,2022-05-01,47,039,TN,Decatur County,4494,4311,183,4.1
CN4704100000000,2022-05-01,47,041,TN,DeKalb County,8133,7829,304,3.7
CN4704300000000,2022-05-01,47,043,TN,Dickson County,28042,27242,800,2.9
CN4704500000000,2022-05-01,47,045,TN,Dyer County,16802,16241,561,3.3
CN4704700000000,2022-05-01,47,047,TN,Fayette County,19366,18723,643,3.3
CN4704900000000,2022-05-01,47,049,TN,Fentress County,7734,7462,272,3.5
CN4705100000000,2022-05-01,47,051,TN,Franklin County,19460,18799,661,3.4
CN4705300000000,2022-05-01,47,053,TN,Gibson County,21790,21073,717,3.3
CN4705500000000,2022-05-01,47,055,TN,Giles County,15171,14708,463,3.1
CN4705700000000,2022-05-01,47,057,TN,Grainger County,9785,9435,350,3.6
CN4705900000000,2022-05-01,47,059,TN,Greene County,29202,28153,1049,3.6
CN4706100000000,2022-05-01,47,061,TN,Grundy County,4965,4746,219,4.4
CN4706300000000,2022-05-01,47,063,TN,Hamblen County,28291,27315,976,3.4
CN4706500000000,2022-05-01,47,065,TN,Hamilton County,183407,177565,5842,3.2
CN4706700000000,2022-05-01,47,067,TN,Hancock County,2323,2227,96,4.1
CN4706900000000,2022-05-01,47,069,TN,Hardeman County,9093,8749,344,3.8
CN4707100000000,2022-05-01,47,071,TN,Hardin County,10193,9810,383,3.8
CN4707300000000,2022-05-01,47,073,TN,Hawkins County,23292,22442,850,3.6
CN4707500000000,2022-05-01,47,075,TN,Haywood County,7645,7359,286,3.7
CN4707700000000,2022-05-01,47,077,TN,Henderson County,11942,11539,403,3.4
CN4707900000000,2022-05-01,47,079,TN,Henry County,13656,13159,497,3.6
CN4708100000000,2022-05-01,47,081,TN,Hickman County,11814,11488,326,2.8
CN4708300000000,2022-05-01,47,083,TN,Houston County,3225,3100,125,3.9
CN4708500000000,2022-05-01,47,085,TN,Humphreys County,8823,8526,297,3.4
CN4708700000000,2022-05-01,47,087,TN,Jackson County,4854,4682,172,3.5
CN4708900000000,2022-05-01,47,089,TN,Jefferson County,25124,24278,846,3.4
CN4709100000000,2022-05-01,47,091,TN,Johnson County,7572,7333,239,3.2
CN4709300000000,2022-05-01,47,093,TN,Knox County,252499,245577,6922,2.7
CN4709500000000,2022-05-01,47,095,TN,Lake County,1650,1578,72,4.4
CN4709700000000,2022-05-01,47,097,TN,Lauderdale County,9444,9043,401,4.2
CN4709900000000,2022-05-01,47,099,TN,Lawrence County,19474,18832,642,3.3
CN4710100000000,2022-05-01,47,101,TN,Lewis County,5657,5465,192,3.4
CN4710300000000,2022-05-01,47,103,TN,Lincoln County,16762,16234,528,3.1
CN4710500000000,2022-05-01,47,105,TN,Loudon County,24510,23749,761,3.1
CN4710700000000,2022-05-01,47,107,TN,McMinn County,21798,20998,800,3.7
CN4710900000000,2022-05-01,47,109,TN,McNairy County,8515,8152,363,4.3
CN4711100000000,2022-05-01,47,111,TN,Macon County,11703,11357,346,3
CN4711300000000,2022-05-01,47,113,TN,Madison County,49513,47920,1593,3.2
CN4711500000000,2022-05-01,47,115,TN,Marion County,12299,11853,446,3.6
CN4711700000000,2022-05-01,47,117,TN,Marshall County,15745,15245,500,3.2
CN4711900000000,2022-05-01,47,119,TN,Maury County,53196,51640,1556,2.9
CN4712100000000,2022-05-01,47,121,TN,Meigs County,5249,5048,201,3.8
CN4712300000000,2022-05-01,47,123,TN,Monroe County,21390,20718,672,3.1
CN4712500000000,2022-05-01,47,125,TN,Montgomery County,88509,85383,3126,3.5
CN4712700000000,2022-05-01,47,127,TN,Moore County,3722,3630,92,2.5
CN4712900000000,2022-05-01,47,129,TN,Morgan County,7876,7591,285,3.6
CN4713100000000,2022-05-01,47,131,TN,Obion County,12818,12360,458,3.6
CN4713300000000,2022-05-01,47,133,TN,Overton County,10171,9845,326,3.2
CN4713500000000,2022-05-01,47,135,TN,Perry County,2824,2691,133,4.7
CN4713700000000,2022-05-01,47,137,TN,Pickett County,2261,2186,75,3.3
CN4713900000000,2022-05-01,47,139,TN,Polk County,7081,6832,249,3.5
CN4714100000000,2022-05-01,47,141,TN,Putnam County,35741,34566,1175,3.3
CN4714300000000,2022-05-01,47,143,TN,Rhea County,14410,13875,535,3.7
CN4714500000000,2022-05-01,47,145,TN,Roane County,23877,23041,836,3.5
CN4714700000000,2022-05-01,47,147,TN,Robertson County,39359,38292,1067,2.7
CN4714900000000,2022-05-01,47,149,TN,Rutherford County,196394,191227,5167,2.6
CN4715100000000,2022-05-01,47,151,TN,Scott County,8178,7809,369,4.5
CN4715300000000,2022-05-01,47,153,TN,Sequatchie County,6175,5946,229,3.7
CN4715500000000,2022-05-01,47,155,TN,Sevier County,56405,54913,1492,2.6
CN4715700000000,2022-05-01,47,157,TN,Shelby County,440141,422390,17751,4
CN4715900000000,2022-05-01,47,159,TN,Smith County,9804,9522,282,2.9
CN4716100000000,2022-05-01,47,161,TN,Stewart County,5516,5317,199,3.6
CN4716300000000,2022-05-01,47,163,TN,Sullivan County,69283,66965,2318,3.3
CN4716500000000,2022-05-01,47,165,TN,Sumner County,109351,106458,2893,2.6
CN4716700000000,2022-05-01,47,167,TN,Tipton County,27813,26859,954,3.4
CN4716900000000,2022-05-01,47,169,TN,Trousdale County,5751,5583,168,2.9
CN4717100000000,2022-05-01,47,171,TN,Unicoi County,7076,6809,267,3.8
CN4717300000000,2022-05-01,47,173,TN,Union County,7920,7635,285,3.6
CN4717500000000,2022-05-01,47,175,TN,Van Buren County,2113,2031,82,3.9
CN4717700000000,2022-05-01,47,177,TN,Warren County,16538,15892,646,3.9
CN4717900000000,2022-05-01,47,179,TN,Washington County,61788,59859,1929,3.1
CN4718100000000,2022-05-01,47,181,TN,Wayne County,6557,6300,257,3.9
CN4718300000000,2022-05-01,47,183,TN,Weakley County,15447,14948,499,3.2
CN4718500000000,2022-05-01,47,185,TN,White County,12246,11840,406,3.3
CN4718700000000,2022-05-01,47,187,TN,Williamson County,138948,135728,3220,2.3
CN4718900000000,2022-05-01,47,189,TN,Wilson County,82301,80201,2100,2.6
CN4800100000000,2022-05-01,48,001,TX,Anderson County,23035,22305,730,3.2
CN4800300000000,2022-05-01,48,003,TX,Andrews County,9482,9193,289,3
CN4800500000000,2022-05-01,48,005,TX,Angelina County,34996,33474,1522,4.3
CN4800700000000,2022-05-01,48,007,TX,Aransas County,9310,8863,447,4.8
CN4800900000000,2022-05-01,48,009,TX,Archer County,4038,3910,128,3.2
CN4801100000000,2022-05-01,48,011,TX,Armstrong County,953,928,25,2.6
CN4801300000000,2022-05-01,48,013,TX,Atascosa County,22464,21609,855,3.8
CN4801500000000,2022-05-01,48,015,TX,Austin County,14138,13607,531,3.8
CN4801700000000,2022-05-01,48,017,TX,Bailey County,2498,2398,100,4
CN4801900000000,2022-05-01,48,019,TX,Bandera County,10601,10230,371,3.5
CN4802100000000,2022-05-01,48,021,TX,Bastrop County,47959,46464,1495,3.1
CN4802300000000,2022-05-01,48,023,TX,Baylor County,1929,1878,51,2.6
CN4802500000000,2022-05-01,48,025,TX,Bee County,9202,8683,519,5.6
CN4802700000000,2022-05-01,48,027,TX,Bell County,148905,142671,6234,4.2
CN4802900000000,2022-05-01,48,029,TX,Bexar County,973949,939939,34010,3.5
CN4803100000000,2022-05-01,48,031,TX,Blanco County,7122,6928,194,2.7
CN4803300000000,2022-05-01,48,033,TX,Borden County,691,678,13,1.9
CN4803500000000,2022-05-01,48,035,TX,Bosque County,8669,8368,301,3.5
CN4803700000000,2022-05-01,48,037,TX,Bowie County,38744,37059,1685,4.3
CN4803900000000,2022-05-01,48,039,TX,Brazoria County,183958,176224,7734,4.2
CN4804100000000,2022-05-01,48,041,TX,Brazos County,129087,125425,3662,2.8
CN4804300000000,2022-05-01,48,043,TX,Brewster County,4182,4037,145,3.5
CN4804500000000,2022-05-01,48,045,TX,Briscoe County,609,590,19,3.1
CN4804700000000,2022-05-01,48,047,TX,Brooks County,2345,2216,129,5.5
CN4804900000000,2022-05-01,48,049,TX,Brown County,15301,14710,591,3.9
CN4805100000000,2022-05-01,48,051,TX,Burleson County,8905,8613,292,3.3
CN4805300000000,2022-05-01,48,053,TX,Burnet County,25742,25018,724,2.8
CN4805500000000,2022-05-01,48,055,TX,Caldwell County,21189,20500,689,3.3
CN4805700000000,2022-05-01,48,057,TX,Calhoun County,12151,11721,430,3.5
CN4805900000000,2022-05-01,48,059,TX,Callahan County,6264,6051,213,3.4
CN4806100000000,2022-05-01,48,061,TX,Cameron County,176580,167179,9401,5.3
CN4806300000000,2022-05-01,48,063,TX,Camp County,5146,4938,208,4
CN4806500000000,2022-05-01,48,065,TX,Carson County,3057,2972,85,2.8
CN4806700000000,2022-05-01,48,067,TX,Cass County,12042,11519,523,4.3
CN4806900000000,2022-05-01,48,069,TX,Castro County,3450,3349,101,2.9
CN4807100000000,2022-05-01,48,071,TX,Chambers County,20900,19909,991,4.7
CN4807300000000,2022-05-01,48,073,TX,Cherokee County,20819,19983,836,4
CN4807500000000,2022-05-01,48,075,TX,Childress County,3235,3143,92,2.8
CN4807700000000,2022-05-01,48,077,TX,Clay County,4905,4725,180,3.7
CN4807900000000,2022-05-01,48,079,TX,Cochran County,1200,1144,56,4.7
CN4808100000000,2022-05-01,48,081,TX,Coke County,1470,1417,53,3.6
CN4808300000000,2022-05-01,48,083,TX,Coleman County,3093,2968,125,4
CN4808500000000,2022-05-01,48,085,TX,Collin County,622045,603689,18356,3
CN4808700000000,2022-05-01,48,087,TX,Collingsworth County,1101,1066,35,3.2
CN4808900000000,2022-05-01,48,089,TX,Colorado County,10390,10051,339,3.3
CN4809100000000,2022-05-01,48,091,TX,Comal County,81855,79201,2654,3.2
CN4809300000000,2022-05-01,48,093,TX,Comanche County,6356,6146,210,3.3
CN4809500000000,2022-05-01,48,095,TX,Concho County,1371,1328,43,3.1
CN4809700000000,2022-05-01,48,097,TX,Cooke County,20167,19545,622,3.1
CN4809900000000,2022-05-01,48,099,TX,Coryell County,24609,23572,1037,4.2
CN4810100000000,2022-05-01,48,101,TX,Cottle County,852,830,22,2.6
CN4810300000000,2022-05-01,48,103,TX,Crane County,1533,1461,72,4.7
CN4810500000000,2022-05-01,48,105,TX,Crockett County,1398,1341,57,4.1
CN4810700000000,2022-05-01,48,107,TX,Crosby County,2464,2373,91,3.7
CN4810900000000,2022-05-01,48,109,TX,Culberson County,1158,1124,34,2.9
CN4811100000000,2022-05-01,48,111,TX,Dallam County,3963,3881,82,2.1
CN4811300000000,2022-05-01,48,113,TX,Dallas County,1412733,1363715,49018,3.5
CN4811500000000,2022-05-01,48,115,TX,Dawson County,4548,4360,188,4.1
CN4811700000000,2022-05-01,48,117,TX,Deaf Smith County,9124,8876,248,2.7
CN4811900000000,2022-05-01,48,119,TX,Delta County,2512,2423,89,3.5
CN4812100000000,2022-05-01,48,121,TX,Denton County,548684,532262,16422,3
CN4812300000000,2022-05-01,48,123,TX,DeWitt County,9053,8763,290,3.2
CN4812500000000,2022-05-01,48,125,TX,Dickens County,690,658,32,4.6
CN4812700000000,2022-05-01,48,127,TX,Dimmit County,6130,5901,229,3.7
CN4812900000000,2022-05-01,48,129,TX,Donley County,1532,1482,50,3.3
CN4813100000000,2022-05-01,48,131,TX,Duval County,5052,4831,221,4.4
CN4813300000000,2022-05-01,48,133,TX,Eastland County,6836,6531,305,4.5
CN4813500000000,2022-05-01,48,135,TX,Ector County,82676,79584,3092,3.7
CN4813700000000,2022-05-01,48,137,TX,Edwards County,1262,1227,35,2.8
CN4813900000000,2022-05-01,48,139,TX,Ellis County,102834,99455,3379,3.3
CN4814100000000,2022-05-01,48,141,TX,El Paso County,369747,354958,14789,4
CN4814300000000,2022-05-01,48,143,TX,Erath County,21475,20789,686,3.2
CN4814500000000,2022-05-01,48,145,TX,Falls County,6857,6592,265,3.9
CN4814700000000,2022-05-01,48,147,TX,Fannin County,17356,16822,534,3.1
CN4814900000000,2022-05-01,48,149,TX,Fayette County,11979,11582,397,3.3
CN4815100000000,2022-05-01,48,151,TX,Fisher County,1679,1623,56,3.3
CN4815300000000,2022-05-01,48,153,TX,Floyd County,2538,2437,101,4
CN4815500000000,2022-05-01,48,155,TX,Foard County,582,567,15,2.6
CN4815700000000,2022-05-01,48,157,TX,Fort Bend County,417611,402269,15342,3.7
CN4815900000000,2022-05-01,48,159,TX,Franklin County,5401,5250,151,2.8
CN4816100000000,2022-05-01,48,161,TX,Freestone County,6374,6046,328,5.1
CN4816300000000,2022-05-01,48,163,TX,Frio County,9405,9093,312,3.3
CN4816500000000,2022-05-01,48,165,TX,Gaines County,10235,9942,293,2.9
CN4816700000000,2022-05-01,48,167,TX,Galveston County,168579,161720,6859,4.1
CN4816900000000,2022-05-01,48,169,TX,Garza County,1940,1873,67,3.5
CN4817100000000,2022-05-01,48,171,TX,Gillespie County,14752,14375,377,2.6
CN4817300000000,2022-05-01,48,173,TX,Glasscock County,891,868,23,2.6
CN4817500000000,2022-05-01,48,175,TX,Goliad County,3178,3052,126,4
CN4817700000000,2022-05-01,48,177,TX,Gonzales County,9601,9308,293,3.1
CN4817900000000,2022-05-01,48,179,TX,Gray County,7671,7343,328,4.3
CN4818100000000,2022-05-01,48,181,TX,Grayson County,65736,63453,2283,3.5
CN4818300000000,2022-05-01,48,183,TX,Gregg County,56980,54738,2242,3.9
CN4818500000000,2022-05-01,48,185,TX,Grimes County,11479,10998,481,4.2
CN4818700000000,2022-05-01,48,187,TX,Guadalupe County,85256,82561,2695,3.2
CN4818900000000,2022-05-01,48,189,TX,Hale County,11885,11378,507,4.3
CN4819100000000,2022-05-01,48,191,TX,Hall County,1114,1070,44,3.9
CN4819300000000,2022-05-01,48,193,TX,Hamilton County,3881,3762,119,3.1
CN4819500000000,2022-05-01,48,195,TX,Hansford County,2862,2799,63,2.2
CN4819700000000,2022-05-01,48,197,TX,Hardeman County,1795,1738,57,3.2
CN4819900000000,2022-05-01,48,199,TX,Hardin County,24729,23565,1164,4.7
CN4820100000000,2022-05-01,48,201,TX,Harris County,2332520,2240689,91831,3.9
CN4820300000000,2022-05-01,48,203,TX,Harrison County,28974,27726,1248,4.3
CN4820500000000,2022-05-01,48,205,TX,Hartley County,2686,2638,48,1.8
CN4820700000000,2022-05-01,48,207,TX,Haskell County,2778,2699,79,2.8
CN4820900000000,2022-05-01,48,209,TX,Hays County,137867,134001,3866,2.8
CN4821100000000,2022-05-01,48,211,TX,Hemphill County,1644,1594,50,3
CN4821300000000,2022-05-01,48,213,TX,Henderson County,39139,37749,1390,3.6
CN4821500000000,2022-05-01,48,215,TX,Hidalgo County,369861,347804,22057,6
CN4821700000000,2022-05-01,48,217,TX,Hill County,17807,17191,616,3.5
CN4821900000000,2022-05-01,48,219,TX,Hockley County,11044,10670,374,3.4
CN4822100000000,2022-05-01,48,221,TX,Hood County,29794,28740,1054,3.5
CN4822300000000,2022-05-01,48,223,TX,Hopkins County,18449,17865,584,3.2
CN4822500000000,2022-05-01,48,225,TX,Houston County,10580,10233,347,3.3
CN4822700000000,2022-05-01,48,227,TX,Howard County,13142,12519,623,4.7
CN4822900000000,2022-05-01,48,229,TX,Hudspeth County,1912,1839,73,3.8
CN4823100000000,2022-05-01,48,231,TX,Hunt County,46534,44876,1658,3.6
CN4823300000000,2022-05-01,48,233,TX,Hutchinson County,8561,8193,368,4.3
CN4823500000000,2022-05-01,48,235,TX,Irion County,800,774,26,3.3
CN4823700000000,2022-05-01,48,237,TX,Jack County,3421,3298,123,3.6
CN4823900000000,2022-05-01,48,239,TX,Jackson County,7192,6960,232,3.2
CN4824100000000,2022-05-01,48,241,TX,Jasper County,12445,11687,758,6.1
CN4824300000000,2022-05-01,48,243,TX,Jeff Davis County,1087,1052,35,3.2
CN4824500000000,2022-05-01,48,245,TX,Jefferson County,100417,94632,5785,5.8
CN4824700000000,2022-05-01,48,247,TX,Jim Hogg County,1829,1737,92,5
CN4824900000000,2022-05-01,48,249,TX,Jim Wells County,15214,14403,811,5.3
CN4825100000000,2022-05-01,48,251,TX,Johnson County,88605,85708,2897,3.3
CN4825300000000,2022-05-01,48,253,TX,Jones County,5837,5599,238,4.1
CN4825500000000,2022-05-01,48,255,TX,Karnes County,6650,6440,210,3.2
CN4825700000000,2022-05-01,48,257,TX,Kaufman County,74696,72095,2601,3.5
CN4825900000000,2022-05-01,48,259,TX,Kendall County,23699,23010,689,2.9
CN4826100000000,2022-05-01,48,261,TX,Kenedy County,130,123,7,5.4
CN4826300000000,2022-05-01,48,263,TX,Kent County,535,522,13,2.4
CN4826500000000,2022-05-01,48,265,TX,Kerr County,22223,21455,768,3.5
CN4826700000000,2022-05-01,48,267,TX,Kimble County,1882,1822,60,3.2
CN4826900000000,2022-05-01,48,269,TX,King County,661,657,4,0.6
CN4827100000000,2022-05-01,48,271,TX,Kinney County,1282,1225,57,4.4
CN4827300000000,2022-05-01,48,273,TX,Kleberg County,13288,12700,588,4.4
CN4827500000000,2022-05-01,48,275,TX,Knox County,1512,1458,54,3.6
CN4827700000000,2022-05-01,48,277,TX,Lamar County,24570,23617,953,3.9
CN4827900000000,2022-05-01,48,279,TX,Lamb County,5405,5203,202,3.7
CN4828100000000,2022-05-01,48,281,TX,Lampasas County,9417,9090,327,3.5
CN4828300000000,2022-05-01,48,283,TX,La Salle County,4028,3912,116,2.9
CN4828500000000,2022-05-01,48,285,TX,Lavaca County,9140,8838,302,3.3
CN4828700000000,2022-05-01,48,287,TX,Lee County,8682,8390,292,3.4
CN4828900000000,2022-05-01,48,289,TX,Leon County,6067,5771,296,4.9
CN4829100000000,2022-05-01,48,291,TX,Liberty County,35148,33270,1878,5.3
CN4829300000000,2022-05-01,48,293,TX,Limestone County,8469,8097,372,4.4
CN4829500000000,2022-05-01,48,295,TX,Lipscomb County,1460,1419,41,2.8
CN4829700000000,2022-05-01,48,297,TX,Live Oak County,4907,4718,189,3.9
CN4829900000000,2022-05-01,48,299,TX,Llano County,9457,9115,342,3.6
CN4830100000000,2022-05-01,48,301,TX,Loving County,437,433,4,0.9
CN4830300000000,2022-05-01,48,303,TX,Lubbock County,164005,158929,5076,3.1
CN4830500000000,2022-05-01,48,305,TX,Lynn County,2930,2823,107,3.7
CN4830700000000,2022-05-01,48,307,TX,McCulloch County,3141,3019,122,3.9
CN4830900000000,2022-05-01,48,309,TX,McLennan County,126642,122365,4277,3.4
CN4831100000000,2022-05-01,48,311,TX,McMullen County,913,898,15,1.6
CN4831300000000,2022-05-01,48,313,TX,Madison County,4779,4581,198,4.1
CN4831500000000,2022-05-01,48,315,TX,Marion County,4198,4004,194,4.6
CN4831700000000,2022-05-01,48,317,TX,Martin County,2803,2716,87,3.1
CN4831900000000,2022-05-01,48,319,TX,Mason County,1841,1782,59,3.2
CN4832100000000,2022-05-01,48,321,TX,Matagorda County,16998,16048,950,5.6
CN4832300000000,2022-05-01,48,323,TX,Maverick County,23534,21678,1856,7.9
CN4832500000000,2022-05-01,48,325,TX,Medina County,22653,21835,818,3.6
CN4832700000000,2022-05-01,48,327,TX,Menard County,856,822,34,4
CN4832900000000,2022-05-01,48,329,TX,Midland County,105051,102088,2963,2.8
CN4833100000000,2022-05-01,48,331,TX,Milam County,10386,9989,397,3.8
CN4833300000000,2022-05-01,48,333,TX,Mills County,1927,1851,76,3.9
CN4833500000000,2022-05-01,48,335,TX,Mitchell County,2330,2226,104,4.5
CN4833700000000,2022-05-01,48,337,TX,Montague County,9272,8961,311,3.4
CN4833900000000,2022-05-01,48,339,TX,Montgomery County,301165,290088,11077,3.7
CN4834100000000,2022-05-01,48,341,TX,Moore County,11229,10952,277,2.5
CN4834300000000,2022-05-01,48,343,TX,Morris County,4439,4181,258,5.8
CN4834500000000,2022-05-01,48,345,TX,Motley County,519,497,22,4.2
CN4834700000000,2022-05-01,48,347,TX,Nacogdoches County,27913,26783,1130,4
CN4834900000000,2022-05-01,48,349,TX,Navarro County,23353,22481,872,3.7
CN4835100000000,2022-05-01,48,351,TX,Newton County,4857,4546,311,6.4
CN4835300000000,2022-05-01,48,353,TX,Nolan County,6802,6563,239,3.5
CN4835500000000,2022-05-01,48,355,TX,Nueces County,164553,157315,7238,4.4
CN4835700000000,2022-05-01,48,357,TX,Ochiltree County,4034,3906,128,3.2
CN4835900000000,2022-05-01,48,359,TX,Oldham County,957,929,28,2.9
CN4836100000000,2022-05-01,48,361,TX,Orange County,34618,32775,1843,5.3
CN4836300000000,2022-05-01,48,363,TX,Palo Pinto County,13176,12714,462,3.5
CN4836500000000,2022-05-01,48,365,TX,Panola County,9454,9027,427,4.5
CN4836700000000,2022-05-01,48,367,TX,Parker County,74315,72018,2297,3.1
CN4836900000000,2022-05-01,48,369,TX,Parmer County,5238,5125,113,2.2
CN4837100000000,2022-05-01,48,371,TX,Pecos County,6370,6128,242,3.8
CN4837300000000,2022-05-01,48,373,TX,Polk County,18599,17623,976,5.2
CN4837500000000,2022-05-01,48,375,TX,Potter County,55502,53822,1680,3
CN4837700000000,2022-05-01,48,377,TX,Presidio County,3145,2966,179,5.7
CN4837900000000,2022-05-01,48,379,TX,Rains County,6506,6298,208,3.2
CN4838100000000,2022-05-01,48,381,TX,Randall County,76810,74750,2060,2.7
CN4838300000000,2022-05-01,48,383,TX,Reagan County,1664,1608,56,3.4
CN4838500000000,2022-05-01,48,385,TX,Real County,1205,1155,50,4.1
CN4838700000000,2022-05-01,48,387,TX,Red River County,5210,4962,248,4.8
CN4838900000000,2022-05-01,48,389,TX,Reeves County,8630,8401,229,2.7
CN4839100000000,2022-05-01,48,391,TX,Refugio County,2981,2840,141,4.7
CN4839300000000,2022-05-01,48,393,TX,Roberts County,401,385,16,4
CN4839500000000,2022-05-01,48,395,TX,Robertson County,8044,7746,298,3.7
CN4839700000000,2022-05-01,48,397,TX,Rockwall County,58880,57087,1793,3
CN4839900000000,2022-05-01,48,399,TX,Runnels County,4679,4535,144,3.1
CN4840100000000,2022-05-01,48,401,TX,Rusk County,22442,21596,846,3.8
CN4840300000000,2022-05-01,48,403,TX,Sabine County,3995,3737,258,6.5
CN4840500000000,2022-05-01,48,405,TX,San Augustine County,3084,2908,176,5.7
CN4840700000000,2022-05-01,48,407,TX,San Jacinto County,12137,11595,542,4.5
CN4840900000000,2022-05-01,48,409,TX,San Patricio County,29385,27736,1649,5.6
CN4841100000000,2022-05-01,48,411,TX,San Saba County,2276,2201,75,3.3
CN4841300000000,2022-05-01,48,413,TX,Schleicher County,1255,1215,40,3.2
CN4841500000000,2022-05-01,48,415,TX,Scurry County,6221,5986,235,3.8
CN4841700000000,2022-05-01,48,417,TX,Shackelford County,1789,1742,47,2.6
CN4841900000000,2022-05-01,48,419,TX,Shelby County,10978,10545,433,3.9
CN4842100000000,2022-05-01,48,421,TX,Sherman County,1407,1370,37,2.6
CN4842300000000,2022-05-01,48,423,TX,Smith County,112978,109047,3931,3.5
CN4842500000000,2022-05-01,48,425,TX,Somervell County,4546,4386,160,3.5
CN4842700000000,2022-05-01,48,427,TX,Starr County,24702,22232,2470,10
CN4842900000000,2022-05-01,48,429,TX,Stephens County,4122,3983,139,3.4
CN4843100000000,2022-05-01,48,431,TX,Sterling County,554,532,22,4
CN4843300000000,2022-05-01,48,433,TX,Stonewall County,601,582,19,3.2
CN4843500000000,2022-05-01,48,435,TX,Sutton County,1045,989,56,5.4
CN4843700000000,2022-05-01,48,437,TX,Swisher County,2605,2510,95,3.6
CN4843900000000,2022-05-01,48,439,TX,Tarrant County,1134173,1096000,38173,3.4
CN4844100000000,2022-05-01,48,441,TX,Taylor County,68682,66508,2174,3.2
CN4844300000000,2022-05-01,48,443,TX,Terrell County,400,387,13,3.3
CN4844500000000,2022-05-01,48,445,TX,Terry County,4744,4555,189,4
CN4844700000000,2022-05-01,48,447,TX,Throckmorton County,746,725,21,2.8
CN4844900000000,2022-05-01,48,449,TX,Titus County,13624,13093,531,3.9
CN4845100000000,2022-05-01,48,451,TX,Tom Green County,55707,53921,1786,3.2
CN4845300000000,2022-05-01,48,453,TX,Travis County,818377,796875,21502,2.6
CN4845500000000,2022-05-01,48,455,TX,Trinity County,5364,5102,262,4.9
CN4845700000000,2022-05-01,48,457,TX,Tyler County,7130,6731,399,5.6
CN4845900000000,2022-05-01,48,459,TX,Upshur County,17859,17151,708,4
CN4846100000000,2022-05-01,48,461,TX,Upton County,2475,2412,63,2.5
CN4846300000000,2022-05-01,48,463,TX,Uvalde County,11314,10870,444,3.9
CN4846500000000,2022-05-01,48,465,TX,Val Verde County,22146,21246,900,4.1
CN4846700000000,2022-05-01,48,467,TX,Van Zandt County,28080,27150,930,3.3
CN4846900000000,2022-05-01,48,469,TX,Victoria County,41136,39492,1644,4
CN4847100000000,2022-05-01,48,471,TX,Walker County,24027,22968,1059,4.4
CN4847300000000,2022-05-01,48,473,TX,Waller County,25413,24413,1000,3.9
CN4847500000000,2022-05-01,48,475,TX,Ward County,6142,5925,217,3.5
CN4847700000000,2022-05-01,48,477,TX,Washington County,15365,14801,564,3.7
CN4847900000000,2022-05-01,48,479,TX,Webb County,117504,112770,4734,4
CN4848100000000,2022-05-01,48,481,TX,Wharton County,21667,20912,755,3.5
CN4848300000000,2022-05-01,48,483,TX,Wheeler County,2018,1946,72,3.6
CN4848500000000,2022-05-01,48,485,TX,Wichita County,55556,53496,2060,3.7
CN4848700000000,2022-05-01,48,487,TX,Wilbarger County,4964,4741,223,4.5
CN4848900000000,2022-05-01,48,489,TX,Willacy County,7310,6697,613,8.4
CN4849100000000,2022-05-01,48,491,TX,Williamson County,362782,352893,9889,2.7
CN4849300000000,2022-05-01,48,493,TX,Wilson County,25910,25111,799,3.1
CN4849500000000,2022-05-01,48,495,TX,Winkler County,3960,3815,145,3.7
CN4849700000000,2022-05-01,48,497,TX,Wise County,34154,33054,1100,3.2
CN4849900000000,2022-05-01,48,499,TX,Wood County,18196,17423,773,4.2
CN4850100000000,2022-05-01,48,501,TX,Yoakum County,3309,3180,129,3.9
CN4850300000000,2022-05-01,48,503,TX,Young County,8155,7881,274,3.4
CN4850500000000,2022-05-01,48,505,TX,Zapata County,4333,4024,309,7.1
CN4850700000000,2022-05-01,48,507,TX,Zavala County,3369,3080,289,8.6
CN4900100000000,2022-05-01,49,001,UT,Beaver County,3087,3010,77,2.5
CN4900300000000,2022-05-01,49,003,UT,Box Elder County,27859,27280,579,2.1
CN4900500000000,2022-05-01,49,005,UT,Cache County,71920,70510,1410,2
CN4900700000000,2022-05-01,49,007,UT,Carbon County,8561,8282,279,3.3
CN4900900000000,2022-05-01,49,009,UT,Daggett County,477,458,19,4
CN4901100000000,2022-05-01,49,011,UT,Davis County,184166,180307,3859,2.1
CN4901300000000,2022-05-01,49,013,UT,Duchesne County,8151,7913,238,2.9
CN4901500000000,2022-05-01,49,015,UT,Emery County,4590,4462,128,2.8
CN4901700000000,2022-05-01,49,017,UT,Garfield County,3291,3163,128,3.9
CN4901900000000,2022-05-01,49,019,UT,Grand County,7478,7332,146,2
CN4902100000000,2022-05-01,49,021,UT,Iron County,27479,26798,681,2.5
CN4902300000000,2022-05-01,49,023,UT,Juab County,6393,6270,123,1.9
CN4902500000000,2022-05-01,49,025,UT,Kane County,4207,4123,84,2
CN4902700000000,2022-05-01,49,027,UT,Millard County,6577,6438,139,2.1
CN4902900000000,2022-05-01,49,029,UT,Morgan County,5965,5849,116,1.9
CN4903100000000,2022-05-01,49,031,UT,Piute County,536,517,19,3.5
CN4903300000000,2022-05-01,49,033,UT,Rich County,1298,1270,28,2.2
CN4903500000000,2022-05-01,49,035,UT,Salt Lake County,671339,656634,14705,2.2
CN4903700000000,2022-05-01,49,037,UT,San Juan County,5822,5606,216,3.7
CN4903900000000,2022-05-01,49,039,UT,Sanpete County,13701,13347,354,2.6
CN4904100000000,2022-05-01,49,041,UT,Sevier County,10439,10188,251,2.4
CN4904300000000,2022-05-01,49,043,UT,Summit County,25484,24799,685,2.7
CN4904500000000,2022-05-01,49,045,UT,Tooele County,37824,36929,895,2.4
CN4904700000000,2022-05-01,49,047,UT,Uintah County,14175,13694,481,3.4
CN4904900000000,2022-05-01,49,049,UT,Utah County,344035,336796,7239,2.1
CN4905100000000,2022-05-01,49,051,UT,Wasatch County,17670,17229,441,2.5
CN4905300000000,2022-05-01,49,053,UT,Washington County,87738,85734,2004,2.3
CN4905500000000,2022-05-01,49,055,UT,Wayne County,1620,1565,55,3.4
CN4905700000000,2022-05-01,49,057,UT,Weber County,135161,132023,3138,2.3
CN5000100000000,2022-05-01,50,001,VT,Addison County,21130,20714,416,2
CN5000300000000,2022-05-01,50,003,VT,Bennington County,17555,17065,490,2.8
CN5000500000000,2022-05-01,50,005,VT,Caledonia County,14543,14191,352,2.4
CN5000700000000,2022-05-01,50,007,VT,Chittenden County,97089,95486,1603,1.7
CN5000900000000,2022-05-01,50,009,VT,Essex County,2654,2586,68,2.6
CN5001100000000,2022-05-01,50,011,VT,Franklin County,27720,27110,610,2.2
CN5001300000000,2022-05-01,50,013,VT,Grand Isle County,4102,4006,96,2.3
CN5001500000000,2022-05-01,50,015,VT,Lamoille County,13932,13473,459,3.3
CN5001700000000,2022-05-01,50,017,VT,Orange County,15611,15301,310,2
CN5001900000000,2022-05-01,50,019,VT,Orleans County,13168,12732,436,3.3
CN5002100000000,2022-05-01,50,021,VT,Rutland County,29686,28836,850,2.9
CN5002300000000,2022-05-01,50,023,VT,Washington County,33433,32752,681,2
CN5002500000000,2022-05-01,50,025,VT,Windham County,21196,20597,599,2.8
CN5002700000000,2022-05-01,50,027,VT,Windsor County,28281,27719,562,2
CN5100100000000,2022-05-01,51,001,VA,Accomack County,15657,15167,490,3.1
CN5100300000000,2022-05-01,51,003,VA,Albemarle County,57876,56307,1569,2.7
CN5100500000000,2022-05-01,51,005,VA,Alleghany County,6640,6421,219,3.3
CN5100700000000,2022-05-01,51,007,VA,Amelia County,6226,6042,184,3
CN5100900000000,2022-05-01,51,009,VA,Amherst County,14789,14337,452,3.1
CN5101100000000,2022-05-01,51,011,VA,Appomattox County,7106,6873,233,3.3
CN5101300000000,2022-05-01,51,013,VA,Arlington County,157506,154182,3324,2.1
CN5101500000000,2022-05-01,51,015,VA,Augusta County,37810,36783,1027,2.7
CN5101700000000,2022-05-01,51,017,VA,Bath County,2362,2305,57,2.4
CN5101900000000,2022-05-01,51,019,VA,Bedford County,38530,37404,1126,2.9
CN5102100000000,2022-05-01,51,021,VA,Bland County,2751,2672,79,2.9
CN5102300000000,2022-05-01,51,023,VA,Botetourt County,17658,17197,461,2.6
CN5102500000000,2022-05-01,51,025,VA,Brunswick County,5860,5605,255,4.4
CN5102700000000,2022-05-01,51,027,VA,Buchanan County,6364,6064,300,4.7
CN5102900000000,2022-05-01,51,029,VA,Buckingham County,6379,6138,241,3.8
CN5103100000000,2022-05-01,51,031,VA,Campbell County,25809,25011,798,3.1
CN5103300000000,2022-05-01,51,033,VA,Caroline County,15322,14838,484,3.2
CN5103500000000,2022-05-01,51,035,VA,Carroll County,12881,12434,447,3.5
CN5103600000000,2022-05-01,51,036,VA,Charles City County,3568,3450,118,3.3
CN5103700000000,2022-05-01,51,037,VA,Charlotte County,5477,5309,168,3.1
CN5104100000000,2022-05-01,51,041,VA,Chesterfield County,193717,188255,5462,2.8
CN5104300000000,2022-05-01,51,043,VA,Clarke County,7639,7435,204,2.7
CN5104500000000,2022-05-01,51,045,VA,Craig County,2311,2241,70,3
CN5104700000000,2022-05-01,51,047,VA,Culpeper County,25589,24848,741,2.9
CN5104900000000,2022-05-01,51,049,VA,Cumberland County,4719,4568,151,3.2
CN5105100000000,2022-05-01,51,051,VA,Dickenson County,4548,4347,201,4.4
CN5105300000000,2022-05-01,51,053,VA,Dinwiddie County,13746,13305,441,3.2
CN5105700000000,2022-05-01,51,057,VA,Essex County,5442,5266,176,3.2
CN5105900000000,2022-05-01,51,059,VA,Fairfax County,641930,625722,16208,2.5
CN5106100000000,2022-05-01,51,061,VA,Fauquier County,37611,36624,987,2.6
CN5106300000000,2022-05-01,51,063,VA,Floyd County,8253,8038,215,2.6
CN5106500000000,2022-05-01,51,065,VA,Fluvanna County,14198,13831,367,2.6
CN5106700000000,2022-05-01,51,067,VA,Franklin County,26443,25639,804,3
CN5106900000000,2022-05-01,51,069,VA,Frederick County,51341,50072,1269,2.5
CN5107100000000,2022-05-01,51,071,VA,Giles County,7963,7720,243,3.1
CN5107300000000,2022-05-01,51,073,VA,Gloucester County,19580,19045,535,2.7
CN5107500000000,2022-05-01,51,075,VA,Goochland County,11832,11502,330,2.8
CN5107700000000,2022-05-01,51,077,VA,Grayson County,8008,7795,213,2.7
CN5107900000000,2022-05-01,51,079,VA,Greene County,10617,10354,263,2.5
CN5108100000000,2022-05-01,51,081,VA,Greensville County,4312,4164,148,3.4
CN5108300000000,2022-05-01,51,083,VA,Halifax County,15379,14801,578,3.8
CN5108500000000,2022-05-01,51,085,VA,Hanover County,60028,58506,1522,2.5
CN5108700000000,2022-05-01,51,087,VA,Henrico County,185498,180212,5286,2.8
CN5108900000000,2022-05-01,51,089,VA,Henry County,23697,22892,805,3.4
CN5109100000000,2022-05-01,51,091,VA,Highland County,1327,1294,33,2.5
CN5109300000000,2022-05-01,51,093,VA,Isle of Wight County,19753,19199,554,2.8
CN5109500000000,2022-05-01,51,095,VA,James City County,37269,36165,1104,3
CN5109700000000,2022-05-01,51,097,VA,King and Queen County,3893,3787,106,2.7
CN5109900000000,2022-05-01,51,099,VA,King George County,14464,14094,370,2.6
CN5110100000000,2022-05-01,51,101,VA,King William County,9564,9305,259,2.7
CN5110300000000,2022-05-01,51,103,VA,Lancaster County,5355,5178,177,3.3
CN5110500000000,2022-05-01,51,105,VA,Lee County,8241,7937,304,3.7
CN5110700000000,2022-05-01,51,107,VA,Loudoun County,232934,227208,5726,2.5
CN5110900000000,2022-05-01,51,109,VA,Louisa County,20737,20161,576,2.8
CN5111100000000,2022-05-01,51,111,VA,Lunenburg County,5112,4945,167,3.3
CN5111300000000,2022-05-01,51,113,VA,Madison County,7568,7391,177,2.3
CN5111500000000,2022-05-01,51,115,VA,Mathews County,4120,3997,123,3
CN5111700000000,2022-05-01,51,117,VA,Mecklenburg County,12873,12416,457,3.6
CN5111900000000,2022-05-01,51,119,VA,Middlesex County,5251,5102,149,2.8
CN5112100000000,2022-05-01,51,121,VA,Montgomery County,51219,49715,1504,2.9
CN5112500000000,2022-05-01,51,125,VA,Nelson County,7343,7126,217,3
CN5112700000000,2022-05-01,51,127,VA,New Kent County,13230,12900,330,2.5
CN5113100000000,2022-05-01,51,131,VA,Northampton County,5370,5189,181,3.4
CN5113300000000,2022-05-01,51,133,VA,Northumberland County,5529,5336,193,3.5
CN5113500000000,2022-05-01,51,135,VA,Nottoway County,7230,7009,221,3.1
CN5113700000000,2022-05-01,51,137,VA,Orange County,17894,17363,531,3
CN5113900000000,2022-05-01,51,139,VA,Page County,12182,11812,370,3
CN5114100000000,2022-05-01,51,141,VA,Patrick County,7183,6920,263,3.7
CN5114300000000,2022-05-01,51,143,VA,Pittsylvania County,30136,29188,948,3.1
CN5114500000000,2022-05-01,51,145,VA,Powhatan County,14686,14305,381,2.6
CN5114700000000,2022-05-01,51,147,VA,Prince Edward County,9855,9455,400,4.1
CN5114900000000,2022-05-01,51,149,VA,Prince George County,15361,14851,510,3.3
CN5115300000000,2022-05-01,51,153,VA,Prince William County,251786,244845,6941,2.8
CN5115500000000,2022-05-01,51,155,VA,Pulaski County,16398,15894,504,3.1
CN5115700000000,2022-05-01,51,157,VA,Rappahannock County,3710,3610,100,2.7
CN5115900000000,2022-05-01,51,159,VA,Richmond County,3961,3849,112,2.8
CN5116100000000,2022-05-01,51,161,VA,Roanoke County,49978,48663,1315,2.6
CN5116300000000,2022-05-01,51,163,VA,Rockbridge County,10614,10297,317,3
CN5116500000000,2022-05-01,51,165,VA,Rockingham County,42196,41070,1126,2.7
CN5116700000000,2022-05-01,51,167,VA,Russell County,10852,10463,389,3.6
CN5116900000000,2022-05-01,51,169,VA,Scott County,9183,8895,288,3.1
CN5117100000000,2022-05-01,51,171,VA,Shenandoah County,21927,21285,642,2.9
CN5117300000000,2022-05-01,51,173,VA,Smyth County,13629,13199,430,3.2
CN5117500000000,2022-05-01,51,175,VA,Southampton County,8727,8463,264,3
CN5117700000000,2022-05-01,51,177,VA,Spotsylvania County,69565,67531,2034,2.9
CN5117900000000,2022-05-01,51,179,VA,Stafford County,75843,73660,2183,2.9
CN5118100000000,2022-05-01,51,181,VA,Surry County,3578,3466,112,3.1
CN5118300000000,2022-05-01,51,183,VA,Sussex County,3583,3430,153,4.3
CN5118500000000,2022-05-01,51,185,VA,Tazewell County,15371,14754,617,4
CN5118700000000,2022-05-01,51,187,VA,Warren County,20827,20211,616,3
CN5119100000000,2022-05-01,51,191,VA,Washington County,26388,25606,782,3
CN5119300000000,2022-05-01,51,193,VA,Westmoreland County,9556,9269,287,3
CN5119500000000,2022-05-01,51,195,VA,Wise County,12767,12238,529,4.1
CN5119700000000,2022-05-01,51,197,VA,Wythe County,13976,13553,423,3
CN5119900000000,2022-05-01,51,199,VA,York County,33455,32502,953,2.8
CN5151000000000,2022-05-01,51,510,VA,Alexandria city,101183,98784,2399,2.4
CN5152000000000,2022-05-01,51,520,VA,Bristol city,7618,7355,263,3.5
CN5153000000000,2022-05-01,51,530,VA,Buena Vista city,3011,2917,94,3.1
CN5154000000000,2022-05-01,51,540,VA,Charlottesville city,25680,24997,683,2.7
CN5155000000000,2022-05-01,51,550,VA,Chesapeake city,124787,121098,3689,3
CN5157000000000,2022-05-01,51,570,VA,Colonial Heights city,8529,8266,263,3.1
CN5158000000000,2022-05-01,51,580,VA,Covington city,2285,2198,87,3.8
CN5159000000000,2022-05-01,51,590,VA,Danville city,18690,17835,855,4.6
CN5159500000000,2022-05-01,51,595,VA,Emporia city,2314,2211,103,4.5
CN5160000000000,2022-05-01,51,600,VA,Fairfax city,12977,12656,321,2.5
CN5161000000000,2022-05-01,51,610,VA,Falls Church city,8601,8415,186,2.2
CN5162000000000,2022-05-01,51,620,VA,Franklin city,3437,3311,126,3.7
CN5163000000000,2022-05-01,51,630,VA,Fredericksburg city,14426,13938,488,3.4
CN5164000000000,2022-05-01,51,640,VA,Galax city,2857,2771,86,3
CN5165000000000,2022-05-01,51,650,VA,Hampton city,64805,62383,2422,3.7
CN5166000000000,2022-05-01,51,660,VA,Harrisonburg city,24682,23812,870,3.5
CN5167000000000,2022-05-01,51,670,VA,Hopewell city,9614,9206,408,4.2
CN5167800000000,2022-05-01,51,678,VA,Lexington city,2184,2090,94,4.3
CN5168000000000,2022-05-01,51,680,VA,Lynchburg city,35734,34323,1411,3.9
CN5168300000000,2022-05-01,51,683,VA,Manassas city,21842,21264,578,2.6
CN5168500000000,2022-05-01,51,685,VA,Manassas Park city,9845,9594,251,2.5
CN5169000000000,2022-05-01,51,690,VA,Martinsville city,5501,5259,242,4.4
CN5170000000000,2022-05-01,51,700,VA,Newport News city,89043,85846,3197,3.6
CN5171000000000,2022-05-01,51,710,VA,Norfolk city,110953,107091,3862,3.5
CN5172000000000,2022-05-01,51,720,VA,Norton city,1600,1535,65,4.1
CN5173000000000,2022-05-01,51,730,VA,Petersburg city,12568,11911,657,5.2
CN5173500000000,2022-05-01,51,735,VA,Poquoson city,6389,6225,164,2.6
CN5174000000000,2022-05-01,51,740,VA,Portsmouth city,44400,42724,1676,3.8
CN5175000000000,2022-05-01,51,750,VA,Radford city,8861,8528,333,3.8
CN5176000000000,2022-05-01,51,760,VA,Richmond city,120823,116750,4073,3.4
CN5177000000000,2022-05-01,51,770,VA,Roanoke city,49132,47596,1536,3.1
CN5177500000000,2022-05-01,51,775,VA,Salem city,12940,12550,390,3
CN5179000000000,2022-05-01,51,790,VA,Staunton city,12362,12014,348,2.8
CN5180000000000,2022-05-01,51,800,VA,Suffolk city,45905,44455,1450,3.2
CN5181000000000,2022-05-01,51,810,VA,Virginia Beach city,233716,227164,6552,2.8
CN5182000000000,2022-05-01,51,820,VA,Waynesboro city,10743,10425,318,3
CN5183000000000,2022-05-01,51,830,VA,Williamsburg city,6875,6591,284,4.1
CN5184000000000,2022-05-01,51,840,VA,Winchester city,14999,14592,407,2.7
CN5300100000000,2022-05-01,53,001,WA,Adams County,9748,9325,423,4.3
CN5300300000000,2022-05-01,53,003,WA,Asotin County,10635,10249,386,3.6
CN5300500000000,2022-05-01,53,005,WA,Benton County,104975,100199,4776,4.5
CN5300700000000,2022-05-01,53,007,WA,Chelan County,42541,40649,1892,4.4
CN5300900000000,2022-05-01,53,009,WA,Clallam County,28846,27257,1589,5.5
CN5301100000000,2022-05-01,53,011,WA,Clark County,246288,235490,10798,4.4
CN5301300000000,2022-05-01,53,013,WA,Columbia County,1775,1685,90,5.1
CN5301500000000,2022-05-01,53,015,WA,Cowlitz County,48328,45765,2563,5.3
CN5301700000000,2022-05-01,53,017,WA,Douglas County,21327,20328,999,4.7
CN5301900000000,2022-05-01,53,019,WA,Ferry County,2307,2124,183,7.9
CN5302100000000,2022-05-01,53,021,WA,Franklin County,44484,42119,2365,5.3
CN5302300000000,2022-05-01,53,023,WA,Garfield County,793,742,51,6.4
CN5302500000000,2022-05-01,53,025,WA,Grant County,48336,45821,2515,5.2
CN5302700000000,2022-05-01,53,027,WA,Grays Harbor County,28986,27178,1808,6.2
CN5302900000000,2022-05-01,53,029,WA,Island County,36660,34977,1683,4.6
CN5303100000000,2022-05-01,53,031,WA,Jefferson County,12425,11767,658,5.3
CN5303300000000,2022-05-01,53,033,WA,King County,1320230,1287486,32744,2.5
CN5303500000000,2022-05-01,53,035,WA,Kitsap County,127975,122542,5433,4.2
CN5303700000000,2022-05-01,53,037,WA,Kittitas County,22960,21769,1191,5.2
CN5303900000000,2022-05-01,53,039,WA,Klickitat County,9810,9305,505,5.1
CN5304100000000,2022-05-01,53,041,WA,Lewis County,34373,32463,1910,5.6
CN5304300000000,2022-05-01,53,043,WA,Lincoln County,4560,4347,213,4.7
CN5304500000000,2022-05-01,53,045,WA,Mason County,25125,23661,1464,5.8
CN5304700000000,2022-05-01,53,047,WA,Okanogan County,19036,17973,1063,5.6
CN5304900000000,2022-05-01,53,049,WA,Pacific County,8541,8020,521,6.1
CN5305100000000,2022-05-01,53,051,WA,Pend Oreille County,5099,4793,306,6
CN5305300000000,2022-05-01,53,053,WA,Pierce County,449989,428485,21504,4.8
CN5305500000000,2022-05-01,53,055,WA,San Juan County,8678,8354,324,3.7
CN5305700000000,2022-05-01,53,057,WA,Skagit County,61175,58155,3020,4.9
CN5305900000000,2022-05-01,53,059,WA,Skamania County,5481,5220,261,4.8
CN5306100000000,2022-05-01,53,061,WA,Snohomish County,449782,437362,12420,2.8
CN5306300000000,2022-05-01,53,063,WA,Spokane County,261404,250308,11096,4.2
CN5306500000000,2022-05-01,53,065,WA,Stevens County,18970,17895,1075,5.7
CN5306700000000,2022-05-01,53,067,WA,Thurston County,147038,140548,6490,4.4
CN5306900000000,2022-05-01,53,069,WA,Wahkiakum County,1324,1235,89,6.7
CN5307100000000,2022-05-01,53,071,WA,Walla Walla County,30721,29455,1266,4.1
CN5307300000000,2022-05-01,53,073,WA,Whatcom County,113975,108786,5189,4.6
CN5307500000000,2022-05-01,53,075,WA,Whitman County,23955,22907,1048,4.4
CN5307700000000,2022-05-01,53,077,WA,Yakima County,128881,121606,7275,5.6
CN5400100000000,2022-05-01,54,001,WV,Barbour County,7296,7008,288,3.9
CN5400300000000,2022-05-01,54,003,WV,Berkeley County,59669,58074,1595,2.7
CN5400500000000,2022-05-01,54,005,WV,Boone County,7075,6776,299,4.2
CN5400700000000,2022-05-01,54,007,WV,Braxton County,5105,4833,272,5.3
CN5400900000000,2022-05-01,54,009,WV,Brooke County,9899,9484,415,4.2
CN5401100000000,2022-05-01,54,011,WV,Cabell County,41482,40132,1350,3.3
CN5401300000000,2022-05-01,54,013,WV,Calhoun County,2538,2391,147,5.8
CN5401500000000,2022-05-01,54,015,WV,Clay County,2944,2799,145,4.9
CN5401700000000,2022-05-01,54,017,WV,Doddridge County,3884,3782,102,2.6
CN5401900000000,2022-05-01,54,019,WV,Fayette County,15728,15089,639,4.1
CN5402100000000,2022-05-01,54,021,WV,Gilmer County,2430,2328,102,4.2
CN5402300000000,2022-05-01,54,023,WV,Grant County,5936,5768,168,2.8
CN5402500000000,2022-05-01,54,025,WV,Greenbrier County,15670,15189,481,3.1
CN5402700000000,2022-05-01,54,027,WV,Hampshire County,11057,10802,255,2.3
CN5402900000000,2022-05-01,54,029,WV,Hancock County,13033,12476,557,4.3
CN5403100000000,2022-05-01,54,031,WV,Hardy County,5675,5477,198,3.5
CN5403300000000,2022-05-01,54,033,WV,Harrison County,33967,32874,1093,3.2
CN5403500000000,2022-05-01,54,035,WV,Jackson County,11959,11530,429,3.6
CN5403700000000,2022-05-01,54,037,WV,Jefferson County,30897,30185,712,2.3
CN5403900000000,2022-05-01,54,039,WV,Kanawha County,79797,77089,2708,3.4
CN5404100000000,2022-05-01,54,041,WV,Lewis County,6429,6174,255,4
CN5404300000000,2022-05-01,54,043,WV,Lincoln County,7036,6726,310,4.4
CN5404500000000,2022-05-01,54,045,WV,Logan County,11547,11105,442,3.8
CN5404700000000,2022-05-01,54,047,WV,McDowell County,4253,4010,243,5.7
CN5404900000000,2022-05-01,54,049,WV,Marion County,25425,24442,983,3.9
CN5405100000000,2022-05-01,54,051,WV,Marshall County,13104,12529,575,4.4
CN5405300000000,2022-05-01,54,053,WV,Mason County,10488,10120,368,3.5
CN5405500000000,2022-05-01,54,055,WV,Mercer County,20575,19702,873,4.2
CN5405700000000,2022-05-01,54,057,WV,Mineral County,12539,12121,418,3.3
CN5405900000000,2022-05-01,54,059,WV,Mingo County,6307,5992,315,5
CN5406100000000,2022-05-01,54,061,WV,Monongalia County,56033,54226,1807,3.2
CN5406300000000,2022-05-01,54,063,WV,Monroe County,6119,5954,165,2.7
CN5406500000000,2022-05-01,54,065,WV,Morgan County,8637,8408,229,2.7
CN5406700000000,2022-05-01,54,067,WV,Nicholas County,9124,8767,357,3.9
CN5406900000000,2022-05-01,54,069,WV,Ohio County,20032,19287,745,3.7
CN5407100000000,2022-05-01,54,071,WV,Pendleton County,3905,3822,83,2.1
CN5407300000000,2022-05-01,54,073,WV,Pleasants County,2666,2540,126,4.7
CN5407500000000,2022-05-01,54,075,WV,Pocahontas County,3853,3653,200,5.2
CN5407700000000,2022-05-01,54,077,WV,Preston County,15637,15095,542,3.5
CN5407900000000,2022-05-01,54,079,WV,Putnam County,26970,26171,799,3
CN5408100000000,2022-05-01,54,081,WV,Raleigh County,29684,28701,983,3.3
CN5408300000000,2022-05-01,54,083,WV,Randolph County,11813,11326,487,4.1
CN5408500000000,2022-05-01,54,085,WV,Ritchie County,4261,4113,148,3.5
CN5408700000000,2022-05-01,54,087,WV,Roane County,5135,4860,275,5.4
CN5408900000000,2022-05-01,54,089,WV,Summers County,4646,4486,160,3.4
CN5409100000000,2022-05-01,54,091,WV,Taylor County,7993,7727,266,3.3
CN5409300000000,2022-05-01,54,093,WV,Tucker County,3619,3507,112,3.1
CN5409500000000,2022-05-01,54,095,WV,Tyler County,2956,2809,147,5
CN5409700000000,2022-05-01,54,097,WV,Upshur County,9817,9410,407,4.1
CN5409900000000,2022-05-01,54,099,WV,Wayne County,15548,15011,537,3.5
CN5410100000000,2022-05-01,54,101,WV,Webster County,3263,3149,114,3.5
CN5410300000000,2022-05-01,54,103,WV,Wetzel County,6588,6300,288,4.4
CN5410500000000,2022-05-01,54,105,WV,Wirt County,2248,2140,108,4.8
CN5410700000000,2022-05-01,54,107,WV,Wood County,36580,35294,1286,3.5
CN5410900000000,2022-05-01,54,109,WV,Wyoming County,7235,6956,279,3.9
CN5500100000000,2022-05-01,55,001,WI,Adams County,7766,7445,321,4.1
CN5500300000000,2022-05-01,55,003,WI,Ashland County,7554,7259,295,3.9
CN5500500000000,2022-05-01,55,005,WI,Barron County,23723,23007,716,3
CN5500700000000,2022-05-01,55,007,WI,Bayfield County,7453,7118,335,4.5
CN5500900000000,2022-05-01,55,009,WI,Brown County,140113,136517,3596,2.6
CN5501100000000,2022-05-01,55,011,WI,Buffalo County,6240,6049,191,3.1
CN5501300000000,2022-05-01,55,013,WI,Burnett County,7264,6965,299,4.1
CN5501500000000,2022-05-01,55,015,WI,Calumet County,27347,26719,628,2.3
CN5501700000000,2022-05-01,55,017,WI,Chippewa County,33665,32768,897,2.7
CN5501900000000,2022-05-01,55,019,WI,Clark County,17517,17136,381,2.2
CN5502100000000,2022-05-01,55,021,WI,Columbia County,31418,30668,750,2.4
CN5502300000000,2022-05-01,55,023,WI,Crawford County,7113,6892,221,3.1
CN5502500000000,2022-05-01,55,025,WI,Dane County,326893,319807,7086,2.2
CN5502700000000,2022-05-01,55,027,WI,Dodge County,47002,45872,1130,2.4
CN5502900000000,2022-05-01,55,029,WI,Door County,15317,14892,425,2.8
CN5503100000000,2022-05-01,55,031,WI,Douglas County,22676,21723,953,4.2
CN5503300000000,2022-05-01,55,033,WI,Dunn County,23807,23135,672,2.8
CN5503500000000,2022-05-01,55,035,WI,Eau Claire County,60004,58629,1375,2.3
CN5503700000000,2022-05-01,55,037,WI,Florence County,2157,2089,68,3.2
CN5503900000000,2022-05-01,55,039,WI,Fond du Lac County,55810,54455,1355,2.4
CN5504100000000,2022-05-01,55,041,WI,Forest County,3851,3676,175,4.5
CN5504300000000,2022-05-01,55,043,WI,Grant County,27244,26598,646,2.4
CN5504500000000,2022-05-01,55,045,WI,Green County,20604,20157,447,2.2
CN5504700000000,2022-05-01,55,047,WI,Green Lake County,9193,8920,273,3
CN5504900000000,2022-05-01,55,049,WI,Iowa County,13481,13174,307,2.3
CN5505100000000,2022-05-01,55,051,WI,Iron County,2513,2389,124,4.9
CN5505300000000,2022-05-01,55,053,WI,Jackson County,9368,9071,297,3.2
CN5505500000000,2022-05-01,55,055,WI,Jefferson County,45552,44392,1160,2.5
CN5505700000000,2022-05-01,55,057,WI,Juneau County,13241,12868,373,2.8
CN5505900000000,2022-05-01,55,059,WI,Kenosha County,89375,86461,2914,3.3
CN5506100000000,2022-05-01,55,061,WI,Kewaunee County,10740,10497,243,2.3
CN5506300000000,2022-05-01,55,063,WI,La Crosse County,65934,64361,1573,2.4
CN5506500000000,2022-05-01,55,065,WI,Lafayette County,10181,9980,201,2
CN5506700000000,2022-05-01,55,067,WI,Langlade County,9238,8923,315,3.4
CN5506900000000,2022-05-01,55,069,WI,Lincoln County,14699,14302,397,2.7
CN5507100000000,2022-05-01,55,071,WI,Manitowoc County,40596,39524,1072,2.6
CN5507300000000,2022-05-01,55,073,WI,Marathon County,72756,71052,1704,2.3
CN5507500000000,2022-05-01,55,075,WI,Marinette County,18956,18300,656,3.5
CN5507700000000,2022-05-01,55,077,WI,Marquette County,7613,7388,225,3
CN5507800000000,2022-05-01,55,078,WI,Menominee County,1504,1416,88,5.9
CN5507900000000,2022-05-01,55,079,WI,Milwaukee County,457817,440826,16991,3.7
CN5508100000000,2022-05-01,55,081,WI,Monroe County,23218,22658,560,2.4
CN5508300000000,2022-05-01,55,083,WI,Oconto County,20459,19889,570,2.8
CN5508500000000,2022-05-01,55,085,WI,Oneida County,17840,17348,492,2.8
CN5508700000000,2022-05-01,55,087,WI,Outagamie County,103166,100692,2474,2.4
CN5508900000000,2022-05-01,55,089,WI,Ozaukee County,48820,47620,1200,2.5
CN5509100000000,2022-05-01,55,091,WI,Pepin County,4101,4003,98,2.4
CN5509300000000,2022-05-01,55,093,WI,Pierce County,24413,23685,728,3
CN5509500000000,2022-05-01,55,095,WI,Polk County,24488,23673,815,3.3
CN5509700000000,2022-05-01,55,097,WI,Portage County,37512,36448,1064,2.8
CN5509900000000,2022-05-01,55,099,WI,Price County,6250,6047,203,3.2
CN5510100000000,2022-05-01,55,101,WI,Racine County,97483,94106,3377,3.5
CN5510300000000,2022-05-01,55,103,WI,Richland County,8821,8598,223,2.5
CN5510500000000,2022-05-01,55,105,WI,Rock County,85265,82229,3036,3.6
CN5510700000000,2022-05-01,55,107,WI,Rusk County,6468,6247,221,3.4
CN5510900000000,2022-05-01,55,109,WI,St. Croix County,49537,48168,1369,2.8
CN5511100000000,2022-05-01,55,111,WI,Sauk County,34294,33373,921,2.7
CN5511300000000,2022-05-01,55,113,WI,Sawyer County,8083,7806,277,3.4
CN5511500000000,2022-05-01,55,115,WI,Shawano County,20435,19877,558,2.7
CN5511700000000,2022-05-01,55,117,WI,Sheboygan County,61172,59667,1505,2.5
CN5511900000000,2022-05-01,55,119,WI,Taylor County,10609,10316,293,2.8
CN5512100000000,2022-05-01,55,121,WI,Trempealeau County,14966,14567,399,2.7
CN5512300000000,2022-05-01,55,123,WI,Vernon County,15270,14905,365,2.4
CN5512500000000,2022-05-01,55,125,WI,Vilas County,10281,9934,347,3.4
CN5512700000000,2022-05-01,55,127,WI,Walworth County,57984,56407,1577,2.7
CN5512900000000,2022-05-01,55,129,WI,Washburn County,7786,7553,233,3
CN5513100000000,2022-05-01,55,131,WI,Washington County,76103,74303,1800,2.4
CN5513300000000,2022-05-01,55,133,WI,Waukesha County,222660,217174,5486,2.5
CN5513500000000,2022-05-01,55,135,WI,Waupaca County,25266,24556,710,2.8
CN5513700000000,2022-05-01,55,137,WI,Waushara County,11056,10703,353,3.2
CN5513900000000,2022-05-01,55,139,WI,Winnebago County,91365,89075,2290,2.5
CN5514100000000,2022-05-01,55,141,WI,Wood County,33642,32633,1009,3
CN5600100000000,2022-05-01,56,001,WY,Albany County,21198,20569,629,3
CN5600300000000,2022-05-01,56,003,WY,Big Horn County,5366,5166,200,3.7
CN5600500000000,2022-05-01,56,005,WY,Campbell County,22414,21644,770,3.4
CN5600700000000,2022-05-01,56,007,WY,Carbon County,7725,7480,245,3.2
CN5600900000000,2022-05-01,56,009,WY,Converse County,7584,7351,233,3.1
CN5601100000000,2022-05-01,56,011,WY,Crook County,4191,4083,108,2.6
CN5601300000000,2022-05-01,56,013,WY,Fremont County,18885,18195,690,3.7
CN5601500000000,2022-05-01,56,015,WY,Goshen County,6747,6569,178,2.6
CN5601700000000,2022-05-01,56,017,WY,Hot Springs County,2305,2242,63,2.7
CN5601900000000,2022-05-01,56,019,WY,Johnson County,4372,4239,133,3
CN5602100000000,2022-05-01,56,021,WY,Laramie County,47761,46157,1604,3.4
CN5602300000000,2022-05-01,56,023,WY,Lincoln County,9478,9155,323,3.4
CN5602500000000,2022-05-01,56,025,WY,Natrona County,38506,37001,1505,3.9
CN5602700000000,2022-05-01,56,027,WY,Niobrara County,1299,1272,27,2.1
CN5602900000000,2022-05-01,56,029,WY,Park County,16090,15570,520,3.2
CN5603100000000,2022-05-01,56,031,WY,Platte County,4680,4538,142,3
CN5603300000000,2022-05-01,56,033,WY,Sheridan County,16199,15711,488,3
CN5603500000000,2022-05-01,56,035,WY,Sublette County,4034,3880,154,3.8
CN5603700000000,2022-05-01,56,037,WY,Sweetwater County,19237,18502,735,3.8
CN5603900000000,2022-05-01,56,039,WY,Teton County,15551,14954,597,3.8
CN5604100000000,2022-05-01,56,041,WY,Uinta County,8752,8434,318,3.6
CN5604300000000,2022-05-01,56,043,WY,Washakie County,3888,3733,155,4
CN5604500000000,2022-05-01,56,045,WY,Weston County,3851,3754,97,2.5
CN7200100000000,2022-05-01,72,001,PR,Adjuntas Municipio,4322,4020,302,7
CN7200300000000,2022-05-01,72,003,PR,Aguada Municipio,13389,12473,916,6.8
CN7200500000000,2022-05-01,72,005,PR,Aguadilla Municipio,16144,15001,1143,7.1
CN7200700000000,2022-05-01,72,007,PR,Aguas Buenas Municipio,7070,6625,445,6.3
CN7200900000000,2022-05-01,72,009,PR,Aibonito Municipio,6774,6320,454,6.7
CN7201100000000,2022-05-01,72,011,PR,Anasco Municipio,10031,9461,570,5.7
CN7201300000000,2022-05-01,72,013,PR,Arecibo Municipio,25841,24121,1720,6.7
CN7201500000000,2022-05-01,72,015,PR,Arroyo Municipio,5010,4575,435,8.7
CN7201700000000,2022-05-01,72,017,PR,Barceloneta Municipio,6400,5905,495,7.7
CN7201900000000,2022-05-01,72,019,PR,Barranquitas Municipio,7805,7288,517,6.6
CN7202100000000,2022-05-01,72,021,PR,Bayamon Municipio,70415,67098,3317,4.7
CN7202300000000,2022-05-01,72,023,PR,Cabo Rojo Municipio,15100,14146,954,6.3
CN7202500000000,2022-05-01,72,025,PR,Caguas Municipio,51828,49429,2399,4.6
CN7202700000000,2022-05-01,72,027,PR,Camuy Municipio,10428,9720,708,6.8
CN7202900000000,2022-05-01,72,029,PR,Canovanas Municipio,17664,16891,773,4.4
CN7203100000000,2022-05-01,72,031,PR,Carolina Municipio,66638,63572,3066,4.6
CN7203300000000,2022-05-01,72,033,PR,Catano Municipio,8417,8011,406,4.8
CN7203500000000,2022-05-01,72,035,PR,Cayey Municipio,17584,16743,841,4.8
CN7203700000000,2022-05-01,72,037,PR,Ceiba Municipio,3901,3638,263,6.7
CN7203900000000,2022-05-01,72,039,PR,Ciales Municipio,3925,3596,329,8.4
CN7204100000000,2022-05-01,72,041,PR,Cidra Municipio,16743,16016,727,4.3
CN7204300000000,2022-05-01,72,043,PR,Coamo Municipio,10992,10226,766,7
CN7204500000000,2022-05-01,72,045,PR,Comerio Municipio,5259,4930,329,6.3
CN7204700000000,2022-05-01,72,047,PR,Corozal Municipio,9530,8856,674,7.1
CN7204900000000,2022-05-01,72,049,PR,Culebra Municipio,1016,994,22,2.2
CN7205100000000,2022-05-01,72,051,PR,Dorado Municipio,14652,14046,606,4.1
CN7205300000000,2022-05-01,72,053,PR,Fajardo Municipio,11419,10704,715,6.3
CN7205400000000,2022-05-01,72,054,PR,Florida Municipio,3525,3264,261,7.4
CN7205500000000,2022-05-01,72,055,PR,Guanica Municipio,4071,3655,416,10.2
CN7205700000000,2022-05-01,72,057,PR,Guayama Municipio,11643,10935,708,6.1
CN7205900000000,2022-05-01,72,059,PR,Guayanilla Municipio,5325,4820,505,9.5
CN7206100000000,2022-05-01,72,061,PR,Guaynabo Municipio,41420,40176,1244,3
CN7206300000000,2022-05-01,72,063,PR,Gurabo Municipio,20429,19634,795,3.9
CN7206500000000,2022-05-01,72,065,PR,Hatillo Municipio,15454,13526,1928,12.5
CN7206700000000,2022-05-01,72,067,PR,Hormigueros Municipio,6078,5691,387,6.4
CN7206900000000,2022-05-01,72,069,PR,Humacao Municipio,18845,17613,1232,6.5
CN7207100000000,2022-05-01,72,071,PR,Isabela Municipio,13257,12428,829,6.3
CN7207300000000,2022-05-01,72,073,PR,Jayuya Municipio,4641,4317,324,7
CN7207500000000,2022-05-01,72,075,PR,Juana Diaz Municipio,16808,15694,1114,6.6
CN7207700000000,2022-05-01,72,077,PR,Juncos Municipio,13478,12659,819,6.1
CN7207900000000,2022-05-01,72,079,PR,Lajas Municipio,5601,5040,561,10
CN7208100000000,2022-05-01,72,081,PR,Lares Municipio,7511,6629,882,11.7
CN7208300000000,2022-05-01,72,083,PR,Las Marias Municipio,2841,2580,261,9.2
CN7208500000000,2022-05-01,72,085,PR,Las Piedras Municipio,12433,11711,722,5.8
CN7208700000000,2022-05-01,72,087,PR,Loiza Municipio,9008,8491,517,5.7
CN7208900000000,2022-05-01,72,089,PR,Luquillo Municipio,6632,6258,374,5.6
CN7209100000000,2022-05-01,72,091,PR,Manati Municipio,12168,11446,722,5.9
CN7209300000000,2022-05-01,72,093,PR,Maricao Municipio,2131,1882,249,11.7
CN7209500000000,2022-05-01,72,095,PR,Maunabo Municipio,3170,2750,420,13.2
CN7209700000000,2022-05-01,72,097,PR,Mayaguez Municipio,24000,22415,1585,6.6
CN7209900000000,2022-05-01,72,099,PR,Moca Municipio,11734,10840,894,7.6
CN7210100000000,2022-05-01,72,101,PR,Morovis Municipio,8707,8127,580,6.7
CN7210300000000,2022-05-01,72,103,PR,Naguabo Municipio,8980,8432,548,6.1
CN7210500000000,2022-05-01,72,105,PR,Naranjito Municipio,7652,7137,515,6.7
CN7210700000000,2022-05-01,72,107,PR,Orocovis Municipio,5181,4816,365,7
CN7210900000000,2022-05-01,72,109,PR,Patillas Municipio,4526,4036,490,10.8
CN7211100000000,2022-05-01,72,111,PR,Penuelas Municipio,6171,5579,592,9.6
CN7211300000000,2022-05-01,72,113,PR,Ponce Municipio,48701,45451,3250,6.7
CN7211500000000,2022-05-01,72,115,PR,Quebradillas Municipio,6589,6074,515,7.8
CN7211700000000,2022-05-01,72,117,PR,Rincon Municipio,5240,4817,423,8.1
CN7211900000000,2022-05-01,72,119,PR,Rio Grande Municipio,18459,17444,1015,5.5
CN7212100000000,2022-05-01,72,121,PR,Sabana Grande Municipio,6330,5861,469,7.4
CN7212300000000,2022-05-01,72,123,PR,Salinas Municipio,7381,6767,614,8.3
CN7212500000000,2022-05-01,72,125,PR,San German Municipio,10503,9667,836,8
CN7212700000000,2022-05-01,72,127,PR,San Juan Municipio,145460,139425,6035,4.1
CN7212900000000,2022-05-01,72,129,PR,San Lorenzo Municipio,12520,11790,730,5.8
CN7213100000000,2022-05-01,72,131,PR,San Sebastian Municipio,11134,10013,1121,10.1
CN7213300000000,2022-05-01,72,133,PR,Santa Isabel Municipio,8737,8075,662,7.6
CN7213500000000,2022-05-01,72,135,PR,Toa Alta Municipio,30331,29012,1319,4.3
CN7213700000000,2022-05-01,72,137,PR,Toa Baja Municipio,31565,30101,1464,4.6
CN7213900000000,2022-05-01,72,139,PR,Trujillo Alto Municipio,29555,28489,1066,3.6
CN7214100000000,2022-05-01,72,141,PR,Utuado Municipio,7278,6715,563,7.7
CN7214300000000,2022-05-01,72,143,PR,Vega Alta Municipio,10751,9951,800,7.4
CN7214500000000,2022-05-01,72,145,PR,Vega Baja Municipio,14148,13111,1037,7.3
CN7214700000000,2022-05-01,72,147,PR,Vieques Municipio,2787,2599,188,6.7
CN7214900000000,2022-05-01,72,149,PR,Villalba Municipio,7791,6994,797,10.2
CN7215100000000,2022-05-01,72,151,PR,Yabucoa Municipio,9264,8498,766,8.3
CN7215300000000,2022-05-01,72,153,PR,Yauco Municipio,10300,9196,1104,10.7
CN0100100000000,2022-06-01,01,001,AL,Autauga County,26815,26045,770,2.9
CN0100300000000,2022-06-01,01,003,AL,Baldwin County,105188,102168,3020,2.9
CN0100500000000,2022-06-01,01,005,AL,Barbour County,8346,7968,378,4.5
CN0100700000000,2022-06-01,01,007,AL,Bibb County,8773,8507,266,3
CN0100900000000,2022-06-01,01,009,AL,Blount County,25972,25224,748,2.9
CN0101100000000,2022-06-01,01,011,AL,Bullock County,4542,4388,154,3.4
CN0101300000000,2022-06-01,01,013,AL,Butler County,8868,8522,346,3.9
CN0101500000000,2022-06-01,01,015,AL,Calhoun County,46367,44638,1729,3.7
CN0101700000000,2022-06-01,01,017,AL,Chambers County,15846,15353,493,3.1
CN0101900000000,2022-06-01,01,019,AL,Cherokee County,11716,11384,332,2.8
CN0102100000000,2022-06-01,01,021,AL,Chilton County,20349,19767,582,2.9
CN0102300000000,2022-06-01,01,023,AL,Choctaw County,4340,4139,201,4.6
CN0102500000000,2022-06-01,01,025,AL,Clarke County,7749,7330,419,5.4
CN0102700000000,2022-06-01,01,027,AL,Clay County,6201,6034,167,2.7
CN0102900000000,2022-06-01,01,029,AL,Cleburne County,6175,5987,188,3
CN0103100000000,2022-06-01,01,031,AL,Coffee County,21565,20879,686,3.2
CN0103300000000,2022-06-01,01,033,AL,Colbert County,23895,22998,897,3.8
CN0103500000000,2022-06-01,01,035,AL,Conecuh County,4284,4103,181,4.2
CN0103700000000,2022-06-01,01,037,AL,Coosa County,4490,4348,142,3.2
CN0103900000000,2022-06-01,01,039,AL,Covington County,15315,14825,490,3.2
CN0104100000000,2022-06-01,01,041,AL,Crenshaw County,5939,5740,199,3.4
CN0104300000000,2022-06-01,01,043,AL,Cullman County,40062,39013,1049,2.6
CN0104500000000,2022-06-01,01,045,AL,Dale County,21121,20440,681,3.2
CN0104700000000,2022-06-01,01,047,AL,Dallas County,13919,13173,746,5.4
CN0104900000000,2022-06-01,01,049,AL,DeKalb County,31595,30643,952,3
CN0105100000000,2022-06-01,01,051,AL,Elmore County,38276,37232,1044,2.7
CN0105300000000,2022-06-01,01,053,AL,Escambia County,14342,13823,519,3.6
CN0105500000000,2022-06-01,01,055,AL,Etowah County,39776,38298,1478,3.7
CN0105700000000,2022-06-01,01,057,AL,Fayette County,6738,6511,227,3.4
CN0105900000000,2022-06-01,01,059,AL,Franklin County,14648,14213,435,3
CN0106100000000,2022-06-01,01,061,AL,Geneva County,11236,10892,344,3.1
CN0106300000000,2022-06-01,01,063,AL,Greene County,2751,2613,138,5
CN0106500000000,2022-06-01,01,065,AL,Hale County,5878,5593,285,4.8
CN0106700000000,2022-06-01,01,067,AL,Henry County,7070,6826,244,3.5
CN0106900000000,2022-06-01,01,069,AL,Houston County,48051,46527,1524,3.2
CN0107100000000,2022-06-01,01,071,AL,Jackson County,23413,22659,754,3.2
CN0107300000000,2022-06-01,01,073,AL,Jefferson County,325440,315399,10041,3.1
CN0107500000000,2022-06-01,01,075,AL,Lamar County,5751,5558,193,3.4
CN0107700000000,2022-06-01,01,077,AL,Lauderdale County,43107,41633,1474,3.4
CN0107900000000,2022-06-01,01,079,AL,Lawrence County,14836,14384,452,3
CN0108100000000,2022-06-01,01,081,AL,Lee County,79715,77327,2388,3
CN0108300000000,2022-06-01,01,083,AL,Limestone County,48562,47268,1294,2.7
CN0108500000000,2022-06-01,01,085,AL,Lowndes County,3493,3292,201,5.8
CN0108700000000,2022-06-01,01,087,AL,Macon County,7921,7546,375,4.7
CN0108900000000,2022-06-01,01,089,AL,Madison County,200343,194978,5365,2.7
CN0109100000000,2022-06-01,01,091,AL,Marengo County,7747,7453,294,3.8
CN0109300000000,2022-06-01,01,093,AL,Marion County,13981,13569,412,2.9
CN0109500000000,2022-06-01,01,095,AL,Marshall County,45752,44551,1201,2.6
CN0109700000000,2022-06-01,01,097,AL,Mobile County,192195,184873,7322,3.8
CN0109900000000,2022-06-01,01,099,AL,Monroe County,7412,7064,348,4.7
CN0110100000000,2022-06-01,01,101,AL,Montgomery County,107048,103317,3731,3.5
CN0110300000000,2022-06-01,01,103,AL,Morgan County,61252,59614,1638,2.7
CN0110500000000,2022-06-01,01,105,AL,Perry County,3098,2897,201,6.5
CN0110700000000,2022-06-01,01,107,AL,Pickens County,7633,7299,334,4.4
CN0110900000000,2022-06-01,01,109,AL,Pike County,16019,15490,529,3.3
CN0111100000000,2022-06-01,01,111,AL,Randolph County,9721,9422,299,3.1
CN0111300000000,2022-06-01,01,113,AL,Russell County,23675,22929,746,3.2
CN0111500000000,2022-06-01,01,115,AL,St. Clair County,42527,41345,1182,2.8
CN0111700000000,2022-06-01,01,117,AL,Shelby County,122143,119320,2823,2.3
CN0111900000000,2022-06-01,01,119,AL,Sumter County,4683,4461,222,4.7
CN0112100000000,2022-06-01,01,121,AL,Talladega County,36257,34927,1330,3.7
CN0112300000000,2022-06-01,01,123,AL,Tallapoosa County,17980,17380,600,3.3
CN0112500000000,2022-06-01,01,125,AL,Tuscaloosa County,102799,99417,3382,3.3
CN0112700000000,2022-06-01,01,127,AL,Walker County,25788,24921,867,3.4
CN0112900000000,2022-06-01,01,129,AL,Washington County,6546,6269,277,4.2
CN0113100000000,2022-06-01,01,131,AL,Wilcox County,2531,2330,201,7.9
CN0113300000000,2022-06-01,01,133,AL,Winston County,10308,10000,308,3
CN0201300000000,2022-06-01,02,013,AK,Aleutians East Borough,2918,2866,52,1.8
CN0201600000000,2022-06-01,02,016,AK,Aleutians West Census Area,3627,3508,119,3.3
CN0202000000000,2022-06-01,02,020,AK,Anchorage Borough/municipality,150193,144854,5339,3.6
CN0205000000000,2022-06-01,02,050,AK,Bethel Census Area,7090,6409,681,9.6
CN0206000000000,2022-06-01,02,060,AK,Bristol Bay Borough,587,570,17,2.9
CN0206300000000,2022-06-01,02,063,AK,Chugach Census Area,4003,3902,101,2.5
CN0206600000000,2022-06-01,02,066,AK,Copper River Census Area,1612,1509,103,6.4
CN0206800000000,2022-06-01,02,068,AK,Denali Borough,1597,1546,51,3.2
CN0207000000000,2022-06-01,02,070,AK,Dillingham Census Area,1763,1652,111,6.3
CN0209000000000,2022-06-01,02,090,AK,Fairbanks North Star Borough,45340,43614,1726,3.8
CN0210000000000,2022-06-01,02,100,AK,Haines Borough,1226,1162,64,5.2
CN0210500000000,2022-06-01,02,105,AK,Hoonah-Angoon Census Area,1575,1517,58,3.7
CN0211000000000,2022-06-01,02,110,AK,Juneau Borough/city,17788,17265,523,2.9
CN0212200000000,2022-06-01,02,122,AK,Kenai Peninsula Borough,30258,29003,1255,4.1
CN0213000000000,2022-06-01,02,130,AK,Ketchikan Gateway Borough,7338,7079,259,3.5
CN0215000000000,2022-06-01,02,150,AK,Kodiak Island Borough,6063,5816,247,4.1
CN0215800000000,2022-06-01,02,158,AK,Kusilvak Census Area,2128,1798,330,15.5
CN0216400000000,2022-06-01,02,164,AK,Lake and Peninsula Borough,719,681,38,5.3
CN0217000000000,2022-06-01,02,170,AK,Matanuska-Susitna Borough,49616,47260,2356,4.7
CN0218000000000,2022-06-01,02,180,AK,Nome Census Area,4183,3865,318,7.6
CN0218500000000,2022-06-01,02,185,AK,North Slope Borough,2878,2713,165,5.7
CN0218800000000,2022-06-01,02,188,AK,Northwest Arctic Borough,2695,2431,264,9.8
CN0219500000000,2022-06-01,02,195,AK,Petersburg Borough,1495,1411,84,5.6
CN0219800000000,2022-06-01,02,198,AK,Prince of Wales-Hyder Census Area,2846,2694,152,5.3
CN0222000000000,2022-06-01,02,220,AK,Sitka Borough/city,4705,4564,141,3
CN0223000000000,2022-06-01,02,230,AK,Skagway Municipality,981,955,26,2.7
CN0224000000000,2022-06-01,02,240,AK,Southeast Fairbanks Census Area,3338,3177,161,4.8
CN0227500000000,2022-06-01,02,275,AK,Wrangell Borough/city,891,845,46,5.2
CN0228200000000,2022-06-01,02,282,AK,Yakutat Borough/city,358,341,17,4.7
CN0229000000000,2022-06-01,02,290,AK,Yukon-Koyukuk Census Area,2458,2279,179,7.3
CN0400100000000,2022-06-01,04,001,AZ,Apache County,18189,16582,1607,8.8
CN0400300000000,2022-06-01,04,003,AZ,Cochise County,48410,46041,2369,4.9
CN0400500000000,2022-06-01,04,005,AZ,Coconino County,74383,70839,3544,4.8
CN0400700000000,2022-06-01,04,007,AZ,Gila County,19867,18889,978,4.9
CN0400900000000,2022-06-01,04,009,AZ,Graham County,15825,15160,665,4.2
CN0401100000000,2022-06-01,04,011,AZ,Greenlee County,4708,4557,151,3.2
CN0401200000000,2022-06-01,04,012,AZ,La Paz County,8211,7740,471,5.7
CN0401300000000,2022-06-01,04,013,AZ,Maricopa County,2388815,2300042,88773,3.7
CN0401500000000,2022-06-01,04,015,AZ,Mohave County,91107,86635,4472,4.9
CN0401700000000,2022-06-01,04,017,AZ,Navajo County,38940,36609,2331,6
CN0401900000000,2022-06-01,04,019,AZ,Pima County,487027,466172,20855,4.3
CN0402100000000,2022-06-01,04,021,AZ,Pinal County,197432,188820,8612,4.4
CN0402300000000,2022-06-01,04,023,AZ,Santa Cruz County,18869,17542,1327,7
CN0402500000000,2022-06-01,04,025,AZ,Yavapai County,107930,103650,4280,4
CN0402700000000,2022-06-01,04,027,AZ,Yuma County,93492,80213,13279,14.2
CN0500100000000,2022-06-01,05,001,AR,Arkansas County,9597,9260,337,3.5
CN0500300000000,2022-06-01,05,003,AR,Ashley County,6922,6535,387,5.6
CN0500500000000,2022-06-01,05,005,AR,Baxter County,17210,16520,690,4
CN0500700000000,2022-06-01,05,007,AR,Benton County,152153,147869,4284,2.8
CN0500900000000,2022-06-01,05,009,AR,Boone County,16290,15755,535,3.3
CN0501100000000,2022-06-01,05,011,AR,Bradley County,4140,3929,211,5.1
CN0501300000000,2022-06-01,05,013,AR,Calhoun County,2403,2320,83,3.5
CN0501500000000,2022-06-01,05,015,AR,Carroll County,13068,12673,395,3
CN0501700000000,2022-06-01,05,017,AR,Chicot County,3004,2800,204,6.8
CN0501900000000,2022-06-01,05,019,AR,Clark County,8486,7998,488,5.8
CN0502100000000,2022-06-01,05,021,AR,Clay County,5517,5269,248,4.5
CN0502300000000,2022-06-01,05,023,AR,Cleburne County,9338,8915,423,4.5
CN0502500000000,2022-06-01,05,025,AR,Cleveland County,3124,2983,141,4.5
CN0502700000000,2022-06-01,05,027,AR,Columbia County,8864,8425,439,5
CN0502900000000,2022-06-01,05,029,AR,Conway County,8701,8339,362,4.2
CN0503100000000,2022-06-01,05,031,AR,Craighead County,58391,56508,1883,3.2
CN0503300000000,2022-06-01,05,033,AR,Crawford County,26766,25773,993,3.7
CN0503500000000,2022-06-01,05,035,AR,Crittenden County,20914,19958,956,4.6
CN0503700000000,2022-06-01,05,037,AR,Cross County,7121,6833,288,4
CN0503900000000,2022-06-01,05,039,AR,Dallas County,2743,2620,123,4.5
CN0504100000000,2022-06-01,05,041,AR,Desha County,5000,4728,272,5.4
CN0504300000000,2022-06-01,05,043,AR,Drew County,7237,6878,359,5
CN0504500000000,2022-06-01,05,045,AR,Faulkner County,63973,61859,2114,3.3
CN0504700000000,2022-06-01,05,047,AR,Franklin County,7577,7284,293,3.9
CN0504900000000,2022-06-01,05,049,AR,Fulton County,5231,5025,206,3.9
CN0505100000000,2022-06-01,05,051,AR,Garland County,43092,41260,1832,4.3
CN0505300000000,2022-06-01,05,053,AR,Grant County,8548,8241,307,3.6
CN0505500000000,2022-06-01,05,055,AR,Greene County,20070,19338,732,3.6
CN0505700000000,2022-06-01,05,057,AR,Hempstead County,9518,9167,351,3.7
CN0505900000000,2022-06-01,05,059,AR,Hot Spring County,14139,13558,581,4.1
CN0506100000000,2022-06-01,05,061,AR,Howard County,5558,5351,207,3.7
CN0506300000000,2022-06-01,05,063,AR,Independence County,16886,16221,665,3.9
CN0506500000000,2022-06-01,05,065,AR,Izard County,4495,4235,260,5.8
CN0506700000000,2022-06-01,05,067,AR,Jackson County,5567,5278,289,5.2
CN0506900000000,2022-06-01,05,069,AR,Jefferson County,26131,24720,1411,5.4
CN0507100000000,2022-06-01,05,071,AR,Johnson County,10240,9754,486,4.7
CN0507300000000,2022-06-01,05,073,AR,Lafayette County,2328,2199,129,5.5
CN0507500000000,2022-06-01,05,075,AR,Lawrence County,6683,6406,277,4.1
CN0507700000000,2022-06-01,05,077,AR,Lee County,2568,2439,129,5
CN0507900000000,2022-06-01,05,079,AR,Lincoln County,3734,3546,188,5
CN0508100000000,2022-06-01,05,081,AR,Little River County,5326,5107,219,4.1
CN0508300000000,2022-06-01,05,083,AR,Logan County,8465,8089,376,4.4
CN0508500000000,2022-06-01,05,085,AR,Lonoke County,34592,33454,1138,3.3
CN0508700000000,2022-06-01,05,087,AR,Madison County,7712,7480,232,3
CN0508900000000,2022-06-01,05,089,AR,Marion County,6566,6304,262,4
CN0509100000000,2022-06-01,05,091,AR,Miller County,19229,18400,829,4.3
CN0509300000000,2022-06-01,05,093,AR,Mississippi County,16591,15594,997,6
CN0509500000000,2022-06-01,05,095,AR,Monroe County,2547,2426,121,4.8
CN0509700000000,2022-06-01,05,097,AR,Montgomery County,2973,2823,150,5
CN0509900000000,2022-06-01,05,099,AR,Nevada County,3532,3375,157,4.4
CN0510100000000,2022-06-01,05,101,AR,Newton County,3251,3142,109,3.4
CN0510300000000,2022-06-01,05,103,AR,Ouachita County,9915,9503,412,4.2
CN0510500000000,2022-06-01,05,105,AR,Perry County,4267,4090,177,4.1
CN0510700000000,2022-06-01,05,107,AR,Phillips County,5593,5242,351,6.3
CN0510900000000,2022-06-01,05,109,AR,Pike County,4248,4067,181,4.3
CN0511100000000,2022-06-01,05,111,AR,Poinsett County,10017,9625,392,3.9
CN0511300000000,2022-06-01,05,113,AR,Polk County,7934,7613,321,4
CN0511500000000,2022-06-01,05,115,AR,Pope County,27824,26551,1273,4.6
CN0511700000000,2022-06-01,05,117,AR,Prairie County,3559,3435,124,3.5
CN0511900000000,2022-06-01,05,119,AR,Pulaski County,192234,184964,7270,3.8
CN0512100000000,2022-06-01,05,121,AR,Randolph County,7298,7009,289,4
CN0512300000000,2022-06-01,05,123,AR,St. Francis County,7781,7387,394,5.1
CN0512500000000,2022-06-01,05,125,AR,Saline County,60948,58994,1954,3.2
CN0512700000000,2022-06-01,05,127,AR,Scott County,4213,4066,147,3.5
CN0512900000000,2022-06-01,05,129,AR,Searcy County,3128,2988,140,4.5
CN0513100000000,2022-06-01,05,131,AR,Sebastian County,56375,54380,1995,3.5
CN0513300000000,2022-06-01,05,133,AR,Sevier County,5492,5252,240,4.4
CN0513500000000,2022-06-01,05,135,AR,Sharp County,6045,5754,291,4.8
CN0513700000000,2022-06-01,05,137,AR,Stone County,4656,4428,228,4.9
CN0513900000000,2022-06-01,05,139,AR,Union County,15171,14396,775,5.1
CN0514100000000,2022-06-01,05,141,AR,Van Buren County,6172,5874,298,4.8
CN0514300000000,2022-06-01,05,143,AR,Washington County,134471,130773,3698,2.8
CN0514500000000,2022-06-01,05,145,AR,White County,34897,33508,1389,4
CN0514700000000,2022-06-01,05,147,AR,Woodruff County,2742,2634,108,3.9
CN0514900000000,2022-06-01,05,149,AR,Yell County,7879,7515,364,4.6
CN0600100000000,2022-06-01,06,001,CA,Alameda County,822302,795561,26741,3.3
CN0600300000000,2022-06-01,06,003,CA,Alpine County,452,425,27,6
CN0600500000000,2022-06-01,06,005,CA,Amador County,14414,13826,588,4.1
CN0600700000000,2022-06-01,06,007,CA,Butte County,90691,86665,4026,4.4
CN0600900000000,2022-06-01,06,009,CA,Calaveras County,22256,21464,792,3.6
CN0601100000000,2022-06-01,06,011,CA,Colusa County,10254,9223,1031,10.1
CN0601300000000,2022-06-01,06,013,CA,Contra Costa County,549443,530277,19166,3.5
CN0601500000000,2022-06-01,06,015,CA,Del Norte County,9345,8867,478,5.1
CN0601700000000,2022-06-01,06,017,CA,El Dorado County,92677,89643,3034,3.3
CN0601900000000,2022-06-01,06,019,CA,Fresno County,452305,424907,27398,6.1
CN0602100000000,2022-06-01,06,021,CA,Glenn County,12724,12046,678,5.3
CN0602300000000,2022-06-01,06,023,CA,Humboldt County,59472,57125,2347,3.9
CN0602500000000,2022-06-01,06,025,CA,Imperial County,69304,59767,9537,13.8
CN0602700000000,2022-06-01,06,027,CA,Inyo County,8181,7891,290,3.5
CN0602900000000,2022-06-01,06,029,CA,Kern County,387869,360600,27269,7
CN0603100000000,2022-06-01,06,031,CA,Kings County,55569,51826,3743,6.7
CN0603300000000,2022-06-01,06,033,CA,Lake County,28270,26972,1298,4.6
CN0603500000000,2022-06-01,06,035,CA,Lassen County,8745,8390,355,4.1
CN0603700000000,2022-06-01,06,037,CA,Los Angeles County,4935287,4694769,240518,4.9
CN0603900000000,2022-06-01,06,039,CA,Madera County,62592,58846,3746,6
CN0604100000000,2022-06-01,06,041,CA,Marin County,132423,128891,3532,2.7
CN0604300000000,2022-06-01,06,043,CA,Mariposa County,7789,7491,298,3.8
CN0604500000000,2022-06-01,06,045,CA,Mendocino County,37294,35855,1439,3.9
CN0604700000000,2022-06-01,06,047,CA,Merced County,116144,107554,8590,7.4
CN0604900000000,2022-06-01,06,049,CA,Modoc County,3262,3114,148,4.5
CN0605100000000,2022-06-01,06,051,CA,Mono County,8749,8449,300,3.4
CN0605300000000,2022-06-01,06,053,CA,Monterey County,227350,217042,10308,4.5
CN0605500000000,2022-06-01,06,055,CA,Napa County,72142,69982,2160,3
CN0605700000000,2022-06-01,06,057,CA,Nevada County,48064,46458,1606,3.3
CN0605900000000,2022-06-01,06,059,CA,Orange County,1582054,1531620,50434,3.2
CN0606100000000,2022-06-01,06,061,CA,Placer County,192512,186592,5920,3.1
CN0606300000000,2022-06-01,06,063,CA,Plumas County,7887,7508,379,4.8
CN0606500000000,2022-06-01,06,065,CA,Riverside County,1140328,1093441,46887,4.1
CN0606700000000,2022-06-01,06,067,CA,Sacramento County,722542,694918,27624,3.8
CN0606900000000,2022-06-01,06,069,CA,San Benito County,32215,30750,1465,4.5
CN0607100000000,2022-06-01,06,071,CA,San Bernardino County,997825,957122,40703,4.1
CN0607300000000,2022-06-01,06,073,CA,San Diego County,1580475,1526316,54159,3.4
CN0607500000000,2022-06-01,06,075,CA,San Francisco County/city,572593,558316,14277,2.5
CN0607700000000,2022-06-01,06,077,CA,San Joaquin County,337780,320649,17131,5.1
CN0607900000000,2022-06-01,06,079,CA,San Luis Obispo County,137830,133594,4236,3.1
CN0608100000000,2022-06-01,06,081,CA,San Mateo County,453665,442722,10943,2.4
CN0608300000000,2022-06-01,06,083,CA,Santa Barbara County,227116,219786,7330,3.2
CN0608500000000,2022-06-01,06,085,CA,Santa Clara County,1034418,1006652,27766,2.7
CN0608700000000,2022-06-01,06,087,CA,Santa Cruz County,135388,129681,5707,4.2
CN0608900000000,2022-06-01,06,089,CA,Shasta County,73082,69887,3195,4.4
CN0609100000000,2022-06-01,06,091,CA,Sierra County,1387,1338,49,3.5
CN0609300000000,2022-06-01,06,093,CA,Siskiyou County,16327,15484,843,5.2
CN0609500000000,2022-06-01,06,095,CA,Solano County,201522,193396,8126,4
CN0609700000000,2022-06-01,06,097,CA,Sonoma County,248603,240941,7662,3.1
CN0609900000000,2022-06-01,06,099,CA,Stanislaus County,239800,226717,13083,5.5
CN0610100000000,2022-06-01,06,101,CA,Sutter County,46684,43811,2873,6.2
CN0610300000000,2022-06-01,06,103,CA,Tehama County,25616,24393,1223,4.8
CN0610500000000,2022-06-01,06,105,CA,Trinity County,4778,4588,190,4
CN0610700000000,2022-06-01,06,107,CA,Tulare County,208863,192753,16110,7.7
CN0610900000000,2022-06-01,06,109,CA,Tuolumne County,19945,19103,842,4.2
CN0611100000000,2022-06-01,06,111,CA,Ventura County,411945,397571,14374,3.5
CN0611300000000,2022-06-01,06,113,CA,Yolo County,108443,104079,4364,4
CN0611500000000,2022-06-01,06,115,CA,Yuba County,31572,29927,1645,5.2
CN0800100000000,2022-06-01,08,001,CO,Adams County,282752,273671,9081,3.2
CN0800300000000,2022-06-01,08,003,CO,Alamosa County,8204,7908,296,3.6
CN0800500000000,2022-06-01,08,005,CO,Arapahoe County,376493,365183,11310,3
CN0800700000000,2022-06-01,08,007,CO,Archuleta County,7190,6963,227,3.2
CN0800900000000,2022-06-01,08,009,CO,Baca County,2109,2068,41,1.9
CN0801100000000,2022-06-01,08,011,CO,Bent County,1774,1712,62,3.5
CN0801300000000,2022-06-01,08,013,CO,Boulder County,201283,195898,5385,2.7
CN0801400000000,2022-06-01,08,014,CO,Broomfield County/city,42662,41541,1121,2.6
CN0801500000000,2022-06-01,08,015,CO,Chaffee County,10290,10015,275,2.7
CN0801700000000,2022-06-01,08,017,CO,Cheyenne County,1082,1060,22,2
CN0801900000000,2022-06-01,08,019,CO,Clear Creek County,6174,6002,172,2.8
CN0802100000000,2022-06-01,08,021,CO,Conejos County,3997,3864,133,3.3
CN0802300000000,2022-06-01,08,023,CO,Costilla County,1820,1750,70,3.8
CN0802500000000,2022-06-01,08,025,CO,Crowley County,1361,1309,52,3.8
CN0802700000000,2022-06-01,08,027,CO,Custer County,2442,2367,75,3.1
CN0802900000000,2022-06-01,08,029,CO,Delta County,13632,13149,483,3.5
CN0803100000000,2022-06-01,08,031,CO,Denver County/city,437344,424517,12827,2.9
CN0803300000000,2022-06-01,08,033,CO,Dolores County,1152,1121,31,2.7
CN0803500000000,2022-06-01,08,035,CO,Douglas County,208818,203327,5491,2.6
CN0803700000000,2022-06-01,08,037,CO,Eagle County,34540,33589,951,2.8
CN0803900000000,2022-06-01,08,039,CO,Elbert County,16122,15710,412,2.6
CN0804100000000,2022-06-01,08,041,CO,El Paso County,358532,346828,11704,3.3
CN0804300000000,2022-06-01,08,043,CO,Fremont County,14612,13941,671,4.6
CN0804500000000,2022-06-01,08,045,CO,Garfield County,31107,30187,920,3
CN0804700000000,2022-06-01,08,047,CO,Gilpin County,3946,3840,106,2.7
CN0804900000000,2022-06-01,08,049,CO,Grand County,9386,9140,246,2.6
CN0805100000000,2022-06-01,08,051,CO,Gunnison County,11404,11115,289,2.5
CN0805300000000,2022-06-01,08,053,CO,Hinsdale County,519,507,12,2.3
CN0805500000000,2022-06-01,08,055,CO,Huerfano County,2473,2338,135,5.5
CN0805700000000,2022-06-01,08,057,CO,Jackson County,1030,1009,21,2
CN0805900000000,2022-06-01,08,059,CO,Jefferson County,344434,334846,9588,2.8
CN0806100000000,2022-06-01,08,061,CO,Kiowa County,903,884,19,2.1
CN0806300000000,2022-06-01,08,063,CO,Kit Carson County,4159,4074,85,2
CN0806500000000,2022-06-01,08,065,CO,Lake County,4630,4504,126,2.7
CN0806700000000,2022-06-01,08,067,CO,La Plata County,31054,30133,921,3
CN0806900000000,2022-06-01,08,069,CO,Larimer County,211513,205629,5884,2.8
CN0807100000000,2022-06-01,08,071,CO,Las Animas County,6109,5835,274,4.5
CN0807300000000,2022-06-01,08,073,CO,Lincoln County,2252,2185,67,3
CN0807500000000,2022-06-01,08,075,CO,Logan County,10207,9906,301,2.9
CN0807700000000,2022-06-01,08,077,CO,Mesa County,76249,73625,2624,3.4
CN0807900000000,2022-06-01,08,079,CO,Mineral County,462,449,13,2.8
CN0808100000000,2022-06-01,08,081,CO,Moffat County,6903,6699,204,3
CN0808300000000,2022-06-01,08,083,CO,Montezuma County,12655,12218,437,3.5
CN0808500000000,2022-06-01,08,085,CO,Montrose County,21410,20715,695,3.2
CN0808700000000,2022-06-01,08,087,CO,Morgan County,15540,15035,505,3.2
CN0808900000000,2022-06-01,08,089,CO,Otero County,7803,7487,316,4
CN0809100000000,2022-06-01,08,091,CO,Ouray County,2663,2585,78,2.9
CN0809300000000,2022-06-01,08,093,CO,Park County,11674,11378,296,2.5
CN0809500000000,2022-06-01,08,095,CO,Phillips County,2469,2413,56,2.3
CN0809700000000,2022-06-01,08,097,CO,Pitkin County,10634,10314,320,3
CN0809900000000,2022-06-01,08,099,CO,Prowers County,6086,5898,188,3.1
CN0810100000000,2022-06-01,08,101,CO,Pueblo County,76417,73208,3209,4.2
CN0810300000000,2022-06-01,08,103,CO,Rio Blanco County,2865,2756,109,3.8
CN0810500000000,2022-06-01,08,105,CO,Rio Grande County,5468,5260,208,3.8
CN0810700000000,2022-06-01,08,107,CO,Routt County,15402,14989,413,2.7
CN0810900000000,2022-06-01,08,109,CO,Saguache County,3425,3306,119,3.5
CN0811100000000,2022-06-01,08,111,CO,San Juan County,665,650,15,2.3
CN0811300000000,2022-06-01,08,113,CO,San Miguel County,5652,5517,135,2.4
CN0811500000000,2022-06-01,08,115,CO,Sedgwick County,1101,1070,31,2.8
CN0811700000000,2022-06-01,08,117,CO,Summit County,20234,19750,484,2.4
CN0811900000000,2022-06-01,08,119,CO,Teller County,13412,13001,411,3.1
CN0812100000000,2022-06-01,08,121,CO,Washington County,2837,2767,70,2.5
CN0812300000000,2022-06-01,08,123,CO,Weld County,168519,163046,5473,3.2
CN0812500000000,2022-06-01,08,125,CO,Yuma County,5774,5645,129,2.2
CN0900100000000,2022-06-01,09,001,CT,Fairfield County,494454,473566,20888,4.2
CN0900300000000,2022-06-01,09,003,CT,Hartford County,485794,464379,21415,4.4
CN0900500000000,2022-06-01,09,005,CT,Litchfield County,107611,103501,4110,3.8
CN0900700000000,2022-06-01,09,007,CT,Middlesex County,95558,91959,3599,3.8
CN0900900000000,2022-06-01,09,009,CT,New Haven County,476464,455269,21195,4.4
CN0901100000000,2022-06-01,09,011,CT,New London County,136559,130532,6027,4.4
CN0901300000000,2022-06-01,09,013,CT,Tolland County,87731,84318,3413,3.9
CN0901500000000,2022-06-01,09,015,CT,Windham County,65352,62396,2956,4.5
CN1000100000000,2022-06-01,10,001,DE,Kent County,80331,75639,4692,5.8
CN1000300000000,2022-06-01,10,003,DE,New Castle County,302780,288353,14427,4.8
CN1000500000000,2022-06-01,10,005,DE,Sussex County,116281,111529,4752,4.1
CN1100100000000,2022-06-01,11,001,DC,District of Columbia,392180,372959,19221,4.9
CN1200100000000,2022-06-01,12,001,FL,Alachua County,139574,135169,4405,3.2
CN1200300000000,2022-06-01,12,003,FL,Baker County,12688,12305,383,3
CN1200500000000,2022-06-01,12,005,FL,Bay County,89388,86841,2547,2.8
CN1200700000000,2022-06-01,12,007,FL,Bradford County,10982,10608,374,3.4
CN1200900000000,2022-06-01,12,009,FL,Brevard County,297788,288626,9162,3.1
CN1201100000000,2022-06-01,12,011,FL,Broward County,1068831,1036394,32437,3
CN1201300000000,2022-06-01,12,013,FL,Calhoun County,4857,4674,183,3.8
CN1201500000000,2022-06-01,12,015,FL,Charlotte County,76501,73850,2651,3.5
CN1201700000000,2022-06-01,12,017,FL,Citrus County,49718,47508,2210,4.4
CN1201900000000,2022-06-01,12,019,FL,Clay County,113476,110197,3279,2.9
CN1202100000000,2022-06-01,12,021,FL,Collier County,188591,182784,5807,3.1
CN1202300000000,2022-06-01,12,023,FL,Columbia County,29427,28376,1051,3.6
CN1202700000000,2022-06-01,12,027,FL,DeSoto County,14036,13544,492,3.5
CN1202900000000,2022-06-01,12,029,FL,Dixie County,5813,5607,206,3.5
CN1203100000000,2022-06-01,12,031,FL,Duval County,514764,497290,17474,3.4
CN1203300000000,2022-06-01,12,033,FL,Escambia County,150012,145129,4883,3.3
CN1203500000000,2022-06-01,12,035,FL,Flagler County,50587,48735,1852,3.7
CN1203700000000,2022-06-01,12,037,FL,Franklin County,4983,4844,139,2.8
CN1203900000000,2022-06-01,12,039,FL,Gadsden County,19225,18447,778,4
CN1204100000000,2022-06-01,12,041,FL,Gilchrist County,7344,7102,242,3.3
CN1204300000000,2022-06-01,12,043,FL,Glades County,5151,4952,199,3.9
CN1204500000000,2022-06-01,12,045,FL,Gulf County,5512,5357,155,2.8
CN1204700000000,2022-06-01,12,047,FL,Hamilton County,4586,4408,178,3.9
CN1204900000000,2022-06-01,12,049,FL,Hardee County,8689,8289,400,4.6
CN1205100000000,2022-06-01,12,051,FL,Hendry County,15514,14655,859,5.5
CN1205300000000,2022-06-01,12,053,FL,Hernando County,77476,74502,2974,3.8
CN1205500000000,2022-06-01,12,055,FL,Highlands County,36497,34835,1662,4.6
CN1205700000000,2022-06-01,12,057,FL,Hillsborough County,808474,784527,23947,3
CN1205900000000,2022-06-01,12,059,FL,Holmes County,7020,6775,245,3.5
CN1206100000000,2022-06-01,12,061,FL,Indian River County,68325,65728,2597,3.8
CN1206300000000,2022-06-01,12,063,FL,Jackson County,16580,15987,593,3.6
CN1206500000000,2022-06-01,12,065,FL,Jefferson County,5732,5513,219,3.8
CN1206700000000,2022-06-01,12,067,FL,Lafayette County,2795,2705,90,3.2
CN1206900000000,2022-06-01,12,069,FL,Lake County,171708,166155,5553,3.2
CN1207100000000,2022-06-01,12,071,FL,Lee County,372244,360631,11613,3.1
CN1207300000000,2022-06-01,12,073,FL,Leon County,159312,154101,5211,3.3
CN1207500000000,2022-06-01,12,075,FL,Levy County,17053,16391,662,3.9
CN1207700000000,2022-06-01,12,077,FL,Liberty County,2612,2526,86,3.3
CN1207900000000,2022-06-01,12,079,FL,Madison County,7922,7650,272,3.4
CN1208100000000,2022-06-01,12,081,FL,Manatee County,187875,182013,5862,3.1
CN1208300000000,2022-06-01,12,083,FL,Marion County,148565,143012,5553,3.7
CN1208500000000,2022-06-01,12,085,FL,Martin County,76140,73829,2311,3
CN1208600000000,2022-06-01,12,086,FL,Miami-Dade County,1363068,1327233,35835,2.6
CN1208700000000,2022-06-01,12,087,FL,Monroe County,49086,48100,986,2
CN1208900000000,2022-06-01,12,089,FL,Nassau County,44830,43602,1228,2.7
CN1209100000000,2022-06-01,12,091,FL,Okaloosa County,105935,103123,2812,2.7
CN1209300000000,2022-06-01,12,093,FL,Okeechobee County,17640,17026,614,3.5
CN1209500000000,2022-06-01,12,095,FL,Orange County,795044,770826,24218,3
CN1209700000000,2022-06-01,12,097,FL,Osceola County,198092,191009,7083,3.6
CN1209900000000,2022-06-01,12,099,FL,Palm Beach County,765613,741275,24338,3.2
CN1210100000000,2022-06-01,12,101,FL,Pasco County,259900,251389,8511,3.3
CN1210300000000,2022-06-01,12,103,FL,Pinellas County,513570,499050,14520,2.8
CN1210500000000,2022-06-01,12,105,FL,Polk County,338624,325819,12805,3.8
CN1210700000000,2022-06-01,12,107,FL,Putnam County,27489,26289,1200,4.4
CN1210900000000,2022-06-01,12,109,FL,St. Johns County,150069,146225,3844,2.6
CN1211100000000,2022-06-01,12,111,FL,St. Lucie County,155691,149898,5793,3.7
CN1211300000000,2022-06-01,12,113,FL,Santa Rosa County,88205,85573,2632,3
CN1211500000000,2022-06-01,12,115,FL,Sarasota County,197709,191576,6133,3.1
CN1211700000000,2022-06-01,12,117,FL,Seminole County,264943,257368,7575,2.9
CN1211900000000,2022-06-01,12,119,FL,Sumter County,37557,35888,1669,4.4
CN1212100000000,2022-06-01,12,121,FL,Suwannee County,17400,16776,624,3.6
CN1212300000000,2022-06-01,12,123,FL,Taylor County,8187,7882,305,3.7
CN1212500000000,2022-06-01,12,125,FL,Union County,4412,4269,143,3.2
CN1212700000000,2022-06-01,12,127,FL,Volusia County,266627,257629,8998,3.4
CN1212900000000,2022-06-01,12,129,FL,Wakulla County,15913,15472,441,2.8
CN1213100000000,2022-06-01,12,131,FL,Walton County,35889,34926,963,2.7
CN1213300000000,2022-06-01,12,133,FL,Washington County,9808,9464,344,3.5
CN1300100000000,2022-06-01,13,001,GA,Appling County,9402,9007,395,4.2
CN1300300000000,2022-06-01,13,003,GA,Atkinson County,4402,4270,132,3
CN1300500000000,2022-06-01,13,005,GA,Bacon County,4946,4786,160,3.2
CN1300700000000,2022-06-01,13,007,GA,Baker County,1132,1082,50,4.4
CN1300900000000,2022-06-01,13,009,GA,Baldwin County,17541,16700,841,4.8
CN1301100000000,2022-06-01,13,011,GA,Banks County,10896,10615,281,2.6
CN1301300000000,2022-06-01,13,013,GA,Barrow County,43200,41986,1214,2.8
CN1301500000000,2022-06-01,13,015,GA,Bartow County,52461,50789,1672,3.2
CN1301700000000,2022-06-01,13,017,GA,Ben Hill County,5623,5361,262,4.7
CN1301900000000,2022-06-01,13,019,GA,Berrien County,7827,7553,274,3.5
CN1302100000000,2022-06-01,13,021,GA,Bibb County,65780,63066,2714,4.1
CN1302300000000,2022-06-01,13,023,GA,Bleckley County,4638,4396,242,5.2
CN1302500000000,2022-06-01,13,025,GA,Brantley County,7451,7159,292,3.9
CN1302700000000,2022-06-01,13,027,GA,Brooks County,6732,6498,234,3.5
CN1302900000000,2022-06-01,13,029,GA,Bryan County,20292,19692,600,3
CN1303100000000,2022-06-01,13,031,GA,Bulloch County,37799,36185,1614,4.3
CN1303300000000,2022-06-01,13,033,GA,Burke County,9095,8541,554,6.1
CN1303500000000,2022-06-01,13,035,GA,Butts County,11365,11018,347,3.1
CN1303700000000,2022-06-01,13,037,GA,Calhoun County,2176,2105,71,3.3
CN1303900000000,2022-06-01,13,039,GA,Camden County,22059,21341,718,3.3
CN1304300000000,2022-06-01,13,043,GA,Candler County,6112,5949,163,2.7
CN1304500000000,2022-06-01,13,045,GA,Carroll County,57530,55483,2047,3.6
CN1304700000000,2022-06-01,13,047,GA,Catoosa County,33242,32264,978,2.9
CN1304900000000,2022-06-01,13,049,GA,Charlton County,5087,4924,163,3.2
CN1305100000000,2022-06-01,13,051,GA,Chatham County,145140,140325,4815,3.3
CN1305300000000,2022-06-01,13,053,GA,Chattahoochee County,1904,1815,89,4.7
CN1305500000000,2022-06-01,13,055,GA,Chattooga County,9210,8823,387,4.2
CN1305700000000,2022-06-01,13,057,GA,Cherokee County,143073,139284,3789,2.6
CN1305900000000,2022-06-01,13,059,GA,Clarke County,57071,54740,2331,4.1
CN1306100000000,2022-06-01,13,061,GA,Clay County,864,812,52,6
CN1306300000000,2022-06-01,13,063,GA,Clayton County,140758,134684,6074,4.3
CN1306500000000,2022-06-01,13,065,GA,Clinch County,3118,3021,97,3.1
CN1306700000000,2022-06-01,13,067,GA,Cobb County,432460,420045,12415,2.9
CN1306900000000,2022-06-01,13,069,GA,Coffee County,18855,18146,709,3.8
CN1307100000000,2022-06-01,13,071,GA,Colquitt County,22027,21333,694,3.2
CN1307300000000,2022-06-01,13,073,GA,Columbia County,75931,73514,2417,3.2
CN1307500000000,2022-06-01,13,075,GA,Cook County,8187,7901,286,3.5
CN1307700000000,2022-06-01,13,077,GA,Coweta County,77945,75637,2308,3
CN1307900000000,2022-06-01,13,079,GA,Crawford County,5401,5215,186,3.4
CN1308100000000,2022-06-01,13,081,GA,Crisp County,9797,9353,444,4.5
CN1308300000000,2022-06-01,13,083,GA,Dade County,7994,7758,236,3
CN1308500000000,2022-06-01,13,085,GA,Dawson County,13450,13080,370,2.8
CN1308700000000,2022-06-01,13,087,GA,Decatur County,11978,11542,436,3.6
CN1308900000000,2022-06-01,13,089,GA,DeKalb County,406191,392299,13892,3.4
CN1309100000000,2022-06-01,13,091,GA,Dodge County,6975,6691,284,4.1
CN1309300000000,2022-06-01,13,093,GA,Dooly County,4700,4501,199,4.2
CN1309500000000,2022-06-01,13,095,GA,Dougherty County,36437,34698,1739,4.8
CN1309700000000,2022-06-01,13,097,GA,Douglas County,75447,72643,2804,3.7
CN1309900000000,2022-06-01,13,099,GA,Early County,4445,4277,168,3.8
CN1310100000000,2022-06-01,13,101,GA,Echols County,1887,1835,52,2.8
CN1310300000000,2022-06-01,13,103,GA,Effingham County,33913,32941,972,2.9
CN1310500000000,2022-06-01,13,105,GA,Elbert County,7852,7532,320,4.1
CN1310700000000,2022-06-01,13,107,GA,Emanuel County,8678,8265,413,4.8
CN1310900000000,2022-06-01,13,109,GA,Evans County,5071,4905,166,3.3
CN1311100000000,2022-06-01,13,111,GA,Fannin County,12096,11757,339,2.8
CN1311300000000,2022-06-01,13,113,GA,Fayette County,59798,57993,1805,3
CN1311500000000,2022-06-01,13,115,GA,Floyd County,43332,41711,1621,3.7
CN1311700000000,2022-06-01,13,117,GA,Forsyth County,130644,127152,3492,2.7
CN1311900000000,2022-06-01,13,119,GA,Franklin County,9987,9619,368,3.7
CN1312100000000,2022-06-01,13,121,GA,Fulton County,577322,557073,20249,3.5
CN1312300000000,2022-06-01,13,123,GA,Gilmer County,12509,12102,407,3.3
CN1312500000000,2022-06-01,13,125,GA,Glascock County,1269,1221,48,3.8
CN1312700000000,2022-06-01,13,127,GA,Glynn County,39786,38524,1262,3.2
CN1312900000000,2022-06-01,13,129,GA,Gordon County,29072,28112,960,3.3
CN1313100000000,2022-06-01,13,131,GA,Grady County,11022,10643,379,3.4
CN1313300000000,2022-06-01,13,133,GA,Greene County,7431,7173,258,3.5
CN1313500000000,2022-06-01,13,135,GA,Gwinnett County,502618,487310,15308,3
CN1313700000000,2022-06-01,13,137,GA,Habersham County,18728,18082,646,3.4
CN1313900000000,2022-06-01,13,139,GA,Hall County,107692,104806,2886,2.7
CN1314100000000,2022-06-01,13,141,GA,Hancock County,2489,2358,131,5.3
CN1314300000000,2022-06-01,13,143,GA,Haralson County,13072,12617,455,3.5
CN1314500000000,2022-06-01,13,145,GA,Harris County,16762,16260,502,3
CN1314700000000,2022-06-01,13,147,GA,Hart County,12304,11910,394,3.2
CN1314900000000,2022-06-01,13,149,GA,Heard County,5342,5169,173,3.2
CN1315100000000,2022-06-01,13,151,GA,Henry County,121188,116852,4336,3.6
CN1315300000000,2022-06-01,13,153,GA,Houston County,71303,68825,2478,3.5
CN1315500000000,2022-06-01,13,155,GA,Irwin County,3583,3433,150,4.2
CN1315700000000,2022-06-01,13,157,GA,Jackson County,45799,44750,1049,2.3
CN1315900000000,2022-06-01,13,159,GA,Jasper County,7222,7015,207,2.9
CN1316100000000,2022-06-01,13,161,GA,Jeff Davis County,6195,5950,245,4
CN1316300000000,2022-06-01,13,163,GA,Jefferson County,6665,6360,305,4.6
CN1316500000000,2022-06-01,13,165,GA,Jenkins County,3269,3114,155,4.7
CN1316700000000,2022-06-01,13,167,GA,Johnson County,4019,3895,124,3.1
CN1316900000000,2022-06-01,13,169,GA,Jones County,13372,12952,420,3.1
CN1317100000000,2022-06-01,13,171,GA,Lamar County,8427,8104,323,3.8
CN1317300000000,2022-06-01,13,173,GA,Lanier County,3783,3641,142,3.8
CN1317500000000,2022-06-01,13,175,GA,Laurens County,19239,18421,818,4.3
CN1317700000000,2022-06-01,13,177,GA,Lee County,15031,14537,494,3.3
CN1317900000000,2022-06-01,13,179,GA,Liberty County,26213,25253,960,3.7
CN1318100000000,2022-06-01,13,181,GA,Lincoln County,3518,3387,131,3.7
CN1318300000000,2022-06-01,13,183,GA,Long County,8508,8206,302,3.5
CN1318500000000,2022-06-01,13,185,GA,Lowndes County,50625,48735,1890,3.7
CN1318700000000,2022-06-01,13,187,GA,Lumpkin County,18496,17941,555,3
CN1318900000000,2022-06-01,13,189,GA,McDuffie County,8418,8013,405,4.8
CN1319100000000,2022-06-01,13,191,GA,McIntosh County,6245,6037,208,3.3
CN1319300000000,2022-06-01,13,193,GA,Macon County,4580,4369,211,4.6
CN1319500000000,2022-06-01,13,195,GA,Madison County,13117,12688,429,3.3
CN1319700000000,2022-06-01,13,197,GA,Marion County,3231,3113,118,3.7
CN1319900000000,2022-06-01,13,199,GA,Meriwether County,9006,8644,362,4
CN1320100000000,2022-06-01,13,201,GA,Miller County,2894,2805,89,3.1
CN1320500000000,2022-06-01,13,205,GA,Mitchell County,8252,7902,350,4.2
CN1320700000000,2022-06-01,13,207,GA,Monroe County,12858,12451,407,3.2
CN1320900000000,2022-06-01,13,209,GA,Montgomery County,3859,3673,186,4.8
CN1321100000000,2022-06-01,13,211,GA,Morgan County,9731,9440,291,3
CN1321300000000,2022-06-01,13,213,GA,Murray County,15479,14812,667,4.3
CN1321500000000,2022-06-01,13,215,GA,Muscogee County,75255,71886,3369,4.5
CN1321700000000,2022-06-01,13,217,GA,Newton County,54549,52434,2115,3.9
CN1321900000000,2022-06-01,13,219,GA,Oconee County,19642,19096,546,2.8
CN1322100000000,2022-06-01,13,221,GA,Oglethorpe County,6804,6591,213,3.1
CN1322300000000,2022-06-01,13,223,GA,Paulding County,91720,89016,2704,2.9
CN1322500000000,2022-06-01,13,225,GA,Peach County,11985,11462,523,4.4
CN1322700000000,2022-06-01,13,227,GA,Pickens County,15951,15501,450,2.8
CN1322900000000,2022-06-01,13,229,GA,Pierce County,8977,8688,289,3.2
CN1323100000000,2022-06-01,13,231,GA,Pike County,9229,8951,278,3
CN1323300000000,2022-06-01,13,233,GA,Polk County,18607,17982,625,3.4
CN1323500000000,2022-06-01,13,235,GA,Pulaski County,4044,3891,153,3.8
CN1323700000000,2022-06-01,13,237,GA,Putnam County,8805,8476,329,3.7
CN1323900000000,2022-06-01,13,239,GA,Quitman County,747,708,39,5.2
CN1324100000000,2022-06-01,13,241,GA,Rabun County,7978,7734,244,3.1
CN1324300000000,2022-06-01,13,243,GA,Randolph County,2346,2233,113,4.8
CN1324500000000,2022-06-01,13,245,GA,Richmond County,82789,78952,3837,4.6
CN1324700000000,2022-06-01,13,247,GA,Rockdale County,45396,43656,1740,3.8
CN1324900000000,2022-06-01,13,249,GA,Schley County,2141,2049,92,4.3
CN1325100000000,2022-06-01,13,251,GA,Screven County,5018,4794,224,4.5
CN1325300000000,2022-06-01,13,253,GA,Seminole County,3131,3013,118,3.8
CN1325500000000,2022-06-01,13,255,GA,Spalding County,29429,28364,1065,3.6
CN1325700000000,2022-06-01,13,257,GA,Stephens County,10636,10224,412,3.9
CN1325900000000,2022-06-01,13,259,GA,Stewart County,2534,2432,102,4
CN1326100000000,2022-06-01,13,261,GA,Sumter County,12171,11611,560,4.6
CN1326300000000,2022-06-01,13,263,GA,Talbot County,2794,2696,98,3.5
CN1326500000000,2022-06-01,13,265,GA,Taliaferro County,547,524,23,4.2
CN1326700000000,2022-06-01,13,267,GA,Tattnall County,9591,9265,326,3.4
CN1326900000000,2022-06-01,13,269,GA,Taylor County,2620,2481,139,5.3
CN1327100000000,2022-06-01,13,271,GA,Telfair County,3691,3478,213,5.8
CN1327300000000,2022-06-01,13,273,GA,Terrell County,3474,3311,163,4.7
CN1327500000000,2022-06-01,13,275,GA,Thomas County,17155,16464,691,4
CN1327700000000,2022-06-01,13,277,GA,Tift County,21070,20394,676,3.2
CN1327900000000,2022-06-01,13,279,GA,Toombs County,12079,11540,539,4.5
CN1328100000000,2022-06-01,13,281,GA,Towns County,4036,3839,197,4.9
CN1328300000000,2022-06-01,13,283,GA,Treutlen County,2637,2514,123,4.7
CN1328500000000,2022-06-01,13,285,GA,Troup County,36676,35460,1216,3.3
CN1328700000000,2022-06-01,13,287,GA,Turner County,3184,3047,137,4.3
CN1328900000000,2022-06-01,13,289,GA,Twiggs County,2748,2608,140,5.1
CN1329100000000,2022-06-01,13,291,GA,Union County,11576,11256,320,2.8
CN1329300000000,2022-06-01,13,293,GA,Upson County,11719,11312,407,3.5
CN1329500000000,2022-06-01,13,295,GA,Walker County,31069,30073,996,3.2
CN1329700000000,2022-06-01,13,297,GA,Walton County,48166,46673,1493,3.1
CN1329900000000,2022-06-01,13,299,GA,Ware County,15968,15447,521,3.3
CN1330100000000,2022-06-01,13,301,GA,Warren County,2691,2576,115,4.3
CN1330300000000,2022-06-01,13,303,GA,Washington County,6986,6678,308,4.4
CN1330500000000,2022-06-01,13,305,GA,Wayne County,12058,11642,416,3.4
CN1330700000000,2022-06-01,13,307,GA,Webster County,989,947,42,4.2
CN1330900000000,2022-06-01,13,309,GA,Wheeler County,1649,1562,87,5.3
CN1331100000000,2022-06-01,13,311,GA,White County,17295,16837,458,2.6
CN1331300000000,2022-06-01,13,313,GA,Whitfield County,43369,41640,1729,4
CN1331500000000,2022-06-01,13,315,GA,Wilcox County,2706,2591,115,4.2
CN1331700000000,2022-06-01,13,317,GA,Wilkes County,3753,3593,160,4.3
CN1331900000000,2022-06-01,13,319,GA,Wilkinson County,3898,3748,150,3.8
CN1332100000000,2022-06-01,13,321,GA,Worth County,8766,8459,307,3.5
CN1500100000000,2022-06-01,15,001,HI,Hawaii County,93264,89178,4086,4.4
CN1500300000000,2022-06-01,15,003,HI,Honolulu County/city,458953,440657,18296,4
CN1500700000000,2022-06-01,15,007,HI,Kauai County,36629,35177,1452,4
CN1500900000000,2022-06-01,15,009,HI,Maui County,87251,83855,3396,3.9
CN1600100000000,2022-06-01,16,001,ID,Ada County,278347,271782,6565,2.4
CN1600300000000,2022-06-01,16,003,ID,Adams County,1891,1812,79,4.2
CN1600500000000,2022-06-01,16,005,ID,Bannock County,44191,42973,1218,2.8
CN1600700000000,2022-06-01,16,007,ID,Bear Lake County,3472,3382,90,2.6
CN1600900000000,2022-06-01,16,009,ID,Benewah County,4213,4067,146,3.5
CN1601100000000,2022-06-01,16,011,ID,Bingham County,25216,24589,627,2.5
CN1601300000000,2022-06-01,16,013,ID,Blaine County,13878,13557,321,2.3
CN1601500000000,2022-06-01,16,015,ID,Boise County,3854,3727,127,3.3
CN1601700000000,2022-06-01,16,017,ID,Bonner County,22528,21864,664,2.9
CN1601900000000,2022-06-01,16,019,ID,Bonneville County,64131,62633,1498,2.3
CN1602100000000,2022-06-01,16,021,ID,Boundary County,6016,5831,185,3.1
CN1602300000000,2022-06-01,16,023,ID,Butte County,1513,1476,37,2.4
CN1602500000000,2022-06-01,16,025,ID,Camas County,742,725,17,2.3
CN1602700000000,2022-06-01,16,027,ID,Canyon County,115138,111628,3510,3
CN1602900000000,2022-06-01,16,029,ID,Caribou County,4344,4243,101,2.3
CN1603100000000,2022-06-01,16,031,ID,Cassia County,13148,12795,353,2.7
CN1603300000000,2022-06-01,16,033,ID,Clark County,399,388,11,2.8
CN1603500000000,2022-06-01,16,035,ID,Clearwater County,3119,2976,143,4.6
CN1603700000000,2022-06-01,16,037,ID,Custer County,2556,2494,62,2.4
CN1603900000000,2022-06-01,16,039,ID,Elmore County,12585,12213,372,3
CN1604100000000,2022-06-01,16,041,ID,Franklin County,7592,7428,164,2.2
CN1604300000000,2022-06-01,16,043,ID,Fremont County,8632,8455,177,2.1
CN1604500000000,2022-06-01,16,045,ID,Gem County,9072,8824,248,2.7
CN1604700000000,2022-06-01,16,047,ID,Gooding County,8658,8442,216,2.5
CN1604900000000,2022-06-01,16,049,ID,Idaho County,7090,6828,262,3.7
CN1605100000000,2022-06-01,16,051,ID,Jefferson County,15554,15193,361,2.3
CN1605300000000,2022-06-01,16,053,ID,Jerome County,12596,12274,322,2.6
CN1605500000000,2022-06-01,16,055,ID,Kootenai County,85858,83454,2404,2.8
CN1605700000000,2022-06-01,16,057,ID,Latah County,20138,19564,574,2.9
CN1605900000000,2022-06-01,16,059,ID,Lemhi County,3976,3858,118,3
CN1606100000000,2022-06-01,16,061,ID,Lewis County,1729,1655,74,4.3
CN1606300000000,2022-06-01,16,063,ID,Lincoln County,2833,2750,83,2.9
CN1606500000000,2022-06-01,16,065,ID,Madison County,24844,24303,541,2.2
CN1606700000000,2022-06-01,16,067,ID,Minidoka County,12280,11959,321,2.6
CN1606900000000,2022-06-01,16,069,ID,Nez Perce County,21780,21252,528,2.4
CN1607100000000,2022-06-01,16,071,ID,Oneida County,2770,2713,57,2.1
CN1607300000000,2022-06-01,16,073,ID,Owyhee County,5781,5589,192,3.3
CN1607500000000,2022-06-01,16,075,ID,Payette County,12556,12173,383,3.1
CN1607700000000,2022-06-01,16,077,ID,Power County,4311,4194,117,2.7
CN1607900000000,2022-06-01,16,079,ID,Shoshone County,5576,5353,223,4
CN1608100000000,2022-06-01,16,081,ID,Teton County,8340,8178,162,1.9
CN1608300000000,2022-06-01,16,083,ID,Twin Falls County,43695,42519,1176,2.7
CN1608500000000,2022-06-01,16,085,ID,Valley County,6250,6062,188,3
CN1608700000000,2022-06-01,16,087,ID,Washington County,5100,4933,167,3.3
CN1700100000000,2022-06-01,17,001,IL,Adams County,31398,30367,1031,3.3
CN1700300000000,2022-06-01,17,003,IL,Alexander County,1846,1716,130,7
CN1700500000000,2022-06-01,17,005,IL,Bond County,7601,7319,282,3.7
CN1700700000000,2022-06-01,17,007,IL,Boone County,25146,23758,1388,5.5
CN1700900000000,2022-06-01,17,009,IL,Brown County,3123,3049,74,2.4
CN1701100000000,2022-06-01,17,011,IL,Bureau County,16454,15788,666,4
CN1701300000000,2022-06-01,17,013,IL,Calhoun County,2216,2126,90,4.1
CN1701500000000,2022-06-01,17,015,IL,Carroll County,7648,7388,260,3.4
CN1701700000000,2022-06-01,17,017,IL,Cass County,5780,5550,230,4
CN1701900000000,2022-06-01,17,019,IL,Champaign County,105949,101561,4388,4.1
CN1702100000000,2022-06-01,17,021,IL,Christian County,13479,12878,601,4.5
CN1702300000000,2022-06-01,17,023,IL,Clark County,7458,7165,293,3.9
CN1702500000000,2022-06-01,17,025,IL,Clay County,5808,5553,255,4.4
CN1702700000000,2022-06-01,17,027,IL,Clinton County,20280,19695,585,2.9
CN1702900000000,2022-06-01,17,029,IL,Coles County,21895,20870,1025,4.7
CN1703100000000,2022-06-01,17,031,IL,Cook County,2718595,2567094,151501,5.6
CN1703300000000,2022-06-01,17,033,IL,Crawford County,8055,7706,349,4.3
CN1703500000000,2022-06-01,17,035,IL,Cumberland County,5952,5753,199,3.3
CN1703700000000,2022-06-01,17,037,IL,DeKalb County,54568,52354,2214,4.1
CN1703900000000,2022-06-01,17,039,IL,De Witt County,7295,7014,281,3.9
CN1704100000000,2022-06-01,17,041,IL,Douglas County,10229,9885,344,3.4
CN1704300000000,2022-06-01,17,043,IL,DuPage County,530190,507939,22251,4.2
CN1704500000000,2022-06-01,17,045,IL,Edgar County,9223,8903,320,3.5
CN1704700000000,2022-06-01,17,047,IL,Edwards County,2424,2316,108,4.5
CN1704900000000,2022-06-01,17,049,IL,Effingham County,20232,19671,561,2.8
CN1705100000000,2022-06-01,17,051,IL,Fayette County,9730,9336,394,4
CN1705300000000,2022-06-01,17,053,IL,Ford County,6100,5844,256,4.2
CN1705500000000,2022-06-01,17,055,IL,Franklin County,15904,15087,817,5.1
CN1705700000000,2022-06-01,17,057,IL,Fulton County,14741,14060,681,4.6
CN1705900000000,2022-06-01,17,059,IL,Gallatin County,2003,1901,102,5.1
CN1706100000000,2022-06-01,17,061,IL,Greene County,5943,5706,237,4
CN1706300000000,2022-06-01,17,063,IL,Grundy County,26726,25334,1392,5.2
CN1706500000000,2022-06-01,17,065,IL,Hamilton County,4333,4191,142,3.3
CN1706700000000,2022-06-01,17,067,IL,Hancock County,8242,7945,297,3.6
CN1706900000000,2022-06-01,17,069,IL,Hardin County,1450,1366,84,5.8
CN1707100000000,2022-06-01,17,071,IL,Henderson County,3594,3458,136,3.8
CN1707300000000,2022-06-01,17,073,IL,Henry County,23951,22978,973,4.1
CN1707500000000,2022-06-01,17,075,IL,Iroquois County,12785,12275,510,4
CN1707700000000,2022-06-01,17,077,IL,Jackson County,26564,25374,1190,4.5
CN1707900000000,2022-06-01,17,079,IL,Jasper County,4976,4794,182,3.7
CN1708100000000,2022-06-01,17,081,IL,Jefferson County,16387,15630,757,4.6
CN1708300000000,2022-06-01,17,083,IL,Jersey County,10804,10412,392,3.6
CN1708500000000,2022-06-01,17,085,IL,Jo Daviess County,10926,10591,335,3.1
CN1708700000000,2022-06-01,17,087,IL,Johnson County,4099,3880,219,5.3
CN1708900000000,2022-06-01,17,089,IL,Kane County,267483,256232,11251,4.2
CN1709100000000,2022-06-01,17,091,IL,Kankakee County,52366,49842,2524,4.8
CN1709300000000,2022-06-01,17,093,IL,Kendall County,74026,70664,3362,4.5
CN1709500000000,2022-06-01,17,095,IL,Knox County,20031,19052,979,4.9
CN1709700000000,2022-06-01,17,097,IL,Lake County,368821,354795,14026,3.8
CN1709900000000,2022-06-01,17,099,IL,LaSalle County,52583,50249,2334,4.4
CN1710100000000,2022-06-01,17,101,IL,Lawrence County,5165,4875,290,5.6
CN1710300000000,2022-06-01,17,103,IL,Lee County,16985,16331,654,3.9
CN1710500000000,2022-06-01,17,105,IL,Livingston County,15526,14944,582,3.7
CN1710700000000,2022-06-01,17,107,IL,Logan County,11673,11187,486,4.2
CN1710900000000,2022-06-01,17,109,IL,McDonough County,12006,11410,596,5
CN1711100000000,2022-06-01,17,111,IL,McHenry County,173057,165399,7658,4.4
CN1711300000000,2022-06-01,17,113,IL,McLean County,88490,85162,3328,3.8
CN1711500000000,2022-06-01,17,115,IL,Macon County,45512,42951,2561,5.6
CN1711700000000,2022-06-01,17,117,IL,Macoupin County,22517,21677,840,3.7
CN1711900000000,2022-06-01,17,119,IL,Madison County,133842,128677,5165,3.9
CN1712100000000,2022-06-01,17,121,IL,Marion County,16713,15960,753,4.5
CN1712300000000,2022-06-01,17,123,IL,Marshall County,5148,4929,219,4.3
CN1712500000000,2022-06-01,17,125,IL,Mason County,6011,5743,268,4.5
CN1712700000000,2022-06-01,17,127,IL,Massac County,5490,5193,297,5.4
CN1712900000000,2022-06-01,17,129,IL,Menard County,6206,6003,203,3.3
CN1713100000000,2022-06-01,17,131,IL,Mercer County,7604,7335,269,3.5
CN1713300000000,2022-06-01,17,133,IL,Monroe County,19052,18498,554,2.9
CN1713500000000,2022-06-01,17,135,IL,Montgomery County,11423,10938,485,4.2
CN1713700000000,2022-06-01,17,137,IL,Morgan County,15742,15106,636,4
CN1713900000000,2022-06-01,17,139,IL,Moultrie County,7541,7293,248,3.3
CN1714100000000,2022-06-01,17,141,IL,Ogle County,24318,23279,1039,4.3
CN1714300000000,2022-06-01,17,143,IL,Peoria County,82977,78966,4011,4.8
CN1714500000000,2022-06-01,17,145,IL,Perry County,7870,7472,398,5.1
CN1714700000000,2022-06-01,17,147,IL,Piatt County,8332,8027,305,3.7
CN1714900000000,2022-06-01,17,149,IL,Pike County,6948,6691,257,3.7
CN1715100000000,2022-06-01,17,151,IL,Pope County,1782,1687,95,5.3
CN1715300000000,2022-06-01,17,153,IL,Pulaski County,1677,1564,113,6.7
CN1715500000000,2022-06-01,17,155,IL,Putnam County,3017,2891,126,4.2
CN1715700000000,2022-06-01,17,157,IL,Randolph County,13464,12968,496,3.7
CN1715900000000,2022-06-01,17,159,IL,Richland County,7337,7047,290,4
CN1716100000000,2022-06-01,17,161,IL,Rock Island County,68090,65335,2755,4
CN1716300000000,2022-06-01,17,163,IL,St. Clair County,125649,120180,5469,4.4
CN1716500000000,2022-06-01,17,165,IL,Saline County,9142,8665,477,5.2
CN1716700000000,2022-06-01,17,167,IL,Sangamon County,98164,94186,3978,4.1
CN1716900000000,2022-06-01,17,169,IL,Schuyler County,3207,3089,118,3.7
CN1717100000000,2022-06-01,17,171,IL,Scott County,2296,2210,86,3.7
CN1717300000000,2022-06-01,17,173,IL,Shelby County,10142,9743,399,3.9
CN1717500000000,2022-06-01,17,175,IL,Stark County,2389,2290,99,4.1
CN1717700000000,2022-06-01,17,177,IL,Stephenson County,21170,20302,868,4.1
CN1717900000000,2022-06-01,17,179,IL,Tazewell County,62502,59969,2533,4.1
CN1718100000000,2022-06-01,17,181,IL,Union County,6994,6663,331,4.7
CN1718300000000,2022-06-01,17,183,IL,Vermilion County,31988,30425,1563,4.9
CN1718500000000,2022-06-01,17,185,IL,Wabash County,5835,5638,197,3.4
CN1718700000000,2022-06-01,17,187,IL,Warren County,7828,7508,320,4.1
CN1718900000000,2022-06-01,17,189,IL,Washington County,9983,9744,239,2.4
CN1719100000000,2022-06-01,17,191,IL,Wayne County,7028,6762,266,3.8
CN1719300000000,2022-06-01,17,193,IL,White County,6180,5946,234,3.8
CN1719500000000,2022-06-01,17,195,IL,Whiteside County,27748,26630,1118,4
CN1719700000000,2022-06-01,17,197,IL,Will County,375562,356479,19083,5.1
CN1719900000000,2022-06-01,17,199,IL,Williamson County,30317,29011,1306,4.3
CN1720100000000,2022-06-01,17,201,IL,Winnebago County,134209,127046,7163,5.3
CN1720300000000,2022-06-01,17,203,IL,Woodford County,18369,17771,598,3.3
CN1800100000000,2022-06-01,18,001,IN,Adams County,17483,17040,443,2.5
CN1800300000000,2022-06-01,18,003,IN,Allen County,190858,184701,6157,3.2
CN1800500000000,2022-06-01,18,005,IN,Bartholomew County,44510,43335,1175,2.6
CN1800700000000,2022-06-01,18,007,IN,Benton County,4488,4367,121,2.7
CN1800900000000,2022-06-01,18,009,IN,Blackford County,4878,4683,195,4
CN1801100000000,2022-06-01,18,011,IN,Boone County,38513,37630,883,2.3
CN1801300000000,2022-06-01,18,013,IN,Brown County,7954,7651,303,3.8
CN1801500000000,2022-06-01,18,015,IN,Carroll County,10073,9743,330,3.3
CN1801700000000,2022-06-01,18,017,IN,Cass County,17894,17204,690,3.9
CN1801900000000,2022-06-01,18,019,IN,Clark County,63429,61507,1922,3
CN1802100000000,2022-06-01,18,021,IN,Clay County,11842,11376,466,3.9
CN1802300000000,2022-06-01,18,023,IN,Clinton County,17404,16896,508,2.9
CN1802500000000,2022-06-01,18,025,IN,Crawford County,4913,4737,176,3.6
CN1802700000000,2022-06-01,18,027,IN,Daviess County,17124,16662,462,2.7
CN1802900000000,2022-06-01,18,029,IN,Dearborn County,26258,25510,748,2.8
CN1803100000000,2022-06-01,18,031,IN,Decatur County,14878,14461,417,2.8
CN1803300000000,2022-06-01,18,033,IN,DeKalb County,22889,22230,659,2.9
CN1803500000000,2022-06-01,18,035,IN,Delaware County,51289,49172,2117,4.1
CN1803700000000,2022-06-01,18,037,IN,Dubois County,22715,22148,567,2.5
CN1803900000000,2022-06-01,18,039,IN,Elkhart County,121994,118784,3210,2.6
CN1804100000000,2022-06-01,18,041,IN,Fayette County,8383,7940,443,5.3
CN1804300000000,2022-06-01,18,043,IN,Floyd County,42707,41552,1155,2.7
CN1804500000000,2022-06-01,18,045,IN,Fountain County,8244,7993,251,3
CN1804700000000,2022-06-01,18,047,IN,Franklin County,11674,11344,330,2.8
CN1804900000000,2022-06-01,18,049,IN,Fulton County,9934,9612,322,3.2
CN1805100000000,2022-06-01,18,051,IN,Gibson County,20310,19781,529,2.6
CN1805300000000,2022-06-01,18,053,IN,Grant County,30970,29765,1205,3.9
CN1805500000000,2022-06-01,18,055,IN,Greene County,13703,13112,591,4.3
CN1805700000000,2022-06-01,18,057,IN,Hamilton County,196459,191551,4908,2.5
CN1805900000000,2022-06-01,18,059,IN,Hancock County,43111,41838,1273,3
CN1806100000000,2022-06-01,18,061,IN,Harrison County,20718,20138,580,2.8
CN1806300000000,2022-06-01,18,063,IN,Hendricks County,95721,93054,2667,2.8
CN1806500000000,2022-06-01,18,065,IN,Henry County,22435,21641,794,3.5
CN1806700000000,2022-06-01,18,067,IN,Howard County,34463,32281,2182,6.3
CN1806900000000,2022-06-01,18,069,IN,Huntington County,18699,18185,514,2.7
CN1807100000000,2022-06-01,18,071,IN,Jackson County,23974,23210,764,3.2
CN1807300000000,2022-06-01,18,073,IN,Jasper County,16248,15678,570,3.5
CN1807500000000,2022-06-01,18,075,IN,Jay County,9077,8814,263,2.9
CN1807700000000,2022-06-01,18,077,IN,Jefferson County,15285,14802,483,3.2
CN1807900000000,2022-06-01,18,079,IN,Jennings County,13884,13375,509,3.7
CN1808100000000,2022-06-01,18,081,IN,Johnson County,87491,85121,2370,2.7
CN1808300000000,2022-06-01,18,083,IN,Knox County,18587,18020,567,3.1
CN1808500000000,2022-06-01,18,085,IN,Kosciusko County,41365,40260,1105,2.7
CN1808700000000,2022-06-01,18,087,IN,LaGrange County,22370,21867,503,2.2
CN1808900000000,2022-06-01,18,089,IN,Lake County,230394,219054,11340,4.9
CN1809100000000,2022-06-01,18,091,IN,LaPorte County,47996,46128,1868,3.9
CN1809300000000,2022-06-01,18,093,IN,Lawrence County,20952,20180,772,3.7
CN1809500000000,2022-06-01,18,095,IN,Madison County,60771,58481,2290,3.8
CN1809700000000,2022-06-01,18,097,IN,Marion County,510589,492380,18209,3.6
CN1809900000000,2022-06-01,18,099,IN,Marshall County,23846,23213,633,2.7
CN1810100000000,2022-06-01,18,101,IN,Martin County,5651,5477,174,3.1
CN1810300000000,2022-06-01,18,103,IN,Miami County,14649,13906,743,5.1
CN1810500000000,2022-06-01,18,105,IN,Monroe County,71340,68883,2457,3.4
CN1810700000000,2022-06-01,18,107,IN,Montgomery County,19230,18689,541,2.8
CN1810900000000,2022-06-01,18,109,IN,Morgan County,37684,36495,1189,3.2
CN1811100000000,2022-06-01,18,111,IN,Newton County,6899,6644,255,3.7
CN1811300000000,2022-06-01,18,113,IN,Noble County,22452,21790,662,2.9
CN1811500000000,2022-06-01,18,115,IN,Ohio County,3233,3159,74,2.3
CN1811700000000,2022-06-01,18,117,IN,Orange County,8400,8089,311,3.7
CN1811900000000,2022-06-01,18,119,IN,Owen County,9424,9100,324,3.4
CN1812100000000,2022-06-01,18,121,IN,Parke County,7380,7129,251,3.4
CN1812300000000,2022-06-01,18,123,IN,Perry County,9005,8718,287,3.2
CN1812500000000,2022-06-01,18,125,IN,Pike County,6066,5853,213,3.5
CN1812700000000,2022-06-01,18,127,IN,Porter County,86775,83712,3063,3.5
CN1812900000000,2022-06-01,18,129,IN,Posey County,13390,13029,361,2.7
CN1813100000000,2022-06-01,18,131,IN,Pulaski County,6867,6685,182,2.7
CN1813300000000,2022-06-01,18,133,IN,Putnam County,17131,16511,620,3.6
CN1813500000000,2022-06-01,18,135,IN,Randolph County,11903,11532,371,3.1
CN1813700000000,2022-06-01,18,137,IN,Ripley County,13117,12685,432,3.3
CN1813900000000,2022-06-01,18,139,IN,Rush County,9197,8954,243,2.6
CN1814100000000,2022-06-01,18,141,IN,St. Joseph County,134635,129604,5031,3.7
CN1814300000000,2022-06-01,18,143,IN,Scott County,10690,10298,392,3.7
CN1814500000000,2022-06-01,18,145,IN,Shelby County,23892,23230,662,2.8
CN1814700000000,2022-06-01,18,147,IN,Spencer County,11443,11130,313,2.7
CN1814900000000,2022-06-01,18,149,IN,Starke County,9857,9475,382,3.9
CN1815100000000,2022-06-01,18,151,IN,Steuben County,21284,20801,483,2.3
CN1815300000000,2022-06-01,18,153,IN,Sullivan County,8138,7800,338,4.2
CN1815500000000,2022-06-01,18,155,IN,Switzerland County,4862,4709,153,3.1
CN1815700000000,2022-06-01,18,157,IN,Tippecanoe County,97354,94043,3311,3.4
CN1815900000000,2022-06-01,18,159,IN,Tipton County,9214,8885,329,3.6
CN1816100000000,2022-06-01,18,161,IN,Union County,3655,3553,102,2.8
CN1816300000000,2022-06-01,18,163,IN,Vanderburgh County,94561,91387,3174,3.4
CN1816500000000,2022-06-01,18,165,IN,Vermillion County,6683,6425,258,3.9
CN1816700000000,2022-06-01,18,167,IN,Vigo County,46394,44565,1829,3.9
CN1816900000000,2022-06-01,18,169,IN,Wabash County,14903,14458,445,3
CN1817100000000,2022-06-01,18,171,IN,Warren County,4199,4078,121,2.9
CN1817300000000,2022-06-01,18,173,IN,Warrick County,33153,32168,985,3
CN1817500000000,2022-06-01,18,175,IN,Washington County,14075,13667,408,2.9
CN1817700000000,2022-06-01,18,177,IN,Wayne County,30011,28938,1073,3.6
CN1817900000000,2022-06-01,18,179,IN,Wells County,14520,14167,353,2.4
CN1818100000000,2022-06-01,18,181,IN,White County,14077,13692,385,2.7
CN1818300000000,2022-06-01,18,183,IN,Whitley County,18046,17561,485,2.7
CN1900100000000,2022-06-01,19,001,IA,Adair County,4355,4270,85,2
CN1900300000000,2022-06-01,19,003,IA,Adams County,2182,2143,39,1.8
CN1900500000000,2022-06-01,19,005,IA,Allamakee County,7150,6943,207,2.9
CN1900700000000,2022-06-01,19,007,IA,Appanoose County,6211,6040,171,2.8
CN1900900000000,2022-06-01,19,009,IA,Audubon County,3087,3016,71,2.3
CN1901100000000,2022-06-01,19,011,IA,Benton County,13212,12843,369,2.8
CN1901300000000,2022-06-01,19,013,IA,Black Hawk County,68072,66074,1998,2.9
CN1901500000000,2022-06-01,19,015,IA,Boone County,14880,14527,353,2.4
CN1901700000000,2022-06-01,19,017,IA,Bremer County,13996,13683,313,2.2
CN1901900000000,2022-06-01,19,019,IA,Buchanan County,11531,11214,317,2.7
CN1902100000000,2022-06-01,19,021,IA,Buena Vista County,11697,11353,344,2.9
CN1902300000000,2022-06-01,19,023,IA,Butler County,8311,8099,212,2.6
CN1902500000000,2022-06-01,19,025,IA,Calhoun County,4256,4149,107,2.5
CN1902700000000,2022-06-01,19,027,IA,Carroll County,10909,10694,215,2
CN1902900000000,2022-06-01,19,029,IA,Cass County,7031,6864,167,2.4
CN1903100000000,2022-06-01,19,031,IA,Cedar County,10665,10393,272,2.6
CN1903300000000,2022-06-01,19,033,IA,Cerro Gordo County,22811,22163,648,2.8
CN1903500000000,2022-06-01,19,035,IA,Cherokee County,6257,6125,132,2.1
CN1903700000000,2022-06-01,19,037,IA,Chickasaw County,6676,6510,166,2.5
CN1903900000000,2022-06-01,19,039,IA,Clarke County,5024,4892,132,2.6
CN1904100000000,2022-06-01,19,041,IA,Clay County,8637,8406,231,2.7
CN1904300000000,2022-06-01,19,043,IA,Clayton County,9768,9487,281,2.9
CN1904500000000,2022-06-01,19,045,IA,Clinton County,22635,21855,780,3.4
CN1904700000000,2022-06-01,19,047,IA,Crawford County,7939,7665,274,3.5
CN1904900000000,2022-06-01,19,049,IA,Dallas County,54644,53489,1155,2.1
CN1905100000000,2022-06-01,19,051,IA,Davis County,4322,4224,98,2.3
CN1905300000000,2022-06-01,19,053,IA,Decatur County,4132,4022,110,2.7
CN1905500000000,2022-06-01,19,055,IA,Delaware County,10716,10485,231,2.2
CN1905700000000,2022-06-01,19,057,IA,Des Moines County,18498,17727,771,4.2
CN1905900000000,2022-06-01,19,059,IA,Dickinson County,11892,11637,255,2.1
CN1906100000000,2022-06-01,19,061,IA,Dubuque County,56739,55249,1490,2.6
CN1906300000000,2022-06-01,19,063,IA,Emmet County,5159,5043,116,2.2
CN1906500000000,2022-06-01,19,065,IA,Fayette County,10220,9917,303,3
CN1906700000000,2022-06-01,19,067,IA,Floyd County,8434,8192,242,2.9
CN1906900000000,2022-06-01,19,069,IA,Franklin County,5701,5560,141,2.5
CN1907100000000,2022-06-01,19,071,IA,Fremont County,3752,3668,84,2.2
CN1907300000000,2022-06-01,19,073,IA,Greene County,5402,5290,112,2.1
CN1907500000000,2022-06-01,19,075,IA,Grundy County,6370,6226,144,2.3
CN1907700000000,2022-06-01,19,077,IA,Guthrie County,5661,5515,146,2.6
CN1907900000000,2022-06-01,19,079,IA,Hamilton County,6874,6678,196,2.9
CN1908100000000,2022-06-01,19,081,IA,Hancock County,5853,5712,141,2.4
CN1908300000000,2022-06-01,19,083,IA,Hardin County,8007,7776,231,2.9
CN1908500000000,2022-06-01,19,085,IA,Harrison County,7174,6973,201,2.8
CN1908700000000,2022-06-01,19,087,IA,Henry County,9390,9121,269,2.9
CN1908900000000,2022-06-01,19,089,IA,Howard County,5340,5196,144,2.7
CN1909100000000,2022-06-01,19,091,IA,Humboldt County,4995,4879,116,2.3
CN1909300000000,2022-06-01,19,093,IA,Ida County,4101,4017,84,2
CN1909500000000,2022-06-01,19,095,IA,Iowa County,9842,9614,228,2.3
CN1909700000000,2022-06-01,19,097,IA,Jackson County,10903,10593,310,2.8
CN1909900000000,2022-06-01,19,099,IA,Jasper County,19047,18506,541,2.8
CN1910100000000,2022-06-01,19,101,IA,Jefferson County,9754,9491,263,2.7
CN1910300000000,2022-06-01,19,103,IA,Johnson County,86607,84504,2103,2.4
CN1910500000000,2022-06-01,19,105,IA,Jones County,10455,10152,303,2.9
CN1910700000000,2022-06-01,19,107,IA,Keokuk County,5258,5110,148,2.8
CN1910900000000,2022-06-01,19,109,IA,Kossuth County,8422,8233,189,2.2
CN1911100000000,2022-06-01,19,111,IA,Lee County,15295,14585,710,4.6
CN1911300000000,2022-06-01,19,113,IA,Linn County,122539,118825,3714,3
CN1911500000000,2022-06-01,19,115,IA,Louisa County,6009,5840,169,2.8
CN1911700000000,2022-06-01,19,117,IA,Lucas County,4876,4766,110,2.3
CN1911900000000,2022-06-01,19,119,IA,Lyon County,7141,7016,125,1.8
CN1912100000000,2022-06-01,19,121,IA,Madison County,8826,8580,246,2.8
CN1912300000000,2022-06-01,19,123,IA,Mahaska County,12204,11896,308,2.5
CN1912500000000,2022-06-01,19,125,IA,Marion County,19311,18914,397,2.1
CN1912700000000,2022-06-01,19,127,IA,Marshall County,17410,16659,751,4.3
CN1912900000000,2022-06-01,19,129,IA,Mills County,7149,6983,166,2.3
CN1913100000000,2022-06-01,19,131,IA,Mitchell County,6023,5902,121,2
CN1913300000000,2022-06-01,19,133,IA,Monona County,4513,4387,126,2.8
CN1913500000000,2022-06-01,19,135,IA,Monroe County,4100,3990,110,2.7
CN1913700000000,2022-06-01,19,137,IA,Montgomery County,5075,4947,128,2.5
CN1913900000000,2022-06-01,19,139,IA,Muscatine County,21507,20891,616,2.9
CN1914100000000,2022-06-01,19,141,IA,O'Brien County,8235,8066,169,2.1
CN1914300000000,2022-06-01,19,143,IA,Osceola County,3637,3573,64,1.8
CN1914500000000,2022-06-01,19,145,IA,Page County,6673,6513,160,2.4
CN1914700000000,2022-06-01,19,147,IA,Palo Alto County,4626,4501,125,2.7
CN1914900000000,2022-06-01,19,149,IA,Plymouth County,14872,14536,336,2.3
CN1915100000000,2022-06-01,19,151,IA,Pocahontas County,4352,4258,94,2.2
CN1915300000000,2022-06-01,19,153,IA,Polk County,279737,272288,7449,2.7
CN1915500000000,2022-06-01,19,155,IA,Pottawattamie County,48152,46806,1346,2.8
CN1915700000000,2022-06-01,19,157,IA,Poweshiek County,9962,9706,256,2.6
CN1915900000000,2022-06-01,19,159,IA,Ringgold County,2428,2367,61,2.5
CN1916100000000,2022-06-01,19,161,IA,Sac County,5409,5290,119,2.2
CN1916300000000,2022-06-01,19,163,IA,Scott County,89874,86876,2998,3.3
CN1916500000000,2022-06-01,19,165,IA,Shelby County,6577,6442,135,2.1
CN1916700000000,2022-06-01,19,167,IA,Sioux County,21722,21320,402,1.9
CN1916900000000,2022-06-01,19,169,IA,Story County,57173,55854,1319,2.3
CN1917100000000,2022-06-01,19,171,IA,Tama County,9267,9036,231,2.5
CN1917300000000,2022-06-01,19,173,IA,Taylor County,3167,3103,64,2
CN1917500000000,2022-06-01,19,175,IA,Union County,6153,5993,160,2.6
CN1917700000000,2022-06-01,19,177,IA,Van Buren County,3715,3617,98,2.6
CN1917900000000,2022-06-01,19,179,IA,Wapello County,17077,16493,584,3.4
CN1918100000000,2022-06-01,19,181,IA,Warren County,29690,28969,721,2.4
CN1918300000000,2022-06-01,19,183,IA,Washington County,11668,11390,278,2.4
CN1918500000000,2022-06-01,19,185,IA,Wayne County,3001,2916,85,2.8
CN1918700000000,2022-06-01,19,187,IA,Webster County,19194,18546,648,3.4
CN1918900000000,2022-06-01,19,189,IA,Winnebago County,5090,4953,137,2.7
CN1919100000000,2022-06-01,19,191,IA,Winneshiek County,11166,10860,306,2.7
CN1919300000000,2022-06-01,19,193,IA,Woodbury County,56458,54811,1647,2.9
CN1919500000000,2022-06-01,19,195,IA,Worth County,4081,3981,100,2.5
CN1919700000000,2022-06-01,19,197,IA,Wright County,6715,6555,160,2.4
CN2000100000000,2022-06-01,20,001,KS,Allen County,6411,6214,197,3.1
CN2000300000000,2022-06-01,20,003,KS,Anderson County,4437,4336,101,2.3
CN2000500000000,2022-06-01,20,005,KS,Atchison County,6849,6588,261,3.8
CN2000700000000,2022-06-01,20,007,KS,Barber County,2357,2303,54,2.3
CN2000900000000,2022-06-01,20,009,KS,Barton County,13281,12926,355,2.7
CN2001100000000,2022-06-01,20,011,KS,Bourbon County,6267,6044,223,3.6
CN2001300000000,2022-06-01,20,013,KS,Brown County,5215,5088,127,2.4
CN2001500000000,2022-06-01,20,015,KS,Butler County,33081,32138,943,2.9
CN2001700000000,2022-06-01,20,017,KS,Chase County,1464,1430,34,2.3
CN2001900000000,2022-06-01,20,019,KS,Chautauqua County,1533,1489,44,2.9
CN2002100000000,2022-06-01,20,021,KS,Cherokee County,9985,9699,286,2.9
CN2002300000000,2022-06-01,20,023,KS,Cheyenne County,1348,1316,32,2.4
CN2002500000000,2022-06-01,20,025,KS,Clark County,1149,1123,26,2.3
CN2002700000000,2022-06-01,20,027,KS,Clay County,3839,3724,115,3
CN2002900000000,2022-06-01,20,029,KS,Cloud County,3954,3835,119,3
CN2003100000000,2022-06-01,20,031,KS,Coffey County,3795,3660,135,3.6
CN2003300000000,2022-06-01,20,033,KS,Comanche County,928,908,20,2.2
CN2003500000000,2022-06-01,20,035,KS,Cowley County,16530,16013,517,3.1
CN2003700000000,2022-06-01,20,037,KS,Crawford County,19139,18543,596,3.1
CN2003900000000,2022-06-01,20,039,KS,Decatur County,1230,1193,37,3
CN2004100000000,2022-06-01,20,041,KS,Dickinson County,8817,8574,243,2.8
CN2004300000000,2022-06-01,20,043,KS,Doniphan County,4098,3982,116,2.8
CN2004500000000,2022-06-01,20,045,KS,Douglas County,64028,62201,1827,2.9
CN2004700000000,2022-06-01,20,047,KS,Edwards County,1428,1393,35,2.5
CN2004900000000,2022-06-01,20,049,KS,Elk County,1227,1196,31,2.5
CN2005100000000,2022-06-01,20,051,KS,Ellis County,17274,16898,376,2.2
CN2005300000000,2022-06-01,20,053,KS,Ellsworth County,2703,2636,67,2.5
CN2005500000000,2022-06-01,20,055,KS,Finney County,20867,20405,462,2.2
CN2005700000000,2022-06-01,20,057,KS,Ford County,18138,17739,399,2.2
CN2005900000000,2022-06-01,20,059,KS,Franklin County,14892,14501,391,2.6
CN2006100000000,2022-06-01,20,061,KS,Geary County,11318,10890,428,3.8
CN2006300000000,2022-06-01,20,063,KS,Gove County,1419,1390,29,2
CN2006500000000,2022-06-01,20,065,KS,Graham County,1254,1222,32,2.6
CN2006700000000,2022-06-01,20,067,KS,Grant County,2892,2793,99,3.4
CN2006900000000,2022-06-01,20,069,KS,Gray County,3300,3227,73,2.2
CN2007100000000,2022-06-01,20,071,KS,Greeley County,822,810,12,1.5
CN2007300000000,2022-06-01,20,073,KS,Greenwood County,3138,3060,78,2.5
CN2007500000000,2022-06-01,20,075,KS,Hamilton County,1668,1637,31,1.9
CN2007700000000,2022-06-01,20,077,KS,Harper County,2871,2808,63,2.2
CN2007900000000,2022-06-01,20,079,KS,Harvey County,17303,16834,469,2.7
CN2008100000000,2022-06-01,20,081,KS,Haskell County,2252,2208,44,2
CN2008300000000,2022-06-01,20,083,KS,Hodgeman County,1048,1025,23,2.2
CN2008500000000,2022-06-01,20,085,KS,Jackson County,7357,7180,177,2.4
CN2008700000000,2022-06-01,20,087,KS,Jefferson County,10473,10192,281,2.7
CN2008900000000,2022-06-01,20,089,KS,Jewell County,1231,1197,34,2.8
CN2009100000000,2022-06-01,20,091,KS,Johnson County,351781,343393,8388,2.4
CN2009300000000,2022-06-01,20,093,KS,Kearny County,2080,2039,41,2
CN2009500000000,2022-06-01,20,095,KS,Kingman County,3320,3230,90,2.7
CN2009700000000,2022-06-01,20,097,KS,Kiowa County,1243,1212,31,2.5
CN2009900000000,2022-06-01,20,099,KS,Labette County,9579,9243,336,3.5
CN2010100000000,2022-06-01,20,101,KS,Lane County,758,737,21,2.8
CN2010300000000,2022-06-01,20,103,KS,Leavenworth County,37680,36593,1087,2.9
CN2010500000000,2022-06-01,20,105,KS,Lincoln County,1733,1695,38,2.2
CN2010700000000,2022-06-01,20,107,KS,Linn County,4400,4226,174,4
CN2010900000000,2022-06-01,20,109,KS,Logan County,1703,1672,31,1.8
CN2011100000000,2022-06-01,20,111,KS,Lyon County,17121,16659,462,2.7
CN2011300000000,2022-06-01,20,113,KS,McPherson County,17644,17266,378,2.1
CN2011500000000,2022-06-01,20,115,KS,Marion County,6075,5913,162,2.7
CN2011700000000,2022-06-01,20,117,KS,Marshall County,5465,5349,116,2.1
CN2011900000000,2022-06-01,20,119,KS,Meade County,2212,2168,44,2
CN2012100000000,2022-06-01,20,121,KS,Miami County,18154,17680,474,2.6
CN2012300000000,2022-06-01,20,123,KS,Mitchell County,3432,3359,73,2.1
CN2012500000000,2022-06-01,20,125,KS,Montgomery County,14682,14206,476,3.2
CN2012700000000,2022-06-01,20,127,KS,Morris County,3210,3138,72,2.2
CN2012900000000,2022-06-01,20,129,KS,Morton County,1185,1154,31,2.6
CN2013100000000,2022-06-01,20,131,KS,Nemaha County,5774,5658,116,2
CN2013300000000,2022-06-01,20,133,KS,Neosho County,6115,5883,232,3.8
CN2013500000000,2022-06-01,20,135,KS,Ness County,1380,1348,32,2.3
CN2013700000000,2022-06-01,20,137,KS,Norton County,2688,2636,52,1.9
CN2013900000000,2022-06-01,20,139,KS,Osage County,8092,7870,222,2.7
CN2014100000000,2022-06-01,20,141,KS,Osborne County,1959,1913,46,2.3
CN2014300000000,2022-06-01,20,143,KS,Ottawa County,3055,2966,89,2.9
CN2014500000000,2022-06-01,20,145,KS,Pawnee County,2786,2720,66,2.4
CN2014700000000,2022-06-01,20,147,KS,Phillips County,2787,2726,61,2.2
CN2014900000000,2022-06-01,20,149,KS,Pottawatomie County,12017,11682,335,2.8
CN2015100000000,2022-06-01,20,151,KS,Pratt County,4986,4871,115,2.3
CN2015300000000,2022-06-01,20,153,KS,Rawlins County,1562,1530,32,2
CN2015500000000,2022-06-01,20,155,KS,Reno County,29605,28732,873,2.9
CN2015700000000,2022-06-01,20,157,KS,Republic County,2427,2372,55,2.3
CN2015900000000,2022-06-01,20,159,KS,Rice County,5492,5362,130,2.4
CN2016100000000,2022-06-01,20,161,KS,Riley County,33188,32162,1026,3.1
CN2016300000000,2022-06-01,20,163,KS,Rooks County,2438,2372,66,2.7
CN2016500000000,2022-06-01,20,165,KS,Rush County,1628,1591,37,2.3
CN2016700000000,2022-06-01,20,167,KS,Russell County,3371,3290,81,2.4
CN2016900000000,2022-06-01,20,169,KS,Saline County,29854,29112,742,2.5
CN2017100000000,2022-06-01,20,171,KS,Scott County,2833,2775,58,2
CN2017300000000,2022-06-01,20,173,KS,Sedgwick County,258116,249930,8186,3.2
CN2017500000000,2022-06-01,20,175,KS,Seward County,9867,9595,272,2.8
CN2017700000000,2022-06-01,20,177,KS,Shawnee County,92711,90142,2569,2.8
CN2017900000000,2022-06-01,20,179,KS,Sheridan County,1540,1511,29,1.9
CN2018100000000,2022-06-01,20,181,KS,Sherman County,2844,2768,76,2.7
CN2018300000000,2022-06-01,20,183,KS,Smith County,2051,2004,47,2.3
CN2018500000000,2022-06-01,20,185,KS,Stafford County,1977,1927,50,2.5
CN2018700000000,2022-06-01,20,187,KS,Stanton County,1160,1137,23,2
CN2018900000000,2022-06-01,20,189,KS,Stevens County,3059,2996,63,2.1
CN2019100000000,2022-06-01,20,191,KS,Sumner County,10895,10559,336,3.1
CN2019300000000,2022-06-01,20,193,KS,Thomas County,4287,4197,90,2.1
CN2019500000000,2022-06-01,20,195,KS,Trego County,1415,1381,34,2.4
CN2019700000000,2022-06-01,20,197,KS,Wabaunsee County,3782,3687,95,2.5
CN2019900000000,2022-06-01,20,199,KS,Wallace County,860,842,18,2.1
CN2020100000000,2022-06-01,20,201,KS,Washington County,3095,3029,66,2.1
CN2020300000000,2022-06-01,20,203,KS,Wichita County,1182,1156,26,2.2
CN2020500000000,2022-06-01,20,205,KS,Wilson County,3822,3709,113,3
CN2020700000000,2022-06-01,20,207,KS,Woodson County,1526,1468,58,3.8
CN2020900000000,2022-06-01,20,209,KS,Wyandotte County,78669,75964,2705,3.4
CN2100100000000,2022-06-01,21,001,KY,Adair County,7150,6767,383,5.4
CN2100300000000,2022-06-01,21,003,KY,Allen County,9002,8580,422,4.7
CN2100500000000,2022-06-01,21,005,KY,Anderson County,12060,11619,441,3.7
CN2100700000000,2022-06-01,21,007,KY,Ballard County,3522,3329,193,5.5
CN2100900000000,2022-06-01,21,009,KY,Barren County,18195,17342,853,4.7
CN2101100000000,2022-06-01,21,011,KY,Bath County,4779,4518,261,5.5
CN2101300000000,2022-06-01,21,013,KY,Bell County,8215,7725,490,6
CN2101500000000,2022-06-01,21,015,KY,Boone County,73473,70817,2656,3.6
CN2101700000000,2022-06-01,21,017,KY,Bourbon County,9618,9219,399,4.1
CN2101900000000,2022-06-01,21,019,KY,Boyd County,17278,16268,1010,5.8
CN2102100000000,2022-06-01,21,021,KY,Boyle County,12879,12273,606,4.7
CN2102300000000,2022-06-01,21,023,KY,Bracken County,3819,3651,168,4.4
CN2102500000000,2022-06-01,21,025,KY,Breathitt County,3276,2999,277,8.5
CN2102700000000,2022-06-01,21,027,KY,Breckinridge County,8061,7650,411,5.1
CN2102900000000,2022-06-01,21,029,KY,Bullitt County,43365,41691,1674,3.9
CN2103100000000,2022-06-01,21,031,KY,Butler County,5001,4766,235,4.7
CN2103300000000,2022-06-01,21,033,KY,Caldwell County,6055,5806,249,4.1
CN2103500000000,2022-06-01,21,035,KY,Calloway County,17302,16456,846,4.9
CN2103700000000,2022-06-01,21,037,KY,Campbell County,51615,49636,1979,3.8
CN2103900000000,2022-06-01,21,039,KY,Carlisle County,2277,2174,103,4.5
CN2104100000000,2022-06-01,21,041,KY,Carroll County,5700,5490,210,3.7
CN2104300000000,2022-06-01,21,043,KY,Carter County,9899,9095,804,8.1
CN2104500000000,2022-06-01,21,045,KY,Casey County,6745,6453,292,4.3
CN2104700000000,2022-06-01,21,047,KY,Christian County,25018,23623,1395,5.6
CN2104900000000,2022-06-01,21,049,KY,Clark County,17437,16709,728,4.2
CN2105100000000,2022-06-01,21,051,KY,Clay County,5108,4754,354,6.9
CN2105300000000,2022-06-01,21,053,KY,Clinton County,3764,3552,212,5.6
CN2105500000000,2022-06-01,21,055,KY,Crittenden County,3871,3687,184,4.8
CN2105700000000,2022-06-01,21,057,KY,Cumberland County,3452,3329,123,3.6
CN2105900000000,2022-06-01,21,059,KY,Daviess County,46839,44782,2057,4.4
CN2106100000000,2022-06-01,21,061,KY,Edmonson County,4784,4516,268,5.6
CN2106300000000,2022-06-01,21,063,KY,Elliott County,1917,1738,179,9.3
CN2106500000000,2022-06-01,21,065,KY,Estill County,5270,4962,308,5.8
CN2106700000000,2022-06-01,21,067,KY,Fayette County,177720,171140,6580,3.7
CN2106900000000,2022-06-01,21,069,KY,Fleming County,6106,5779,327,5.4
CN2107100000000,2022-06-01,21,071,KY,Floyd County,10931,10204,727,6.7
CN2107300000000,2022-06-01,21,073,KY,Franklin County,25321,24298,1023,4
CN2107500000000,2022-06-01,21,075,KY,Fulton County,2130,2023,107,5
CN2107700000000,2022-06-01,21,077,KY,Gallatin County,4068,3898,170,4.2
CN2107900000000,2022-06-01,21,079,KY,Garrard County,7992,7638,354,4.4
CN2108100000000,2022-06-01,21,081,KY,Grant County,11874,11378,496,4.2
CN2108300000000,2022-06-01,21,083,KY,Graves County,15705,14912,793,5
CN2108500000000,2022-06-01,21,085,KY,Grayson County,10578,10032,546,5.2
CN2108700000000,2022-06-01,21,087,KY,Green County,5091,4856,235,4.6
CN2108900000000,2022-06-01,21,089,KY,Greenup County,13004,12155,849,6.5
CN2109100000000,2022-06-01,21,091,KY,Hancock County,3905,3723,182,4.7
CN2109300000000,2022-06-01,21,093,KY,Hardin County,47772,45573,2199,4.6
CN2109500000000,2022-06-01,21,095,KY,Harlan County,6490,6007,483,7.4
CN2109700000000,2022-06-01,21,097,KY,Harrison County,8868,8518,350,3.9
CN2109900000000,2022-06-01,21,099,KY,Hart County,7736,7372,364,4.7
CN2110100000000,2022-06-01,21,101,KY,Henderson County,21154,20212,942,4.5
CN2110300000000,2022-06-01,21,103,KY,Henry County,8181,7876,305,3.7
CN2110500000000,2022-06-01,21,105,KY,Hickman County,1679,1591,88,5.2
CN2110700000000,2022-06-01,21,107,KY,Hopkins County,18358,17430,928,5.1
CN2110900000000,2022-06-01,21,109,KY,Jackson County,4250,3966,284,6.7
CN2111100000000,2022-06-01,21,111,KY,Jefferson County,398998,383175,15823,4
CN2111300000000,2022-06-01,21,113,KY,Jessamine County,26865,25827,1038,3.9
CN2111500000000,2022-06-01,21,115,KY,Johnson County,6777,6322,455,6.7
CN2111700000000,2022-06-01,21,117,KY,Kenton County,89396,85985,3411,3.8
CN2111900000000,2022-06-01,21,119,KY,Knott County,4324,4019,305,7.1
CN2112100000000,2022-06-01,21,121,KY,Knox County,9904,9275,629,6.4
CN2112300000000,2022-06-01,21,123,KY,Larue County,5810,5514,296,5.1
CN2112500000000,2022-06-01,21,125,KY,Laurel County,24987,23730,1257,5
CN2112700000000,2022-06-01,21,127,KY,Lawrence County,5798,5455,343,5.9
CN2112900000000,2022-06-01,21,129,KY,Lee County,2108,1961,147,7
CN2113100000000,2022-06-01,21,131,KY,Leslie County,2552,2354,198,7.8
CN2113300000000,2022-06-01,21,133,KY,Letcher County,6067,5642,425,7
CN2113500000000,2022-06-01,21,135,KY,Lewis County,4567,4219,348,7.6
CN2113700000000,2022-06-01,21,137,KY,Lincoln County,9447,8934,513,5.4
CN2113900000000,2022-06-01,21,139,KY,Livingston County,3696,3503,193,5.2
CN2114100000000,2022-06-01,21,141,KY,Logan County,12449,11931,518,4.2
CN2114300000000,2022-06-01,21,143,KY,Lyon County,3478,3329,149,4.3
CN2114500000000,2022-06-01,21,145,KY,McCracken County,30328,28927,1401,4.6
CN2114700000000,2022-06-01,21,147,KY,McCreary County,4754,4467,287,6
CN2114900000000,2022-06-01,21,149,KY,McLean County,4045,3842,203,5
CN2115100000000,2022-06-01,21,151,KY,Madison County,47289,45193,2096,4.4
CN2115300000000,2022-06-01,21,153,KY,Magoffin County,3196,2818,378,11.8
CN2115500000000,2022-06-01,21,155,KY,Marion County,9386,9034,352,3.8
CN2115700000000,2022-06-01,21,157,KY,Marshall County,15021,14349,672,4.5
CN2115900000000,2022-06-01,21,159,KY,Martin County,2317,2123,194,8.4
CN2116100000000,2022-06-01,21,161,KY,Mason County,6593,6239,354,5.4
CN2116300000000,2022-06-01,21,163,KY,Meade County,11790,11212,578,4.9
CN2116500000000,2022-06-01,21,165,KY,Menifee County,2431,2282,149,6.1
CN2116700000000,2022-06-01,21,167,KY,Mercer County,10168,9730,438,4.3
CN2116900000000,2022-06-01,21,169,KY,Metcalfe County,3958,3753,205,5.2
CN2117100000000,2022-06-01,21,171,KY,Monroe County,4650,4464,186,4
CN2117300000000,2022-06-01,21,173,KY,Montgomery County,12186,11564,622,5.1
CN2117500000000,2022-06-01,21,175,KY,Morgan County,4193,3936,257,6.1
CN2117700000000,2022-06-01,21,177,KY,Muhlenberg County,10027,9391,636,6.3
CN2117900000000,2022-06-01,21,179,KY,Nelson County,23796,22886,910,3.8
CN2118100000000,2022-06-01,21,181,KY,Nicholas County,3318,3155,163,4.9
CN2118300000000,2022-06-01,21,183,KY,Ohio County,9259,8772,487,5.3
CN2118500000000,2022-06-01,21,185,KY,Oldham County,33654,32481,1173,3.5
CN2118700000000,2022-06-01,21,187,KY,Owen County,5305,5098,207,3.9
CN2118900000000,2022-06-01,21,189,KY,Owsley County,1076,990,86,8
CN2119100000000,2022-06-01,21,191,KY,Pendleton County,7013,6740,273,3.9
CN2119300000000,2022-06-01,21,193,KY,Perry County,8082,7607,475,5.9
CN2119500000000,2022-06-01,21,195,KY,Pike County,18959,17812,1147,6
CN2119700000000,2022-06-01,21,197,KY,Powell County,5359,5107,252,4.7
CN2119900000000,2022-06-01,21,199,KY,Pulaski County,25615,24283,1332,5.2
CN2120100000000,2022-06-01,21,201,KY,Robertson County,824,778,46,5.6
CN2120300000000,2022-06-01,21,203,KY,Rockcastle County,6559,6193,366,5.6
CN2120500000000,2022-06-01,21,205,KY,Rowan County,10094,9516,578,5.7
CN2120700000000,2022-06-01,21,207,KY,Russell County,6395,6041,354,5.5
CN2120900000000,2022-06-01,21,209,KY,Scott County,30689,29586,1103,3.6
CN2121100000000,2022-06-01,21,211,KY,Shelby County,26109,25149,960,3.7
CN2121300000000,2022-06-01,21,213,KY,Simpson County,8815,8449,366,4.2
CN2121500000000,2022-06-01,21,215,KY,Spencer County,10644,10261,383,3.6
CN2121700000000,2022-06-01,21,217,KY,Taylor County,12012,11481,531,4.4
CN2121900000000,2022-06-01,21,219,KY,Todd County,5732,5513,219,3.8
CN2122100000000,2022-06-01,21,221,KY,Trigg County,6089,5777,312,5.1
CN2122300000000,2022-06-01,21,223,KY,Trimble County,3871,3689,182,4.7
CN2122500000000,2022-06-01,21,225,KY,Union County,5902,5597,305,5.2
CN2122700000000,2022-06-01,21,227,KY,Warren County,66310,63523,2787,4.2
CN2122900000000,2022-06-01,21,229,KY,Washington County,6160,5931,229,3.7
CN2123100000000,2022-06-01,21,231,KY,Wayne County,7188,6782,406,5.6
CN2123300000000,2022-06-01,21,233,KY,Webster County,5270,5028,242,4.6
CN2123500000000,2022-06-01,21,235,KY,Whitley County,13888,13142,746,5.4
CN2123700000000,2022-06-01,21,237,KY,Wolfe County,2317,2161,156,6.7
CN2123900000000,2022-06-01,21,239,KY,Woodford County,15034,14482,552,3.7
CN2200100000000,2022-06-01,22,001,LA,Acadia Parish,24249,23148,1101,4.5
CN2200300000000,2022-06-01,22,003,LA,Allen Parish,8329,7880,449,5.4
CN2200500000000,2022-06-01,22,005,LA,Ascension Parish,67029,64511,2518,3.8
CN2200700000000,2022-06-01,22,007,LA,Assumption Parish,8982,8493,489,5.4
CN2200900000000,2022-06-01,22,009,LA,Avoyelles Parish,14745,13939,806,5.5
CN2201100000000,2022-06-01,22,011,LA,Beauregard Parish,14765,14120,645,4.4
CN2201300000000,2022-06-01,22,013,LA,Bienville Parish,5264,5000,264,5
CN2201500000000,2022-06-01,22,015,LA,Bossier Parish,59093,56874,2219,3.8
CN2201700000000,2022-06-01,22,017,LA,Caddo Parish,103781,98627,5154,5
CN2201900000000,2022-06-01,22,019,LA,Calcasieu Parish,93695,89688,4007,4.3
CN2202100000000,2022-06-01,22,021,LA,Caldwell Parish,3758,3582,176,4.7
CN2202300000000,2022-06-01,22,023,LA,Cameron Parish,3472,3354,118,3.4
CN2202500000000,2022-06-01,22,025,LA,Catahoula Parish,3513,3335,178,5.1
CN2202700000000,2022-06-01,22,027,LA,Claiborne Parish,5556,5296,260,4.7
CN2202900000000,2022-06-01,22,029,LA,Concordia Parish,7178,6785,393,5.5
CN2203100000000,2022-06-01,22,031,LA,De Soto Parish,11124,10604,520,4.7
CN2203300000000,2022-06-01,22,033,LA,East Baton Rouge Parish,234164,223988,10176,4.3
CN2203500000000,2022-06-01,22,035,LA,East Carroll Parish,1672,1512,160,9.6
CN2203700000000,2022-06-01,22,037,LA,East Feliciana Parish,7927,7611,316,4
CN2203900000000,2022-06-01,22,039,LA,Evangeline Parish,12397,11754,643,5.2
CN2204100000000,2022-06-01,22,041,LA,Franklin Parish,7640,7214,426,5.6
CN2204300000000,2022-06-01,22,043,LA,Grant Parish,8491,8119,372,4.4
CN2204500000000,2022-06-01,22,045,LA,Iberia Parish,28094,26670,1424,5.1
CN2204700000000,2022-06-01,22,047,LA,Iberville Parish,13952,13210,742,5.3
CN2204900000000,2022-06-01,22,049,LA,Jackson Parish,7090,6812,278,3.9
CN2205100000000,2022-06-01,22,051,LA,Jefferson Parish,212879,203933,8946,4.2
CN2205300000000,2022-06-01,22,053,LA,Jefferson Davis Parish,12569,12027,542,4.3
CN2205500000000,2022-06-01,22,055,LA,Lafayette Parish,118028,113392,4636,3.9
CN2205700000000,2022-06-01,22,057,LA,Lafourche Parish,41347,39622,1725,4.2
CN2205900000000,2022-06-01,22,059,LA,LaSalle Parish,6855,6620,235,3.4
CN2206100000000,2022-06-01,22,061,LA,Lincoln Parish,21202,20178,1024,4.8
CN2206300000000,2022-06-01,22,063,LA,Livingston Parish,71894,69324,2570,3.6
CN2206500000000,2022-06-01,22,065,LA,Madison Parish,3592,3374,218,6.1
CN2206700000000,2022-06-01,22,067,LA,Morehouse Parish,10088,9487,601,6
CN2206900000000,2022-06-01,22,069,LA,Natchitoches Parish,16727,15849,878,5.2
CN2207100000000,2022-06-01,22,071,LA,Orleans Parish,178951,169630,9321,5.2
CN2207300000000,2022-06-01,22,073,LA,Ouachita Parish,71701,68519,3182,4.4
CN2207500000000,2022-06-01,22,075,LA,Plaquemines Parish,9938,9546,392,3.9
CN2207700000000,2022-06-01,22,077,LA,Pointe Coupee Parish,9891,9411,480,4.9
CN2207900000000,2022-06-01,22,079,LA,Rapides Parish,57029,54744,2285,4
CN2208100000000,2022-06-01,22,081,LA,Red River Parish,3831,3671,160,4.2
CN2208300000000,2022-06-01,22,083,LA,Richland Parish,8339,7928,411,4.9
CN2208500000000,2022-06-01,22,085,LA,Sabine Parish,9439,9044,395,4.2
CN2208700000000,2022-06-01,22,087,LA,St. Bernard Parish,20324,19347,977,4.8
CN2208900000000,2022-06-01,22,089,LA,St. Charles Parish,25116,24087,1029,4.1
CN2209100000000,2022-06-01,22,091,LA,St. Helena Parish,4316,4030,286,6.6
CN2209300000000,2022-06-01,22,093,LA,St. James Parish,9021,8528,493,5.5
CN2209500000000,2022-06-01,22,095,LA,St. John the Baptist Parish,19308,18217,1091,5.7
CN2209700000000,2022-06-01,22,097,LA,St. Landry Parish,32898,31130,1768,5.4
CN2209900000000,2022-06-01,22,099,LA,St. Martin Parish,22315,21325,990,4.4
CN2210100000000,2022-06-01,22,101,LA,St. Mary Parish,19722,18715,1007,5.1
CN2210300000000,2022-06-01,22,103,LA,St. Tammany Parish,121565,116964,4601,3.8
CN2210500000000,2022-06-01,22,105,LA,Tangipahoa Parish,57233,54153,3080,5.4
CN2210700000000,2022-06-01,22,107,LA,Tensas Parish,1369,1289,80,5.8
CN2210900000000,2022-06-01,22,109,LA,Terrebonne Parish,45417,43333,2084,4.6
CN2211100000000,2022-06-01,22,111,LA,Union Parish,9362,8942,420,4.5
CN2211300000000,2022-06-01,22,113,LA,Vermilion Parish,24526,23443,1083,4.4
CN2211500000000,2022-06-01,22,115,LA,Vernon Parish,16609,15672,937,5.6
CN2211700000000,2022-06-01,22,117,LA,Washington Parish,17220,16288,932,5.4
CN2211900000000,2022-06-01,22,119,LA,Webster Parish,14447,13721,726,5
CN2212100000000,2022-06-01,22,121,LA,West Baton Rouge Parish,14025,13456,569,4.1
CN2212300000000,2022-06-01,22,123,LA,West Carroll Parish,3722,3496,226,6.1
CN2212500000000,2022-06-01,22,125,LA,West Feliciana Parish,5453,5277,176,3.2
CN2212700000000,2022-06-01,22,127,LA,Winn Parish,4704,4461,243,5.2
CN2300100000000,2022-06-01,23,001,ME,Androscoggin County,52490,51010,1480,2.8
CN2300300000000,2022-06-01,23,003,ME,Aroostook County,28699,27548,1151,4
CN2300500000000,2022-06-01,23,005,ME,Cumberland County,163474,159742,3732,2.3
CN2300700000000,2022-06-01,23,007,ME,Franklin County,13517,13049,468,3.5
CN2300900000000,2022-06-01,23,009,ME,Hancock County,30175,29430,745,2.5
CN2301100000000,2022-06-01,23,011,ME,Kennebec County,61260,59660,1600,2.6
CN2301300000000,2022-06-01,23,013,ME,Knox County,20436,19933,503,2.5
CN2301500000000,2022-06-01,23,015,ME,Lincoln County,17295,16898,397,2.3
CN2301700000000,2022-06-01,23,017,ME,Oxford County,25986,25197,789,3
CN2301900000000,2022-06-01,23,019,ME,Penobscot County,74314,72195,2119,2.9
CN2302100000000,2022-06-01,23,021,ME,Piscataquis County,7438,7185,253,3.4
CN2302300000000,2022-06-01,23,023,ME,Sagadahoc County,18997,18591,406,2.1
CN2302500000000,2022-06-01,23,025,ME,Somerset County,22220,21432,788,3.5
CN2302700000000,2022-06-01,23,027,ME,Waldo County,20628,20034,594,2.9
CN2302900000000,2022-06-01,23,029,ME,Washington County,13664,13169,495,3.6
CN2303100000000,2022-06-01,23,031,ME,York County,112740,110082,2658,2.4
CN2400100000000,2022-06-01,24,001,MD,Allegany County,31503,30070,1433,4.5
CN2400300000000,2022-06-01,24,003,MD,Anne Arundel County,316000,305409,10591,3.4
CN2400500000000,2022-06-01,24,005,MD,Baltimore County,447427,430516,16911,3.8
CN2400900000000,2022-06-01,24,009,MD,Calvert County,49607,47856,1751,3.5
CN2401100000000,2022-06-01,24,011,MD,Caroline County,17341,16732,609,3.5
CN2401300000000,2022-06-01,24,013,MD,Carroll County,95125,91996,3129,3.3
CN2401500000000,2022-06-01,24,015,MD,Cecil County,54027,51886,2141,4
CN2401700000000,2022-06-01,24,017,MD,Charles County,86803,83485,3318,3.8
CN2401900000000,2022-06-01,24,019,MD,Dorchester County,16093,15459,634,3.9
CN2402100000000,2022-06-01,24,021,MD,Frederick County,136428,131514,4914,3.6
CN2402300000000,2022-06-01,24,023,MD,Garrett County,15139,14541,598,4
CN2402500000000,2022-06-01,24,025,MD,Harford County,140782,135853,4929,3.5
CN2402700000000,2022-06-01,24,027,MD,Howard County,189183,183117,6066,3.2
CN2402900000000,2022-06-01,24,029,MD,Kent County,9799,9407,392,4
CN2403100000000,2022-06-01,24,031,MD,Montgomery County,551783,532459,19324,3.5
CN2403300000000,2022-06-01,24,033,MD,Prince George's County,497763,478470,19293,3.9
CN2403500000000,2022-06-01,24,035,MD,Queen Anne's County,28007,27081,926,3.3
CN2403700000000,2022-06-01,24,037,MD,St. Mary's County,58524,56363,2161,3.7
CN2403900000000,2022-06-01,24,039,MD,Somerset County,9293,8809,484,5.2
CN2404100000000,2022-06-01,24,041,MD,Talbot County,17820,17133,687,3.9
CN2404300000000,2022-06-01,24,043,MD,Washington County,72159,69303,2856,4
CN2404500000000,2022-06-01,24,045,MD,Wicomico County,53684,51482,2202,4.1
CN2404700000000,2022-06-01,24,047,MD,Worcester County,26125,25026,1099,4.2
CN2451000000000,2022-06-01,24,510,MD,Baltimore city,275607,262784,12823,4.7
CN2500100000000,2022-06-01,25,001,MA,Barnstable County,118912,114412,4500,3.8
CN2500300000000,2022-06-01,25,003,MA,Berkshire County,63599,60940,2659,4.2
CN2500500000000,2022-06-01,25,005,MA,Bristol County,300895,287271,13624,4.5
CN2500700000000,2022-06-01,25,007,MA,Dukes County,11008,10613,395,3.6
CN2500900000000,2022-06-01,25,009,MA,Essex County,423938,406680,17258,4.1
CN2501100000000,2022-06-01,25,011,MA,Franklin County,40915,39520,1395,3.4
CN2501300000000,2022-06-01,25,013,MA,Hampden County,224844,213493,11351,5
CN2501500000000,2022-06-01,25,015,MA,Hampshire County,90019,86664,3355,3.7
CN2501700000000,2022-06-01,25,017,MA,Middlesex County,915216,884797,30419,3.3
CN2501900000000,2022-06-01,25,019,MA,Nantucket County/town,9172,8873,299,3.3
CN2502100000000,2022-06-01,25,021,MA,Norfolk County,394495,380420,14075,3.6
CN2502300000000,2022-06-01,25,023,MA,Plymouth County,285301,273907,11394,4
CN2502500000000,2022-06-01,25,025,MA,Suffolk County,456245,437755,18490,4.1
CN2502700000000,2022-06-01,25,027,MA,Worcester County,445500,427361,18139,4.1
CN2600100000000,2022-06-01,26,001,MI,Alcona County,4067,3790,277,6.8
CN2600300000000,2022-06-01,26,003,MI,Alger County,3498,3275,223,6.4
CN2600500000000,2022-06-01,26,005,MI,Allegan County,63148,60613,2535,4
CN2600700000000,2022-06-01,26,007,MI,Alpena County,13445,12741,704,5.2
CN2600900000000,2022-06-01,26,009,MI,Antrim County,10900,10308,592,5.4
CN2601100000000,2022-06-01,26,011,MI,Arenac County,5952,5542,410,6.9
CN2601300000000,2022-06-01,26,013,MI,Baraga County,3140,2915,225,7.2
CN2601500000000,2022-06-01,26,015,MI,Barry County,32268,30904,1364,4.2
CN2601700000000,2022-06-01,26,017,MI,Bay County,49534,46822,2712,5.5
CN2601900000000,2022-06-01,26,019,MI,Benzie County,9161,8705,456,5
CN2602100000000,2022-06-01,26,021,MI,Berrien County,73241,69623,3618,4.9
CN2602300000000,2022-06-01,26,023,MI,Branch County,19968,19063,905,4.5
CN2602500000000,2022-06-01,26,025,MI,Calhoun County,60631,57429,3202,5.3
CN2602700000000,2022-06-01,26,027,MI,Cass County,23801,22604,1197,5
CN2602900000000,2022-06-01,26,029,MI,Charlevoix County,13849,13251,598,4.3
CN2603100000000,2022-06-01,26,031,MI,Cheboygan County,11108,10536,572,5.1
CN2603300000000,2022-06-01,26,033,MI,Chippewa County,16287,15281,1006,6.2
CN2603500000000,2022-06-01,26,035,MI,Clare County,11394,10597,797,7
CN2603700000000,2022-06-01,26,037,MI,Clinton County,40148,38478,1670,4.2
CN2603900000000,2022-06-01,26,039,MI,Crawford County,5662,5293,369,6.5
CN2604100000000,2022-06-01,26,041,MI,Delta County,16912,15965,947,5.6
CN2604300000000,2022-06-01,26,043,MI,Dickinson County,12429,11855,574,4.6
CN2604500000000,2022-06-01,26,045,MI,Eaton County,55685,53187,2498,4.5
CN2604700000000,2022-06-01,26,047,MI,Emmet County,17992,17126,866,4.8
CN2604900000000,2022-06-01,26,049,MI,Genesee County,180318,169783,10535,5.8
CN2605100000000,2022-06-01,26,051,MI,Gladwin County,10174,9574,600,5.9
CN2605300000000,2022-06-01,26,053,MI,Gogebic County,5601,5289,312,5.6
CN2605500000000,2022-06-01,26,055,MI,Grand Traverse County,51969,49970,1999,3.8
CN2605700000000,2022-06-01,26,057,MI,Gratiot County,17412,16552,860,4.9
CN2605900000000,2022-06-01,26,059,MI,Hillsdale County,20582,19549,1033,5
CN2606100000000,2022-06-01,26,061,MI,Houghton County,15793,14934,859,5.4
CN2606300000000,2022-06-01,26,063,MI,Huron County,15513,14751,762,4.9
CN2606500000000,2022-06-01,26,065,MI,Ingham County,145940,138881,7059,4.8
CN2606700000000,2022-06-01,26,067,MI,Ionia County,30502,29222,1280,4.2
CN2606900000000,2022-06-01,26,069,MI,Iosco County,10604,9932,672,6.3
CN2607100000000,2022-06-01,26,071,MI,Iron County,4858,4576,282,5.8
CN2607300000000,2022-06-01,26,073,MI,Isabella County,31475,29684,1791,5.7
CN2607500000000,2022-06-01,26,075,MI,Jackson County,75516,71895,3621,4.8
CN2607700000000,2022-06-01,26,077,MI,Kalamazoo County,133270,127361,5909,4.4
CN2607900000000,2022-06-01,26,079,MI,Kalkaska County,8213,7765,448,5.5
CN2608100000000,2022-06-01,26,081,MI,Kent County,364404,349997,14407,4
CN2608300000000,2022-06-01,26,083,MI,Keweenaw County,881,826,55,6.2
CN2608500000000,2022-06-01,26,085,MI,Lake County,3944,3670,274,6.9
CN2608700000000,2022-06-01,26,087,MI,Lapeer County,40117,38523,1594,4
CN2608900000000,2022-06-01,26,089,MI,Leelanau County,10835,10383,452,4.2
CN2609100000000,2022-06-01,26,091,MI,Lenawee County,45185,42845,2340,5.2
CN2609300000000,2022-06-01,26,093,MI,Livingston County,103036,99977,3059,3
CN2609500000000,2022-06-01,26,095,MI,Luce County,2198,2066,132,6
CN2609700000000,2022-06-01,26,097,MI,Mackinac County,5901,5674,227,3.8
CN2609900000000,2022-06-01,26,099,MI,Macomb County,440062,423903,16159,3.7
CN2610100000000,2022-06-01,26,101,MI,Manistee County,10251,9680,571,5.6
CN2610300000000,2022-06-01,26,103,MI,Marquette County,31865,30194,1671,5.2
CN2610500000000,2022-06-01,26,105,MI,Mason County,13841,13149,692,5
CN2610700000000,2022-06-01,26,107,MI,Mecosta County,17969,16885,1084,6
CN2610900000000,2022-06-01,26,109,MI,Menominee County,10954,10432,522,4.8
CN2611100000000,2022-06-01,26,111,MI,Midland County,40712,38764,1948,4.8
CN2611300000000,2022-06-01,26,113,MI,Missaukee County,7007,6653,354,5.1
CN2611500000000,2022-06-01,26,115,MI,Monroe County,75916,71741,4175,5.5
CN2611700000000,2022-06-01,26,117,MI,Montcalm County,28121,26760,1361,4.8
CN2611900000000,2022-06-01,26,119,MI,Montmorency County,3113,2871,242,7.8
CN2612100000000,2022-06-01,26,121,MI,Muskegon County,78425,74236,4189,5.3
CN2612300000000,2022-06-01,26,123,MI,Newaygo County,23761,22583,1178,5
CN2612500000000,2022-06-01,26,125,MI,Oakland County,666248,645315,20933,3.1
CN2612700000000,2022-06-01,26,127,MI,Oceana County,12279,11528,751,6.1
CN2612900000000,2022-06-01,26,129,MI,Ogemaw County,8578,8025,553,6.4
CN2613100000000,2022-06-01,26,131,MI,Ontonagon County,2074,1909,165,8
CN2613300000000,2022-06-01,26,133,MI,Osceola County,11493,10933,560,4.9
CN2613500000000,2022-06-01,26,135,MI,Oscoda County,2972,2753,219,7.4
CN2613700000000,2022-06-01,26,137,MI,Otsego County,11912,11225,687,5.8
CN2613900000000,2022-06-01,26,139,MI,Ottawa County,163897,157726,6171,3.8
CN2614100000000,2022-06-01,26,141,MI,Presque Isle County,5111,4782,329,6.4
CN2614300000000,2022-06-01,26,143,MI,Roscommon County,8370,7730,640,7.6
CN2614500000000,2022-06-01,26,145,MI,Saginaw County,83291,78340,4951,5.9
CN2614700000000,2022-06-01,26,147,MI,St. Clair County,74311,71529,2782,3.7
CN2614900000000,2022-06-01,26,149,MI,St. Joseph County,28826,27444,1382,4.8
CN2615100000000,2022-06-01,26,151,MI,Sanilac County,19146,18102,1044,5.5
CN2615300000000,2022-06-01,26,153,MI,Schoolcraft County,3208,2989,219,6.8
CN2615500000000,2022-06-01,26,155,MI,Shiawassee County,32595,30994,1601,4.9
CN2615700000000,2022-06-01,26,157,MI,Tuscola County,23306,21951,1355,5.8
CN2615900000000,2022-06-01,26,159,MI,Van Buren County,34599,32785,1814,5.2
CN2616100000000,2022-06-01,26,161,MI,Washtenaw County,194423,186054,8369,4.3
CN2616300000000,2022-06-01,26,163,MI,Wayne County,785235,748415,36820,4.7
CN2616500000000,2022-06-01,26,165,MI,Wexford County,15211,14449,762,5
CN2700100000000,2022-06-01,27,001,MN,Aitkin County,7585,7325,260,3.4
CN2700300000000,2022-06-01,27,003,MN,Anoka County,199566,194107,5459,2.7
CN2700500000000,2022-06-01,27,005,MN,Becker County,19816,19289,527,2.7
CN2700700000000,2022-06-01,27,007,MN,Beltrami County,25125,24344,781,3.1
CN2700900000000,2022-06-01,27,009,MN,Benton County,21284,20637,647,3
CN2701100000000,2022-06-01,27,011,MN,Big Stone County,2413,2344,69,2.9
CN2701300000000,2022-06-01,27,013,MN,Blue Earth County,39434,38424,1010,2.6
CN2701500000000,2022-06-01,27,015,MN,Brown County,13817,13446,371,2.7
CN2701700000000,2022-06-01,27,017,MN,Carlton County,17466,16892,574,3.3
CN2701900000000,2022-06-01,27,019,MN,Carver County,59526,58142,1384,2.3
CN2702100000000,2022-06-01,27,021,MN,Cass County,15451,14951,500,3.2
CN2702300000000,2022-06-01,27,023,MN,Chippewa County,6571,6408,163,2.5
CN2702500000000,2022-06-01,27,025,MN,Chisago County,29911,29089,822,2.7
CN2702700000000,2022-06-01,27,027,MN,Clay County,37427,36554,873,2.3
CN2702900000000,2022-06-01,27,029,MN,Clearwater County,4447,4225,222,5
CN2703100000000,2022-06-01,27,031,MN,Cook County,2988,2908,80,2.7
CN2703300000000,2022-06-01,27,033,MN,Cottonwood County,6739,6543,196,2.9
CN2703500000000,2022-06-01,27,035,MN,Crow Wing County,34534,33614,920,2.7
CN2703700000000,2022-06-01,27,037,MN,Dakota County,243531,237284,6247,2.6
CN2703900000000,2022-06-01,27,039,MN,Dodge County,11868,11569,299,2.5
CN2704100000000,2022-06-01,27,041,MN,Douglas County,21931,21450,481,2.2
CN2704300000000,2022-06-01,27,043,MN,Faribault County,7019,6808,211,3
CN2704500000000,2022-06-01,27,045,MN,Fillmore County,11327,11041,286,2.5
CN2704700000000,2022-06-01,27,047,MN,Freeborn County,15915,15477,438,2.8
CN2704900000000,2022-06-01,27,049,MN,Goodhue County,26821,26147,674,2.5
CN2705100000000,2022-06-01,27,051,MN,Grant County,3285,3208,77,2.3
CN2705300000000,2022-06-01,27,053,MN,Hennepin County,708772,689317,19455,2.7
CN2705500000000,2022-06-01,27,055,MN,Houston County,10202,9984,218,2.1
CN2705700000000,2022-06-01,27,057,MN,Hubbard County,10556,10185,371,3.5
CN2705900000000,2022-06-01,27,059,MN,Isanti County,21648,21054,594,2.7
CN2706100000000,2022-06-01,27,061,MN,Itasca County,22083,21201,882,4
CN2706300000000,2022-06-01,27,063,MN,Jackson County,5415,5285,130,2.4
CN2706500000000,2022-06-01,27,065,MN,Kanabec County,9217,8941,276,3
CN2706700000000,2022-06-01,27,067,MN,Kandiyohi County,23124,22499,625,2.7
CN2706900000000,2022-06-01,27,069,MN,Kittson County,2231,2168,63,2.8
CN2707100000000,2022-06-01,27,071,MN,Koochiching County,5971,5720,251,4.2
CN2707300000000,2022-06-01,27,073,MN,Lac qui Parle County,3410,3318,92,2.7
CN2707500000000,2022-06-01,27,075,MN,Lake County,5457,5110,347,6.4
CN2707700000000,2022-06-01,27,077,MN,Lake of the Woods County,2407,2328,79,3.3
CN2707900000000,2022-06-01,27,079,MN,Le Sueur County,15762,15326,436,2.8
CN2708100000000,2022-06-01,27,081,MN,Lincoln County,3019,2942,77,2.6
CN2708300000000,2022-06-01,27,083,MN,Lyon County,14486,14114,372,2.6
CN2708500000000,2022-06-01,27,085,MN,McLeod County,19417,18887,530,2.7
CN2708700000000,2022-06-01,27,087,MN,Mahnomen County,2247,2155,92,4.1
CN2708900000000,2022-06-01,27,089,MN,Marshall County,5367,5214,153,2.9
CN2709100000000,2022-06-01,27,091,MN,Martin County,9679,9393,286,3
CN2709300000000,2022-06-01,27,093,MN,Meeker County,13459,13141,318,2.4
CN2709500000000,2022-06-01,27,095,MN,Mille Lacs County,12520,12123,397,3.2
CN2709700000000,2022-06-01,27,097,MN,Morrison County,17303,16740,563,3.3
CN2709900000000,2022-06-01,27,099,MN,Mower County,20883,20341,542,2.6
CN2710100000000,2022-06-01,27,101,MN,Murray County,4667,4553,114,2.4
CN2710300000000,2022-06-01,27,103,MN,Nicollet County,20164,19730,434,2.2
CN2710500000000,2022-06-01,27,105,MN,Nobles County,10971,10697,274,2.5
CN2710700000000,2022-06-01,27,107,MN,Norman County,3198,3090,108,3.4
CN2710900000000,2022-06-01,27,109,MN,Olmsted County,91622,89456,2166,2.4
CN2711100000000,2022-06-01,27,111,MN,Otter Tail County,32419,31601,818,2.5
CN2711300000000,2022-06-01,27,113,MN,Pennington County,8869,8637,232,2.6
CN2711500000000,2022-06-01,27,115,MN,Pine County,14533,14068,465,3.2
CN2711700000000,2022-06-01,27,117,MN,Pipestone County,4689,4590,99,2.1
CN2711900000000,2022-06-01,27,119,MN,Polk County,15765,15256,509,3.2
CN2712100000000,2022-06-01,27,121,MN,Pope County,6600,6464,136,2.1
CN2712300000000,2022-06-01,27,123,MN,Ramsey County,287294,278688,8606,3
CN2712500000000,2022-06-01,27,125,MN,Red Lake County,2164,2098,66,3
CN2712700000000,2022-06-01,27,127,MN,Redwood County,7723,7523,200,2.6
CN2712900000000,2022-06-01,27,129,MN,Renville County,7950,7671,279,3.5
CN2713100000000,2022-06-01,27,131,MN,Rice County,37446,36476,970,2.6
CN2713300000000,2022-06-01,27,133,MN,Rock County,6053,5951,102,1.7
CN2713500000000,2022-06-01,27,135,MN,Roseau County,8123,7917,206,2.5
CN2713700000000,2022-06-01,27,137,MN,St. Louis County,100222,96785,3437,3.4
CN2713900000000,2022-06-01,27,139,MN,Scott County,84751,82709,2042,2.4
CN2714100000000,2022-06-01,27,141,MN,Sherburne County,53156,51774,1382,2.6
CN2714300000000,2022-06-01,27,143,MN,Sibley County,7956,7737,219,2.8
CN2714500000000,2022-06-01,27,145,MN,Stearns County,88385,85982,2403,2.7
CN2714700000000,2022-06-01,27,147,MN,Steele County,19335,18784,551,2.8
CN2714900000000,2022-06-01,27,149,MN,Stevens County,5387,5275,112,2.1
CN2715100000000,2022-06-01,27,151,MN,Swift County,4839,4698,141,2.9
CN2715300000000,2022-06-01,27,153,MN,Todd County,13516,13140,376,2.8
CN2715500000000,2022-06-01,27,155,MN,Traverse County,1639,1605,34,2.1
CN2715700000000,2022-06-01,27,157,MN,Wabasha County,12093,11774,319,2.6
CN2715900000000,2022-06-01,27,159,MN,Wadena County,6012,5804,208,3.5
CN2716100000000,2022-06-01,27,161,MN,Waseca County,8585,8288,297,3.5
CN2716300000000,2022-06-01,27,163,MN,Washington County,145610,142003,3607,2.5
CN2716500000000,2022-06-01,27,165,MN,Watonwan County,6465,6294,171,2.6
CN2716700000000,2022-06-01,27,167,MN,Wilkin County,3384,3300,84,2.5
CN2716900000000,2022-06-01,27,169,MN,Winona County,27617,26924,693,2.5
CN2717100000000,2022-06-01,27,171,MN,Wright County,76604,74773,1831,2.4
CN2717300000000,2022-06-01,27,173,MN,Yellow Medicine County,5035,4891,144,2.9
CN2800100000000,2022-06-01,28,001,MS,Adams County,10702,10058,644,6
CN2800300000000,2022-06-01,28,003,MS,Alcorn County,15154,14514,640,4.2
CN2800500000000,2022-06-01,28,005,MS,Amite County,4451,4188,263,5.9
CN2800700000000,2022-06-01,28,007,MS,Attala County,6947,6599,348,5
CN2800900000000,2022-06-01,28,009,MS,Benton County,3108,2911,197,6.3
CN2801100000000,2022-06-01,28,011,MS,Bolivar County,11348,10672,676,6
CN2801300000000,2022-06-01,28,013,MS,Calhoun County,5626,5365,261,4.6
CN2801500000000,2022-06-01,28,015,MS,Carroll County,3409,3237,172,5
CN2801700000000,2022-06-01,28,017,MS,Chickasaw County,6830,6464,366,5.4
CN2801900000000,2022-06-01,28,019,MS,Choctaw County,3649,3491,158,4.3
CN2802100000000,2022-06-01,28,021,MS,Claiborne County,2971,2662,309,10.4
CN2802300000000,2022-06-01,28,023,MS,Clarke County,5663,5358,305,5.4
CN2802500000000,2022-06-01,28,025,MS,Clay County,8750,8343,407,4.7
CN2802700000000,2022-06-01,28,027,MS,Coahoma County,7659,7150,509,6.6
CN2802900000000,2022-06-01,28,029,MS,Copiah County,10902,10334,568,5.2
CN2803100000000,2022-06-01,28,031,MS,Covington County,8450,8095,355,4.2
CN2803300000000,2022-06-01,28,033,MS,DeSoto County,94342,90692,3650,3.9
CN2803500000000,2022-06-01,28,035,MS,Forrest County,33347,31850,1497,4.5
CN2803700000000,2022-06-01,28,037,MS,Franklin County,2718,2552,166,6.1
CN2803900000000,2022-06-01,28,039,MS,George County,8997,8439,558,6.2
CN2804100000000,2022-06-01,28,041,MS,Greene County,4318,4004,314,7.3
CN2804300000000,2022-06-01,28,043,MS,Grenada County,9070,8681,389,4.3
CN2804500000000,2022-06-01,28,045,MS,Hancock County,19142,18237,905,4.7
CN2804700000000,2022-06-01,28,047,MS,Harrison County,88213,84283,3930,4.5
CN2804900000000,2022-06-01,28,049,MS,Hinds County,102283,97384,4899,4.8
CN2805100000000,2022-06-01,28,051,MS,Holmes County,5103,4712,391,7.7
CN2805300000000,2022-06-01,28,053,MS,Humphreys County,2113,1937,176,8.3
CN2805500000000,2022-06-01,28,055,MS,Issaquena County,327,302,25,7.6
CN2805700000000,2022-06-01,28,057,MS,Itawamba County,10422,9993,429,4.1
CN2805900000000,2022-06-01,28,059,MS,Jackson County,59243,56237,3006,5.1
CN2806100000000,2022-06-01,28,061,MS,Jasper County,5987,5632,355,5.9
CN2806300000000,2022-06-01,28,063,MS,Jefferson County,1990,1660,330,16.6
CN2806500000000,2022-06-01,28,065,MS,Jefferson Davis County,3859,3634,225,5.8
CN2806700000000,2022-06-01,28,067,MS,Jones County,25346,24105,1241,4.9
CN2806900000000,2022-06-01,28,069,MS,Kemper County,3347,3101,246,7.3
CN2807100000000,2022-06-01,28,071,MS,Lafayette County,27443,26307,1136,4.1
CN2807300000000,2022-06-01,28,073,MS,Lamar County,31629,30470,1159,3.7
CN2807500000000,2022-06-01,28,075,MS,Lauderdale County,29008,27616,1392,4.8
CN2807700000000,2022-06-01,28,077,MS,Lawrence County,4866,4608,258,5.3
CN2807900000000,2022-06-01,28,079,MS,Leake County,7817,7423,394,5
CN2808100000000,2022-06-01,28,081,MS,Lee County,41152,39538,1614,3.9
CN2808300000000,2022-06-01,28,083,MS,Leflore County,9599,9006,593,6.2
CN2808500000000,2022-06-01,28,085,MS,Lincoln County,15051,14398,653,4.3
CN2808700000000,2022-06-01,28,087,MS,Lowndes County,24446,23241,1205,4.9
CN2808900000000,2022-06-01,28,089,MS,Madison County,53539,51475,2064,3.9
CN2809100000000,2022-06-01,28,091,MS,Marion County,10313,9865,448,4.3
CN2809300000000,2022-06-01,28,093,MS,Marshall County,14425,13683,742,5.1
CN2809500000000,2022-06-01,28,095,MS,Monroe County,15811,15098,713,4.5
CN2809700000000,2022-06-01,28,097,MS,Montgomery County,4000,3803,197,4.9
CN2809900000000,2022-06-01,28,099,MS,Neshoba County,10279,9745,534,5.2
CN2810100000000,2022-06-01,28,101,MS,Newton County,8174,7698,476,5.8
CN2810300000000,2022-06-01,28,103,MS,Noxubee County,3540,3294,246,6.9
CN2810500000000,2022-06-01,28,105,MS,Oktibbeha County,21671,20474,1197,5.5
CN2810700000000,2022-06-01,28,107,MS,Panola County,12606,11900,706,5.6
CN2810900000000,2022-06-01,28,109,MS,Pearl River County,23668,22579,1089,4.6
CN2811100000000,2022-06-01,28,111,MS,Perry County,4283,4037,246,5.7
CN2811300000000,2022-06-01,28,113,MS,Pike County,14406,13590,816,5.7
CN2811500000000,2022-06-01,28,115,MS,Pontotoc County,15026,14445,581,3.9
CN2811700000000,2022-06-01,28,117,MS,Prentiss County,11425,10992,433,3.8
CN2811900000000,2022-06-01,28,119,MS,Quitman County,2424,2258,166,6.8
CN2812100000000,2022-06-01,28,121,MS,Rankin County,76732,74053,2679,3.5
CN2812300000000,2022-06-01,28,123,MS,Scott County,12704,11941,763,6
CN2812500000000,2022-06-01,28,125,MS,Sharkey County,1382,1287,95,6.9
CN2812700000000,2022-06-01,28,127,MS,Simpson County,10691,10212,479,4.5
CN2812900000000,2022-06-01,28,129,MS,Smith County,6375,6078,297,4.7
CN2813100000000,2022-06-01,28,131,MS,Stone County,7030,6680,350,5
CN2813300000000,2022-06-01,28,133,MS,Sunflower County,7438,6949,489,6.6
CN2813500000000,2022-06-01,28,135,MS,Tallahatchie County,4812,4554,258,5.4
CN2813700000000,2022-06-01,28,137,MS,Tate County,12351,11735,616,5
CN2813900000000,2022-06-01,28,139,MS,Tippah County,9833,9429,404,4.1
CN2814100000000,2022-06-01,28,141,MS,Tishomingo County,8673,8300,373,4.3
CN2814300000000,2022-06-01,28,143,MS,Tunica County,4273,4038,235,5.5
CN2814500000000,2022-06-01,28,145,MS,Union County,14818,14299,519,3.5
CN2814700000000,2022-06-01,28,147,MS,Walthall County,4987,4703,284,5.7
CN2814900000000,2022-06-01,28,149,MS,Warren County,19330,18358,972,5
CN2815100000000,2022-06-01,28,151,MS,Washington County,15108,14108,1000,6.6
CN2815300000000,2022-06-01,28,153,MS,Wayne County,7156,6749,407,5.7
CN2815500000000,2022-06-01,28,155,MS,Webster County,3940,3759,181,4.6
CN2815700000000,2022-06-01,28,157,MS,Wilkinson County,2622,2441,181,6.9
CN2815900000000,2022-06-01,28,159,MS,Winston County,7212,6843,369,5.1
CN2816100000000,2022-06-01,28,161,MS,Yalobusha County,4799,4563,236,4.9
CN2816300000000,2022-06-01,28,163,MS,Yazoo County,9033,8554,479,5.3
CN2900100000000,2022-06-01,29,001,MO,Adair County,10005,9714,291,2.9
CN2900300000000,2022-06-01,29,003,MO,Andrew County,9516,9318,198,2.1
CN2900500000000,2022-06-01,29,005,MO,Atchison County,2833,2771,62,2.2
CN2900700000000,2022-06-01,29,007,MO,Audrain County,10162,9875,287,2.8
CN2900900000000,2022-06-01,29,009,MO,Barry County,14680,14316,364,2.5
CN2901100000000,2022-06-01,29,011,MO,Barton County,5376,5258,118,2.2
CN2901300000000,2022-06-01,29,013,MO,Bates County,7813,7622,191,2.4
CN2901500000000,2022-06-01,29,015,MO,Benton County,7489,7269,220,2.9
CN2901700000000,2022-06-01,29,017,MO,Bollinger County,5404,5278,126,2.3
CN2901900000000,2022-06-01,29,019,MO,Boone County,98668,96794,1874,1.9
CN2902100000000,2022-06-01,29,021,MO,Buchanan County,42159,41234,925,2.2
CN2902300000000,2022-06-01,29,023,MO,Butler County,18165,17656,509,2.8
CN2902500000000,2022-06-01,29,025,MO,Caldwell County,4362,4257,105,2.4
CN2902700000000,2022-06-01,29,027,MO,Callaway County,21620,21144,476,2.2
CN2902900000000,2022-06-01,29,029,MO,Camden County,20626,20140,486,2.4
CN2903100000000,2022-06-01,29,031,MO,Cape Girardeau County,40624,39732,892,2.2
CN2903300000000,2022-06-01,29,033,MO,Carroll County,4557,4454,103,2.3
CN2903500000000,2022-06-01,29,035,MO,Carter County,2608,2525,83,3.2
CN2903700000000,2022-06-01,29,037,MO,Cass County,54962,53790,1172,2.1
CN2903900000000,2022-06-01,29,039,MO,Cedar County,5943,5787,156,2.6
CN2904100000000,2022-06-01,29,041,MO,Chariton County,3876,3804,72,1.9
CN2904300000000,2022-06-01,29,043,MO,Christian County,47100,46228,872,1.9
CN2904500000000,2022-06-01,29,045,MO,Clark County,3135,3051,84,2.7
CN2904700000000,2022-06-01,29,047,MO,Clay County,138193,135187,3006,2.2
CN2904900000000,2022-06-01,29,049,MO,Clinton County,10728,10457,271,2.5
CN2905100000000,2022-06-01,29,051,MO,Cole County,39014,38308,706,1.8
CN2905300000000,2022-06-01,29,053,MO,Cooper County,7258,7102,156,2.1
CN2905500000000,2022-06-01,29,055,MO,Crawford County,11061,10783,278,2.5
CN2905700000000,2022-06-01,29,057,MO,Dade County,3666,3595,71,1.9
CN2905900000000,2022-06-01,29,059,MO,Dallas County,7309,7132,177,2.4
CN2906100000000,2022-06-01,29,061,MO,Daviess County,4267,4176,91,2.1
CN2906300000000,2022-06-01,29,063,MO,DeKalb County,4146,4041,105,2.5
CN2906500000000,2022-06-01,29,065,MO,Dent County,6173,5986,187,3
CN2906700000000,2022-06-01,29,067,MO,Douglas County,5234,5099,135,2.6
CN2906900000000,2022-06-01,29,069,MO,Dunklin County,11536,11144,392,3.4
CN2907100000000,2022-06-01,29,071,MO,Franklin County,53321,52217,1104,2.1
CN2907300000000,2022-06-01,29,073,MO,Gasconade County,7798,7639,159,2
CN2907500000000,2022-06-01,29,075,MO,Gentry County,3435,3353,82,2.4
CN2907700000000,2022-06-01,29,077,MO,Greene County,153940,151038,2902,1.9
CN2907900000000,2022-06-01,29,079,MO,Grundy County,4286,4189,97,2.3
CN2908100000000,2022-06-01,29,081,MO,Harrison County,3991,3916,75,1.9
CN2908300000000,2022-06-01,29,083,MO,Henry County,10318,10077,241,2.3
CN2908500000000,2022-06-01,29,085,MO,Hickory County,4309,4207,102,2.4
CN2908700000000,2022-06-01,29,087,MO,Holt County,2630,2581,49,1.9
CN2908900000000,2022-06-01,29,089,MO,Howard County,4767,4662,105,2.2
CN2909100000000,2022-06-01,29,091,MO,Howell County,16128,15671,457,2.8
CN2909300000000,2022-06-01,29,093,MO,Iron County,3537,3407,130,3.7
CN2909500000000,2022-06-01,29,095,MO,Jackson County,357999,349002,8997,2.5
CN2909700000000,2022-06-01,29,097,MO,Jasper County,56784,55539,1245,2.2
CN2909900000000,2022-06-01,29,099,MO,Jefferson County,118421,115940,2481,2.1
CN2910100000000,2022-06-01,29,101,MO,Johnson County,23090,22512,578,2.5
CN2910300000000,2022-06-01,29,103,MO,Knox County,1848,1805,43,2.3
CN2910500000000,2022-06-01,29,105,MO,Laclede County,16815,16448,367,2.2
CN2910700000000,2022-06-01,29,107,MO,Lafayette County,16960,16564,396,2.3
CN2910900000000,2022-06-01,29,109,MO,Lawrence County,17507,17118,389,2.2
CN2911100000000,2022-06-01,29,111,MO,Lewis County,4912,4820,92,1.9
CN2911300000000,2022-06-01,29,113,MO,Lincoln County,29525,28886,639,2.2
CN2911500000000,2022-06-01,29,115,MO,Linn County,5333,5207,126,2.4
CN2911700000000,2022-06-01,29,117,MO,Livingston County,7471,7347,124,1.7
CN2911900000000,2022-06-01,29,119,MO,McDonald County,11009,10735,274,2.5
CN2912100000000,2022-06-01,29,121,MO,Macon County,7513,7351,162,2.2
CN2912300000000,2022-06-01,29,123,MO,Madison County,5409,5263,146,2.7
CN2912500000000,2022-06-01,29,125,MO,Maries County,3943,3854,89,2.3
CN2912700000000,2022-06-01,29,127,MO,Marion County,14025,13718,307,2.2
CN2912900000000,2022-06-01,29,129,MO,Mercer County,1921,1887,34,1.8
CN2913100000000,2022-06-01,29,131,MO,Miller County,13414,13136,278,2.1
CN2913300000000,2022-06-01,29,133,MO,Mississippi County,5458,5291,167,3.1
CN2913500000000,2022-06-01,29,135,MO,Moniteau County,7238,7090,148,2
CN2913700000000,2022-06-01,29,137,MO,Monroe County,3940,3844,96,2.4
CN2913900000000,2022-06-01,29,139,MO,Montgomery County,5981,5854,127,2.1
CN2914100000000,2022-06-01,29,141,MO,Morgan County,8963,8750,213,2.4
CN2914300000000,2022-06-01,29,143,MO,New Madrid County,8442,8201,241,2.9
CN2914500000000,2022-06-01,29,145,MO,Newton County,27116,26477,639,2.4
CN2914700000000,2022-06-01,29,147,MO,Nodaway County,11060,10811,249,2.3
CN2914900000000,2022-06-01,29,149,MO,Oregon County,3883,3769,114,2.9
CN2915100000000,2022-06-01,29,151,MO,Osage County,7160,7033,127,1.8
CN2915300000000,2022-06-01,29,153,MO,Ozark County,3675,3573,102,2.8
CN2915500000000,2022-06-01,29,155,MO,Pemiscot County,5932,5720,212,3.6
CN2915700000000,2022-06-01,29,157,MO,Perry County,9685,9493,192,2
CN2915900000000,2022-06-01,29,159,MO,Pettis County,20208,19690,518,2.6
CN2916100000000,2022-06-01,29,161,MO,Phelps County,19998,19521,477,2.4
CN2916300000000,2022-06-01,29,163,MO,Pike County,7437,7271,166,2.2
CN2916500000000,2022-06-01,29,165,MO,Platte County,59846,58662,1184,2
CN2916700000000,2022-06-01,29,167,MO,Polk County,14858,14524,334,2.2
CN2916900000000,2022-06-01,29,169,MO,Pulaski County,14649,14245,404,2.8
CN2917100000000,2022-06-01,29,171,MO,Putnam County,2366,2325,41,1.7
CN2917300000000,2022-06-01,29,173,MO,Ralls County,5561,5452,109,2
CN2917500000000,2022-06-01,29,175,MO,Randolph County,10276,10038,238,2.3
CN2917700000000,2022-06-01,29,177,MO,Ray County,10931,10589,342,3.1
CN2917900000000,2022-06-01,29,179,MO,Reynolds County,3039,2961,78,2.6
CN2918100000000,2022-06-01,29,181,MO,Ripley County,5205,5059,146,2.8
CN2918300000000,2022-06-01,29,183,MO,St. Charles County,230515,226244,4271,1.9
CN2918500000000,2022-06-01,29,185,MO,St. Clair County,3996,3889,107,2.7
CN2918600000000,2022-06-01,29,186,MO,Ste. Genevieve County,9578,9369,209,2.2
CN2918700000000,2022-06-01,29,187,MO,St. Francois County,25787,24985,802,3.1
CN2918900000000,2022-06-01,29,189,MO,St. Louis County,528654,516945,11709,2.2
CN2919500000000,2022-06-01,29,195,MO,Saline County,10472,10231,241,2.3
CN2919700000000,2022-06-01,29,197,MO,Schuyler County,1896,1850,46,2.4
CN2919900000000,2022-06-01,29,199,MO,Scotland County,2422,2372,50,2.1
CN2920100000000,2022-06-01,29,201,MO,Scott County,20388,19901,487,2.4
CN2920300000000,2022-06-01,29,203,MO,Shannon County,3560,3450,110,3.1
CN2920500000000,2022-06-01,29,205,MO,Shelby County,3108,3048,60,1.9
CN2920700000000,2022-06-01,29,207,MO,Stoddard County,13462,13088,374,2.8
CN2920900000000,2022-06-01,29,209,MO,Stone County,14237,13865,372,2.6
CN2921100000000,2022-06-01,29,211,MO,Sullivan County,2629,2572,57,2.2
CN2921300000000,2022-06-01,29,213,MO,Taney County,27310,26594,716,2.6
CN2921500000000,2022-06-01,29,215,MO,Texas County,9446,9207,239,2.5
CN2921700000000,2022-06-01,29,217,MO,Vernon County,9406,9181,225,2.4
CN2921900000000,2022-06-01,29,219,MO,Warren County,18931,18531,400,2.1
CN2922100000000,2022-06-01,29,221,MO,Washington County,10249,9954,295,2.9
CN2922300000000,2022-06-01,29,223,MO,Wayne County,4941,4791,150,3
CN2922500000000,2022-06-01,29,225,MO,Webster County,17768,17402,366,2.1
CN2922700000000,2022-06-01,29,227,MO,Worth County,1269,1248,21,1.7
CN2922900000000,2022-06-01,29,229,MO,Wright County,7992,7788,204,2.6
CN2951000000000,2022-06-01,29,510,MO,St. Louis city,149250,145058,4192,2.8
CN3000100000000,2022-06-01,30,001,MT,Beaverhead County,5228,5094,134,2.6
CN3000300000000,2022-06-01,30,003,MT,Big Horn County,4749,4538,211,4.4
CN3000500000000,2022-06-01,30,005,MT,Blaine County,2100,2027,73,3.5
CN3000700000000,2022-06-01,30,007,MT,Broadwater County,2757,2662,95,3.4
CN3000900000000,2022-06-01,30,009,MT,Carbon County,5837,5668,169,2.9
CN3001100000000,2022-06-01,30,011,MT,Carter County,652,638,14,2.1
CN3001300000000,2022-06-01,30,013,MT,Cascade County,39532,38425,1107,2.8
CN3001500000000,2022-06-01,30,015,MT,Chouteau County,2438,2369,69,2.8
CN3001700000000,2022-06-01,30,017,MT,Custer County,6470,6303,167,2.6
CN3001900000000,2022-06-01,30,019,MT,Daniels County,853,837,16,1.9
CN3002100000000,2022-06-01,30,021,MT,Dawson County,4601,4473,128,2.8
CN3002300000000,2022-06-01,30,023,MT,Deer Lodge County,5430,5296,134,2.5
CN3002500000000,2022-06-01,30,025,MT,Fallon County,1670,1645,25,1.5
CN3002700000000,2022-06-01,30,027,MT,Fergus County,5935,5771,164,2.8
CN3002900000000,2022-06-01,30,029,MT,Flathead County,53368,51788,1580,3
CN3003100000000,2022-06-01,30,031,MT,Gallatin County,78930,77380,1550,2
CN3003300000000,2022-06-01,30,033,MT,Garfield County,710,688,22,3.1
CN3003500000000,2022-06-01,30,035,MT,Glacier County,6053,5700,353,5.8
CN3003700000000,2022-06-01,30,037,MT,Golden Valley County,371,359,12,3.2
CN3003900000000,2022-06-01,30,039,MT,Granite County,1761,1703,58,3.3
CN3004100000000,2022-06-01,30,041,MT,Hill County,7608,7375,233,3.1
CN3004300000000,2022-06-01,30,043,MT,Jefferson County,6114,5956,158,2.6
CN3004500000000,2022-06-01,30,045,MT,Judith Basin County,926,903,23,2.5
CN3004700000000,2022-06-01,30,047,MT,Lake County,14699,14273,426,2.9
CN3004900000000,2022-06-01,30,049,MT,Lewis and Clark County,38973,37963,1010,2.6
CN3005100000000,2022-06-01,30,051,MT,Liberty County,943,918,25,2.7
CN3005300000000,2022-06-01,30,053,MT,Lincoln County,8701,8286,415,4.8
CN3005500000000,2022-06-01,30,055,MT,McCone County,931,911,20,2.1
CN3005700000000,2022-06-01,30,057,MT,Madison County,4924,4810,114,2.3
CN3005900000000,2022-06-01,30,059,MT,Meagher County,961,938,23,2.4
CN3006100000000,2022-06-01,30,061,MT,Mineral County,1915,1820,95,5
CN3006300000000,2022-06-01,30,063,MT,Missoula County,68056,66206,1850,2.7
CN3006500000000,2022-06-01,30,065,MT,Musselshell County,2375,2311,64,2.7
CN3006700000000,2022-06-01,30,067,MT,Park County,10845,10575,270,2.5
CN3006900000000,2022-06-01,30,069,MT,Petroleum County,261,253,8,3.1
CN3007100000000,2022-06-01,30,071,MT,Phillips County,1801,1735,66,3.7
CN3007300000000,2022-06-01,30,073,MT,Pondera County,2597,2520,77,3
CN3007500000000,2022-06-01,30,075,MT,Powder River County,995,973,22,2.2
CN3007700000000,2022-06-01,30,077,MT,Powell County,3018,2932,86,2.8
CN3007900000000,2022-06-01,30,079,MT,Prairie County,479,467,12,2.5
CN3008100000000,2022-06-01,30,081,MT,Ravalli County,22077,21456,621,2.8
CN3008300000000,2022-06-01,30,083,MT,Richland County,5703,5522,181,3.2
CN3008500000000,2022-06-01,30,085,MT,Roosevelt County,4363,4182,181,4.1
CN3008700000000,2022-06-01,30,087,MT,Rosebud County,3638,3477,161,4.4
CN3008900000000,2022-06-01,30,089,MT,Sanders County,5425,5216,209,3.9
CN3009100000000,2022-06-01,30,091,MT,Sheridan County,1768,1735,33,1.9
CN3009300000000,2022-06-01,30,093,MT,Silver Bow County,18265,17705,560,3.1
CN3009500000000,2022-06-01,30,095,MT,Stillwater County,5426,5298,128,2.4
CN3009700000000,2022-06-01,30,097,MT,Sweet Grass County,1913,1872,41,2.1
CN3009900000000,2022-06-01,30,099,MT,Teton County,2787,2710,77,2.8
CN3010100000000,2022-06-01,30,101,MT,Toole County,2066,2018,48,2.3
CN3010300000000,2022-06-01,30,103,MT,Treasure County,349,340,9,2.6
CN3010500000000,2022-06-01,30,105,MT,Valley County,4007,3909,98,2.4
CN3010700000000,2022-06-01,30,107,MT,Wheatland County,710,685,25,3.5
CN3010900000000,2022-06-01,30,109,MT,Wibaux County,458,447,11,2.4
CN3011100000000,2022-06-01,30,111,MT,Yellowstone County,88287,85830,2457,2.8
CN3100100000000,2022-06-01,31,001,NE,Adams County,17662,17197,465,2.6
CN3100300000000,2022-06-01,31,003,NE,Antelope County,3789,3713,76,2
CN3100500000000,2022-06-01,31,005,NE,Arthur County,238,232,6,2.5
CN3100700000000,2022-06-01,31,007,NE,Banner County,393,381,12,3.1
CN3100900000000,2022-06-01,31,009,NE,Blaine County,261,251,10,3.8
CN3101100000000,2022-06-01,31,011,NE,Boone County,3099,3031,68,2.2
CN3101300000000,2022-06-01,31,013,NE,Box Butte County,5431,5271,160,2.9
CN3101500000000,2022-06-01,31,015,NE,Boyd County,1062,1035,27,2.5
CN3101700000000,2022-06-01,31,017,NE,Brown County,1472,1425,47,3.2
CN3101900000000,2022-06-01,31,019,NE,Buffalo County,28774,28085,689,2.4
CN3102100000000,2022-06-01,31,021,NE,Burt County,3706,3616,90,2.4
CN3102300000000,2022-06-01,31,023,NE,Butler County,4844,4748,96,2
CN3102500000000,2022-06-01,31,025,NE,Cass County,13794,13409,385,2.8
CN3102700000000,2022-06-01,31,027,NE,Cedar County,4831,4720,111,2.3
CN3102900000000,2022-06-01,31,029,NE,Chase County,2382,2330,52,2.2
CN3103100000000,2022-06-01,31,031,NE,Cherry County,3497,3424,73,2.1
CN3103300000000,2022-06-01,31,033,NE,Cheyenne County,4352,4226,126,2.9
CN3103500000000,2022-06-01,31,035,NE,Clay County,3219,3142,77,2.4
CN3103700000000,2022-06-01,31,037,NE,Colfax County,5838,5705,133,2.3
CN3103900000000,2022-06-01,31,039,NE,Cuming County,5002,4891,111,2.2
CN3104100000000,2022-06-01,31,041,NE,Custer County,6646,6510,136,2
CN3104300000000,2022-06-01,31,043,NE,Dakota County,11101,10741,360,3.2
CN3104500000000,2022-06-01,31,045,NE,Dawes County,5054,4913,141,2.8
CN3104700000000,2022-06-01,31,047,NE,Dawson County,13968,13612,356,2.5
CN3104900000000,2022-06-01,31,049,NE,Deuel County,1106,1079,27,2.4
CN3105100000000,2022-06-01,31,051,NE,Dixon County,3045,2974,71,2.3
CN3105300000000,2022-06-01,31,053,NE,Dodge County,21149,20636,513,2.4
CN3105500000000,2022-06-01,31,055,NE,Douglas County,308294,299418,8876,2.9
CN3105700000000,2022-06-01,31,057,NE,Dundy County,1201,1180,21,1.7
CN3105900000000,2022-06-01,31,059,NE,Fillmore County,3431,3357,74,2.2
CN3106100000000,2022-06-01,31,061,NE,Franklin County,1592,1551,41,2.6
CN3106300000000,2022-06-01,31,063,NE,Frontier County,1521,1485,36,2.4
CN3106500000000,2022-06-01,31,065,NE,Furnas County,2625,2566,59,2.2
CN3106700000000,2022-06-01,31,067,NE,Gage County,11104,10791,313,2.8
CN3106900000000,2022-06-01,31,069,NE,Garden County,1154,1129,25,2.2
CN3107100000000,2022-06-01,31,071,NE,Garfield County,1193,1157,36,3
CN3107300000000,2022-06-01,31,073,NE,Gosper County,1291,1264,27,2.1
CN3107500000000,2022-06-01,31,075,NE,Grant County,419,412,7,1.7
CN3107700000000,2022-06-01,31,077,NE,Greeley County,1301,1273,28,2.2
CN3107900000000,2022-06-01,31,079,NE,Hall County,33289,32437,852,2.6
CN3108100000000,2022-06-01,31,081,NE,Hamilton County,4989,4865,124,2.5
CN3108300000000,2022-06-01,31,083,NE,Harlan County,1928,1888,40,2.1
CN3108500000000,2022-06-01,31,085,NE,Hayes County,599,589,10,1.7
CN3108700000000,2022-06-01,31,087,NE,Hitchcock County,1351,1315,36,2.7
CN3108900000000,2022-06-01,31,089,NE,Holt County,5857,5735,122,2.1
CN3109100000000,2022-06-01,31,091,NE,Hooker County,473,461,12,2.5
CN3109300000000,2022-06-01,31,093,NE,Howard County,3528,3445,83,2.4
CN3109500000000,2022-06-01,31,095,NE,Jefferson County,4347,4251,96,2.2
CN3109700000000,2022-06-01,31,097,NE,Johnson County,2070,2011,59,2.9
CN3109900000000,2022-06-01,31,099,NE,Kearney County,3819,3733,86,2.3
CN3110100000000,2022-06-01,31,101,NE,Keith County,4879,4777,102,2.1
CN3110300000000,2022-06-01,31,103,NE,Keya Paha County,538,525,13,2.4
CN3110500000000,2022-06-01,31,105,NE,Kimball County,2020,1977,43,2.1
CN3110700000000,2022-06-01,31,107,NE,Knox County,4839,4713,126,2.6
CN3110900000000,2022-06-01,31,109,NE,Lancaster County,180412,175797,4615,2.6
CN3111100000000,2022-06-01,31,111,NE,Lincoln County,18891,18393,498,2.6
CN3111300000000,2022-06-01,31,113,NE,Logan County,491,479,12,2.4
CN3111500000000,2022-06-01,31,115,NE,Loup County,419,407,12,2.9
CN3111700000000,2022-06-01,31,117,NE,McPherson County,434,425,9,2.1
CN3111900000000,2022-06-01,31,119,NE,Madison County,20202,19704,498,2.5
CN3112100000000,2022-06-01,31,121,NE,Merrick County,4241,4146,95,2.2
CN3112300000000,2022-06-01,31,123,NE,Morrill County,2730,2668,62,2.3
CN3112500000000,2022-06-01,31,125,NE,Nance County,2026,1971,55,2.7
CN3112700000000,2022-06-01,31,127,NE,Nemaha County,3600,3498,102,2.8
CN3112900000000,2022-06-01,31,129,NE,Nuckolls County,2563,2498,65,2.5
CN3113100000000,2022-06-01,31,131,NE,Otoe County,8757,8523,234,2.7
CN3113300000000,2022-06-01,31,133,NE,Pawnee County,1525,1491,34,2.2
CN3113500000000,2022-06-01,31,135,NE,Perkins County,1906,1870,36,1.9
CN3113700000000,2022-06-01,31,137,NE,Phelps County,5150,5027,123,2.4
CN3113900000000,2022-06-01,31,139,NE,Pierce County,4330,4234,96,2.2
CN3114100000000,2022-06-01,31,141,NE,Platte County,18811,18366,445,2.4
CN3114300000000,2022-06-01,31,143,NE,Polk County,3014,2950,64,2.1
CN3114500000000,2022-06-01,31,145,NE,Red Willow County,6069,5919,150,2.5
CN3114700000000,2022-06-01,31,147,NE,Richardson County,4300,4196,104,2.4
CN3114900000000,2022-06-01,31,149,NE,Rock County,926,908,18,1.9
CN3115100000000,2022-06-01,31,151,NE,Saline County,7266,7056,210,2.9
CN3115300000000,2022-06-01,31,153,NE,Sarpy County,100495,97922,2573,2.6
CN3115500000000,2022-06-01,31,155,NE,Saunders County,11669,11395,274,2.3
CN3115700000000,2022-06-01,31,157,NE,Scotts Bluff County,18200,17643,557,3.1
CN3115900000000,2022-06-01,31,159,NE,Seward County,8960,8689,271,3
CN3116100000000,2022-06-01,31,161,NE,Sheridan County,2871,2807,64,2.2
CN3116300000000,2022-06-01,31,163,NE,Sherman County,1711,1662,49,2.9
CN3116500000000,2022-06-01,31,165,NE,Sioux County,777,761,16,2.1
CN3116700000000,2022-06-01,31,167,NE,Stanton County,3640,3557,83,2.3
CN3116900000000,2022-06-01,31,169,NE,Thayer County,2787,2731,56,2
CN3117100000000,2022-06-01,31,171,NE,Thomas County,469,459,10,2.1
CN3117300000000,2022-06-01,31,173,NE,Thurston County,3393,3258,135,4
CN3117500000000,2022-06-01,31,175,NE,Valley County,2225,2164,61,2.7
CN3117700000000,2022-06-01,31,177,NE,Washington County,11579,11286,293,2.5
CN3117900000000,2022-06-01,31,179,NE,Wayne County,5532,5360,172,3.1
CN3118100000000,2022-06-01,31,181,NE,Webster County,1730,1683,47,2.7
CN3118300000000,2022-06-01,31,183,NE,Wheeler County,554,545,9,1.6
CN3118500000000,2022-06-01,31,185,NE,York County,7572,7367,205,2.7
CN3200100000000,2022-06-01,32,001,NV,Churchill County,11027,10610,417,3.8
CN3200300000000,2022-06-01,32,003,NV,Clark County,1144229,1072900,71329,6.2
CN3200500000000,2022-06-01,32,005,NV,Douglas County,22520,21563,957,4.2
CN3200700000000,2022-06-01,32,007,NV,Elko County,25767,24859,908,3.5
CN3200900000000,2022-06-01,32,009,NV,Esmeralda County,391,378,13,3.3
CN3201100000000,2022-06-01,32,011,NV,Eureka County,968,937,31,3.2
CN3201300000000,2022-06-01,32,013,NV,Humboldt County,7690,7412,278,3.6
CN3201500000000,2022-06-01,32,015,NV,Lander County,3033,2923,110,3.6
CN3201700000000,2022-06-01,32,017,NV,Lincoln County,2051,1961,90,4.4
CN3201900000000,2022-06-01,32,019,NV,Lyon County,23781,22601,1180,5
CN3202100000000,2022-06-01,32,021,NV,Mineral County,1956,1872,84,4.3
CN3202300000000,2022-06-01,32,023,NV,Nye County,17683,16637,1046,5.9
CN3202700000000,2022-06-01,32,027,NV,Pershing County,2428,2324,104,4.3
CN3202900000000,2022-06-01,32,029,NV,Storey County,2102,2010,92,4.4
CN3203100000000,2022-06-01,32,031,NV,Washoe County,256988,247669,9319,3.6
CN3203300000000,2022-06-01,32,033,NV,White Pine County,4492,4346,146,3.3
CN3251000000000,2022-06-01,32,510,NV,Carson City,25416,24349,1067,4.2
CN3300100000000,2022-06-01,33,001,NH,Belknap County,31906,31162,744,2.3
CN3300300000000,2022-06-01,33,003,NH,Carroll County,23977,23402,575,2.4
CN3300500000000,2022-06-01,33,005,NH,Cheshire County,39298,38249,1049,2.7
CN3300700000000,2022-06-01,33,007,NH,Coos County,14722,14319,403,2.7
CN3300900000000,2022-06-01,33,009,NH,Grafton County,48944,47771,1173,2.4
CN3301100000000,2022-06-01,33,011,NH,Hillsborough County,241744,235860,5884,2.4
CN3301300000000,2022-06-01,33,013,NH,Merrimack County,82993,81117,1876,2.3
CN3301500000000,2022-06-01,33,015,NH,Rockingham County,190868,186403,4465,2.3
CN3301700000000,2022-06-01,33,017,NH,Strafford County,74255,72473,1782,2.4
CN3301900000000,2022-06-01,33,019,NH,Sullivan County,22932,22394,538,2.3
CN3400100000000,2022-06-01,34,001,NJ,Atlantic County,124613,118847,5766,4.6
CN3400300000000,2022-06-01,34,003,NJ,Bergen County,505075,488305,16770,3.3
CN3400500000000,2022-06-01,34,005,NJ,Burlington County,247973,239915,8058,3.2
CN3400700000000,2022-06-01,34,007,NJ,Camden County,270850,260411,10439,3.9
CN3400900000000,2022-06-01,34,009,NJ,Cape May County,54488,52288,2200,4
CN3401100000000,2022-06-01,34,011,NJ,Cumberland County,68893,65747,3146,4.6
CN3401300000000,2022-06-01,34,013,NJ,Essex County,389887,372896,16991,4.4
CN3401500000000,2022-06-01,34,015,NJ,Gloucester County,161446,155729,5717,3.5
CN3401700000000,2022-06-01,34,017,NJ,Hudson County,377906,364613,13293,3.5
CN3401900000000,2022-06-01,34,019,NJ,Hunterdon County,68344,66331,2013,2.9
CN3402100000000,2022-06-01,34,021,NJ,Mercer County,216782,209807,6975,3.2
CN3402300000000,2022-06-01,34,023,NJ,Middlesex County,467705,452278,15427,3.3
CN3402500000000,2022-06-01,34,025,NJ,Monmouth County,350650,339464,11186,3.2
CN3402700000000,2022-06-01,34,027,NJ,Morris County,270334,262085,8249,3.1
CN3402900000000,2022-06-01,34,029,NJ,Ocean County,300393,289889,10504,3.5
CN3403100000000,2022-06-01,34,031,NJ,Passaic County,252913,242016,10897,4.3
CN3403300000000,2022-06-01,34,033,NJ,Salem County,30180,28833,1347,4.5
CN3403500000000,2022-06-01,34,035,NJ,Somerset County,180378,174759,5619,3.1
CN3403700000000,2022-06-01,34,037,NJ,Sussex County,77736,75063,2673,3.4
CN3403900000000,2022-06-01,34,039,NJ,Union County,290843,280085,10758,3.7
CN3404100000000,2022-06-01,34,041,NJ,Warren County,58662,56617,2045,3.5
CN3500100000000,2022-06-01,35,001,NM,Bernalillo County,335484,321347,14137,4.2
CN3500300000000,2022-06-01,35,003,NM,Catron County,1186,1123,63,5.3
CN3500500000000,2022-06-01,35,005,NM,Chaves County,28093,26685,1408,5
CN3500600000000,2022-06-01,35,006,NM,Cibola County,8337,7838,499,6
CN3500700000000,2022-06-01,35,007,NM,Colfax County,5290,5051,239,4.5
CN3500900000000,2022-06-01,35,009,NM,Curry County,22725,21859,866,3.8
CN3501100000000,2022-06-01,35,011,NM,De Baca County,760,734,26,3.4
CN3501300000000,2022-06-01,35,013,NM,Dona Ana County,99356,94245,5111,5.1
CN3501500000000,2022-06-01,35,015,NM,Eddy County,31268,30083,1185,3.8
CN3501700000000,2022-06-01,35,017,NM,Grant County,11765,11243,522,4.4
CN3501900000000,2022-06-01,35,019,NM,Guadalupe County,1524,1427,97,6.4
CN3502100000000,2022-06-01,35,021,NM,Harding County,290,280,10,3.4
CN3502300000000,2022-06-01,35,023,NM,Hidalgo County,1961,1889,72,3.7
CN3502500000000,2022-06-01,35,025,NM,Lea County,29372,27830,1542,5.2
CN3502700000000,2022-06-01,35,027,NM,Lincoln County,9411,9016,395,4.2
CN3502800000000,2022-06-01,35,028,NM,Los Alamos County,10754,10472,282,2.6
CN3502900000000,2022-06-01,35,029,NM,Luna County,10252,9328,924,9
CN3503100000000,2022-06-01,35,031,NM,McKinley County,22840,21315,1525,6.7
CN3503300000000,2022-06-01,35,033,NM,Mora County,1994,1856,138,6.9
CN3503500000000,2022-06-01,35,035,NM,Otero County,25329,24098,1231,4.9
CN3503700000000,2022-06-01,35,037,NM,Quay County,3067,2921,146,4.8
CN3503900000000,2022-06-01,35,039,NM,Rio Arriba County,16868,16032,836,5
CN3504100000000,2022-06-01,35,041,NM,Roosevelt County,7760,7372,388,5
CN3504300000000,2022-06-01,35,043,NM,Sandoval County,67889,64865,3024,4.5
CN3504500000000,2022-06-01,35,045,NM,San Juan County,47883,45192,2691,5.6
CN3504700000000,2022-06-01,35,047,NM,San Miguel County,10275,9666,609,5.9
CN3504900000000,2022-06-01,35,049,NM,Santa Fe County,73441,70454,2987,4.1
CN3505100000000,2022-06-01,35,051,NM,Sierra County,4105,3877,228,5.6
CN3505300000000,2022-06-01,35,053,NM,Socorro County,6177,5866,311,5
CN3505500000000,2022-06-01,35,055,NM,Taos County,14891,14105,786,5.3
CN3505700000000,2022-06-01,35,057,NM,Torrance County,5405,5067,338,6.3
CN3505900000000,2022-06-01,35,059,NM,Union County,1541,1488,53,3.4
CN3506100000000,2022-06-01,35,061,NM,Valencia County,31086,29500,1586,5.1
CN3600100000000,2022-06-01,36,001,NY,Albany County,161185,156169,5016,3.1
CN3600300000000,2022-06-01,36,003,NY,Allegany County,18758,18022,736,3.9
CN3600500000000,2022-06-01,36,005,NY,Bronx County,599329,555357,43972,7.3
CN3600700000000,2022-06-01,36,007,NY,Broome County,83265,80123,3142,3.8
CN3600900000000,2022-06-01,36,009,NY,Cattaraugus County,33111,31864,1247,3.8
CN3601100000000,2022-06-01,36,011,NY,Cayuga County,36088,34919,1169,3.2
CN3601300000000,2022-06-01,36,013,NY,Chautauqua County,54058,52094,1964,3.6
CN3601500000000,2022-06-01,36,015,NY,Chemung County,35764,34491,1273,3.6
CN3601700000000,2022-06-01,36,017,NY,Chenango County,22277,21594,683,3.1
CN3601900000000,2022-06-01,36,019,NY,Clinton County,35575,34395,1180,3.3
CN3602100000000,2022-06-01,36,021,NY,Columbia County,31383,30535,848,2.7
CN3602300000000,2022-06-01,36,023,NY,Cortland County,21946,21133,813,3.7
CN3602500000000,2022-06-01,36,025,NY,Delaware County,19252,18564,688,3.6
CN3602700000000,2022-06-01,36,027,NY,Dutchess County,147791,143191,4600,3.1
CN3602900000000,2022-06-01,36,029,NY,Erie County,449769,434199,15570,3.5
CN3603100000000,2022-06-01,36,031,NY,Essex County,16913,16393,520,3.1
CN3603300000000,2022-06-01,36,033,NY,Franklin County,19208,18560,648,3.4
CN3603500000000,2022-06-01,36,035,NY,Fulton County,22882,22043,839,3.7
CN3603700000000,2022-06-01,36,037,NY,Genesee County,30281,29398,883,2.9
CN3603900000000,2022-06-01,36,039,NY,Greene County,20770,20083,687,3.3
CN3604100000000,2022-06-01,36,041,NY,Hamilton County,2350,2276,74,3.1
CN3604300000000,2022-06-01,36,043,NY,Herkimer County,27527,26557,970,3.5
CN3604500000000,2022-06-01,36,045,NY,Jefferson County,45899,44291,1608,3.5
CN3604700000000,2022-06-01,36,047,NY,Kings County,1203487,1135758,67729,5.6
CN3604900000000,2022-06-01,36,049,NY,Lewis County,11984,11590,394,3.3
CN3605100000000,2022-06-01,36,051,NY,Livingston County,30640,29666,974,3.2
CN3605300000000,2022-06-01,36,053,NY,Madison County,32989,31926,1063,3.2
CN3605500000000,2022-06-01,36,055,NY,Monroe County,369355,356689,12666,3.4
CN3605700000000,2022-06-01,36,057,NY,Montgomery County,22562,21721,841,3.7
CN3605900000000,2022-06-01,36,059,NY,Nassau County,743713,722300,21413,2.9
CN3606100000000,2022-06-01,36,061,NY,New York County,916970,875450,41520,4.5
CN3606300000000,2022-06-01,36,063,NY,Niagara County,99099,95617,3482,3.5
CN3606500000000,2022-06-01,36,065,NY,Oneida County,101082,97542,3540,3.5
CN3606700000000,2022-06-01,36,067,NY,Onondaga County,225233,217746,7487,3.3
CN3606900000000,2022-06-01,36,069,NY,Ontario County,56516,54829,1687,3
CN3607100000000,2022-06-01,36,071,NY,Orange County,193387,187204,6183,3.2
CN3607300000000,2022-06-01,36,073,NY,Orleans County,17353,16706,647,3.7
CN3607500000000,2022-06-01,36,075,NY,Oswego County,53103,50989,2114,4
CN3607700000000,2022-06-01,36,077,NY,Otsego County,27932,27039,893,3.2
CN3607900000000,2022-06-01,36,079,NY,Putnam County,52436,50893,1543,2.9
CN3608100000000,2022-06-01,36,081,NY,Queens County,1136643,1079307,57336,5
CN3608300000000,2022-06-01,36,083,NY,Rensselaer County,83064,80552,2512,3
CN3608500000000,2022-06-01,36,085,NY,Richmond County,226043,213983,12060,5.3
CN3608700000000,2022-06-01,36,087,NY,Rockland County,161903,157309,4594,2.8
CN3608900000000,2022-06-01,36,089,NY,St. Lawrence County,42875,41081,1794,4.2
CN3609100000000,2022-06-01,36,091,NY,Saratoga County,122985,119713,3272,2.7
CN3609300000000,2022-06-01,36,093,NY,Schenectady County,78728,76138,2590,3.3
CN3609500000000,2022-06-01,36,095,NY,Schoharie County,14902,14401,501,3.4
CN3609700000000,2022-06-01,36,097,NY,Schuyler County,8282,8014,268,3.2
CN3609900000000,2022-06-01,36,099,NY,Seneca County,15065,14604,461,3.1
CN3610100000000,2022-06-01,36,101,NY,Steuben County,42368,40954,1414,3.3
CN3610300000000,2022-06-01,36,103,NY,Suffolk County,815355,790786,24569,3
CN3610500000000,2022-06-01,36,105,NY,Sullivan County,38674,37499,1175,3
CN3610700000000,2022-06-01,36,107,NY,Tioga County,22478,21787,691,3.1
CN3610900000000,2022-06-01,36,109,NY,Tompkins County,47587,46141,1446,3
CN3611100000000,2022-06-01,36,111,NY,Ulster County,89489,86723,2766,3.1
CN3611300000000,2022-06-01,36,113,NY,Warren County,32478,31487,991,3.1
CN3611500000000,2022-06-01,36,115,NY,Washington County,28612,27753,859,3
CN3611700000000,2022-06-01,36,117,NY,Wayne County,43929,42558,1371,3.1
CN3611900000000,2022-06-01,36,119,NY,Westchester County,504571,488790,15781,3.1
CN3612100000000,2022-06-01,36,121,NY,Wyoming County,17819,17306,513,2.9
CN3612300000000,2022-06-01,36,123,NY,Yates County,11785,11463,322,2.7
CN3700100000000,2022-06-01,37,001,NC,Alamance County,83233,79799,3434,4.1
CN3700300000000,2022-06-01,37,003,NC,Alexander County,18179,17527,652,3.6
CN3700500000000,2022-06-01,37,005,NC,Alleghany County,4722,4536,186,3.9
CN3700700000000,2022-06-01,37,007,NC,Anson County,10246,9752,494,4.8
CN3700900000000,2022-06-01,37,009,NC,Ashe County,13000,12482,518,4
CN3701100000000,2022-06-01,37,011,NC,Avery County,8018,7729,289,3.6
CN3701300000000,2022-06-01,37,013,NC,Beaufort County,20010,19139,871,4.4
CN3701500000000,2022-06-01,37,015,NC,Bertie County,7218,6841,377,5.2
CN3701700000000,2022-06-01,37,017,NC,Bladen County,14597,13931,666,4.6
CN3701900000000,2022-06-01,37,019,NC,Brunswick County,59188,56229,2959,5
CN3702100000000,2022-06-01,37,021,NC,Buncombe County,143023,138308,4715,3.3
CN3702300000000,2022-06-01,37,023,NC,Burke County,41250,39659,1591,3.9
CN3702500000000,2022-06-01,37,025,NC,Cabarrus County,116478,112198,4280,3.7
CN3702700000000,2022-06-01,37,027,NC,Caldwell County,36744,35269,1475,4
CN3702900000000,2022-06-01,37,029,NC,Camden County,4725,4523,202,4.3
CN3703100000000,2022-06-01,37,031,NC,Carteret County,33036,31791,1245,3.8
CN3703300000000,2022-06-01,37,033,NC,Caswell County,9551,9119,432,4.5
CN3703500000000,2022-06-01,37,035,NC,Catawba County,80080,77050,3030,3.8
CN3703700000000,2022-06-01,37,037,NC,Chatham County,37829,36495,1334,3.5
CN3703900000000,2022-06-01,37,039,NC,Cherokee County,11134,10613,521,4.7
CN3704100000000,2022-06-01,37,041,NC,Chowan County,5839,5578,261,4.5
CN3704300000000,2022-06-01,37,043,NC,Clay County,4157,3968,189,4.5
CN3704500000000,2022-06-01,37,045,NC,Cleveland County,49127,47094,2033,4.1
CN3704700000000,2022-06-01,37,047,NC,Columbus County,23527,22435,1092,4.6
CN3704900000000,2022-06-01,37,049,NC,Craven County,42752,41027,1725,4
CN3705100000000,2022-06-01,37,051,NC,Cumberland County,128782,121817,6965,5.4
CN3705300000000,2022-06-01,37,053,NC,Currituck County,14828,14278,550,3.7
CN3705500000000,2022-06-01,37,055,NC,Dare County,22333,21538,795,3.6
CN3705700000000,2022-06-01,37,057,NC,Davidson County,81665,78493,3172,3.9
CN3705900000000,2022-06-01,37,059,NC,Davie County,20825,20044,781,3.8
CN3706100000000,2022-06-01,37,061,NC,Duplin County,24462,23438,1024,4.2
CN3706300000000,2022-06-01,37,063,NC,Durham County,180087,173783,6304,3.5
CN3706500000000,2022-06-01,37,065,NC,Edgecombe County,20081,18717,1364,6.8
CN3706700000000,2022-06-01,37,067,NC,Forsyth County,189052,181316,7736,4.1
CN3706900000000,2022-06-01,37,069,NC,Franklin County,34229,32859,1370,4
CN3707100000000,2022-06-01,37,071,NC,Gaston County,115036,110489,4547,4
CN3707300000000,2022-06-01,37,073,NC,Gates County,5183,4983,200,3.9
CN3707500000000,2022-06-01,37,075,NC,Graham County,2955,2793,162,5.5
CN3707700000000,2022-06-01,37,077,NC,Granville County,30382,29315,1067,3.5
CN3707900000000,2022-06-01,37,079,NC,Greene County,9561,9227,334,3.5
CN3708100000000,2022-06-01,37,081,NC,Guilford County,259798,248266,11532,4.4
CN3708300000000,2022-06-01,37,083,NC,Halifax County,19311,18181,1130,5.9
CN3708500000000,2022-06-01,37,085,NC,Harnett County,55196,52700,2496,4.5
CN3708700000000,2022-06-01,37,087,NC,Haywood County,30425,29341,1084,3.6
CN3708900000000,2022-06-01,37,089,NC,Henderson County,56007,53993,2014,3.6
CN3709100000000,2022-06-01,37,091,NC,Hertford County,8536,8054,482,5.6
CN3709300000000,2022-06-01,37,093,NC,Hoke County,20478,19408,1070,5.2
CN3709500000000,2022-06-01,37,095,NC,Hyde County,1944,1857,87,4.5
CN3709700000000,2022-06-01,37,097,NC,Iredell County,95021,91477,3544,3.7
CN3709900000000,2022-06-01,37,099,NC,Jackson County,20142,19298,844,4.2
CN3710100000000,2022-06-01,37,101,NC,Johnston County,108838,104852,3986,3.7
CN3710300000000,2022-06-01,37,103,NC,Jones County,4392,4233,159,3.6
CN3710500000000,2022-06-01,37,105,NC,Lee County,26270,25109,1161,4.4
CN3710700000000,2022-06-01,37,107,NC,Lenoir County,27812,26715,1097,3.9
CN3710900000000,2022-06-01,37,109,NC,Lincoln County,46625,44991,1634,3.5
CN3711100000000,2022-06-01,37,111,NC,McDowell County,20258,19462,796,3.9
CN3711300000000,2022-06-01,37,113,NC,Macon County,16119,15497,622,3.9
CN3711500000000,2022-06-01,37,115,NC,Madison County,10164,9773,391,3.8
CN3711700000000,2022-06-01,37,117,NC,Martin County,8658,8245,413,4.8
CN3711900000000,2022-06-01,37,119,NC,Mecklenburg County,653960,629618,24342,3.7
CN3712100000000,2022-06-01,37,121,NC,Mitchell County,5881,5606,275,4.7
CN3712300000000,2022-06-01,37,123,NC,Montgomery County,11493,11021,472,4.1
CN3712500000000,2022-06-01,37,125,NC,Moore County,42660,40898,1762,4.1
CN3712700000000,2022-06-01,37,127,NC,Nash County,42024,39738,2286,5.4
CN3712900000000,2022-06-01,37,129,NC,New Hanover County,130294,125634,4660,3.6
CN3713100000000,2022-06-01,37,131,NC,Northampton County,7291,6914,377,5.2
CN3713300000000,2022-06-01,37,133,NC,Onslow County,68919,65665,3254,4.7
CN3713500000000,2022-06-01,37,135,NC,Orange County,82195,79351,2844,3.5
CN3713700000000,2022-06-01,37,137,NC,Pamlico County,5598,5369,229,4.1
CN3713900000000,2022-06-01,37,139,NC,Pasquotank County,16851,16021,830,4.9
CN3714100000000,2022-06-01,37,141,NC,Pender County,30991,29805,1186,3.8
CN3714300000000,2022-06-01,37,143,NC,Perquimans County,5030,4780,250,5
CN3714500000000,2022-06-01,37,145,NC,Person County,18943,18175,768,4.1
CN3714700000000,2022-06-01,37,147,NC,Pitt County,88099,84115,3984,4.5
CN3714900000000,2022-06-01,37,149,NC,Polk County,9489,9092,397,4.2
CN3715100000000,2022-06-01,37,151,NC,Randolph County,65331,62703,2628,4
CN3715300000000,2022-06-01,37,153,NC,Richmond County,17209,16312,897,5.2
CN3715500000000,2022-06-01,37,155,NC,Robeson County,48541,45738,2803,5.8
CN3715700000000,2022-06-01,37,157,NC,Rockingham County,39462,37685,1777,4.5
CN3715900000000,2022-06-01,37,159,NC,Rowan County,68079,65362,2717,4
CN3716100000000,2022-06-01,37,161,NC,Rutherford County,25443,24141,1302,5.1
CN3716300000000,2022-06-01,37,163,NC,Sampson County,28472,27278,1194,4.2
CN3716500000000,2022-06-01,37,165,NC,Scotland County,11293,10552,741,6.6
CN3716700000000,2022-06-01,37,167,NC,Stanly County,30747,29625,1122,3.6
CN3716900000000,2022-06-01,37,169,NC,Stokes County,21749,20922,827,3.8
CN3717100000000,2022-06-01,37,171,NC,Surry County,32624,31339,1285,3.9
CN3717300000000,2022-06-01,37,173,NC,Swain County,7482,7232,250,3.3
CN3717500000000,2022-06-01,37,175,NC,Transylvania County,15067,14490,577,3.8
CN3717700000000,2022-06-01,37,177,NC,Tyrrell County,1451,1389,62,4.3
CN3717900000000,2022-06-01,37,179,NC,Union County,130992,126396,4596,3.5
CN3718100000000,2022-06-01,37,181,NC,Vance County,16855,15844,1011,6
CN3718300000000,2022-06-01,37,183,NC,Wake County,634812,613429,21383,3.4
CN3718500000000,2022-06-01,37,185,NC,Warren County,6521,6108,413,6.3
CN3718700000000,2022-06-01,37,187,NC,Washington County,4432,4201,231,5.2
CN3718900000000,2022-06-01,37,189,NC,Watauga County,29036,27925,1111,3.8
CN3719100000000,2022-06-01,37,191,NC,Wayne County,51146,48876,2270,4.4
CN3719300000000,2022-06-01,37,193,NC,Wilkes County,27761,26578,1183,4.3
CN3719500000000,2022-06-01,37,195,NC,Wilson County,33542,31711,1831,5.5
CN3719700000000,2022-06-01,37,197,NC,Yadkin County,17701,17044,657,3.7
CN3719900000000,2022-06-01,37,199,NC,Yancey County,8281,7953,328,4
CN3800100000000,2022-06-01,38,001,ND,Adams County,940,917,23,2.4
CN3800300000000,2022-06-01,38,003,ND,Barnes County,5302,5171,131,2.5
CN3800500000000,2022-06-01,38,005,ND,Benson County,2318,2243,75,3.2
CN3800700000000,2022-06-01,38,007,ND,Billings County,577,565,12,2.1
CN3800900000000,2022-06-01,38,009,ND,Bottineau County,3182,3083,99,3.1
CN3801100000000,2022-06-01,38,011,ND,Bowman County,1611,1583,28,1.7
CN3801300000000,2022-06-01,38,013,ND,Burke County,1073,1049,24,2.2
CN3801500000000,2022-06-01,38,015,ND,Burleigh County,53789,52647,1142,2.1
CN3801700000000,2022-06-01,38,017,ND,Cass County,112033,109822,2211,2
CN3801900000000,2022-06-01,38,019,ND,Cavalier County,1851,1804,47,2.5
CN3802100000000,2022-06-01,38,021,ND,Dickey County,2329,2280,49,2.1
CN3802300000000,2022-06-01,38,023,ND,Divide County,1414,1391,23,1.6
CN3802500000000,2022-06-01,38,025,ND,Dunn County,3294,3244,50,1.5
CN3802700000000,2022-06-01,38,027,ND,Eddy County,1267,1230,37,2.9
CN3802900000000,2022-06-01,38,029,ND,Emmons County,1433,1375,58,4
CN3803100000000,2022-06-01,38,031,ND,Foster County,1559,1525,34,2.2
CN3803300000000,2022-06-01,38,033,ND,Golden Valley County,868,851,17,2
CN3803500000000,2022-06-01,38,035,ND,Grand Forks County,38008,37148,860,2.3
CN3803700000000,2022-06-01,38,037,ND,Grant County,1199,1173,26,2.2
CN3803900000000,2022-06-01,38,039,ND,Griggs County,1028,1008,20,1.9
CN3804100000000,2022-06-01,38,041,ND,Hettinger County,1454,1429,25,1.7
CN3804300000000,2022-06-01,38,043,ND,Kidder County,1323,1277,46,3.5
CN3804500000000,2022-06-01,38,045,ND,LaMoure County,2116,2075,41,1.9
CN3804700000000,2022-06-01,38,047,ND,Logan County,853,836,17,2
CN3804900000000,2022-06-01,38,049,ND,McHenry County,3133,3041,92,2.9
CN3805100000000,2022-06-01,38,051,ND,McIntosh County,1061,1037,24,2.3
CN3805300000000,2022-06-01,38,053,ND,McKenzie County,9224,9020,204,2.2
CN3805500000000,2022-06-01,38,055,ND,McLean County,4913,4751,162,3.3
CN3805700000000,2022-06-01,38,057,ND,Mercer County,3862,3738,124,3.2
CN3805900000000,2022-06-01,38,059,ND,Morton County,17554,17123,431,2.5
CN3806100000000,2022-06-01,38,061,ND,Mountrail County,6548,6435,113,1.7
CN3806300000000,2022-06-01,38,063,ND,Nelson County,1521,1471,50,3.3
CN3806500000000,2022-06-01,38,065,ND,Oliver County,891,863,28,3.1
CN3806700000000,2022-06-01,38,067,ND,Pembina County,3304,3183,121,3.7
CN3806900000000,2022-06-01,38,069,ND,Pierce County,1733,1689,44,2.5
CN3807100000000,2022-06-01,38,071,ND,Ramsey County,5818,5678,140,2.4
CN3807300000000,2022-06-01,38,073,ND,Ransom County,2755,2703,52,1.9
CN3807500000000,2022-06-01,38,075,ND,Renville County,1205,1179,26,2.2
CN3807700000000,2022-06-01,38,077,ND,Richland County,8925,8718,207,2.3
CN3807900000000,2022-06-01,38,079,ND,Rolette County,5136,4661,475,9.2
CN3808100000000,2022-06-01,38,081,ND,Sargent County,2374,2327,47,2
CN3808300000000,2022-06-01,38,083,ND,Sheridan County,648,635,13,2
CN3808500000000,2022-06-01,38,085,ND,Sioux County,1269,1218,51,4
CN3808700000000,2022-06-01,38,087,ND,Slope County,326,317,9,2.8
CN3808900000000,2022-06-01,38,089,ND,Stark County,18446,18062,384,2.1
CN3809100000000,2022-06-01,38,091,ND,Steele County,959,936,23,2.4
CN3809300000000,2022-06-01,38,093,ND,Stutsman County,10753,10496,257,2.4
CN3809500000000,2022-06-01,38,095,ND,Towner County,1139,1111,28,2.5
CN3809700000000,2022-06-01,38,097,ND,Traill County,4511,4393,118,2.6
CN3809900000000,2022-06-01,38,099,ND,Walsh County,5467,5282,185,3.4
CN3810100000000,2022-06-01,38,101,ND,Ward County,33044,32222,822,2.5
CN3810300000000,2022-06-01,38,103,ND,Wells County,1920,1860,60,3.1
CN3810500000000,2022-06-01,38,105,ND,Williams County,22211,21671,540,2.4
CN3900100000000,2022-06-01,39,001,OH,Adams County,10873,10297,576,5.3
CN3900300000000,2022-06-01,39,003,OH,Allen County,46995,44948,2047,4.4
CN3900500000000,2022-06-01,39,005,OH,Ashland County,26315,25289,1026,3.9
CN3900700000000,2022-06-01,39,007,OH,Ashtabula County,44007,42061,1946,4.4
CN3900900000000,2022-06-01,39,009,OH,Athens County,24592,23095,1497,6.1
CN3901100000000,2022-06-01,39,011,OH,Auglaize County,24390,23550,840,3.4
CN3901300000000,2022-06-01,39,013,OH,Belmont County,27255,25838,1417,5.2
CN3901500000000,2022-06-01,39,015,OH,Brown County,19545,18631,914,4.7
CN3901700000000,2022-06-01,39,017,OH,Butler County,198926,190714,8212,4.1
CN3901900000000,2022-06-01,39,019,OH,Carroll County,12665,12117,548,4.3
CN3902100000000,2022-06-01,39,021,OH,Champaign County,19449,18660,789,4.1
CN3902300000000,2022-06-01,39,023,OH,Clark County,63222,60438,2784,4.4
CN3902500000000,2022-06-01,39,025,OH,Clermont County,108877,104503,4374,4
CN3902700000000,2022-06-01,39,027,OH,Clinton County,17975,17105,870,4.8
CN3902900000000,2022-06-01,39,029,OH,Columbiana County,45185,42918,2267,5
CN3903100000000,2022-06-01,39,031,OH,Coshocton County,13925,13183,742,5.3
CN3903300000000,2022-06-01,39,033,OH,Crawford County,17943,17030,913,5.1
CN3903500000000,2022-06-01,39,035,OH,Cuyahoga County,611258,577103,34155,5.6
CN3903700000000,2022-06-01,39,037,OH,Darke County,26129,25123,1006,3.9
CN3903900000000,2022-06-01,39,039,OH,Defiance County,17592,16830,762,4.3
CN3904100000000,2022-06-01,39,041,OH,Delaware County,116651,112611,4040,3.5
CN3904300000000,2022-06-01,39,043,OH,Erie County,39102,37443,1659,4.2
CN3904500000000,2022-06-01,39,045,OH,Fairfield County,81032,77874,3158,3.9
CN3904700000000,2022-06-01,39,047,OH,Fayette County,13846,13269,577,4.2
CN3904900000000,2022-06-01,39,049,OH,Franklin County,715484,688064,27420,3.8
CN3905100000000,2022-06-01,39,051,OH,Fulton County,21601,20750,851,3.9
CN3905300000000,2022-06-01,39,053,OH,Gallia County,12202,11601,601,4.9
CN3905500000000,2022-06-01,39,055,OH,Geauga County,49046,46773,2273,4.6
CN3905700000000,2022-06-01,39,057,OH,Greene County,82883,79507,3376,4.1
CN3905900000000,2022-06-01,39,059,OH,Guernsey County,17963,17095,868,4.8
CN3906100000000,2022-06-01,39,061,OH,Hamilton County,420771,403666,17105,4.1
CN3906300000000,2022-06-01,39,063,OH,Hancock County,40490,39052,1438,3.6
CN3906500000000,2022-06-01,39,065,OH,Hardin County,13353,12711,642,4.8
CN3906700000000,2022-06-01,39,067,OH,Harrison County,6533,6210,323,4.9
CN3906900000000,2022-06-01,39,069,OH,Henry County,12805,12262,543,4.2
CN3907100000000,2022-06-01,39,071,OH,Highland County,17374,16495,879,5.1
CN3907300000000,2022-06-01,39,073,OH,Hocking County,13027,12480,547,4.2
CN3907500000000,2022-06-01,39,075,OH,Holmes County,22033,21336,697,3.2
CN3907700000000,2022-06-01,39,077,OH,Huron County,28367,27115,1252,4.4
CN3907900000000,2022-06-01,39,079,OH,Jackson County,12385,11733,652,5.3
CN3908100000000,2022-06-01,39,081,OH,Jefferson County,27335,25755,1580,5.8
CN3908300000000,2022-06-01,39,083,OH,Knox County,30943,29709,1234,4
CN3908500000000,2022-06-01,39,085,OH,Lake County,126851,120683,6168,4.9
CN3908700000000,2022-06-01,39,087,OH,Lawrence County,23277,22025,1252,5.4
CN3908900000000,2022-06-01,39,089,OH,Licking County,92788,89227,3561,3.8
CN3909100000000,2022-06-01,39,091,OH,Logan County,22791,21928,863,3.8
CN3909300000000,2022-06-01,39,093,OH,Lorain County,156468,147856,8612,5.5
CN3909500000000,2022-06-01,39,095,OH,Lucas County,203433,193977,9456,4.6
CN3909700000000,2022-06-01,39,097,OH,Madison County,21153,20391,762,3.6
CN3909900000000,2022-06-01,39,099,OH,Mahoning County,99111,93981,5130,5.2
CN3910100000000,2022-06-01,39,101,OH,Marion County,27546,26314,1232,4.5
CN3910300000000,2022-06-01,39,103,OH,Medina County,99352,94766,4586,4.6
CN3910500000000,2022-06-01,39,105,OH,Meigs County,8554,8041,513,6
CN3910700000000,2022-06-01,39,107,OH,Mercer County,23398,22694,704,3
CN3910900000000,2022-06-01,39,109,OH,Miami County,53791,51720,2071,3.9
CN3911100000000,2022-06-01,39,111,OH,Monroe County,5066,4756,310,6.1
CN3911300000000,2022-06-01,39,113,OH,Montgomery County,247821,236683,11138,4.5
CN3911500000000,2022-06-01,39,115,OH,Morgan County,6831,6515,316,4.6
CN3911700000000,2022-06-01,39,117,OH,Morrow County,17115,16422,693,4
CN3911900000000,2022-06-01,39,119,OH,Muskingum County,41010,39241,1769,4.3
CN3912100000000,2022-06-01,39,121,OH,Noble County,4677,4405,272,5.8
CN3912300000000,2022-06-01,39,123,OH,Ottawa County,21792,20872,920,4.2
CN3912500000000,2022-06-01,39,125,OH,Paulding County,8791,8426,365,4.2
CN3912700000000,2022-06-01,39,127,OH,Perry County,16050,15336,714,4.4
CN3912900000000,2022-06-01,39,129,OH,Pickaway County,27008,25934,1074,4
CN3913100000000,2022-06-01,39,131,OH,Pike County,11166,10577,589,5.3
CN3913300000000,2022-06-01,39,133,OH,Portage County,85120,81545,3575,4.2
CN3913500000000,2022-06-01,39,135,OH,Preble County,22120,21314,806,3.6
CN3913700000000,2022-06-01,39,137,OH,Putnam County,19145,18548,597,3.1
CN3913900000000,2022-06-01,39,139,OH,Richland County,51098,48753,2345,4.6
CN3914100000000,2022-06-01,39,141,OH,Ross County,35498,34088,1410,4
CN3914300000000,2022-06-01,39,143,OH,Sandusky County,30323,28872,1451,4.8
CN3914500000000,2022-06-01,39,145,OH,Scioto County,29150,27588,1562,5.4
CN3914700000000,2022-06-01,39,147,OH,Seneca County,26598,25420,1178,4.4
CN3914900000000,2022-06-01,39,149,OH,Shelby County,23898,22936,962,4
CN3915100000000,2022-06-01,39,151,OH,Stark County,182600,174841,7759,4.2
CN3915300000000,2022-06-01,39,153,OH,Summit County,265109,253341,11768,4.4
CN3915500000000,2022-06-01,39,155,OH,Trumbull County,83631,79240,4391,5.3
CN3915700000000,2022-06-01,39,157,OH,Tuscarawas County,45323,43563,1760,3.9
CN3915900000000,2022-06-01,39,159,OH,Union County,30422,29389,1033,3.4
CN3916100000000,2022-06-01,39,161,OH,Van Wert County,14546,14006,540,3.7
CN3916300000000,2022-06-01,39,163,OH,Vinton County,5450,5172,278,5.1
CN3916500000000,2022-06-01,39,165,OH,Warren County,123481,118891,4590,3.7
CN3916700000000,2022-06-01,39,167,OH,Washington County,26973,25671,1302,4.8
CN3916900000000,2022-06-01,39,169,OH,Wayne County,60568,58411,2157,3.6
CN3917100000000,2022-06-01,39,171,OH,Williams County,18273,17583,690,3.8
CN3917300000000,2022-06-01,39,173,OH,Wood County,69580,66833,2747,3.9
CN3917500000000,2022-06-01,39,175,OH,Wyandot County,13375,12969,406,3
CN4000100000000,2022-06-01,40,001,OK,Adair County,8564,8222,342,4
CN4000300000000,2022-06-01,40,003,OK,Alfalfa County,2657,2608,49,1.8
CN4000500000000,2022-06-01,40,005,OK,Atoka County,5148,4914,234,4.5
CN4000700000000,2022-06-01,40,007,OK,Beaver County,2727,2671,56,2.1
CN4000900000000,2022-06-01,40,009,OK,Beckham County,10536,10240,296,2.8
CN4001100000000,2022-06-01,40,011,OK,Blaine County,4390,4264,126,2.9
CN4001300000000,2022-06-01,40,013,OK,Bryan County,23135,22406,729,3.2
CN4001500000000,2022-06-01,40,015,OK,Caddo County,11802,11358,444,3.8
CN4001700000000,2022-06-01,40,017,OK,Canadian County,80656,78361,2295,2.8
CN4001900000000,2022-06-01,40,019,OK,Carter County,21897,21050,847,3.9
CN4002100000000,2022-06-01,40,021,OK,Cherokee County,20240,19380,860,4.2
CN4002300000000,2022-06-01,40,023,OK,Choctaw County,6034,5700,334,5.5
CN4002500000000,2022-06-01,40,025,OK,Cimarron County,1558,1531,27,1.7
CN4002700000000,2022-06-01,40,027,OK,Cleveland County,148845,144577,4268,2.9
CN4002900000000,2022-06-01,40,029,OK,Coal County,2292,2193,99,4.3
CN4003100000000,2022-06-01,40,031,OK,Comanche County,48024,46118,1906,4
CN4003300000000,2022-06-01,40,033,OK,Cotton County,2685,2601,84,3.1
CN4003500000000,2022-06-01,40,035,OK,Craig County,5945,5738,207,3.5
CN4003700000000,2022-06-01,40,037,OK,Creek County,31933,30673,1260,3.9
CN4003900000000,2022-06-01,40,039,OK,Custer County,15144,14673,471,3.1
CN4004100000000,2022-06-01,40,041,OK,Delaware County,20284,19636,648,3.2
CN4004300000000,2022-06-01,40,043,OK,Dewey County,2986,2918,68,2.3
CN4004500000000,2022-06-01,40,045,OK,Ellis County,2050,1996,54,2.6
CN4004700000000,2022-06-01,40,047,OK,Garfield County,26942,26066,876,3.3
CN4004900000000,2022-06-01,40,049,OK,Garvin County,12944,12544,400,3.1
CN4005100000000,2022-06-01,40,051,OK,Grady County,27376,26542,834,3
CN4005300000000,2022-06-01,40,053,OK,Grant County,2755,2696,59,2.1
CN4005500000000,2022-06-01,40,055,OK,Greer County,1805,1735,70,3.9
CN4005700000000,2022-06-01,40,057,OK,Harmon County,1239,1202,37,3
CN4005900000000,2022-06-01,40,059,OK,Harper County,1712,1674,38,2.2
CN4006100000000,2022-06-01,40,061,OK,Haskell County,4180,3970,210,5
CN4006300000000,2022-06-01,40,063,OK,Hughes County,5021,4800,221,4.4
CN4006500000000,2022-06-01,40,065,OK,Jackson County,10821,10496,325,3
CN4006700000000,2022-06-01,40,067,OK,Jefferson County,2473,2385,88,3.6
CN4006900000000,2022-06-01,40,069,OK,Johnston County,3689,3530,159,4.3
CN4007100000000,2022-06-01,40,071,OK,Kay County,18694,17957,737,3.9
CN4007300000000,2022-06-01,40,073,OK,Kingfisher County,9042,8837,205,2.3
CN4007500000000,2022-06-01,40,075,OK,Kiowa County,3635,3492,143,3.9
CN4007700000000,2022-06-01,40,077,OK,Latimer County,3192,2979,213,6.7
CN4007900000000,2022-06-01,40,079,OK,Le Flore County,19785,18923,862,4.4
CN4008100000000,2022-06-01,40,081,OK,Lincoln County,16254,15693,561,3.5
CN4008300000000,2022-06-01,40,083,OK,Logan County,23425,22699,726,3.1
CN4008500000000,2022-06-01,40,085,OK,Love County,5836,5669,167,2.9
CN4008700000000,2022-06-01,40,087,OK,McClain County,20952,20323,629,3
CN4008900000000,2022-06-01,40,089,OK,McCurtain County,16001,15262,739,4.6
CN4009100000000,2022-06-01,40,091,OK,McIntosh County,7259,6856,403,5.6
CN4009300000000,2022-06-01,40,093,OK,Major County,3818,3726,92,2.4
CN4009500000000,2022-06-01,40,095,OK,Marshall County,7655,7405,250,3.3
CN4009700000000,2022-06-01,40,097,OK,Mayes County,20041,19350,691,3.4
CN4009900000000,2022-06-01,40,099,OK,Murray County,6318,6106,212,3.4
CN4010100000000,2022-06-01,40,101,OK,Muskogee County,29016,27909,1107,3.8
CN4010300000000,2022-06-01,40,103,OK,Noble County,5892,5745,147,2.5
CN4010500000000,2022-06-01,40,105,OK,Nowata County,4769,4619,150,3.1
CN4010700000000,2022-06-01,40,107,OK,Okfuskee County,4422,4236,186,4.2
CN4010900000000,2022-06-01,40,109,OK,Oklahoma County,399505,386550,12955,3.2
CN4011100000000,2022-06-01,40,111,OK,Okmulgee County,15808,15074,734,4.6
CN4011300000000,2022-06-01,40,113,OK,Osage County,20832,19977,855,4.1
CN4011500000000,2022-06-01,40,115,OK,Ottawa County,15016,14535,481,3.2
CN4011700000000,2022-06-01,40,117,OK,Pawnee County,7472,7163,309,4.1
CN4011900000000,2022-06-01,40,119,OK,Payne County,38707,37419,1288,3.3
CN4012100000000,2022-06-01,40,121,OK,Pittsburg County,16403,15608,795,4.8
CN4012300000000,2022-06-01,40,123,OK,Pontotoc County,19591,18962,629,3.2
CN4012500000000,2022-06-01,40,125,OK,Pottawatomie County,33429,32149,1280,3.8
CN4012700000000,2022-06-01,40,127,OK,Pushmataha County,4424,4225,199,4.5
CN4012900000000,2022-06-01,40,129,OK,Roger Mills County,1762,1717,45,2.6
CN4013100000000,2022-06-01,40,131,OK,Rogers County,46138,44644,1494,3.2
CN4013300000000,2022-06-01,40,133,OK,Seminole County,9151,8710,441,4.8
CN4013500000000,2022-06-01,40,135,OK,Sequoyah County,16953,16319,634,3.7
CN4013700000000,2022-06-01,40,137,OK,Stephens County,19378,18717,661,3.4
CN4013900000000,2022-06-01,40,139,OK,Texas County,12062,11802,260,2.2
CN4014100000000,2022-06-01,40,141,OK,Tillman County,2784,2677,107,3.8
CN4014300000000,2022-06-01,40,143,OK,Tulsa County,331130,320111,11019,3.3
CN4014500000000,2022-06-01,40,145,OK,Wagoner County,39719,38396,1323,3.3
CN4014700000000,2022-06-01,40,147,OK,Washington County,22617,21787,830,3.7
CN4014900000000,2022-06-01,40,149,OK,Washita County,5291,5111,180,3.4
CN4015100000000,2022-06-01,40,151,OK,Woods County,4748,4644,104,2.2
CN4015300000000,2022-06-01,40,153,OK,Woodward County,8624,8345,279,3.2
CN4100100000000,2022-06-01,41,001,OR,Baker County,7448,7127,321,4.3
CN4100300000000,2022-06-01,41,003,OR,Benton County,49525,47584,1941,3.9
CN4100500000000,2022-06-01,41,005,OR,Clackamas County,225015,216444,8571,3.8
CN4100700000000,2022-06-01,41,007,OR,Clatsop County,20073,19284,789,3.9
CN4100900000000,2022-06-01,41,009,OR,Columbia County,24891,23714,1177,4.7
CN4101100000000,2022-06-01,41,011,OR,Coos County,26454,25106,1348,5.1
CN4101300000000,2022-06-01,41,013,OR,Crook County,11300,10751,549,4.9
CN4101500000000,2022-06-01,41,015,OR,Curry County,9377,8928,449,4.8
CN4101700000000,2022-06-01,41,017,OR,Deschutes County,103321,99296,4025,3.9
CN4101900000000,2022-06-01,41,019,OR,Douglas County,47766,45375,2391,5
CN4102100000000,2022-06-01,41,021,OR,Gilliam County,909,870,39,4.3
CN4102300000000,2022-06-01,41,023,OR,Grant County,3305,3142,163,4.9
CN4102500000000,2022-06-01,41,025,OR,Harney County,3728,3574,154,4.1
CN4102700000000,2022-06-01,41,027,OR,Hood River County,14234,13697,537,3.8
CN4102900000000,2022-06-01,41,029,OR,Jackson County,106736,101816,4920,4.6
CN4103100000000,2022-06-01,41,031,OR,Jefferson County,10455,9914,541,5.2
CN4103300000000,2022-06-01,41,033,OR,Josephine County,36948,34981,1967,5.3
CN4103500000000,2022-06-01,41,035,OR,Klamath County,30436,28809,1627,5.3
CN4103700000000,2022-06-01,41,037,OR,Lake County,3753,3578,175,4.7
CN4103900000000,2022-06-01,41,039,OR,Lane County,183706,175476,8230,4.5
CN4104100000000,2022-06-01,41,041,OR,Lincoln County,21214,20209,1005,4.7
CN4104300000000,2022-06-01,41,043,OR,Linn County,61278,58519,2759,4.5
CN4104500000000,2022-06-01,41,045,OR,Malheur County,12706,12144,562,4.4
CN4104700000000,2022-06-01,41,047,OR,Marion County,169704,162480,7224,4.3
CN4104900000000,2022-06-01,41,049,OR,Morrow County,6045,5780,265,4.4
CN4105100000000,2022-06-01,41,051,OR,Multnomah County,463830,446211,17619,3.8
CN4105300000000,2022-06-01,41,053,OR,Polk County,42376,40538,1838,4.3
CN4105500000000,2022-06-01,41,055,OR,Sherman County,979,950,29,3
CN4105700000000,2022-06-01,41,057,OR,Tillamook County,12368,11856,512,4.1
CN4105900000000,2022-06-01,41,059,OR,Umatilla County,38315,36642,1673,4.4
CN4106100000000,2022-06-01,41,061,OR,Union County,12297,11743,554,4.5
CN4106300000000,2022-06-01,41,063,OR,Wallowa County,3787,3609,178,4.7
CN4106500000000,2022-06-01,41,065,OR,Wasco County,13954,13433,521,3.7
CN4106700000000,2022-06-01,41,067,OR,Washington County,331491,319825,11666,3.5
CN4106900000000,2022-06-01,41,069,OR,Wheeler County,753,729,24,3.2
CN4107100000000,2022-06-01,41,071,OR,Yamhill County,55987,53779,2208,3.9
CN4200100000000,2022-06-01,42,001,PA,Adams County,55315,53115,2200,4
CN4200300000000,2022-06-01,42,003,PA,Allegheny County,634305,605486,28819,4.5
CN4200500000000,2022-06-01,42,005,PA,Armstrong County,31425,29658,1767,5.6
CN4200700000000,2022-06-01,42,007,PA,Beaver County,82215,77623,4592,5.6
CN4200900000000,2022-06-01,42,009,PA,Bedford County,24850,23739,1111,4.5
CN4201100000000,2022-06-01,42,011,PA,Berks County,215974,205636,10338,4.8
CN4201300000000,2022-06-01,42,013,PA,Blair County,60072,57078,2994,5
CN4201500000000,2022-06-01,42,015,PA,Bradford County,28586,27295,1291,4.5
CN4201700000000,2022-06-01,42,017,PA,Bucks County,353106,338926,14180,4
CN4201900000000,2022-06-01,42,019,PA,Butler County,99395,94869,4526,4.6
CN4202100000000,2022-06-01,42,021,PA,Cambria County,55743,52272,3471,6.2
CN4202300000000,2022-06-01,42,023,PA,Cameron County,2011,1894,117,5.8
CN4202500000000,2022-06-01,42,025,PA,Carbon County,32805,31018,1787,5.4
CN4202700000000,2022-06-01,42,027,PA,Centre County,75382,71960,3422,4.5
CN4202900000000,2022-06-01,42,029,PA,Chester County,299717,288818,10899,3.6
CN4203100000000,2022-06-01,42,031,PA,Clarion County,16355,15421,934,5.7
CN4203300000000,2022-06-01,42,033,PA,Clearfield County,35354,33420,1934,5.5
CN4203500000000,2022-06-01,42,035,PA,Clinton County,17033,16062,971,5.7
CN4203700000000,2022-06-01,42,037,PA,Columbia County,34033,32314,1719,5.1
CN4203900000000,2022-06-01,42,039,PA,Crawford County,39033,36998,2035,5.2
CN4204100000000,2022-06-01,42,041,PA,Cumberland County,136324,130880,5444,4
CN4204300000000,2022-06-01,42,043,PA,Dauphin County,146888,140469,6419,4.4
CN4204500000000,2022-06-01,42,045,PA,Delaware County,302061,288613,13448,4.5
CN4204700000000,2022-06-01,42,047,PA,Elk County,15126,14278,848,5.6
CN4204900000000,2022-06-01,42,049,PA,Erie County,127182,120487,6695,5.3
CN4205100000000,2022-06-01,42,051,PA,Fayette County,55458,51898,3560,6.4
CN4205300000000,2022-06-01,42,053,PA,Forest County,1754,1638,116,6.6
CN4205500000000,2022-06-01,42,055,PA,Franklin County,78871,75583,3288,4.2
CN4205700000000,2022-06-01,42,057,PA,Fulton County,7337,7025,312,4.3
CN4205900000000,2022-06-01,42,059,PA,Greene County,15606,14656,950,6.1
CN4206100000000,2022-06-01,42,061,PA,Huntingdon County,19477,18320,1157,5.9
CN4206300000000,2022-06-01,42,063,PA,Indiana County,36235,33941,2294,6.3
CN4206500000000,2022-06-01,42,065,PA,Jefferson County,19632,18620,1012,5.2
CN4206700000000,2022-06-01,42,067,PA,Juniata County,12732,12132,600,4.7
CN4206900000000,2022-06-01,42,069,PA,Lackawanna County,105126,99770,5356,5.1
CN4207100000000,2022-06-01,42,071,PA,Lancaster County,295194,283114,12080,4.1
CN4207300000000,2022-06-01,42,073,PA,Lawrence County,39900,37785,2115,5.3
CN4207500000000,2022-06-01,42,075,PA,Lebanon County,74120,70925,3195,4.3
CN4207700000000,2022-06-01,42,077,PA,Lehigh County,198423,189205,9218,4.6
CN4207900000000,2022-06-01,42,079,PA,Luzerne County,158117,149290,8827,5.6
CN4208100000000,2022-06-01,42,081,PA,Lycoming County,55320,52497,2823,5.1
CN4208300000000,2022-06-01,42,083,PA,McKean County,17082,16119,963,5.6
CN4208500000000,2022-06-01,42,085,PA,Mercer County,48416,45698,2718,5.6
CN4208700000000,2022-06-01,42,087,PA,Mifflin County,21387,20271,1116,5.2
CN4208900000000,2022-06-01,42,089,PA,Monroe County,83306,78237,5069,6.1
CN4209100000000,2022-06-01,42,091,PA,Montgomery County,470004,452126,17878,3.8
CN4209300000000,2022-06-01,42,093,PA,Montour County,9255,8884,371,4
CN4209500000000,2022-06-01,42,095,PA,Northampton County,165471,157858,7613,4.6
CN4209700000000,2022-06-01,42,097,PA,Northumberland County,43267,41027,2240,5.2
CN4209900000000,2022-06-01,42,099,PA,Perry County,25019,24028,991,4
CN4210100000000,2022-06-01,42,101,PA,Philadelphia County/city,727364,686233,41131,5.7
CN4210300000000,2022-06-01,42,103,PA,Pike County,26159,24735,1424,5.4
CN4210500000000,2022-06-01,42,105,PA,Potter County,7108,6701,407,5.7
CN4210700000000,2022-06-01,42,107,PA,Schuylkill County,66825,63214,3611,5.4
CN4210900000000,2022-06-01,42,109,PA,Snyder County,20003,19028,975,4.9
CN4211100000000,2022-06-01,42,111,PA,Somerset County,32902,31065,1837,5.6
CN4211300000000,2022-06-01,42,113,PA,Sullivan County,2647,2493,154,5.8
CN4211500000000,2022-06-01,42,115,PA,Susquehanna County,20604,19733,871,4.2
CN4211700000000,2022-06-01,42,117,PA,Tioga County,19437,18443,994,5.1
CN4211900000000,2022-06-01,42,119,PA,Union County,19682,18747,935,4.8
CN4212100000000,2022-06-01,42,121,PA,Venango County,21817,20660,1157,5.3
CN4212300000000,2022-06-01,42,123,PA,Warren County,18090,17229,861,4.8
CN4212500000000,2022-06-01,42,125,PA,Washington County,105415,100134,5281,5
CN4212700000000,2022-06-01,42,127,PA,Wayne County,22993,21851,1142,5
CN4212900000000,2022-06-01,42,129,PA,Westmoreland County,176840,168088,8752,4.9
CN4213100000000,2022-06-01,42,131,PA,Wyoming County,13599,12904,695,5.1
CN4213300000000,2022-06-01,42,133,PA,York County,240249,229667,10582,4.4
CN4400100000000,2022-06-01,44,001,RI,Bristol County,26748,26087,661,2.5
CN4400300000000,2022-06-01,44,003,RI,Kent County,94324,91810,2514,2.7
CN4400500000000,2022-06-01,44,005,RI,Newport County,45388,44265,1123,2.5
CN4400700000000,2022-06-01,44,007,RI,Providence County,336465,325916,10549,3.1
CN4400900000000,2022-06-01,44,009,RI,Washington County,71110,69348,1762,2.5
CN4500100000000,2022-06-01,45,001,SC,Abbeville County,9513,9095,418,4.4
CN4500300000000,2022-06-01,45,003,SC,Aiken County,73685,71133,2552,3.5
CN4500500000000,2022-06-01,45,005,SC,Allendale County,2279,2144,135,5.9
CN4500700000000,2022-06-01,45,007,SC,Anderson County,92162,89123,3039,3.3
CN4500900000000,2022-06-01,45,009,SC,Bamberg County,4640,4370,270,5.8
CN4501100000000,2022-06-01,45,011,SC,Barnwell County,7633,7267,366,4.8
CN4501300000000,2022-06-01,45,013,SC,Beaufort County,78125,75456,2669,3.4
CN4501500000000,2022-06-01,45,015,SC,Berkeley County,110652,107083,3569,3.2
CN4501700000000,2022-06-01,45,017,SC,Calhoun County,6451,6216,235,3.6
CN4501900000000,2022-06-01,45,019,SC,Charleston County,217472,210987,6485,3
CN4502100000000,2022-06-01,45,021,SC,Cherokee County,24223,23197,1026,4.2
CN4502300000000,2022-06-01,45,023,SC,Chester County,13406,12830,576,4.3
CN4502500000000,2022-06-01,45,025,SC,Chesterfield County,21418,20620,798,3.7
CN4502700000000,2022-06-01,45,027,SC,Clarendon County,12209,11698,511,4.2
CN4502900000000,2022-06-01,45,029,SC,Colleton County,15950,15356,594,3.7
CN4503100000000,2022-06-01,45,031,SC,Darlington County,30180,29017,1163,3.9
CN4503300000000,2022-06-01,45,033,SC,Dillon County,13071,12470,601,4.6
CN4503500000000,2022-06-01,45,035,SC,Dorchester County,80271,77787,2484,3.1
CN4503700000000,2022-06-01,45,037,SC,Edgefield County,10348,9997,351,3.4
CN4503900000000,2022-06-01,45,039,SC,Fairfield County,9270,8818,452,4.9
CN4504100000000,2022-06-01,45,041,SC,Florence County,66749,64464,2285,3.4
CN4504300000000,2022-06-01,45,043,SC,Georgetown County,26869,25829,1040,3.9
CN4504500000000,2022-06-01,45,045,SC,Greenville County,261725,253767,7958,3
CN4504700000000,2022-06-01,45,047,SC,Greenwood County,29822,28643,1179,4
CN4504900000000,2022-06-01,45,049,SC,Hampton County,8016,7761,255,3.2
CN4505100000000,2022-06-01,45,051,SC,Horry County,156054,150059,5995,3.8
CN4505300000000,2022-06-01,45,053,SC,Jasper County,13504,13046,458,3.4
CN4505500000000,2022-06-01,45,055,SC,Kershaw County,29562,28499,1063,3.6
CN4505700000000,2022-06-01,45,057,SC,Lancaster County,43844,42190,1654,3.8
CN4505900000000,2022-06-01,45,059,SC,Laurens County,30348,29234,1114,3.7
CN4506100000000,2022-06-01,45,061,SC,Lee County,6456,6144,312,4.8
CN4506300000000,2022-06-01,45,063,SC,Lexington County,151986,147510,4476,2.9
CN4506500000000,2022-06-01,45,065,SC,McCormick County,3518,3380,138,3.9
CN4506700000000,2022-06-01,45,067,SC,Marion County,12789,12149,640,5
CN4506900000000,2022-06-01,45,069,SC,Marlboro County,8256,7741,515,6.2
CN4507100000000,2022-06-01,45,071,SC,Newberry County,19274,18685,589,3.1
CN4507300000000,2022-06-01,45,073,SC,Oconee County,34544,33374,1170,3.4
CN4507500000000,2022-06-01,45,075,SC,Orangeburg County,32948,31209,1739,5.3
CN4507700000000,2022-06-01,45,077,SC,Pickens County,58450,56428,2022,3.5
CN4507900000000,2022-06-01,45,079,SC,Richland County,197990,190914,7076,3.6
CN4508100000000,2022-06-01,45,081,SC,Saluda County,8536,8269,267,3.1
CN4508300000000,2022-06-01,45,083,SC,Spartanburg County,154970,149545,5425,3.5
CN4508500000000,2022-06-01,45,085,SC,Sumter County,42392,40690,1702,4
CN4508700000000,2022-06-01,45,087,SC,Union County,11229,10690,539,4.8
CN4508900000000,2022-06-01,45,089,SC,Williamsburg County,11076,10507,569,5.1
CN4509100000000,2022-06-01,45,091,SC,York County,148955,143988,4967,3.3
CN4600300000000,2022-06-01,46,003,SD,Aurora County,1512,1484,28,1.9
CN4600500000000,2022-06-01,46,005,SD,Beadle County,9421,9231,190,2
CN4600700000000,2022-06-01,46,007,SD,Bennett County,1062,1024,38,3.6
CN4600900000000,2022-06-01,46,009,SD,Bon Homme County,2923,2865,58,2
CN4601100000000,2022-06-01,46,011,SD,Brookings County,18887,18425,462,2.4
CN4601300000000,2022-06-01,46,013,SD,Brown County,20350,19877,473,2.3
CN4601500000000,2022-06-01,46,015,SD,Brule County,2707,2653,54,2
CN4601700000000,2022-06-01,46,017,SD,Buffalo County,730,696,34,4.7
CN4601900000000,2022-06-01,46,019,SD,Butte County,5080,4975,105,2.1
CN4602100000000,2022-06-01,46,021,SD,Campbell County,798,777,21,2.6
CN4602300000000,2022-06-01,46,023,SD,Charles Mix County,4018,3915,103,2.6
CN4602500000000,2022-06-01,46,025,SD,Clark County,1990,1948,42,2.1
CN4602700000000,2022-06-01,46,027,SD,Clay County,6933,6750,183,2.6
CN4602900000000,2022-06-01,46,029,SD,Codington County,16099,15771,328,2
CN4603100000000,2022-06-01,46,031,SD,Corson County,1275,1226,49,3.8
CN4603300000000,2022-06-01,46,033,SD,Custer County,4309,4194,115,2.7
CN4603500000000,2022-06-01,46,035,SD,Davison County,11176,10955,221,2
CN4603700000000,2022-06-01,46,037,SD,Day County,2782,2707,75,2.7
CN4603900000000,2022-06-01,46,039,SD,Deuel County,2318,2260,58,2.5
CN4604100000000,2022-06-01,46,041,SD,Dewey County,2382,2190,192,8.1
CN4604300000000,2022-06-01,46,043,SD,Douglas County,1562,1530,32,2
CN4604500000000,2022-06-01,46,045,SD,Edmunds County,1999,1957,42,2.1
CN4604700000000,2022-06-01,46,047,SD,Fall River County,3249,3173,76,2.3
CN4604900000000,2022-06-01,46,049,SD,Faulk County,1088,1063,25,2.3
CN4605100000000,2022-06-01,46,051,SD,Grant County,4440,4353,87,2
CN4605300000000,2022-06-01,46,053,SD,Gregory County,2184,2142,42,1.9
CN4605500000000,2022-06-01,46,055,SD,Haakon County,1071,1051,20,1.9
CN4605700000000,2022-06-01,46,057,SD,Hamlin County,3646,3570,76,2.1
CN4605900000000,2022-06-01,46,059,SD,Hand County,1799,1766,33,1.8
CN4606100000000,2022-06-01,46,061,SD,Hanson County,1789,1744,45,2.5
CN4606300000000,2022-06-01,46,063,SD,Harding County,737,721,16,2.2
CN4606500000000,2022-06-01,46,065,SD,Hughes County,10224,10050,174,1.7
CN4606700000000,2022-06-01,46,067,SD,Hutchinson County,3666,3583,83,2.3
CN4606900000000,2022-06-01,46,069,SD,Hyde County,655,639,16,2.4
CN4607100000000,2022-06-01,46,071,SD,Jackson County,1308,1275,33,2.5
CN4607300000000,2022-06-01,46,073,SD,Jerauld County,1355,1334,21,1.5
CN4607500000000,2022-06-01,46,075,SD,Jones County,584,572,12,2.1
CN4607700000000,2022-06-01,46,077,SD,Kingsbury County,2975,2922,53,1.8
CN4607900000000,2022-06-01,46,079,SD,Lake County,6750,6595,155,2.3
CN4608100000000,2022-06-01,46,081,SD,Lawrence County,14521,14218,303,2.1
CN4608300000000,2022-06-01,46,083,SD,Lincoln County,37961,37291,670,1.8
CN4608500000000,2022-06-01,46,085,SD,Lyman County,1715,1668,47,2.7
CN4608700000000,2022-06-01,46,087,SD,McCook County,3124,3066,58,1.9
CN4608900000000,2022-06-01,46,089,SD,McPherson County,1000,972,28,2.8
CN4609100000000,2022-06-01,46,091,SD,Marshall County,2550,2484,66,2.6
CN4609300000000,2022-06-01,46,093,SD,Meade County,15012,14686,326,2.2
CN4609500000000,2022-06-01,46,095,SD,Mellette County,740,718,22,3
CN4609700000000,2022-06-01,46,097,SD,Miner County,1230,1206,24,2
CN4609900000000,2022-06-01,46,099,SD,Minnehaha County,117867,115643,2224,1.9
CN4610100000000,2022-06-01,46,101,SD,Moody County,4086,3969,117,2.9
CN4610200000000,2022-06-01,46,102,SD,Oglala Lakota County,3751,3584,167,4.5
CN4610300000000,2022-06-01,46,103,SD,Pennington County,62079,60752,1327,2.1
CN4610500000000,2022-06-01,46,105,SD,Perkins County,1449,1417,32,2.2
CN4610700000000,2022-06-01,46,107,SD,Potter County,1098,1074,24,2.2
CN4610900000000,2022-06-01,46,109,SD,Roberts County,4696,4564,132,2.8
CN4611100000000,2022-06-01,46,111,SD,Sanborn County,1240,1216,24,1.9
CN4611500000000,2022-06-01,46,115,SD,Spink County,3082,3008,74,2.4
CN4611700000000,2022-06-01,46,117,SD,Stanley County,1968,1934,34,1.7
CN4611900000000,2022-06-01,46,119,SD,Sully County,821,805,16,1.9
CN4612100000000,2022-06-01,46,121,SD,Todd County,3095,2963,132,4.3
CN4612300000000,2022-06-01,46,123,SD,Tripp County,3146,3095,51,1.6
CN4612500000000,2022-06-01,46,125,SD,Turner County,4758,4667,91,1.9
CN4612700000000,2022-06-01,46,127,SD,Union County,8695,8494,201,2.3
CN4612900000000,2022-06-01,46,129,SD,Walworth County,2174,2106,68,3.1
CN4613500000000,2022-06-01,46,135,SD,Yankton County,11992,11752,240,2
CN4613700000000,2022-06-01,46,137,SD,Ziebach County,978,927,51,5.2
CN4700100000000,2022-06-01,47,001,TN,Anderson County,35665,34175,1490,4.2
CN4700300000000,2022-06-01,47,003,TN,Bedford County,22042,21135,907,4.1
CN4700500000000,2022-06-01,47,005,TN,Benton County,6870,6541,329,4.8
CN4700700000000,2022-06-01,47,007,TN,Bledsoe County,4381,4098,283,6.5
CN4700900000000,2022-06-01,47,009,TN,Blount County,66294,63755,2539,3.8
CN4701100000000,2022-06-01,47,011,TN,Bradley County,50860,48679,2181,4.3
CN4701300000000,2022-06-01,47,013,TN,Campbell County,15183,14405,778,5.1
CN4701500000000,2022-06-01,47,015,TN,Cannon County,6989,6721,268,3.8
CN4701700000000,2022-06-01,47,017,TN,Carroll County,11740,11189,551,4.7
CN4701900000000,2022-06-01,47,019,TN,Carter County,24173,23101,1072,4.4
CN4702100000000,2022-06-01,47,021,TN,Cheatham County,22907,22186,721,3.1
CN4702300000000,2022-06-01,47,023,TN,Chester County,8659,8341,318,3.7
CN4702500000000,2022-06-01,47,025,TN,Claiborne County,13072,12433,639,4.9
CN4702700000000,2022-06-01,47,027,TN,Clay County,2773,2615,158,5.7
CN4702900000000,2022-06-01,47,029,TN,Cocke County,14988,14147,841,5.6
CN4703100000000,2022-06-01,47,031,TN,Coffee County,25537,24493,1044,4.1
CN4703300000000,2022-06-01,47,033,TN,Crockett County,7013,6752,261,3.7
CN4703500000000,2022-06-01,47,035,TN,Cumberland County,23640,22487,1153,4.9
CN4703700000000,2022-06-01,47,037,TN,Davidson County,417076,403370,13706,3.3
CN4703900000000,2022-06-01,47,039,TN,Decatur County,4443,4210,233,5.2
CN4704100000000,2022-06-01,47,041,TN,DeKalb County,8244,7860,384,4.7
CN4704300000000,2022-06-01,47,043,TN,Dickson County,28278,27279,999,3.5
CN4704500000000,2022-06-01,47,045,TN,Dyer County,16784,16086,698,4.2
CN4704700000000,2022-06-01,47,047,TN,Fayette County,19557,18771,786,4
CN4704900000000,2022-06-01,47,049,TN,Fentress County,7824,7462,362,4.6
CN4705100000000,2022-06-01,47,051,TN,Franklin County,19678,18839,839,4.3
CN4705300000000,2022-06-01,47,053,TN,Gibson County,21788,20863,925,4.2
CN4705500000000,2022-06-01,47,055,TN,Giles County,15085,14474,611,4.1
CN4705700000000,2022-06-01,47,057,TN,Grainger County,9911,9439,472,4.8
CN4705900000000,2022-06-01,47,059,TN,Greene County,29097,27678,1419,4.9
CN4706100000000,2022-06-01,47,061,TN,Grundy County,4853,4570,283,5.8
CN4706300000000,2022-06-01,47,063,TN,Hamblen County,28478,27202,1276,4.5
CN4706500000000,2022-06-01,47,065,TN,Hamilton County,184288,176865,7423,4
CN4706700000000,2022-06-01,47,067,TN,Hancock County,2282,2159,123,5.4
CN4706900000000,2022-06-01,47,069,TN,Hardeman County,9073,8638,435,4.8
CN4707100000000,2022-06-01,47,071,TN,Hardin County,10143,9649,494,4.9
CN4707300000000,2022-06-01,47,073,TN,Hawkins County,23364,22220,1144,4.9
CN4707500000000,2022-06-01,47,075,TN,Haywood County,7711,7291,420,5.4
CN4707700000000,2022-06-01,47,077,TN,Henderson County,11880,11357,523,4.4
CN4707900000000,2022-06-01,47,079,TN,Henry County,13833,13205,628,4.5
CN4708100000000,2022-06-01,47,081,TN,Hickman County,11927,11516,411,3.4
CN4708300000000,2022-06-01,47,083,TN,Houston County,3181,3018,163,5.1
CN4708500000000,2022-06-01,47,085,TN,Humphreys County,8613,8255,358,4.2
CN4708700000000,2022-06-01,47,087,TN,Jackson County,4826,4591,235,4.9
CN4708900000000,2022-06-01,47,089,TN,Jefferson County,25262,24177,1085,4.3
CN4709100000000,2022-06-01,47,091,TN,Johnson County,7503,7198,305,4.1
CN4709300000000,2022-06-01,47,093,TN,Knox County,253325,244336,8989,3.5
CN4709500000000,2022-06-01,47,095,TN,Lake County,1675,1585,90,5.4
CN4709700000000,2022-06-01,47,097,TN,Lauderdale County,9507,8995,512,5.4
CN4709900000000,2022-06-01,47,099,TN,Lawrence County,19455,18633,822,4.2
CN4710100000000,2022-06-01,47,101,TN,Lewis County,5675,5433,242,4.3
CN4710300000000,2022-06-01,47,103,TN,Lincoln County,16769,16121,648,3.9
CN4710500000000,2022-06-01,47,105,TN,Loudon County,24783,23795,988,4
CN4710700000000,2022-06-01,47,107,TN,McMinn County,21709,20666,1043,4.8
CN4710900000000,2022-06-01,47,109,TN,McNairy County,8550,8073,477,5.6
CN4711100000000,2022-06-01,47,111,TN,Macon County,11983,11539,444,3.7
CN4711300000000,2022-06-01,47,113,TN,Madison County,49470,47495,1975,4
CN4711500000000,2022-06-01,47,115,TN,Marion County,12383,11807,576,4.7
CN4711700000000,2022-06-01,47,117,TN,Marshall County,15640,15007,633,4
CN4711900000000,2022-06-01,47,119,TN,Maury County,53649,51707,1942,3.6
CN4712100000000,2022-06-01,47,121,TN,Meigs County,5158,4903,255,4.9
CN4712300000000,2022-06-01,47,123,TN,Monroe County,21327,20462,865,4.1
CN4712500000000,2022-06-01,47,125,TN,Montgomery County,88803,84875,3928,4.4
CN4712700000000,2022-06-01,47,127,TN,Moore County,3769,3648,121,3.2
CN4712900000000,2022-06-01,47,129,TN,Morgan County,7954,7591,363,4.6
CN4713100000000,2022-06-01,47,131,TN,Obion County,12931,12342,589,4.6
CN4713300000000,2022-06-01,47,133,TN,Overton County,10169,9747,422,4.1
CN4713500000000,2022-06-01,47,135,TN,Perry County,2841,2678,163,5.7
CN4713700000000,2022-06-01,47,137,TN,Pickett County,2252,2146,106,4.7
CN4713900000000,2022-06-01,47,139,TN,Polk County,7142,6834,308,4.3
CN4714100000000,2022-06-01,47,141,TN,Putnam County,35518,34057,1461,4.1
CN4714300000000,2022-06-01,47,143,TN,Rhea County,13939,13238,701,5
CN4714500000000,2022-06-01,47,145,TN,Roane County,24070,22972,1098,4.6
CN4714700000000,2022-06-01,47,147,TN,Robertson County,39849,38515,1334,3.3
CN4714900000000,2022-06-01,47,149,TN,Rutherford County,197690,191275,6415,3.2
CN4715100000000,2022-06-01,47,151,TN,Scott County,8263,7769,494,6
CN4715300000000,2022-06-01,47,153,TN,Sequatchie County,6230,5931,299,4.8
CN4715500000000,2022-06-01,47,155,TN,Sevier County,56889,55039,1850,3.3
CN4715700000000,2022-06-01,47,157,TN,Shelby County,441945,419364,22581,5.1
CN4715900000000,2022-06-01,47,159,TN,Smith County,9929,9566,363,3.7
CN4716100000000,2022-06-01,47,161,TN,Stewart County,5494,5241,253,4.6
CN4716300000000,2022-06-01,47,163,TN,Sullivan County,69242,66210,3032,4.4
CN4716500000000,2022-06-01,47,165,TN,Sumner County,110030,106440,3590,3.3
CN4716700000000,2022-06-01,47,167,TN,Tipton County,27974,26768,1206,4.3
CN4716900000000,2022-06-01,47,169,TN,Trousdale County,5819,5606,213,3.7
CN4717100000000,2022-06-01,47,171,TN,Unicoi County,7161,6796,365,5.1
CN4717300000000,2022-06-01,47,173,TN,Union County,7984,7599,385,4.8
CN4717500000000,2022-06-01,47,175,TN,Van Buren County,2060,1941,119,5.8
CN4717700000000,2022-06-01,47,177,TN,Warren County,16705,15828,877,5.2
CN4717900000000,2022-06-01,47,179,TN,Washington County,61502,59068,2434,4
CN4718100000000,2022-06-01,47,181,TN,Wayne County,6590,6260,330,5
CN4718300000000,2022-06-01,47,183,TN,Weakley County,15231,14594,637,4.2
CN4718500000000,2022-06-01,47,185,TN,White County,12027,11491,536,4.5
CN4718700000000,2022-06-01,47,187,TN,Williamson County,139737,135741,3996,2.9
CN4718900000000,2022-06-01,47,189,TN,Wilson County,82982,80342,2640,3.2
CN4800100000000,2022-06-01,48,001,TX,Anderson County,23000,22141,859,3.7
CN4800300000000,2022-06-01,48,003,TX,Andrews County,9509,9186,323,3.4
CN4800500000000,2022-06-01,48,005,TX,Angelina County,35296,33551,1745,4.9
CN4800700000000,2022-06-01,48,007,TX,Aransas County,9323,8824,499,5.4
CN4800900000000,2022-06-01,48,009,TX,Archer County,4056,3902,154,3.8
CN4801100000000,2022-06-01,48,011,TX,Armstrong County,944,915,29,3.1
CN4801300000000,2022-06-01,48,013,TX,Atascosa County,22617,21631,986,4.4
CN4801500000000,2022-06-01,48,015,TX,Austin County,14183,13567,616,4.3
CN4801700000000,2022-06-01,48,017,TX,Bailey County,2455,2335,120,4.9
CN4801900000000,2022-06-01,48,019,TX,Bandera County,10667,10252,415,3.9
CN4802100000000,2022-06-01,48,021,TX,Bastrop County,48357,46544,1813,3.7
CN4802300000000,2022-06-01,48,023,TX,Baylor County,1891,1837,54,2.9
CN4802500000000,2022-06-01,48,025,TX,Bee County,9245,8653,592,6.4
CN4802700000000,2022-06-01,48,027,TX,Bell County,149089,141970,7119,4.8
CN4802900000000,2022-06-01,48,029,TX,Bexar County,981503,942295,39208,4
CN4803100000000,2022-06-01,48,031,TX,Blanco County,7184,6965,219,3
CN4803300000000,2022-06-01,48,033,TX,Borden County,642,629,13,2
CN4803500000000,2022-06-01,48,035,TX,Bosque County,8757,8405,352,4
CN4803700000000,2022-06-01,48,037,TX,Bowie County,38952,37060,1892,4.9
CN4803900000000,2022-06-01,48,039,TX,Brazoria County,184860,175903,8957,4.8
CN4804100000000,2022-06-01,48,041,TX,Brazos County,125060,120580,4480,3.6
CN4804300000000,2022-06-01,48,043,TX,Brewster County,4180,4022,158,3.8
CN4804500000000,2022-06-01,48,045,TX,Briscoe County,617,595,22,3.6
CN4804700000000,2022-06-01,48,047,TX,Brooks County,2352,2190,162,6.9
CN4804900000000,2022-06-01,48,049,TX,Brown County,15354,14655,699,4.6
CN4805100000000,2022-06-01,48,051,TX,Burleson County,8620,8292,328,3.8
CN4805300000000,2022-06-01,48,053,TX,Burnet County,25557,24744,813,3.2
CN4805500000000,2022-06-01,48,055,TX,Caldwell County,21383,20538,845,4
CN4805700000000,2022-06-01,48,057,TX,Calhoun County,12374,11855,519,4.2
CN4805900000000,2022-06-01,48,059,TX,Callahan County,6256,6018,238,3.8
CN4806100000000,2022-06-01,48,061,TX,Cameron County,177200,166368,10832,6.1
CN4806300000000,2022-06-01,48,063,TX,Camp County,5149,4898,251,4.9
CN4806500000000,2022-06-01,48,065,TX,Carson County,3025,2931,94,3.1
CN4806700000000,2022-06-01,48,067,TX,Cass County,12117,11514,603,5
CN4806900000000,2022-06-01,48,069,TX,Castro County,3420,3303,117,3.4
CN4807100000000,2022-06-01,48,071,TX,Chambers County,21062,19881,1181,5.6
CN4807300000000,2022-06-01,48,073,TX,Cherokee County,20802,19824,978,4.7
CN4807500000000,2022-06-01,48,075,TX,Childress County,3238,3136,102,3.2
CN4807700000000,2022-06-01,48,077,TX,Clay County,4914,4709,205,4.2
CN4807900000000,2022-06-01,48,079,TX,Cochran County,1172,1114,58,4.9
CN4808100000000,2022-06-01,48,081,TX,Coke County,1489,1431,58,3.9
CN4808300000000,2022-06-01,48,083,TX,Coleman County,3111,2977,134,4.3
CN4808500000000,2022-06-01,48,085,TX,Collin County,624236,602597,21639,3.5
CN4808700000000,2022-06-01,48,087,TX,Collingsworth County,1126,1083,43,3.8
CN4808900000000,2022-06-01,48,089,TX,Colorado County,10489,10105,384,3.7
CN4809100000000,2022-06-01,48,091,TX,Comal County,82651,79464,3187,3.9
CN4809300000000,2022-06-01,48,093,TX,Comanche County,6314,6077,237,3.8
CN4809500000000,2022-06-01,48,095,TX,Concho County,1337,1291,46,3.4
CN4809700000000,2022-06-01,48,097,TX,Cooke County,20458,19602,856,4.2
CN4809900000000,2022-06-01,48,099,TX,Coryell County,24651,23454,1197,4.9
CN4810100000000,2022-06-01,48,101,TX,Cottle County,874,847,27,3.1
CN4810300000000,2022-06-01,48,103,TX,Crane County,1560,1472,88,5.6
CN4810500000000,2022-06-01,48,105,TX,Crockett County,1417,1356,61,4.3
CN4810700000000,2022-06-01,48,107,TX,Crosby County,2426,2319,107,4.4
CN4810900000000,2022-06-01,48,109,TX,Culberson County,1190,1155,35,2.9
CN4811100000000,2022-06-01,48,111,TX,Dallam County,3919,3820,99,2.5
CN4811300000000,2022-06-01,48,113,TX,Dallas County,1417830,1361727,56103,4
CN4811500000000,2022-06-01,48,115,TX,Dawson County,4546,4336,210,4.6
CN4811700000000,2022-06-01,48,117,TX,Deaf Smith County,9051,8740,311,3.4
CN4811900000000,2022-06-01,48,119,TX,Delta County,2467,2358,109,4.4
CN4812100000000,2022-06-01,48,121,TX,Denton County,550544,531163,19381,3.5
CN4812300000000,2022-06-01,48,123,TX,DeWitt County,9124,8778,346,3.8
CN4812500000000,2022-06-01,48,125,TX,Dickens County,713,675,38,5.3
CN4812700000000,2022-06-01,48,127,TX,Dimmit County,6240,5962,278,4.5
CN4812900000000,2022-06-01,48,129,TX,Donley County,1536,1475,61,4
CN4813100000000,2022-06-01,48,131,TX,Duval County,5028,4791,237,4.7
CN4813300000000,2022-06-01,48,133,TX,Eastland County,6712,6363,349,5.2
CN4813500000000,2022-06-01,48,135,TX,Ector County,82707,79258,3449,4.2
CN4813700000000,2022-06-01,48,137,TX,Edwards County,1226,1188,38,3.1
CN4813900000000,2022-06-01,48,139,TX,Ellis County,103201,99280,3921,3.8
CN4814100000000,2022-06-01,48,141,TX,El Paso County,369370,352563,16807,4.6
CN4814300000000,2022-06-01,48,143,TX,Erath County,20753,19900,853,4.1
CN4814500000000,2022-06-01,48,145,TX,Falls County,6767,6466,301,4.4
CN4814700000000,2022-06-01,48,147,TX,Fannin County,17347,16737,610,3.5
CN4814900000000,2022-06-01,48,149,TX,Fayette County,11984,11533,451,3.8
CN4815100000000,2022-06-01,48,151,TX,Fisher County,1650,1584,66,4
CN4815300000000,2022-06-01,48,153,TX,Floyd County,2485,2375,110,4.4
CN4815500000000,2022-06-01,48,155,TX,Foard County,554,536,18,3.2
CN4815700000000,2022-06-01,48,157,TX,Fort Bend County,419379,401796,17583,4.2
CN4815900000000,2022-06-01,48,159,TX,Franklin County,5402,5213,189,3.5
CN4816100000000,2022-06-01,48,161,TX,Freestone County,6390,6015,375,5.9
CN4816300000000,2022-06-01,48,163,TX,Frio County,9362,9000,362,3.9
CN4816500000000,2022-06-01,48,165,TX,Gaines County,10159,9820,339,3.3
CN4816700000000,2022-06-01,48,167,TX,Galveston County,169417,161485,7932,4.7
CN4816900000000,2022-06-01,48,169,TX,Garza County,1974,1892,82,4.2
CN4817100000000,2022-06-01,48,171,TX,Gillespie County,14756,14333,423,2.9
CN4817300000000,2022-06-01,48,173,TX,Glasscock County,861,834,27,3.1
CN4817500000000,2022-06-01,48,175,TX,Goliad County,3198,3049,149,4.7
CN4817700000000,2022-06-01,48,177,TX,Gonzales County,9513,9169,344,3.6
CN4817900000000,2022-06-01,48,179,TX,Gray County,7795,7417,378,4.8
CN4818100000000,2022-06-01,48,181,TX,Grayson County,66109,63479,2630,4
CN4818300000000,2022-06-01,48,183,TX,Gregg County,56734,54183,2551,4.5
CN4818500000000,2022-06-01,48,185,TX,Grimes County,11339,10766,573,5.1
CN4818700000000,2022-06-01,48,187,TX,Guadalupe County,85891,82711,3180,3.7
CN4818900000000,2022-06-01,48,189,TX,Hale County,11793,11102,691,5.9
CN4819100000000,2022-06-01,48,191,TX,Hall County,1123,1077,46,4.1
CN4819300000000,2022-06-01,48,193,TX,Hamilton County,3895,3753,142,3.6
CN4819500000000,2022-06-01,48,195,TX,Hansford County,2911,2834,77,2.6
CN4819700000000,2022-06-01,48,197,TX,Hardeman County,1815,1748,67,3.7
CN4819900000000,2022-06-01,48,199,TX,Hardin County,24873,23506,1367,5.5
CN4820100000000,2022-06-01,48,201,TX,Harris County,2344511,2238918,105593,4.5
CN4820300000000,2022-06-01,48,203,TX,Harrison County,28987,27588,1399,4.8
CN4820500000000,2022-06-01,48,205,TX,Hartley County,2670,2614,56,2.1
CN4820700000000,2022-06-01,48,207,TX,Haskell County,2775,2687,88,3.2
CN4820900000000,2022-06-01,48,209,TX,Hays County,138924,134314,4610,3.3
CN4821100000000,2022-06-01,48,211,TX,Hemphill County,1659,1601,58,3.5
CN4821300000000,2022-06-01,48,213,TX,Henderson County,39281,37668,1613,4.1
CN4821500000000,2022-06-01,48,215,TX,Hidalgo County,372591,346299,26292,7.1
CN4821700000000,2022-06-01,48,217,TX,Hill County,17759,17040,719,4
CN4821900000000,2022-06-01,48,219,TX,Hockley County,10961,10518,443,4
CN4822100000000,2022-06-01,48,221,TX,Hood County,29934,28758,1176,3.9
CN4822300000000,2022-06-01,48,223,TX,Hopkins County,18335,17684,651,3.6
CN4822500000000,2022-06-01,48,225,TX,Houston County,10706,10298,408,3.8
CN4822700000000,2022-06-01,48,227,TX,Howard County,13277,12544,733,5.5
CN4822900000000,2022-06-01,48,229,TX,Hudspeth County,1885,1807,78,4.1
CN4823100000000,2022-06-01,48,231,TX,Hunt County,46753,44792,1961,4.2
CN4823300000000,2022-06-01,48,233,TX,Hutchinson County,8551,8151,400,4.7
CN4823500000000,2022-06-01,48,235,TX,Irion County,796,770,26,3.3
CN4823700000000,2022-06-01,48,237,TX,Jack County,3488,3349,139,4
CN4823900000000,2022-06-01,48,239,TX,Jackson County,7193,6921,272,3.8
CN4824100000000,2022-06-01,48,241,TX,Jasper County,12449,11583,866,7
CN4824300000000,2022-06-01,48,243,TX,Jeff Davis County,1040,1005,35,3.4
CN4824500000000,2022-06-01,48,245,TX,Jefferson County,100958,94405,6553,6.5
CN4824700000000,2022-06-01,48,247,TX,Jim Hogg County,1780,1678,102,5.7
CN4824900000000,2022-06-01,48,249,TX,Jim Wells County,15393,14452,941,6.1
CN4825100000000,2022-06-01,48,251,TX,Johnson County,89137,85717,3420,3.8
CN4825300000000,2022-06-01,48,253,TX,Jones County,5824,5538,286,4.9
CN4825500000000,2022-06-01,48,255,TX,Karnes County,6662,6416,246,3.7
CN4825700000000,2022-06-01,48,257,TX,Kaufman County,74950,71931,3019,4
CN4825900000000,2022-06-01,48,259,TX,Kendall County,23872,23049,823,3.4
CN4826100000000,2022-06-01,48,261,TX,Kenedy County,126,116,10,7.9
CN4826300000000,2022-06-01,48,263,TX,Kent County,562,549,13,2.3
CN4826500000000,2022-06-01,48,265,TX,Kerr County,22687,21821,866,3.8
CN4826700000000,2022-06-01,48,267,TX,Kimble County,1932,1866,66,3.4
CN4826900000000,2022-06-01,48,269,TX,King County,565,559,6,1.1
CN4827100000000,2022-06-01,48,271,TX,Kinney County,1280,1214,66,5.2
CN4827300000000,2022-06-01,48,273,TX,Kleberg County,12981,12309,672,5.2
CN4827500000000,2022-06-01,48,275,TX,Knox County,1503,1439,64,4.3
CN4827700000000,2022-06-01,48,277,TX,Lamar County,24511,23445,1066,4.3
CN4827900000000,2022-06-01,48,279,TX,Lamb County,5457,5219,238,4.4
CN4828100000000,2022-06-01,48,281,TX,Lampasas County,9414,9043,371,3.9
CN4828300000000,2022-06-01,48,283,TX,La Salle County,4124,3983,141,3.4
CN4828500000000,2022-06-01,48,285,TX,Lavaca County,9251,8918,333,3.6
CN4828700000000,2022-06-01,48,287,TX,Lee County,9026,8682,344,3.8
CN4828900000000,2022-06-01,48,289,TX,Leon County,6034,5698,336,5.6
CN4829100000000,2022-06-01,48,291,TX,Liberty County,35439,33206,2233,6.3
CN4829300000000,2022-06-01,48,293,TX,Limestone County,8499,8073,426,5
CN4829500000000,2022-06-01,48,295,TX,Lipscomb County,1482,1432,50,3.4
CN4829700000000,2022-06-01,48,297,TX,Live Oak County,4965,4746,219,4.4
CN4829900000000,2022-06-01,48,299,TX,Llano County,9564,9181,383,4
CN4830100000000,2022-06-01,48,301,TX,Loving County,447,442,5,1.1
CN4830300000000,2022-06-01,48,303,TX,Lubbock County,163680,157249,6431,3.9
CN4830500000000,2022-06-01,48,305,TX,Lynn County,2885,2767,118,4.1
CN4830700000000,2022-06-01,48,307,TX,McCulloch County,3138,2997,141,4.5
CN4830900000000,2022-06-01,48,309,TX,McLennan County,125623,120537,5086,4
CN4831100000000,2022-06-01,48,311,TX,McMullen County,919,901,18,2
CN4831300000000,2022-06-01,48,313,TX,Madison County,4767,4533,234,4.9
CN4831500000000,2022-06-01,48,315,TX,Marion County,4218,3999,219,5.2
CN4831700000000,2022-06-01,48,317,TX,Martin County,2798,2699,99,3.5
CN4831900000000,2022-06-01,48,319,TX,Mason County,1835,1769,66,3.6
CN4832100000000,2022-06-01,48,321,TX,Matagorda County,17009,15895,1114,6.5
CN4832300000000,2022-06-01,48,323,TX,Maverick County,23332,21509,1823,7.8
CN4832500000000,2022-06-01,48,325,TX,Medina County,22798,21842,956,4.2
CN4832700000000,2022-06-01,48,327,TX,Menard County,851,819,32,3.8
CN4832900000000,2022-06-01,48,329,TX,Midland County,105484,102153,3331,3.2
CN4833100000000,2022-06-01,48,331,TX,Milam County,10360,9877,483,4.7
CN4833300000000,2022-06-01,48,333,TX,Mills County,1921,1839,82,4.3
CN4833500000000,2022-06-01,48,335,TX,Mitchell County,2355,2246,109,4.6
CN4833700000000,2022-06-01,48,337,TX,Montague County,9297,8919,378,4.1
CN4833900000000,2022-06-01,48,339,TX,Montgomery County,302512,289868,12644,4.2
CN4834100000000,2022-06-01,48,341,TX,Moore County,11284,10959,325,2.9
CN4834300000000,2022-06-01,48,343,TX,Morris County,4448,4165,283,6.4
CN4834500000000,2022-06-01,48,345,TX,Motley County,535,513,22,4.1
CN4834700000000,2022-06-01,48,347,TX,Nacogdoches County,27901,26585,1316,4.7
CN4834900000000,2022-06-01,48,349,TX,Navarro County,23687,22699,988,4.2
CN4835100000000,2022-06-01,48,351,TX,Newton County,4870,4527,343,7
CN4835300000000,2022-06-01,48,353,TX,Nolan County,6950,6668,282,4.1
CN4835500000000,2022-06-01,48,355,TX,Nueces County,164784,156559,8225,5
CN4835700000000,2022-06-01,48,357,TX,Ochiltree County,4085,3939,146,3.6
CN4835900000000,2022-06-01,48,359,TX,Oldham County,941,912,29,3.1
CN4836100000000,2022-06-01,48,361,TX,Orange County,34799,32712,2087,6
CN4836300000000,2022-06-01,48,363,TX,Palo Pinto County,13296,12773,523,3.9
CN4836500000000,2022-06-01,48,365,TX,Panola County,9524,9036,488,5.1
CN4836700000000,2022-06-01,48,367,TX,Parker County,74651,72026,2625,3.5
CN4836900000000,2022-06-01,48,369,TX,Parmer County,5182,5040,142,2.7
CN4837100000000,2022-06-01,48,371,TX,Pecos County,6475,6201,274,4.2
CN4837300000000,2022-06-01,48,373,TX,Polk County,18685,17590,1095,5.9
CN4837500000000,2022-06-01,48,375,TX,Potter County,55321,53362,1959,3.5
CN4837700000000,2022-06-01,48,377,TX,Presidio County,3106,2903,203,6.5
CN4837900000000,2022-06-01,48,379,TX,Rains County,6507,6272,235,3.6
CN4838100000000,2022-06-01,48,381,TX,Randall County,76346,73971,2375,3.1
CN4838300000000,2022-06-01,48,383,TX,Reagan County,1646,1584,62,3.8
CN4838500000000,2022-06-01,48,385,TX,Real County,1240,1186,54,4.4
CN4838700000000,2022-06-01,48,387,TX,Red River County,5195,4909,286,5.5
CN4838900000000,2022-06-01,48,389,TX,Reeves County,8569,8313,256,3
CN4839100000000,2022-06-01,48,391,TX,Refugio County,3008,2846,162,5.4
CN4839300000000,2022-06-01,48,393,TX,Roberts County,401,383,18,4.5
CN4839500000000,2022-06-01,48,395,TX,Robertson County,7796,7445,351,4.5
CN4839700000000,2022-06-01,48,397,TX,Rockwall County,59129,57002,2127,3.6
CN4839900000000,2022-06-01,48,399,TX,Runnels County,4677,4504,173,3.7
CN4840100000000,2022-06-01,48,401,TX,Rusk County,22363,21374,989,4.4
CN4840300000000,2022-06-01,48,403,TX,Sabine County,4073,3759,314,7.7
CN4840500000000,2022-06-01,48,405,TX,San Augustine County,3043,2857,186,6.1
CN4840700000000,2022-06-01,48,407,TX,San Jacinto County,12165,11544,621,5.1
CN4840900000000,2022-06-01,48,409,TX,San Patricio County,29423,27555,1868,6.3
CN4841100000000,2022-06-01,48,411,TX,San Saba County,2255,2169,86,3.8
CN4841300000000,2022-06-01,48,413,TX,Schleicher County,1266,1216,50,3.9
CN4841500000000,2022-06-01,48,415,TX,Scurry County,6248,5970,278,4.4
CN4841700000000,2022-06-01,48,417,TX,Shackelford County,1885,1829,56,3
CN4841900000000,2022-06-01,48,419,TX,Shelby County,11072,10566,506,4.6
CN4842100000000,2022-06-01,48,421,TX,Sherman County,1380,1338,42,3
CN4842300000000,2022-06-01,48,423,TX,Smith County,112438,107894,4544,4
CN4842500000000,2022-06-01,48,425,TX,Somervell County,4582,4390,192,4.2
CN4842700000000,2022-06-01,48,427,TX,Starr County,24569,21760,2809,11.4
CN4842900000000,2022-06-01,48,429,TX,Stephens County,4154,3988,166,4
CN4843100000000,2022-06-01,48,431,TX,Sterling County,540,516,24,4.4
CN4843300000000,2022-06-01,48,433,TX,Stonewall County,620,598,22,3.5
CN4843500000000,2022-06-01,48,435,TX,Sutton County,1057,993,64,6.1
CN4843700000000,2022-06-01,48,437,TX,Swisher County,2616,2501,115,4.4
CN4843900000000,2022-06-01,48,439,TX,Tarrant County,1141097,1096636,44461,3.9
CN4844100000000,2022-06-01,48,441,TX,Taylor County,68550,66044,2506,3.7
CN4844300000000,2022-06-01,48,443,TX,Terrell County,410,396,14,3.4
CN4844500000000,2022-06-01,48,445,TX,Terry County,4725,4511,214,4.5
CN4844700000000,2022-06-01,48,447,TX,Throckmorton County,727,698,29,4
CN4844900000000,2022-06-01,48,449,TX,Titus County,13805,13120,685,5
CN4845100000000,2022-06-01,48,451,TX,Tom Green County,55850,53761,2089,3.7
CN4845300000000,2022-06-01,48,453,TX,Travis County,823935,799152,24783,3
CN4845500000000,2022-06-01,48,455,TX,Trinity County,5342,5049,293,5.5
CN4845700000000,2022-06-01,48,457,TX,Tyler County,7158,6715,443,6.2
CN4845900000000,2022-06-01,48,459,TX,Upshur County,17793,16974,819,4.6
CN4846100000000,2022-06-01,48,461,TX,Upton County,2455,2381,74,3
CN4846300000000,2022-06-01,48,463,TX,Uvalde County,11456,10909,547,4.8
CN4846500000000,2022-06-01,48,465,TX,Val Verde County,21996,21023,973,4.4
CN4846700000000,2022-06-01,48,467,TX,Van Zandt County,28315,27249,1066,3.8
CN4846900000000,2022-06-01,48,469,TX,Victoria County,41349,39491,1858,4.5
CN4847100000000,2022-06-01,48,471,TX,Walker County,24003,22737,1266,5.3
CN4847300000000,2022-06-01,48,473,TX,Waller County,25563,24342,1221,4.8
CN4847500000000,2022-06-01,48,475,TX,Ward County,6258,6012,246,3.9
CN4847700000000,2022-06-01,48,477,TX,Washington County,15507,14800,707,4.6
CN4847900000000,2022-06-01,48,479,TX,Webb County,118317,113002,5315,4.5
CN4848100000000,2022-06-01,48,481,TX,Wharton County,21547,20665,882,4.1
CN4848300000000,2022-06-01,48,483,TX,Wheeler County,2022,1940,82,4.1
CN4848500000000,2022-06-01,48,485,TX,Wichita County,56012,53592,2420,4.3
CN4848700000000,2022-06-01,48,487,TX,Wilbarger County,5011,4753,258,5.1
CN4848900000000,2022-06-01,48,489,TX,Willacy County,7315,6649,666,9.1
CN4849100000000,2022-06-01,48,491,TX,Williamson County,365112,353633,11479,3.1
CN4849300000000,2022-06-01,48,493,TX,Wilson County,26101,25157,944,3.6
CN4849500000000,2022-06-01,48,495,TX,Winkler County,4016,3856,160,4
CN4849700000000,2022-06-01,48,497,TX,Wise County,34417,33039,1378,4
CN4849900000000,2022-06-01,48,499,TX,Wood County,18339,17451,888,4.8
CN4850100000000,2022-06-01,48,501,TX,Yoakum County,3332,3186,146,4.4
CN4850300000000,2022-06-01,48,503,TX,Young County,8200,7902,298,3.6
CN4850500000000,2022-06-01,48,505,TX,Zapata County,4371,4046,325,7.4
CN4850700000000,2022-06-01,48,507,TX,Zavala County,3404,3077,327,9.6
CN4900100000000,2022-06-01,49,001,UT,Beaver County,2932,2849,83,2.8
CN4900300000000,2022-06-01,49,003,UT,Box Elder County,27767,27078,689,2.5
CN4900500000000,2022-06-01,49,005,UT,Cache County,70751,69044,1707,2.4
CN4900700000000,2022-06-01,49,007,UT,Carbon County,8559,8237,322,3.8
CN4900900000000,2022-06-01,49,009,UT,Daggett County,507,489,18,3.6
CN4901100000000,2022-06-01,49,011,UT,Davis County,185402,180890,4512,2.4
CN4901300000000,2022-06-01,49,013,UT,Duchesne County,8282,7995,287,3.5
CN4901500000000,2022-06-01,49,015,UT,Emery County,4630,4461,169,3.7
CN4901700000000,2022-06-01,49,017,UT,Garfield County,3360,3226,134,4
CN4901900000000,2022-06-01,49,019,UT,Grand County,7667,7507,160,2.1
CN4902100000000,2022-06-01,49,021,UT,Iron County,27035,26264,771,2.9
CN4902300000000,2022-06-01,49,023,UT,Juab County,6358,6209,149,2.3
CN4902500000000,2022-06-01,49,025,UT,Kane County,4320,4223,97,2.2
CN4902700000000,2022-06-01,49,027,UT,Millard County,6377,6223,154,2.4
CN4902900000000,2022-06-01,49,029,UT,Morgan County,5989,5849,140,2.3
CN4903100000000,2022-06-01,49,031,UT,Piute County,529,509,20,3.8
CN4903300000000,2022-06-01,49,033,UT,Rich County,1619,1576,43,2.7
CN4903500000000,2022-06-01,49,035,UT,Salt Lake County,679382,662332,17050,2.5
CN4903700000000,2022-06-01,49,037,UT,San Juan County,5825,5555,270,4.6
CN4903900000000,2022-06-01,49,039,UT,Sanpete County,13624,13180,444,3.3
CN4904100000000,2022-06-01,49,041,UT,Sevier County,10534,10222,312,3
CN4904300000000,2022-06-01,49,043,UT,Summit County,26319,25698,621,2.4
CN4904500000000,2022-06-01,49,045,UT,Tooele County,38337,37257,1080,2.8
CN4904700000000,2022-06-01,49,047,UT,Uintah County,14354,13768,586,4.1
CN4904900000000,2022-06-01,49,049,UT,Utah County,342230,333577,8653,2.5
CN4905100000000,2022-06-01,49,051,UT,Wasatch County,18099,17642,457,2.5
CN4905300000000,2022-06-01,49,053,UT,Washington County,86691,84378,2313,2.7
CN4905500000000,2022-06-01,49,055,UT,Wayne County,1625,1570,55,3.4
CN4905700000000,2022-06-01,49,057,UT,Weber County,135900,132319,3581,2.6
CN5000100000000,2022-06-01,50,001,VT,Addison County,21072,20517,555,2.6
CN5000300000000,2022-06-01,50,003,VT,Bennington County,18004,17387,617,3.4
CN5000500000000,2022-06-01,50,005,VT,Caledonia County,14939,14441,498,3.3
CN5000700000000,2022-06-01,50,007,VT,Chittenden County,98207,95753,2454,2.5
CN5000900000000,2022-06-01,50,009,VT,Essex County,2771,2682,89,3.2
CN5001100000000,2022-06-01,50,011,VT,Franklin County,28152,27348,804,2.9
CN5001300000000,2022-06-01,50,013,VT,Grand Isle County,4141,4016,125,3
CN5001500000000,2022-06-01,50,015,VT,Lamoille County,14227,13775,452,3.2
CN5001700000000,2022-06-01,50,017,VT,Orange County,15992,15586,406,2.5
CN5001900000000,2022-06-01,50,019,VT,Orleans County,13646,13117,529,3.9
CN5002100000000,2022-06-01,50,021,VT,Rutland County,30213,29137,1076,3.6
CN5002300000000,2022-06-01,50,023,VT,Washington County,34279,33351,928,2.7
CN5002500000000,2022-06-01,50,025,VT,Windham County,21482,20802,680,3.2
CN5002700000000,2022-06-01,50,027,VT,Windsor County,29299,28549,750,2.6
CN5100100000000,2022-06-01,51,001,VA,Accomack County,16156,15641,515,3.2
CN5100300000000,2022-06-01,51,003,VA,Albemarle County,57815,56159,1656,2.9
CN5100500000000,2022-06-01,51,005,VA,Alleghany County,6697,6469,228,3.4
CN5100700000000,2022-06-01,51,007,VA,Amelia County,6368,6172,196,3.1
CN5100900000000,2022-06-01,51,009,VA,Amherst County,14822,14360,462,3.1
CN5101100000000,2022-06-01,51,011,VA,Appomattox County,7166,6928,238,3.3
CN5101300000000,2022-06-01,51,013,VA,Arlington County,158123,154734,3389,2.1
CN5101500000000,2022-06-01,51,015,VA,Augusta County,38342,37280,1062,2.8
CN5101700000000,2022-06-01,51,017,VA,Bath County,2403,2344,59,2.5
CN5101900000000,2022-06-01,51,019,VA,Bedford County,38472,37316,1156,3
CN5102100000000,2022-06-01,51,021,VA,Bland County,2776,2689,87,3.1
CN5102300000000,2022-06-01,51,023,VA,Botetourt County,17792,17315,477,2.7
CN5102500000000,2022-06-01,51,025,VA,Brunswick County,5864,5604,260,4.4
CN5102700000000,2022-06-01,51,027,VA,Buchanan County,6366,6051,315,4.9
CN5102900000000,2022-06-01,51,029,VA,Buckingham County,6421,6171,250,3.9
CN5103100000000,2022-06-01,51,031,VA,Campbell County,25783,24952,831,3.2
CN5103300000000,2022-06-01,51,033,VA,Caroline County,15437,14942,495,3.2
CN5103500000000,2022-06-01,51,035,VA,Carroll County,12999,12536,463,3.6
CN5103600000000,2022-06-01,51,036,VA,Charles City County,3651,3532,119,3.3
CN5103700000000,2022-06-01,51,037,VA,Charlotte County,5566,5394,172,3.1
CN5104100000000,2022-06-01,51,041,VA,Chesterfield County,194423,188854,5569,2.9
CN5104300000000,2022-06-01,51,043,VA,Clarke County,7823,7604,219,2.8
CN5104500000000,2022-06-01,51,045,VA,Craig County,2331,2256,75,3.2
CN5104700000000,2022-06-01,51,047,VA,Culpeper County,25846,25110,736,2.8
CN5104900000000,2022-06-01,51,049,VA,Cumberland County,4740,4571,169,3.6
CN5105100000000,2022-06-01,51,051,VA,Dickenson County,4576,4357,219,4.8
CN5105300000000,2022-06-01,51,053,VA,Dinwiddie County,13890,13436,454,3.3
CN5105700000000,2022-06-01,51,057,VA,Essex County,5494,5310,184,3.3
CN5105900000000,2022-06-01,51,059,VA,Fairfax County,643932,627441,16491,2.6
CN5106100000000,2022-06-01,51,061,VA,Fauquier County,38342,37327,1015,2.6
CN5106300000000,2022-06-01,51,063,VA,Floyd County,8362,8143,219,2.6
CN5106500000000,2022-06-01,51,065,VA,Fluvanna County,14107,13721,386,2.7
CN5106700000000,2022-06-01,51,067,VA,Franklin County,26719,25899,820,3.1
CN5106900000000,2022-06-01,51,069,VA,Frederick County,51661,50364,1297,2.5
CN5107100000000,2022-06-01,51,071,VA,Giles County,7910,7647,263,3.3
CN5107300000000,2022-06-01,51,073,VA,Gloucester County,19742,19205,537,2.7
CN5107500000000,2022-06-01,51,075,VA,Goochland County,11912,11573,339,2.8
CN5107700000000,2022-06-01,51,077,VA,Grayson County,8013,7793,220,2.7
CN5107900000000,2022-06-01,51,079,VA,Greene County,10583,10312,271,2.6
CN5108100000000,2022-06-01,51,081,VA,Greensville County,4344,4181,163,3.8
CN5108300000000,2022-06-01,51,083,VA,Halifax County,15518,14907,611,3.9
CN5108500000000,2022-06-01,51,085,VA,Hanover County,60438,58874,1564,2.6
CN5108700000000,2022-06-01,51,087,VA,Henrico County,186049,180674,5375,2.9
CN5108900000000,2022-06-01,51,089,VA,Henry County,23525,22692,833,3.5
CN5109100000000,2022-06-01,51,091,VA,Highland County,1425,1395,30,2.1
CN5109300000000,2022-06-01,51,093,VA,Isle of Wight County,19953,19375,578,2.9
CN5109500000000,2022-06-01,51,095,VA,James City County,37382,36237,1145,3.1
CN5109700000000,2022-06-01,51,097,VA,King and Queen County,3936,3823,113,2.9
CN5109900000000,2022-06-01,51,099,VA,King George County,14521,14142,379,2.6
CN5110100000000,2022-06-01,51,101,VA,King William County,9629,9368,261,2.7
CN5110300000000,2022-06-01,51,103,VA,Lancaster County,5356,5189,167,3.1
CN5110500000000,2022-06-01,51,105,VA,Lee County,8242,7925,317,3.8
CN5110700000000,2022-06-01,51,107,VA,Loudoun County,234481,228621,5860,2.5
CN5110900000000,2022-06-01,51,109,VA,Louisa County,20833,20233,600,2.9
CN5111100000000,2022-06-01,51,111,VA,Lunenburg County,5233,5052,181,3.5
CN5111300000000,2022-06-01,51,113,VA,Madison County,7666,7486,180,2.3
CN5111500000000,2022-06-01,51,115,VA,Mathews County,4138,4014,124,3
CN5111700000000,2022-06-01,51,117,VA,Mecklenburg County,13078,12606,472,3.6
CN5111900000000,2022-06-01,51,119,VA,Middlesex County,5391,5236,155,2.9
CN5112100000000,2022-06-01,51,121,VA,Montgomery County,50449,48883,1566,3.1
CN5112500000000,2022-06-01,51,125,VA,Nelson County,7386,7169,217,2.9
CN5112700000000,2022-06-01,51,127,VA,New Kent County,13309,12981,328,2.5
CN5113100000000,2022-06-01,51,131,VA,Northampton County,5830,5647,183,3.1
CN5113300000000,2022-06-01,51,133,VA,Northumberland County,5559,5368,191,3.4
CN5113500000000,2022-06-01,51,135,VA,Nottoway County,7295,7064,231,3.2
CN5113700000000,2022-06-01,51,137,VA,Orange County,18151,17598,553,3
CN5113900000000,2022-06-01,51,139,VA,Page County,12448,12058,390,3.1
CN5114100000000,2022-06-01,51,141,VA,Patrick County,7210,6932,278,3.9
CN5114300000000,2022-06-01,51,143,VA,Pittsylvania County,30306,29299,1007,3.3
CN5114500000000,2022-06-01,51,145,VA,Powhatan County,14743,14350,393,2.7
CN5114700000000,2022-06-01,51,147,VA,Prince Edward County,9752,9298,454,4.7
CN5114900000000,2022-06-01,51,149,VA,Prince George County,15475,14937,538,3.5
CN5115300000000,2022-06-01,51,153,VA,Prince William County,252983,245915,7068,2.8
CN5115500000000,2022-06-01,51,155,VA,Pulaski County,16126,15605,521,3.2
CN5115700000000,2022-06-01,51,157,VA,Rappahannock County,3774,3672,102,2.7
CN5115900000000,2022-06-01,51,159,VA,Richmond County,4037,3926,111,2.7
CN5116100000000,2022-06-01,51,161,VA,Roanoke County,50033,48683,1350,2.7
CN5116300000000,2022-06-01,51,163,VA,Rockbridge County,10708,10375,333,3.1
CN5116500000000,2022-06-01,51,165,VA,Rockingham County,43147,41928,1219,2.8
CN5116700000000,2022-06-01,51,167,VA,Russell County,10977,10579,398,3.6
CN5116900000000,2022-06-01,51,169,VA,Scott County,9202,8895,307,3.3
CN5117100000000,2022-06-01,51,171,VA,Shenandoah County,22361,21723,638,2.9
CN5117300000000,2022-06-01,51,173,VA,Smyth County,13625,13178,447,3.3
CN5117500000000,2022-06-01,51,175,VA,Southampton County,9045,8784,261,2.9
CN5117700000000,2022-06-01,51,177,VA,Spotsylvania County,70060,67947,2113,3
CN5117900000000,2022-06-01,51,179,VA,Stafford County,76326,74073,2253,3
CN5118100000000,2022-06-01,51,181,VA,Surry County,3628,3519,109,3
CN5118300000000,2022-06-01,51,183,VA,Sussex County,3792,3640,152,4
CN5118500000000,2022-06-01,51,185,VA,Tazewell County,15446,14788,658,4.3
CN5118700000000,2022-06-01,51,187,VA,Warren County,20960,20335,625,3
CN5119100000000,2022-06-01,51,191,VA,Washington County,26363,25525,838,3.2
CN5119300000000,2022-06-01,51,193,VA,Westmoreland County,9788,9486,302,3.1
CN5119500000000,2022-06-01,51,195,VA,Wise County,12656,12090,566,4.5
CN5119700000000,2022-06-01,51,197,VA,Wythe County,14174,13713,461,3.3
CN5119900000000,2022-06-01,51,199,VA,York County,33527,32553,974,2.9
CN5151000000000,2022-06-01,51,510,VA,Alexandria city,101552,99141,2411,2.4
CN5152000000000,2022-06-01,51,520,VA,Bristol city,7534,7264,270,3.6
CN5153000000000,2022-06-01,51,530,VA,Buena Vista city,3033,2924,109,3.6
CN5154000000000,2022-06-01,51,540,VA,Charlottesville city,25558,24812,746,2.9
CN5155000000000,2022-06-01,51,550,VA,Chesapeake city,125193,121424,3769,3
CN5157000000000,2022-06-01,51,570,VA,Colonial Heights city,8562,8285,277,3.2
CN5158000000000,2022-06-01,51,580,VA,Covington city,2296,2205,91,4
CN5159000000000,2022-06-01,51,590,VA,Danville city,18629,17745,884,4.7
CN5159500000000,2022-06-01,51,595,VA,Emporia city,2349,2242,107,4.6
CN5160000000000,2022-06-01,51,600,VA,Fairfax city,13007,12682,325,2.5
CN5161000000000,2022-06-01,51,610,VA,Falls Church city,8629,8428,201,2.3
CN5162000000000,2022-06-01,51,620,VA,Franklin city,3464,3320,144,4.2
CN5163000000000,2022-06-01,51,630,VA,Fredericksburg city,14496,13987,509,3.5
CN5164000000000,2022-06-01,51,640,VA,Galax city,2866,2769,97,3.4
CN5165000000000,2022-06-01,51,650,VA,Hampton city,64959,62508,2451,3.8
CN5166000000000,2022-06-01,51,660,VA,Harrisonburg city,24887,23927,960,3.9
CN5167000000000,2022-06-01,51,670,VA,Hopewell city,9648,9246,402,4.2
CN5167800000000,2022-06-01,51,678,VA,Lexington city,2128,2026,102,4.8
CN5168000000000,2022-06-01,51,680,VA,Lynchburg city,35709,34199,1510,4.2
CN5168300000000,2022-06-01,51,683,VA,Manassas city,21911,21325,586,2.7
CN5168500000000,2022-06-01,51,685,VA,Manassas Park city,9866,9616,250,2.5
CN5169000000000,2022-06-01,51,690,VA,Martinsville city,5457,5223,234,4.3
CN5170000000000,2022-06-01,51,700,VA,Newport News city,89178,85972,3206,3.6
CN5171000000000,2022-06-01,51,710,VA,Norfolk city,111125,107230,3895,3.5
CN5172000000000,2022-06-01,51,720,VA,Norton city,1586,1517,69,4.4
CN5173000000000,2022-06-01,51,730,VA,Petersburg city,12617,11950,667,5.3
CN5173500000000,2022-06-01,51,735,VA,Poquoson city,6468,6296,172,2.7
CN5174000000000,2022-06-01,51,740,VA,Portsmouth city,44471,42764,1707,3.8
CN5175000000000,2022-06-01,51,750,VA,Radford city,8725,8374,351,4
CN5176000000000,2022-06-01,51,760,VA,Richmond city,121143,117014,4129,3.4
CN5177000000000,2022-06-01,51,770,VA,Roanoke city,49193,47579,1614,3.3
CN5177500000000,2022-06-01,51,775,VA,Salem city,12949,12548,401,3.1
CN5179000000000,2022-06-01,51,790,VA,Staunton city,12395,12031,364,2.9
CN5180000000000,2022-06-01,51,800,VA,Suffolk city,46107,44627,1480,3.2
CN5181000000000,2022-06-01,51,810,VA,Virginia Beach city,234112,227397,6715,2.9
CN5182000000000,2022-06-01,51,820,VA,Waynesboro city,10749,10418,331,3.1
CN5183000000000,2022-06-01,51,830,VA,Williamsburg city,6895,6587,308,4.5
CN5184000000000,2022-06-01,51,840,VA,Winchester city,15191,14768,423,2.8
CN5300100000000,2022-06-01,53,001,WA,Adams County,10459,10031,428,4.1
CN5300300000000,2022-06-01,53,003,WA,Asotin County,10620,10198,422,4
CN5300500000000,2022-06-01,53,005,WA,Benton County,108505,103463,5042,4.6
CN5300700000000,2022-06-01,53,007,WA,Chelan County,45765,43820,1945,4.2
CN5300900000000,2022-06-01,53,009,WA,Clallam County,29215,27602,1613,5.5
CN5301100000000,2022-06-01,53,011,WA,Clark County,245216,233736,11480,4.7
CN5301300000000,2022-06-01,53,013,WA,Columbia County,1757,1672,85,4.8
CN5301500000000,2022-06-01,53,015,WA,Cowlitz County,48649,45984,2665,5.5
CN5301700000000,2022-06-01,53,017,WA,Douglas County,23056,21964,1092,4.7
CN5301900000000,2022-06-01,53,019,WA,Ferry County,2309,2117,192,8.3
CN5302100000000,2022-06-01,53,021,WA,Franklin County,46518,44031,2487,5.3
CN5302300000000,2022-06-01,53,023,WA,Garfield County,814,762,52,6.4
CN5302500000000,2022-06-01,53,025,WA,Grant County,51402,48870,2532,4.9
CN5302700000000,2022-06-01,53,027,WA,Grays Harbor County,29241,27408,1833,6.3
CN5302900000000,2022-06-01,53,029,WA,Island County,37059,35313,1746,4.7
CN5303100000000,2022-06-01,53,031,WA,Jefferson County,12707,12035,672,5.3
CN5303300000000,2022-06-01,53,033,WA,King County,1318788,1280549,38239,2.9
CN5303500000000,2022-06-01,53,035,WA,Kitsap County,128010,122308,5702,4.5
CN5303700000000,2022-06-01,53,037,WA,Kittitas County,22903,21640,1263,5.5
CN5303900000000,2022-06-01,53,039,WA,Klickitat County,10475,9936,539,5.1
CN5304100000000,2022-06-01,53,041,WA,Lewis County,34398,32420,1978,5.8
CN5304300000000,2022-06-01,53,043,WA,Lincoln County,4639,4418,221,4.8
CN5304500000000,2022-06-01,53,045,WA,Mason County,25216,23694,1522,6
CN5304700000000,2022-06-01,53,047,WA,Okanogan County,20080,18991,1089,5.4
CN5304900000000,2022-06-01,53,049,WA,Pacific County,8572,8044,528,6.2
CN5305100000000,2022-06-01,53,051,WA,Pend Oreille County,5091,4786,305,6
CN5305300000000,2022-06-01,53,053,WA,Pierce County,448346,426217,22129,4.9
CN5305500000000,2022-06-01,53,055,WA,San Juan County,9200,8865,335,3.6
CN5305700000000,2022-06-01,53,057,WA,Skagit County,61615,58503,3112,5.1
CN5305900000000,2022-06-01,53,059,WA,Skamania County,5457,5188,269,4.9
CN5306100000000,2022-06-01,53,061,WA,Snohomish County,449300,434802,14498,3.2
CN5306300000000,2022-06-01,53,063,WA,Spokane County,260959,249154,11805,4.5
CN5306500000000,2022-06-01,53,065,WA,Stevens County,18970,17863,1107,5.8
CN5306700000000,2022-06-01,53,067,WA,Thurston County,146240,139530,6710,4.6
CN5306900000000,2022-06-01,53,069,WA,Wahkiakum County,1348,1261,87,6.5
CN5307100000000,2022-06-01,53,071,WA,Walla Walla County,30893,29484,1409,4.6
CN5307300000000,2022-06-01,53,073,WA,Whatcom County,114226,108717,5509,4.8
CN5307500000000,2022-06-01,53,075,WA,Whitman County,20998,19774,1224,5.8
CN5307700000000,2022-06-01,53,077,WA,Yakima County,137843,130571,7272,5.3
CN5400100000000,2022-06-01,54,001,WV,Barbour County,7397,7042,355,4.8
CN5400300000000,2022-06-01,54,003,WV,Berkeley County,60853,58831,2022,3.3
CN5400500000000,2022-06-01,54,005,WV,Boone County,7249,6870,379,5.2
CN5400700000000,2022-06-01,54,007,WV,Braxton County,5034,4715,319,6.3
CN5400900000000,2022-06-01,54,009,WV,Brooke County,10153,9642,511,5
CN5401100000000,2022-06-01,54,011,WV,Cabell County,42091,40353,1738,4.1
CN5401300000000,2022-06-01,54,013,WV,Calhoun County,2469,2310,159,6.4
CN5401500000000,2022-06-01,54,015,WV,Clay County,3024,2832,192,6.3
CN5401700000000,2022-06-01,54,017,WV,Doddridge County,3862,3737,125,3.2
CN5401900000000,2022-06-01,54,019,WV,Fayette County,16083,15269,814,5.1
CN5402100000000,2022-06-01,54,021,WV,Gilmer County,2357,2226,131,5.6
CN5402300000000,2022-06-01,54,023,WV,Grant County,6114,5891,223,3.6
CN5402500000000,2022-06-01,54,025,WV,Greenbrier County,15867,15177,690,4.3
CN5402700000000,2022-06-01,54,027,WV,Hampshire County,11324,10999,325,2.9
CN5402900000000,2022-06-01,54,029,WV,Hancock County,13397,12696,701,5.2
CN5403100000000,2022-06-01,54,031,WV,Hardy County,5808,5568,240,4.1
CN5403300000000,2022-06-01,54,033,WV,Harrison County,34546,33241,1305,3.8
CN5403500000000,2022-06-01,54,035,WV,Jackson County,12054,11508,546,4.5
CN5403700000000,2022-06-01,54,037,WV,Jefferson County,31687,30762,925,2.9
CN5403900000000,2022-06-01,54,039,WV,Kanawha County,81461,78168,3293,4
CN5404100000000,2022-06-01,54,041,WV,Lewis County,6540,6240,300,4.6
CN5404300000000,2022-06-01,54,043,WV,Lincoln County,7156,6763,393,5.5
CN5404500000000,2022-06-01,54,045,WV,Logan County,11782,11234,548,4.7
CN5404700000000,2022-06-01,54,047,WV,McDowell County,4279,3973,306,7.2
CN5404900000000,2022-06-01,54,049,WV,Marion County,25664,24390,1274,5
CN5405100000000,2022-06-01,54,051,WV,Marshall County,13273,12626,647,4.9
CN5405300000000,2022-06-01,54,053,WV,Mason County,10677,10164,513,4.8
CN5405500000000,2022-06-01,54,055,WV,Mercer County,20855,19787,1068,5.1
CN5405700000000,2022-06-01,54,057,WV,Mineral County,12774,12260,514,4
CN5405900000000,2022-06-01,54,059,WV,Mingo County,6291,5914,377,6
CN5406100000000,2022-06-01,54,061,WV,Monongalia County,55992,53720,2272,4.1
CN5406300000000,2022-06-01,54,063,WV,Monroe County,6364,5988,376,5.9
CN5406500000000,2022-06-01,54,065,WV,Morgan County,8800,8529,271,3.1
CN5406700000000,2022-06-01,54,067,WV,Nicholas County,9256,8807,449,4.9
CN5406900000000,2022-06-01,54,069,WV,Ohio County,20331,19438,893,4.4
CN5407100000000,2022-06-01,54,071,WV,Pendleton County,3933,3827,106,2.7
CN5407300000000,2022-06-01,54,073,WV,Pleasants County,2679,2526,153,5.7
CN5407500000000,2022-06-01,54,075,WV,Pocahontas County,3878,3735,143,3.7
CN5407700000000,2022-06-01,54,077,WV,Preston County,15618,14931,687,4.4
CN5407900000000,2022-06-01,54,079,WV,Putnam County,27368,26306,1062,3.9
CN5408100000000,2022-06-01,54,081,WV,Raleigh County,30255,29058,1197,4
CN5408300000000,2022-06-01,54,083,WV,Randolph County,11783,11225,558,4.7
CN5408500000000,2022-06-01,54,085,WV,Ritchie County,4321,4148,173,4
CN5408700000000,2022-06-01,54,087,WV,Roane County,5069,4757,312,6.2
CN5408900000000,2022-06-01,54,089,WV,Summers County,4620,4409,211,4.6
CN5409100000000,2022-06-01,54,091,WV,Taylor County,8044,7715,329,4.1
CN5409300000000,2022-06-01,54,093,WV,Tucker County,3611,3474,137,3.8
CN5409500000000,2022-06-01,54,095,WV,Tyler County,2991,2793,198,6.6
CN5409700000000,2022-06-01,54,097,WV,Upshur County,9820,9250,570,5.8
CN5409900000000,2022-06-01,54,099,WV,Wayne County,15776,15094,682,4.3
CN5410100000000,2022-06-01,54,101,WV,Webster County,3293,3143,150,4.6
CN5410300000000,2022-06-01,54,103,WV,Wetzel County,6692,6326,366,5.5
CN5410500000000,2022-06-01,54,105,WV,Wirt County,2279,2158,121,5.3
CN5410700000000,2022-06-01,54,107,WV,Wood County,37303,35688,1615,4.3
CN5410900000000,2022-06-01,54,109,WV,Wyoming County,7347,6946,401,5.5
CN5500100000000,2022-06-01,55,001,WI,Adams County,8050,7661,389,4.8
CN5500300000000,2022-06-01,55,003,WI,Ashland County,7834,7489,345,4.4
CN5500500000000,2022-06-01,55,005,WI,Barron County,24279,23474,805,3.3
CN5500700000000,2022-06-01,55,007,WI,Bayfield County,7678,7319,359,4.7
CN5500900000000,2022-06-01,55,009,WI,Brown County,142487,137859,4628,3.2
CN5501100000000,2022-06-01,55,011,WI,Buffalo County,6345,6097,248,3.9
CN5501300000000,2022-06-01,55,013,WI,Burnett County,7408,7095,313,4.2
CN5501500000000,2022-06-01,55,015,WI,Calumet County,28004,27166,838,3
CN5501700000000,2022-06-01,55,017,WI,Chippewa County,33767,32630,1137,3.4
CN5501900000000,2022-06-01,55,019,WI,Clark County,18138,17613,525,2.9
CN5502100000000,2022-06-01,55,021,WI,Columbia County,32095,31087,1008,3.1
CN5502300000000,2022-06-01,55,023,WI,Crawford County,7254,6979,275,3.8
CN5502500000000,2022-06-01,55,025,WI,Dane County,332462,323214,9248,2.8
CN5502700000000,2022-06-01,55,027,WI,Dodge County,48364,46864,1500,3.1
CN5502900000000,2022-06-01,55,029,WI,Door County,16630,16141,489,2.9
CN5503100000000,2022-06-01,55,031,WI,Douglas County,22731,21704,1027,4.5
CN5503300000000,2022-06-01,55,033,WI,Dunn County,23401,22525,876,3.7
CN5503500000000,2022-06-01,55,035,WI,Eau Claire County,60137,58231,1906,3.2
CN5503700000000,2022-06-01,55,037,WI,Florence County,2212,2134,78,3.5
CN5503900000000,2022-06-01,55,039,WI,Fond du Lac County,57318,55486,1832,3.2
CN5504100000000,2022-06-01,55,041,WI,Forest County,3913,3728,185,4.7
CN5504300000000,2022-06-01,55,043,WI,Grant County,26968,26081,887,3.3
CN5504500000000,2022-06-01,55,045,WI,Green County,21068,20469,599,2.8
CN5504700000000,2022-06-01,55,047,WI,Green Lake County,9499,9135,364,3.8
CN5504900000000,2022-06-01,55,049,WI,Iowa County,13806,13400,406,2.9
CN5505100000000,2022-06-01,55,051,WI,Iron County,2509,2391,118,4.7
CN5505300000000,2022-06-01,55,053,WI,Jackson County,9660,9294,366,3.8
CN5505500000000,2022-06-01,55,055,WI,Jefferson County,46455,44938,1517,3.3
CN5505700000000,2022-06-01,55,057,WI,Juneau County,13671,13198,473,3.5
CN5505900000000,2022-06-01,55,059,WI,Kenosha County,91123,87574,3549,3.9
CN5506100000000,2022-06-01,55,061,WI,Kewaunee County,11000,10674,326,3
CN5506300000000,2022-06-01,55,063,WI,La Crosse County,65768,63642,2126,3.2
CN5506500000000,2022-06-01,55,065,WI,Lafayette County,10453,10171,282,2.7
CN5506700000000,2022-06-01,55,067,WI,Langlade County,9496,9107,389,4.1
CN5506900000000,2022-06-01,55,069,WI,Lincoln County,15018,14476,542,3.6
CN5507100000000,2022-06-01,55,071,WI,Manitowoc County,41491,40148,1343,3.2
CN5507300000000,2022-06-01,55,073,WI,Marathon County,74406,72101,2305,3.1
CN5507500000000,2022-06-01,55,075,WI,Marinette County,19239,18394,845,4.4
CN5507700000000,2022-06-01,55,077,WI,Marquette County,7731,7449,282,3.6
CN5507800000000,2022-06-01,55,078,WI,Menominee County,1558,1453,105,6.7
CN5507900000000,2022-06-01,55,079,WI,Milwaukee County,463074,442863,20211,4.4
CN5508100000000,2022-06-01,55,081,WI,Monroe County,23476,22734,742,3.2
CN5508300000000,2022-06-01,55,083,WI,Oconto County,20824,20112,712,3.4
CN5508500000000,2022-06-01,55,085,WI,Oneida County,18641,18019,622,3.3
CN5508700000000,2022-06-01,55,087,WI,Outagamie County,105471,102149,3322,3.1
CN5508900000000,2022-06-01,55,089,WI,Ozaukee County,49316,47784,1532,3.1
CN5509100000000,2022-06-01,55,091,WI,Pepin County,4211,4076,135,3.2
CN5509300000000,2022-06-01,55,093,WI,Pierce County,24701,23837,864,3.5
CN5509500000000,2022-06-01,55,095,WI,Polk County,24872,24019,853,3.4
CN5509700000000,2022-06-01,55,097,WI,Portage County,37177,35772,1405,3.8
CN5509900000000,2022-06-01,55,099,WI,Price County,6438,6198,240,3.7
CN5510100000000,2022-06-01,55,101,WI,Racine County,99337,95249,4088,4.1
CN5510300000000,2022-06-01,55,103,WI,Richland County,9129,8831,298,3.3
CN5510500000000,2022-06-01,55,105,WI,Rock County,86449,83022,3427,4
CN5510700000000,2022-06-01,55,107,WI,Rusk County,6533,6279,254,3.9
CN5510900000000,2022-06-01,55,109,WI,St. Croix County,50048,48365,1683,3.4
CN5511100000000,2022-06-01,55,111,WI,Sauk County,35634,34506,1128,3.2
CN5511300000000,2022-06-01,55,113,WI,Sawyer County,8436,8129,307,3.6
CN5511500000000,2022-06-01,55,115,WI,Shawano County,20980,20283,697,3.3
CN5511700000000,2022-06-01,55,117,WI,Sheboygan County,63036,61105,1931,3.1
CN5511900000000,2022-06-01,55,119,WI,Taylor County,10835,10501,334,3.1
CN5512100000000,2022-06-01,55,121,WI,Trempealeau County,15203,14695,508,3.3
CN5512300000000,2022-06-01,55,123,WI,Vernon County,15572,15103,469,3
CN5512500000000,2022-06-01,55,125,WI,Vilas County,11099,10675,424,3.8
CN5512700000000,2022-06-01,55,127,WI,Walworth County,58570,56601,1969,3.4
CN5512900000000,2022-06-01,55,129,WI,Washburn County,7962,7689,273,3.4
CN5513100000000,2022-06-01,55,131,WI,Washington County,77050,74726,2324,3
CN5513300000000,2022-06-01,55,133,WI,Waukesha County,225009,218040,6969,3.1
CN5513500000000,2022-06-01,55,135,WI,Waupaca County,26124,25212,912,3.5
CN5513700000000,2022-06-01,55,137,WI,Waushara County,11271,10857,414,3.7
CN5513900000000,2022-06-01,55,139,WI,Winnebago County,92955,89892,3063,3.3
CN5514100000000,2022-06-01,55,141,WI,Wood County,34249,32911,1338,3.9
CN5600100000000,2022-06-01,56,001,WY,Albany County,20185,19416,769,3.8
CN5600300000000,2022-06-01,56,003,WY,Big Horn County,5439,5213,226,4.2
CN5600500000000,2022-06-01,56,005,WY,Campbell County,22618,21772,846,3.7
CN5600700000000,2022-06-01,56,007,WY,Carbon County,7856,7584,272,3.5
CN5600900000000,2022-06-01,56,009,WY,Converse County,7644,7399,245,3.2
CN5601100000000,2022-06-01,56,011,WY,Crook County,4093,3973,120,2.9
CN5601300000000,2022-06-01,56,013,WY,Fremont County,19208,18402,806,4.2
CN5601500000000,2022-06-01,56,015,WY,Goshen County,6644,6425,219,3.3
CN5601700000000,2022-06-01,56,017,WY,Hot Springs County,2349,2279,70,3
CN5601900000000,2022-06-01,56,019,WY,Johnson County,4478,4328,150,3.3
CN5602100000000,2022-06-01,56,021,WY,Laramie County,48590,46781,1809,3.7
CN5602300000000,2022-06-01,56,023,WY,Lincoln County,10251,9811,440,4.3
CN5602500000000,2022-06-01,56,025,WY,Natrona County,39008,37405,1603,4.1
CN5602700000000,2022-06-01,56,027,WY,Niobrara County,1271,1237,34,2.7
CN5602900000000,2022-06-01,56,029,WY,Park County,16852,16296,556,3.3
CN5603100000000,2022-06-01,56,031,WY,Platte County,4661,4500,161,3.5
CN5603300000000,2022-06-01,56,033,WY,Sheridan County,16330,15774,556,3.4
CN5603500000000,2022-06-01,56,035,WY,Sublette County,4041,3873,168,4.2
CN5603700000000,2022-06-01,56,037,WY,Sweetwater County,19335,18488,847,4.4
CN5603900000000,2022-06-01,56,039,WY,Teton County,17932,17495,437,2.4
CN5604100000000,2022-06-01,56,041,WY,Uinta County,8874,8498,376,4.2
CN5604300000000,2022-06-01,56,043,WY,Washakie County,3950,3789,161,4.1
CN5604500000000,2022-06-01,56,045,WY,Weston County,3838,3731,107,2.8
CN7200100000000,2022-06-01,72,001,PR,Adjuntas Municipio,4262,3950,312,7.3
CN7200300000000,2022-06-01,72,003,PR,Aguada Municipio,13152,12280,872,6.6
CN7200500000000,2022-06-01,72,005,PR,Aguadilla Municipio,16069,14769,1300,8.1
CN7200700000000,2022-06-01,72,007,PR,Aguas Buenas Municipio,6985,6533,452,6.5
CN7200900000000,2022-06-01,72,009,PR,Aibonito Municipio,6728,6235,493,7.3
CN7201100000000,2022-06-01,72,011,PR,Anasco Municipio,9878,9312,566,5.7
CN7201300000000,2022-06-01,72,013,PR,Arecibo Municipio,25292,23630,1662,6.6
CN7201500000000,2022-06-01,72,015,PR,Arroyo Municipio,4909,4487,422,8.6
CN7201700000000,2022-06-01,72,017,PR,Barceloneta Municipio,6331,5816,515,8.1
CN7201900000000,2022-06-01,72,019,PR,Barranquitas Municipio,7731,7185,546,7.1
CN7202100000000,2022-06-01,72,021,PR,Bayamon Municipio,69493,66174,3319,4.8
CN7202300000000,2022-06-01,72,023,PR,Cabo Rojo Municipio,15007,14031,976,6.5
CN7202500000000,2022-06-01,72,025,PR,Caguas Municipio,51165,48722,2443,4.8
CN7202700000000,2022-06-01,72,027,PR,Camuy Municipio,10218,9517,701,6.9
CN7202900000000,2022-06-01,72,029,PR,Canovanas Municipio,17467,16650,817,4.7
CN7203100000000,2022-06-01,72,031,PR,Carolina Municipio,65686,62661,3025,4.6
CN7203300000000,2022-06-01,72,033,PR,Catano Municipio,8297,7900,397,4.8
CN7203500000000,2022-06-01,72,035,PR,Cayey Municipio,17381,16509,872,5
CN7203700000000,2022-06-01,72,037,PR,Ceiba Municipio,3819,3589,230,6
CN7203900000000,2022-06-01,72,039,PR,Ciales Municipio,3904,3552,352,9
CN7204100000000,2022-06-01,72,041,PR,Cidra Municipio,16535,15787,748,4.5
CN7204300000000,2022-06-01,72,043,PR,Coamo Municipio,10810,10062,748,6.9
CN7204500000000,2022-06-01,72,045,PR,Comerio Municipio,5201,4861,340,6.5
CN7204700000000,2022-06-01,72,047,PR,Corozal Municipio,9391,8727,664,7.1
CN7204900000000,2022-06-01,72,049,PR,Culebra Municipio,1004,982,22,2.2
CN7205100000000,2022-06-01,72,051,PR,Dorado Municipio,14485,13862,623,4.3
CN7205300000000,2022-06-01,72,053,PR,Fajardo Municipio,11260,10555,705,6.3
CN7205400000000,2022-06-01,72,054,PR,Florida Municipio,3464,3213,251,7.2
CN7205500000000,2022-06-01,72,055,PR,Guanica Municipio,3974,3617,357,9
CN7205700000000,2022-06-01,72,057,PR,Guayama Municipio,11496,10724,772,6.7
CN7205900000000,2022-06-01,72,059,PR,Guayanilla Municipio,5202,4764,438,8.4
CN7206100000000,2022-06-01,72,061,PR,Guaynabo Municipio,40921,39648,1273,3.1
CN7206300000000,2022-06-01,72,063,PR,Gurabo Municipio,20208,19356,852,4.2
CN7206500000000,2022-06-01,72,065,PR,Hatillo Municipio,14755,13253,1502,10.2
CN7206700000000,2022-06-01,72,067,PR,Hormigueros Municipio,5976,5630,346,5.8
CN7206900000000,2022-06-01,72,069,PR,Humacao Municipio,18603,17436,1167,6.3
CN7207100000000,2022-06-01,72,071,PR,Isabela Municipio,13168,12243,925,7
CN7207300000000,2022-06-01,72,073,PR,Jayuya Municipio,4529,4227,302,6.7
CN7207500000000,2022-06-01,72,075,PR,Juana Diaz Municipio,16457,15404,1053,6.4
CN7207700000000,2022-06-01,72,077,PR,Juncos Municipio,13279,12470,809,6.1
CN7207900000000,2022-06-01,72,079,PR,Lajas Municipio,5527,5007,520,9.4
CN7208100000000,2022-06-01,72,081,PR,Lares Municipio,7314,6554,760,10.4
CN7208300000000,2022-06-01,72,083,PR,Las Marias Municipio,2716,2472,244,9
CN7208500000000,2022-06-01,72,085,PR,Las Piedras Municipio,12338,11548,790,6.4
CN7208700000000,2022-06-01,72,087,PR,Loiza Municipio,8842,8365,477,5.4
CN7208900000000,2022-06-01,72,089,PR,Luquillo Municipio,6571,6170,401,6.1
CN7209100000000,2022-06-01,72,091,PR,Manati Municipio,12022,11293,729,6.1
CN7209300000000,2022-06-01,72,093,PR,Maricao Municipio,2063,1849,214,10.4
CN7209500000000,2022-06-01,72,095,PR,Maunabo Municipio,3071,2710,361,11.8
CN7209700000000,2022-06-01,72,097,PR,Mayaguez Municipio,23828,22221,1607,6.7
CN7209900000000,2022-06-01,72,099,PR,Moca Municipio,11611,10672,939,8.1
CN7210100000000,2022-06-01,72,101,PR,Morovis Municipio,8608,8003,605,7
CN7210300000000,2022-06-01,72,103,PR,Naguabo Municipio,8842,8324,518,5.9
CN7210500000000,2022-06-01,72,105,PR,Naranjito Municipio,7545,7028,517,6.9
CN7210700000000,2022-06-01,72,107,PR,Orocovis Municipio,5110,4747,363,7.1
CN7210900000000,2022-06-01,72,109,PR,Patillas Municipio,4366,3954,412,9.4
CN7211100000000,2022-06-01,72,111,PR,Penuelas Municipio,6016,5484,532,8.8
CN7211300000000,2022-06-01,72,113,PR,Ponce Municipio,47847,44718,3129,6.5
CN7211500000000,2022-06-01,72,115,PR,Quebradillas Municipio,6486,5952,534,8.2
CN7211700000000,2022-06-01,72,117,PR,Rincon Municipio,5076,4742,334,6.6
CN7211900000000,2022-06-01,72,119,PR,Rio Grande Municipio,18154,17186,968,5.3
CN7212100000000,2022-06-01,72,121,PR,Sabana Grande Municipio,6372,5830,542,8.5
CN7212300000000,2022-06-01,72,123,PR,Salinas Municipio,7280,6653,627,8.6
CN7212500000000,2022-06-01,72,125,PR,San German Municipio,10393,9594,799,7.7
CN7212700000000,2022-06-01,72,127,PR,San Juan Municipio,143507,137631,5876,4.1
CN7212900000000,2022-06-01,72,129,PR,San Lorenzo Municipio,12412,11615,797,6.4
CN7213100000000,2022-06-01,72,131,PR,San Sebastian Municipio,10890,9892,998,9.2
CN7213300000000,2022-06-01,72,133,PR,Santa Isabel Municipio,8665,8052,613,7.1
CN7213500000000,2022-06-01,72,135,PR,Toa Alta Municipio,29926,28590,1336,4.5
CN7213700000000,2022-06-01,72,137,PR,Toa Baja Municipio,31039,29662,1377,4.4
CN7213900000000,2022-06-01,72,139,PR,Trujillo Alto Municipio,29180,28086,1094,3.7
CN7214100000000,2022-06-01,72,141,PR,Utuado Municipio,7191,6618,573,8
CN7214300000000,2022-06-01,72,143,PR,Vega Alta Municipio,10552,9800,752,7.1
CN7214500000000,2022-06-01,72,145,PR,Vega Baja Municipio,13922,12909,1013,7.3
CN7214700000000,2022-06-01,72,147,PR,Vieques Municipio,2732,2577,155,5.7
CN7214900000000,2022-06-01,72,149,PR,Villalba Municipio,7542,6882,660,8.8
CN7215100000000,2022-06-01,72,151,PR,Yabucoa Municipio,9075,8378,697,7.7
CN7215300000000,2022-06-01,72,153,PR,Yauco Municipio,10012,9054,958,9.6
CN0100100000000,2022-07-01,01,001,AL,Autauga County,26931,26238,693,2.6
CN0100300000000,2022-07-01,01,003,AL,Baldwin County,105485,102791,2694,2.6
CN0100500000000,2022-07-01,01,005,AL,Barbour County,8229,7869,360,4.4
CN0100700000000,2022-07-01,01,007,AL,Bibb County,8799,8547,252,2.9
CN0100900000000,2022-07-01,01,009,AL,Blount County,26085,25434,651,2.5
CN0101100000000,2022-07-01,01,011,AL,Bullock County,4676,4525,151,3.2
CN0101300000000,2022-07-01,01,013,AL,Butler County,9018,8658,360,4
CN0101500000000,2022-07-01,01,015,AL,Calhoun County,46177,44572,1605,3.5
CN0101700000000,2022-07-01,01,017,AL,Chambers County,15886,15404,482,3
CN0101900000000,2022-07-01,01,019,AL,Cherokee County,11753,11449,304,2.6
CN0102100000000,2022-07-01,01,021,AL,Chilton County,20489,19963,526,2.6
CN0102300000000,2022-07-01,01,023,AL,Choctaw County,4287,4093,194,4.5
CN0102500000000,2022-07-01,01,025,AL,Clarke County,7653,7232,421,5.5
CN0102700000000,2022-07-01,01,027,AL,Clay County,6243,6096,147,2.4
CN0102900000000,2022-07-01,01,029,AL,Cleburne County,6197,6028,169,2.7
CN0103100000000,2022-07-01,01,031,AL,Coffee County,21518,20911,607,2.8
CN0103300000000,2022-07-01,01,033,AL,Colbert County,23881,23046,835,3.5
CN0103500000000,2022-07-01,01,035,AL,Conecuh County,4336,4155,181,4.2
CN0103700000000,2022-07-01,01,037,AL,Coosa County,4464,4345,119,2.7
CN0103900000000,2022-07-01,01,039,AL,Covington County,15473,14991,482,3.1
CN0104100000000,2022-07-01,01,041,AL,Crenshaw County,6081,5899,182,3
CN0104300000000,2022-07-01,01,043,AL,Cullman County,38848,37933,915,2.4
CN0104500000000,2022-07-01,01,045,AL,Dale County,21351,20731,620,2.9
CN0104700000000,2022-07-01,01,047,AL,Dallas County,13929,13068,861,6.2
CN0104900000000,2022-07-01,01,049,AL,DeKalb County,31596,30748,848,2.7
CN0105100000000,2022-07-01,01,051,AL,Elmore County,38413,37430,983,2.6
CN0105300000000,2022-07-01,01,053,AL,Escambia County,14261,13760,501,3.5
CN0105500000000,2022-07-01,01,055,AL,Etowah County,39524,38181,1343,3.4
CN0105700000000,2022-07-01,01,057,AL,Fayette County,6481,6261,220,3.4
CN0105900000000,2022-07-01,01,059,AL,Franklin County,14646,14250,396,2.7
CN0106100000000,2022-07-01,01,061,AL,Geneva County,11434,11134,300,2.6
CN0106300000000,2022-07-01,01,063,AL,Greene County,2766,2625,141,5.1
CN0106500000000,2022-07-01,01,065,AL,Hale County,6052,5771,281,4.6
CN0106700000000,2022-07-01,01,067,AL,Henry County,7130,6907,223,3.1
CN0106900000000,2022-07-01,01,069,AL,Houston County,48174,46747,1427,3
CN0107100000000,2022-07-01,01,071,AL,Jackson County,23546,22810,736,3.1
CN0107300000000,2022-07-01,01,073,AL,Jefferson County,325289,315816,9473,2.9
CN0107500000000,2022-07-01,01,075,AL,Lamar County,5875,5574,301,5.1
CN0107700000000,2022-07-01,01,077,AL,Lauderdale County,43054,41711,1343,3.1
CN0107900000000,2022-07-01,01,079,AL,Lawrence County,14838,14437,401,2.7
CN0108100000000,2022-07-01,01,081,AL,Lee County,79268,77035,2233,2.8
CN0108300000000,2022-07-01,01,083,AL,Limestone County,48612,47445,1167,2.4
CN0108500000000,2022-07-01,01,085,AL,Lowndes County,3570,3340,230,6.4
CN0108700000000,2022-07-01,01,087,AL,Macon County,7899,7531,368,4.7
CN0108900000000,2022-07-01,01,089,AL,Madison County,200087,195128,4959,2.5
CN0109100000000,2022-07-01,01,091,AL,Marengo County,7565,7277,288,3.8
CN0109300000000,2022-07-01,01,093,AL,Marion County,13828,13394,434,3.1
CN0109500000000,2022-07-01,01,095,AL,Marshall County,45707,44618,1089,2.4
CN0109700000000,2022-07-01,01,097,AL,Mobile County,192808,185695,7113,3.7
CN0109900000000,2022-07-01,01,099,AL,Monroe County,7390,7058,332,4.5
CN0110100000000,2022-07-01,01,101,AL,Montgomery County,107619,103822,3797,3.5
CN0110300000000,2022-07-01,01,103,AL,Morgan County,61040,59538,1502,2.5
CN0110500000000,2022-07-01,01,105,AL,Perry County,3158,2954,204,6.5
CN0110700000000,2022-07-01,01,107,AL,Pickens County,7730,7420,310,4
CN0110900000000,2022-07-01,01,109,AL,Pike County,16018,15511,507,3.2
CN0111100000000,2022-07-01,01,111,AL,Randolph County,9742,9471,271,2.8
CN0111300000000,2022-07-01,01,113,AL,Russell County,23828,23126,702,2.9
CN0111500000000,2022-07-01,01,115,AL,St. Clair County,42515,41465,1050,2.5
CN0111700000000,2022-07-01,01,117,AL,Shelby County,122030,119500,2530,2.1
CN0111900000000,2022-07-01,01,119,AL,Sumter County,4691,4461,230,4.9
CN0112100000000,2022-07-01,01,121,AL,Talladega County,36382,35093,1289,3.5
CN0112300000000,2022-07-01,01,123,AL,Tallapoosa County,17669,17078,591,3.3
CN0112500000000,2022-07-01,01,125,AL,Tuscaloosa County,102994,99807,3187,3.1
CN0112700000000,2022-07-01,01,127,AL,Walker County,25800,25008,792,3.1
CN0112900000000,2022-07-01,01,129,AL,Washington County,6554,6303,251,3.8
CN0113100000000,2022-07-01,01,131,AL,Wilcox County,2604,2367,237,9.1
CN0113300000000,2022-07-01,01,133,AL,Winston County,10362,10082,280,2.7
CN0201300000000,2022-07-01,02,013,AK,Aleutians East Borough,3718,3674,44,1.2
CN0201600000000,2022-07-01,02,016,AK,Aleutians West Census Area,4125,4037,88,2.1
CN0202000000000,2022-07-01,02,020,AK,Anchorage Borough/municipality,148296,143812,4484,3
CN0205000000000,2022-07-01,02,050,AK,Bethel Census Area,6615,6033,582,8.8
CN0206000000000,2022-07-01,02,060,AK,Bristol Bay Borough,1214,1202,12,1
CN0206300000000,2022-07-01,02,063,AK,Chugach Census Area,4563,4488,75,1.6
CN0206600000000,2022-07-01,02,066,AK,Copper River Census Area,1811,1724,87,4.8
CN0206800000000,2022-07-01,02,068,AK,Denali Borough,1699,1658,41,2.4
CN0207000000000,2022-07-01,02,070,AK,Dillingham Census Area,2090,1997,93,4.4
CN0209000000000,2022-07-01,02,090,AK,Fairbanks North Star Borough,45448,44025,1423,3.1
CN0210000000000,2022-07-01,02,100,AK,Haines Borough,1251,1196,55,4.4
CN0210500000000,2022-07-01,02,105,AK,Hoonah-Angoon Census Area,1583,1539,44,2.8
CN0211000000000,2022-07-01,02,110,AK,Juneau Borough/city,17976,17565,411,2.3
CN0212200000000,2022-07-01,02,122,AK,Kenai Peninsula Borough,30252,29203,1049,3.5
CN0213000000000,2022-07-01,02,130,AK,Ketchikan Gateway Borough,7756,7545,211,2.7
CN0215000000000,2022-07-01,02,150,AK,Kodiak Island Borough,6867,6686,181,2.6
CN0215800000000,2022-07-01,02,158,AK,Kusilvak Census Area,1866,1571,295,15.8
CN0216400000000,2022-07-01,02,164,AK,Lake and Peninsula Borough,775,743,32,4.1
CN0217000000000,2022-07-01,02,170,AK,Matanuska-Susitna Borough,48787,46817,1970,4
CN0218000000000,2022-07-01,02,180,AK,Nome Census Area,3997,3715,282,7.1
CN0218500000000,2022-07-01,02,185,AK,North Slope Borough,2894,2759,135,4.7
CN0218800000000,2022-07-01,02,188,AK,Northwest Arctic Borough,2590,2347,243,9.4
CN0219500000000,2022-07-01,02,195,AK,Petersburg Borough,1628,1563,65,4
CN0219800000000,2022-07-01,02,198,AK,Prince of Wales-Hyder Census Area,2576,2447,129,5
CN0222000000000,2022-07-01,02,220,AK,Sitka Borough/city,4974,4867,107,2.2
CN0223000000000,2022-07-01,02,230,AK,Skagway Municipality,935,912,23,2.5
CN0224000000000,2022-07-01,02,240,AK,Southeast Fairbanks Census Area,3262,3133,129,4
CN0227500000000,2022-07-01,02,275,AK,Wrangell Borough/city,878,842,36,4.1
CN0228200000000,2022-07-01,02,282,AK,Yakutat Borough/city,384,372,12,3.1
CN0229000000000,2022-07-01,02,290,AK,Yukon-Koyukuk Census Area,2369,2221,148,6.2
CN0400100000000,2022-07-01,04,001,AZ,Apache County,18584,16929,1655,8.9
CN0400300000000,2022-07-01,04,003,AZ,Cochise County,48291,45889,2402,5
CN0400500000000,2022-07-01,04,005,AZ,Coconino County,73667,70156,3511,4.8
CN0400700000000,2022-07-01,04,007,AZ,Gila County,20296,19342,954,4.7
CN0400900000000,2022-07-01,04,009,AZ,Graham County,15388,14718,670,4.4
CN0401100000000,2022-07-01,04,011,AZ,Greenlee County,4798,4645,153,3.2
CN0401200000000,2022-07-01,04,012,AZ,La Paz County,8108,7647,461,5.7
CN0401300000000,2022-07-01,04,013,AZ,Maricopa County,2390118,2301837,88281,3.7
CN0401500000000,2022-07-01,04,015,AZ,Mohave County,91314,86890,4424,4.8
CN0401700000000,2022-07-01,04,017,AZ,Navajo County,38592,36270,2322,6
CN0401900000000,2022-07-01,04,019,AZ,Pima County,488716,468016,20700,4.2
CN0402100000000,2022-07-01,04,021,AZ,Pinal County,197594,189027,8567,4.3
CN0402300000000,2022-07-01,04,023,AZ,Santa Cruz County,17833,16282,1551,8.7
CN0402500000000,2022-07-01,04,025,AZ,Yavapai County,107493,103252,4241,3.9
CN0402700000000,2022-07-01,04,027,AZ,Yuma County,94307,79833,14474,15.3
CN0500100000000,2022-07-01,05,001,AR,Arkansas County,9623,9288,335,3.5
CN0500300000000,2022-07-01,05,003,AR,Ashley County,6691,6260,431,6.4
CN0500500000000,2022-07-01,05,005,AR,Baxter County,16579,15893,686,4.1
CN0500700000000,2022-07-01,05,007,AR,Benton County,153987,149795,4192,2.7
CN0500900000000,2022-07-01,05,009,AR,Boone County,15761,15240,521,3.3
CN0501100000000,2022-07-01,05,011,AR,Bradley County,4039,3815,224,5.5
CN0501300000000,2022-07-01,05,013,AR,Calhoun County,2347,2261,86,3.7
CN0501500000000,2022-07-01,05,015,AR,Carroll County,12692,12316,376,3
CN0501700000000,2022-07-01,05,017,AR,Chicot County,3136,2922,214,6.8
CN0501900000000,2022-07-01,05,019,AR,Clark County,8349,7844,505,6
CN0502100000000,2022-07-01,05,021,AR,Clay County,5553,5307,246,4.4
CN0502300000000,2022-07-01,05,023,AR,Cleburne County,9077,8644,433,4.8
CN0502500000000,2022-07-01,05,025,AR,Cleveland County,3156,3008,148,4.7
CN0502700000000,2022-07-01,05,027,AR,Columbia County,8329,7903,426,5.1
CN0502900000000,2022-07-01,05,029,AR,Conway County,8346,7969,377,4.5
CN0503100000000,2022-07-01,05,031,AR,Craighead County,58670,56785,1885,3.2
CN0503300000000,2022-07-01,05,033,AR,Crawford County,26621,25649,972,3.7
CN0503500000000,2022-07-01,05,035,AR,Crittenden County,21295,20173,1122,5.3
CN0503700000000,2022-07-01,05,037,AR,Cross County,7129,6836,293,4.1
CN0503900000000,2022-07-01,05,039,AR,Dallas County,2777,2644,133,4.8
CN0504100000000,2022-07-01,05,041,AR,Desha County,5089,4766,323,6.3
CN0504300000000,2022-07-01,05,043,AR,Drew County,7285,6916,369,5.1
CN0504500000000,2022-07-01,05,045,AR,Faulkner County,64220,62068,2152,3.4
CN0504700000000,2022-07-01,05,047,AR,Franklin County,7403,7110,293,4
CN0504900000000,2022-07-01,05,049,AR,Fulton County,4979,4757,222,4.5
CN0505100000000,2022-07-01,05,051,AR,Garland County,43521,41610,1911,4.4
CN0505300000000,2022-07-01,05,053,AR,Grant County,8630,8315,315,3.7
CN0505500000000,2022-07-01,05,055,AR,Greene County,20170,19449,721,3.6
CN0505700000000,2022-07-01,05,057,AR,Hempstead County,9408,9044,364,3.9
CN0505900000000,2022-07-01,05,059,AR,Hot Spring County,14152,13535,617,4.4
CN0506100000000,2022-07-01,05,061,AR,Howard County,5539,5315,224,4
CN0506300000000,2022-07-01,05,063,AR,Independence County,16501,15805,696,4.2
CN0506500000000,2022-07-01,05,065,AR,Izard County,4404,4126,278,6.3
CN0506700000000,2022-07-01,05,067,AR,Jackson County,5512,5207,305,5.5
CN0506900000000,2022-07-01,05,069,AR,Jefferson County,25922,24347,1575,6.1
CN0507100000000,2022-07-01,05,071,AR,Johnson County,9976,9442,534,5.4
CN0507300000000,2022-07-01,05,073,AR,Lafayette County,2276,2140,136,6
CN0507500000000,2022-07-01,05,075,AR,Lawrence County,6610,6317,293,4.4
CN0507700000000,2022-07-01,05,077,AR,Lee County,2594,2466,128,4.9
CN0507900000000,2022-07-01,05,079,AR,Lincoln County,3780,3596,184,4.9
CN0508100000000,2022-07-01,05,081,AR,Little River County,5307,5081,226,4.3
CN0508300000000,2022-07-01,05,083,AR,Logan County,8269,7893,376,4.5
CN0508500000000,2022-07-01,05,085,AR,Lonoke County,34905,33800,1105,3.2
CN0508700000000,2022-07-01,05,087,AR,Madison County,8010,7784,226,2.8
CN0508900000000,2022-07-01,05,089,AR,Marion County,6387,6133,254,4
CN0509100000000,2022-07-01,05,091,AR,Miller County,19212,18351,861,4.5
CN0509300000000,2022-07-01,05,093,AR,Mississippi County,16718,15554,1164,7
CN0509500000000,2022-07-01,05,095,AR,Monroe County,2586,2453,133,5.1
CN0509700000000,2022-07-01,05,097,AR,Montgomery County,2997,2840,157,5.2
CN0509900000000,2022-07-01,05,099,AR,Nevada County,3455,3293,162,4.7
CN0510100000000,2022-07-01,05,101,AR,Newton County,3209,3099,110,3.4
CN0510300000000,2022-07-01,05,103,AR,Ouachita County,9468,9033,435,4.6
CN0510500000000,2022-07-01,05,105,AR,Perry County,4324,4147,177,4.1
CN0510700000000,2022-07-01,05,107,AR,Phillips County,5490,5108,382,7
CN0510900000000,2022-07-01,05,109,AR,Pike County,4080,3905,175,4.3
CN0511100000000,2022-07-01,05,111,AR,Poinsett County,10234,9846,388,3.8
CN0511300000000,2022-07-01,05,113,AR,Polk County,7832,7485,347,4.4
CN0511500000000,2022-07-01,05,115,AR,Pope County,27503,26120,1383,5
CN0511700000000,2022-07-01,05,117,AR,Prairie County,3531,3413,118,3.3
CN0511900000000,2022-07-01,05,119,AR,Pulaski County,192770,185070,7700,4
CN0512100000000,2022-07-01,05,121,AR,Randolph County,7192,6890,302,4.2
CN0512300000000,2022-07-01,05,123,AR,St. Francis County,7590,7157,433,5.7
CN0512500000000,2022-07-01,05,125,AR,Saline County,60965,59046,1919,3.1
CN0512700000000,2022-07-01,05,127,AR,Scott County,4337,4195,142,3.3
CN0512900000000,2022-07-01,05,129,AR,Searcy County,2907,2760,147,5.1
CN0513100000000,2022-07-01,05,131,AR,Sebastian County,55832,53889,1943,3.5
CN0513300000000,2022-07-01,05,133,AR,Sevier County,5449,5205,244,4.5
CN0513500000000,2022-07-01,05,135,AR,Sharp County,5811,5520,291,5
CN0513700000000,2022-07-01,05,137,AR,Stone County,4645,4401,244,5.3
CN0513900000000,2022-07-01,05,139,AR,Union County,14716,13882,834,5.7
CN0514100000000,2022-07-01,05,141,AR,Van Buren County,5963,5666,297,5
CN0514300000000,2022-07-01,05,143,AR,Washington County,136052,132505,3547,2.6
CN0514500000000,2022-07-01,05,145,AR,White County,33713,32326,1387,4.1
CN0514700000000,2022-07-01,05,147,AR,Woodruff County,2739,2635,104,3.8
CN0514900000000,2022-07-01,05,149,AR,Yell County,7951,7572,379,4.8
CN0600100000000,2022-07-01,06,001,CA,Alameda County,826482,799913,26569,3.2
CN0600300000000,2022-07-01,06,003,CA,Alpine County,460,436,24,5.2
CN0600500000000,2022-07-01,06,005,CA,Amador County,14245,13662,583,4.1
CN0600700000000,2022-07-01,06,007,CA,Butte County,89320,85375,3945,4.4
CN0600900000000,2022-07-01,06,009,CA,Calaveras County,22493,21722,771,3.4
CN0601100000000,2022-07-01,06,011,CA,Colusa County,10301,9368,933,9.1
CN0601300000000,2022-07-01,06,013,CA,Contra Costa County,551995,533029,18966,3.4
CN0601500000000,2022-07-01,06,015,CA,Del Norte County,9319,8844,475,5.1
CN0601700000000,2022-07-01,06,017,CA,El Dorado County,93581,90632,2949,3.2
CN0601900000000,2022-07-01,06,019,CA,Fresno County,451569,424678,26891,6
CN0602100000000,2022-07-01,06,021,CA,Glenn County,12539,11864,675,5.4
CN0602300000000,2022-07-01,06,023,CA,Humboldt County,58437,56108,2329,4
CN0602500000000,2022-07-01,06,025,CA,Imperial County,68932,58427,10505,15.2
CN0602700000000,2022-07-01,06,027,CA,Inyo County,8345,8054,291,3.5
CN0602900000000,2022-07-01,06,029,CA,Kern County,390934,364386,26548,6.8
CN0603100000000,2022-07-01,06,031,CA,Kings County,56395,52766,3629,6.4
CN0603300000000,2022-07-01,06,033,CA,Lake County,28126,26850,1276,4.5
CN0603500000000,2022-07-01,06,035,CA,Lassen County,8553,8183,370,4.3
CN0603700000000,2022-07-01,06,037,CA,Los Angeles County,4957468,4716142,241326,4.9
CN0603900000000,2022-07-01,06,039,CA,Madera County,62195,58519,3676,5.9
CN0604100000000,2022-07-01,06,041,CA,Marin County,132689,129209,3480,2.6
CN0604300000000,2022-07-01,06,043,CA,Mariposa County,7751,7462,289,3.7
CN0604500000000,2022-07-01,06,045,CA,Mendocino County,37251,35823,1428,3.8
CN0604700000000,2022-07-01,06,047,CA,Merced County,116219,107945,8274,7.1
CN0604900000000,2022-07-01,06,049,CA,Modoc County,3230,3085,145,4.5
CN0605100000000,2022-07-01,06,051,CA,Mono County,8968,8670,298,3.3
CN0605300000000,2022-07-01,06,053,CA,Monterey County,230115,220196,9919,4.3
CN0605500000000,2022-07-01,06,055,CA,Napa County,72435,70352,2083,2.9
CN0605700000000,2022-07-01,06,057,CA,Nevada County,49004,47433,1571,3.2
CN0605900000000,2022-07-01,06,059,CA,Orange County,1584783,1534830,49953,3.2
CN0606100000000,2022-07-01,06,061,CA,Placer County,194610,188729,5881,3
CN0606300000000,2022-07-01,06,063,CA,Plumas County,7824,7442,382,4.9
CN0606500000000,2022-07-01,06,065,CA,Riverside County,1146311,1098030,48281,4.2
CN0606700000000,2022-07-01,06,067,CA,Sacramento County,730788,703191,27597,3.8
CN0606900000000,2022-07-01,06,069,CA,San Benito County,32545,31103,1442,4.4
CN0607100000000,2022-07-01,06,071,CA,San Bernardino County,1003313,962189,41124,4.1
CN0607300000000,2022-07-01,06,073,CA,San Diego County,1589923,1535963,53960,3.4
CN0607500000000,2022-07-01,06,075,CA,San Francisco County/city,576970,562863,14107,2.4
CN0607700000000,2022-07-01,06,077,CA,San Joaquin County,344347,327228,17119,5
CN0607900000000,2022-07-01,06,079,CA,San Luis Obispo County,137461,133319,4142,3
CN0608100000000,2022-07-01,06,081,CA,San Mateo County,456940,446250,10690,2.3
CN0608300000000,2022-07-01,06,083,CA,Santa Barbara County,226347,219150,7197,3.2
CN0608500000000,2022-07-01,06,085,CA,Santa Clara County,1046153,1018945,27208,2.6
CN0608700000000,2022-07-01,06,087,CA,Santa Cruz County,136866,131359,5507,4
CN0608900000000,2022-07-01,06,089,CA,Shasta County,71870,68705,3165,4.4
CN0609100000000,2022-07-01,06,091,CA,Sierra County,1367,1322,45,3.3
CN0609300000000,2022-07-01,06,093,CA,Siskiyou County,16479,15657,822,5
CN0609500000000,2022-07-01,06,095,CA,Solano County,202793,194714,8079,4
CN0609700000000,2022-07-01,06,097,CA,Sonoma County,248844,241253,7591,3.1
CN0609900000000,2022-07-01,06,099,CA,Stanislaus County,244681,231825,12856,5.3
CN0610100000000,2022-07-01,06,101,CA,Sutter County,46609,43947,2662,5.7
CN0610300000000,2022-07-01,06,103,CA,Tehama County,25208,23975,1233,4.9
CN0610500000000,2022-07-01,06,105,CA,Trinity County,4602,4412,190,4.1
CN0610700000000,2022-07-01,06,107,CA,Tulare County,205680,189311,16369,8
CN0610900000000,2022-07-01,06,109,CA,Tuolumne County,19958,19109,849,4.3
CN0611100000000,2022-07-01,06,111,CA,Ventura County,409993,395324,14669,3.6
CN0611300000000,2022-07-01,06,113,CA,Yolo County,109897,105671,4226,3.8
CN0611500000000,2022-07-01,06,115,CA,Yuba County,31439,29805,1634,5.2
CN0800100000000,2022-07-01,08,001,CO,Adams County,282369,273454,8915,3.2
CN0800300000000,2022-07-01,08,003,CO,Alamosa County,8255,7952,303,3.7
CN0800500000000,2022-07-01,08,005,CO,Arapahoe County,375335,364460,10875,2.9
CN0800700000000,2022-07-01,08,007,CO,Archuleta County,7280,7071,209,2.9
CN0800900000000,2022-07-01,08,009,CO,Baca County,2190,2154,36,1.6
CN0801100000000,2022-07-01,08,011,CO,Bent County,1855,1800,55,3
CN0801300000000,2022-07-01,08,013,CO,Boulder County,200702,195640,5062,2.5
CN0801400000000,2022-07-01,08,014,CO,Broomfield County/city,42491,41449,1042,2.5
CN0801500000000,2022-07-01,08,015,CO,Chaffee County,10346,10103,243,2.3
CN0801700000000,2022-07-01,08,017,CO,Cheyenne County,1116,1095,21,1.9
CN0801900000000,2022-07-01,08,019,CO,Clear Creek County,6165,5997,168,2.7
CN0802100000000,2022-07-01,08,021,CO,Conejos County,4069,3941,128,3.1
CN0802300000000,2022-07-01,08,023,CO,Costilla County,1841,1773,68,3.7
CN0802500000000,2022-07-01,08,025,CO,Crowley County,1370,1317,53,3.9
CN0802700000000,2022-07-01,08,027,CO,Custer County,2440,2378,62,2.5
CN0802900000000,2022-07-01,08,029,CO,Delta County,13766,13322,444,3.2
CN0803100000000,2022-07-01,08,031,CO,Denver County/city,436170,423693,12477,2.9
CN0803300000000,2022-07-01,08,033,CO,Dolores County,1201,1173,28,2.3
CN0803500000000,2022-07-01,08,035,CO,Douglas County,208121,202945,5176,2.5
CN0803700000000,2022-07-01,08,037,CO,Eagle County,35018,34212,806,2.3
CN0803900000000,2022-07-01,08,039,CO,Elbert County,16215,15847,368,2.3
CN0804100000000,2022-07-01,08,041,CO,El Paso County,358490,346907,11583,3.2
CN0804300000000,2022-07-01,08,043,CO,Fremont County,14583,13946,637,4.4
CN0804500000000,2022-07-01,08,045,CO,Garfield County,31649,30803,846,2.7
CN0804700000000,2022-07-01,08,047,CO,Gilpin County,3932,3836,96,2.4
CN0804900000000,2022-07-01,08,049,CO,Grand County,9647,9426,221,2.3
CN0805100000000,2022-07-01,08,051,CO,Gunnison County,11817,11557,260,2.2
CN0805300000000,2022-07-01,08,053,CO,Hinsdale County,541,531,10,1.8
CN0805500000000,2022-07-01,08,055,CO,Huerfano County,2572,2414,158,6.1
CN0805700000000,2022-07-01,08,057,CO,Jackson County,1081,1062,19,1.8
CN0805900000000,2022-07-01,08,059,CO,Jefferson County,343332,334314,9018,2.6
CN0806100000000,2022-07-01,08,061,CO,Kiowa County,967,951,16,1.7
CN0806300000000,2022-07-01,08,063,CO,Kit Carson County,4344,4260,84,1.9
CN0806500000000,2022-07-01,08,065,CO,Lake County,4736,4616,120,2.5
CN0806700000000,2022-07-01,08,067,CO,La Plata County,31190,30330,860,2.8
CN0806900000000,2022-07-01,08,069,CO,Larimer County,211475,205965,5510,2.6
CN0807100000000,2022-07-01,08,071,CO,Las Animas County,6147,5871,276,4.5
CN0807300000000,2022-07-01,08,073,CO,Lincoln County,2302,2239,63,2.7
CN0807500000000,2022-07-01,08,075,CO,Logan County,10264,9962,302,2.9
CN0807700000000,2022-07-01,08,077,CO,Mesa County,76358,73863,2495,3.3
CN0807900000000,2022-07-01,08,079,CO,Mineral County,462,450,12,2.6
CN0808100000000,2022-07-01,08,081,CO,Moffat County,6891,6699,192,2.8
CN0808300000000,2022-07-01,08,083,CO,Montezuma County,12374,11967,407,3.3
CN0808500000000,2022-07-01,08,085,CO,Montrose County,21539,20884,655,3
CN0808700000000,2022-07-01,08,087,CO,Morgan County,15706,15210,496,3.2
CN0808900000000,2022-07-01,08,089,CO,Otero County,7947,7619,328,4.1
CN0809100000000,2022-07-01,08,091,CO,Ouray County,2676,2609,67,2.5
CN0809300000000,2022-07-01,08,093,CO,Park County,11674,11404,270,2.3
CN0809500000000,2022-07-01,08,095,CO,Phillips County,2690,2635,55,2
CN0809700000000,2022-07-01,08,097,CO,Pitkin County,10775,10503,272,2.5
CN0809900000000,2022-07-01,08,099,CO,Prowers County,6319,6140,179,2.8
CN0810100000000,2022-07-01,08,101,CO,Pueblo County,75680,72421,3259,4.3
CN0810300000000,2022-07-01,08,103,CO,Rio Blanco County,2916,2810,106,3.6
CN0810500000000,2022-07-01,08,105,CO,Rio Grande County,5640,5408,232,4.1
CN0810700000000,2022-07-01,08,107,CO,Routt County,15993,15634,359,2.2
CN0810900000000,2022-07-01,08,109,CO,Saguache County,3515,3399,116,3.3
CN0811100000000,2022-07-01,08,111,CO,San Juan County,673,659,14,2.1
CN0811300000000,2022-07-01,08,113,CO,San Miguel County,5977,5850,127,2.1
CN0811500000000,2022-07-01,08,115,CO,Sedgwick County,1156,1128,28,2.4
CN0811700000000,2022-07-01,08,117,CO,Summit County,20814,20370,444,2.1
CN0811900000000,2022-07-01,08,119,CO,Teller County,13389,13000,389,2.9
CN0812100000000,2022-07-01,08,121,CO,Washington County,2889,2826,63,2.2
CN0812300000000,2022-07-01,08,123,CO,Weld County,169778,164447,5331,3.1
CN0812500000000,2022-07-01,08,125,CO,Yuma County,5971,5855,116,1.9
CN0900100000000,2022-07-01,09,001,CT,Fairfield County,499557,478577,20980,4.2
CN0900300000000,2022-07-01,09,003,CT,Hartford County,484826,463512,21314,4.4
CN0900500000000,2022-07-01,09,005,CT,Litchfield County,107198,103183,4015,3.7
CN0900700000000,2022-07-01,09,007,CT,Middlesex County,95257,91815,3442,3.6
CN0900900000000,2022-07-01,09,009,CT,New Haven County,478260,456846,21414,4.5
CN0901100000000,2022-07-01,09,011,CT,New London County,137629,131850,5779,4.2
CN0901300000000,2022-07-01,09,013,CT,Tolland County,87665,84154,3511,4
CN0901500000000,2022-07-01,09,015,CT,Windham County,65399,62531,2868,4.4
CN1000100000000,2022-07-01,10,001,DE,Kent County,79353,74849,4504,5.7
CN1000300000000,2022-07-01,10,003,DE,New Castle County,303318,289338,13980,4.6
CN1000500000000,2022-07-01,10,005,DE,Sussex County,116658,112093,4565,3.9
CN1100100000000,2022-07-01,11,001,DC,District of Columbia,398415,379597,18818,4.7
CN1200100000000,2022-07-01,12,001,FL,Alachua County,139903,135590,4313,3.1
CN1200300000000,2022-07-01,12,003,FL,Baker County,12765,12390,375,2.9
CN1200500000000,2022-07-01,12,005,FL,Bay County,90011,87563,2448,2.7
CN1200700000000,2022-07-01,12,007,FL,Bradford County,11080,10713,367,3.3
CN1200900000000,2022-07-01,12,009,FL,Brevard County,298037,289352,8685,2.9
CN1201100000000,2022-07-01,12,011,FL,Broward County,1069190,1038241,30949,2.9
CN1201300000000,2022-07-01,12,013,FL,Calhoun County,4808,4649,159,3.3
CN1201500000000,2022-07-01,12,015,FL,Charlotte County,76616,74137,2479,3.2
CN1201700000000,2022-07-01,12,017,FL,Citrus County,48634,46554,2080,4.3
CN1201900000000,2022-07-01,12,019,FL,Clay County,114148,110968,3180,2.8
CN1202100000000,2022-07-01,12,021,FL,Collier County,187753,182090,5663,3
CN1202300000000,2022-07-01,12,023,FL,Columbia County,29183,28201,982,3.4
CN1202700000000,2022-07-01,12,027,FL,DeSoto County,13601,13142,459,3.4
CN1202900000000,2022-07-01,12,029,FL,Dixie County,5782,5594,188,3.3
CN1203100000000,2022-07-01,12,031,FL,Duval County,517555,500760,16795,3.2
CN1203300000000,2022-07-01,12,033,FL,Escambia County,151145,146471,4674,3.1
CN1203500000000,2022-07-01,12,035,FL,Flagler County,50512,48771,1741,3.4
CN1203700000000,2022-07-01,12,037,FL,Franklin County,4923,4798,125,2.5
CN1203900000000,2022-07-01,12,039,FL,Gadsden County,19124,18377,747,3.9
CN1204100000000,2022-07-01,12,041,FL,Gilchrist County,7338,7100,238,3.2
CN1204300000000,2022-07-01,12,043,FL,Glades County,5030,4845,185,3.7
CN1204500000000,2022-07-01,12,045,FL,Gulf County,5558,5400,158,2.8
CN1204700000000,2022-07-01,12,047,FL,Hamilton County,4302,4134,168,3.9
CN1204900000000,2022-07-01,12,049,FL,Hardee County,8634,8240,394,4.6
CN1205100000000,2022-07-01,12,051,FL,Hendry County,15236,14294,942,6.2
CN1205300000000,2022-07-01,12,053,FL,Hernando County,77237,74418,2819,3.6
CN1205500000000,2022-07-01,12,055,FL,Highlands County,35664,34101,1563,4.4
CN1205700000000,2022-07-01,12,057,FL,Hillsborough County,805643,782596,23047,2.9
CN1205900000000,2022-07-01,12,059,FL,Holmes County,7027,6799,228,3.2
CN1206100000000,2022-07-01,12,061,FL,Indian River County,67999,65521,2478,3.6
CN1206300000000,2022-07-01,12,063,FL,Jackson County,16493,15946,547,3.3
CN1206500000000,2022-07-01,12,065,FL,Jefferson County,5736,5525,211,3.7
CN1206700000000,2022-07-01,12,067,FL,Lafayette County,2806,2710,96,3.4
CN1206900000000,2022-07-01,12,069,FL,Lake County,172377,167105,5272,3.1
CN1207100000000,2022-07-01,12,071,FL,Lee County,373036,362093,10943,2.9
CN1207300000000,2022-07-01,12,073,FL,Leon County,159700,154705,4995,3.1
CN1207500000000,2022-07-01,12,075,FL,Levy County,16988,16361,627,3.7
CN1207700000000,2022-07-01,12,077,FL,Liberty County,2600,2519,81,3.1
CN1207900000000,2022-07-01,12,079,FL,Madison County,7803,7549,254,3.3
CN1208100000000,2022-07-01,12,081,FL,Manatee County,187241,181688,5553,3
CN1208300000000,2022-07-01,12,083,FL,Marion County,148774,143473,5301,3.6
CN1208500000000,2022-07-01,12,085,FL,Martin County,76081,73908,2173,2.9
CN1208600000000,2022-07-01,12,086,FL,Miami-Dade County,1368585,1329633,38952,2.8
CN1208700000000,2022-07-01,12,087,FL,Monroe County,49387,48487,900,1.8
CN1208900000000,2022-07-01,12,089,FL,Nassau County,45080,43905,1175,2.6
CN1209100000000,2022-07-01,12,091,FL,Okaloosa County,106275,103626,2649,2.5
CN1209300000000,2022-07-01,12,093,FL,Okeechobee County,17517,16948,569,3.2
CN1209500000000,2022-07-01,12,095,FL,Orange County,799022,775670,23352,2.9
CN1209700000000,2022-07-01,12,097,FL,Osceola County,199032,192221,6811,3.4
CN1209900000000,2022-07-01,12,099,FL,Palm Beach County,765040,741493,23547,3.1
CN1210100000000,2022-07-01,12,101,FL,Pasco County,259204,251115,8089,3.1
CN1210300000000,2022-07-01,12,103,FL,Pinellas County,512154,498527,13627,2.7
CN1210500000000,2022-07-01,12,105,FL,Polk County,338282,325954,12328,3.6
CN1210700000000,2022-07-01,12,107,FL,Putnam County,27449,26299,1150,4.2
CN1210900000000,2022-07-01,12,109,FL,St. Johns County,150429,146779,3650,2.4
CN1211100000000,2022-07-01,12,111,FL,St. Lucie County,155366,149840,5526,3.6
CN1211300000000,2022-07-01,12,113,FL,Santa Rosa County,88846,86302,2544,2.9
CN1211500000000,2022-07-01,12,115,FL,Sarasota County,197128,191440,5688,2.9
CN1211700000000,2022-07-01,12,117,FL,Seminole County,266173,258918,7255,2.7
CN1211900000000,2022-07-01,12,119,FL,Sumter County,37293,35785,1508,4
CN1212100000000,2022-07-01,12,121,FL,Suwannee County,17446,16853,593,3.4
CN1212300000000,2022-07-01,12,123,FL,Taylor County,8165,7886,279,3.4
CN1212500000000,2022-07-01,12,125,FL,Union County,4402,4258,144,3.3
CN1212700000000,2022-07-01,12,127,FL,Volusia County,266360,257855,8505,3.2
CN1212900000000,2022-07-01,12,129,FL,Wakulla County,15956,15529,427,2.7
CN1213100000000,2022-07-01,12,131,FL,Walton County,36018,35100,918,2.5
CN1213300000000,2022-07-01,12,133,FL,Washington County,9814,9485,329,3.4
CN1300100000000,2022-07-01,13,001,GA,Appling County,9478,9076,402,4.2
CN1300300000000,2022-07-01,13,003,GA,Atkinson County,4447,4305,142,3.2
CN1300500000000,2022-07-01,13,005,GA,Bacon County,4936,4786,150,3
CN1300700000000,2022-07-01,13,007,GA,Baker County,1119,1070,49,4.4
CN1300900000000,2022-07-01,13,009,GA,Baldwin County,17187,16466,721,4.2
CN1301100000000,2022-07-01,13,011,GA,Banks County,10752,10507,245,2.3
CN1301300000000,2022-07-01,13,013,GA,Barrow County,43131,42045,1086,2.5
CN1301500000000,2022-07-01,13,015,GA,Bartow County,52314,50860,1454,2.8
CN1301700000000,2022-07-01,13,017,GA,Ben Hill County,5541,5263,278,5
CN1301900000000,2022-07-01,13,019,GA,Berrien County,7729,7462,267,3.5
CN1302100000000,2022-07-01,13,021,GA,Bibb County,64908,62310,2598,4
CN1302300000000,2022-07-01,13,023,GA,Bleckley County,4439,4233,206,4.6
CN1302500000000,2022-07-01,13,025,GA,Brantley County,7566,7297,269,3.6
CN1302700000000,2022-07-01,13,027,GA,Brooks County,6712,6495,217,3.2
CN1302900000000,2022-07-01,13,029,GA,Bryan County,20154,19640,514,2.6
CN1303100000000,2022-07-01,13,031,GA,Bulloch County,37483,36104,1379,3.7
CN1303300000000,2022-07-01,13,033,GA,Burke County,9037,8482,555,6.1
CN1303500000000,2022-07-01,13,035,GA,Butts County,11343,11031,312,2.8
CN1303700000000,2022-07-01,13,037,GA,Calhoun County,2183,2105,78,3.6
CN1303900000000,2022-07-01,13,039,GA,Camden County,21907,21277,630,2.9
CN1304300000000,2022-07-01,13,043,GA,Candler County,5979,5841,138,2.3
CN1304500000000,2022-07-01,13,045,GA,Carroll County,57434,55623,1811,3.2
CN1304700000000,2022-07-01,13,047,GA,Catoosa County,33124,32247,877,2.6
CN1304900000000,2022-07-01,13,049,GA,Charlton County,5022,4869,153,3
CN1305100000000,2022-07-01,13,051,GA,Chatham County,144307,139883,4424,3.1
CN1305300000000,2022-07-01,13,053,GA,Chattahoochee County,1908,1820,88,4.6
CN1305500000000,2022-07-01,13,055,GA,Chattooga County,9201,8825,376,4.1
CN1305700000000,2022-07-01,13,057,GA,Cherokee County,142912,139673,3239,2.3
CN1305900000000,2022-07-01,13,059,GA,Clarke County,56662,54694,1968,3.5
CN1306100000000,2022-07-01,13,061,GA,Clay County,820,762,58,7.1
CN1306300000000,2022-07-01,13,063,GA,Clayton County,140687,134841,5846,4.2
CN1306500000000,2022-07-01,13,065,GA,Clinch County,2942,2839,103,3.5
CN1306700000000,2022-07-01,13,067,GA,Cobb County,432407,421085,11322,2.6
CN1306900000000,2022-07-01,13,069,GA,Coffee County,18900,18108,792,4.2
CN1307100000000,2022-07-01,13,071,GA,Colquitt County,21999,21364,635,2.9
CN1307300000000,2022-07-01,13,073,GA,Columbia County,75427,73237,2190,2.9
CN1307500000000,2022-07-01,13,075,GA,Cook County,8137,7873,264,3.2
CN1307700000000,2022-07-01,13,077,GA,Coweta County,77878,75759,2119,2.7
CN1307900000000,2022-07-01,13,079,GA,Crawford County,5339,5152,187,3.5
CN1308100000000,2022-07-01,13,081,GA,Crisp County,9792,9340,452,4.6
CN1308300000000,2022-07-01,13,083,GA,Dade County,8013,7806,207,2.6
CN1308500000000,2022-07-01,13,085,GA,Dawson County,13463,13136,327,2.4
CN1308700000000,2022-07-01,13,087,GA,Decatur County,11840,11440,400,3.4
CN1308900000000,2022-07-01,13,089,GA,DeKalb County,406268,393086,13182,3.2
CN1309100000000,2022-07-01,13,091,GA,Dodge County,6978,6711,267,3.8
CN1309300000000,2022-07-01,13,093,GA,Dooly County,4737,4548,189,4
CN1309500000000,2022-07-01,13,095,GA,Dougherty County,36172,34484,1688,4.7
CN1309700000000,2022-07-01,13,097,GA,Douglas County,75389,72800,2589,3.4
CN1309900000000,2022-07-01,13,099,GA,Early County,4394,4239,155,3.5
CN1310100000000,2022-07-01,13,101,GA,Echols County,1869,1824,45,2.4
CN1310300000000,2022-07-01,13,103,GA,Effingham County,33658,32808,850,2.5
CN1310500000000,2022-07-01,13,105,GA,Elbert County,7879,7503,376,4.8
CN1310700000000,2022-07-01,13,107,GA,Emanuel County,8648,8263,385,4.5
CN1310900000000,2022-07-01,13,109,GA,Evans County,5021,4873,148,2.9
CN1311100000000,2022-07-01,13,111,GA,Fannin County,12085,11792,293,2.4
CN1311300000000,2022-07-01,13,113,GA,Fayette County,59659,58085,1574,2.6
CN1311500000000,2022-07-01,13,115,GA,Floyd County,43913,42506,1407,3.2
CN1311700000000,2022-07-01,13,117,GA,Forsyth County,130410,127418,2992,2.3
CN1311900000000,2022-07-01,13,119,GA,Franklin County,9926,9573,353,3.6
CN1312100000000,2022-07-01,13,121,GA,Fulton County,577070,558190,18880,3.3
CN1312300000000,2022-07-01,13,123,GA,Gilmer County,12521,12149,372,3
CN1312500000000,2022-07-01,13,125,GA,Glascock County,1224,1187,37,3
CN1312700000000,2022-07-01,13,127,GA,Glynn County,40300,39188,1112,2.8
CN1312900000000,2022-07-01,13,129,GA,Gordon County,29045,28193,852,2.9
CN1313100000000,2022-07-01,13,131,GA,Grady County,10827,10487,340,3.1
CN1313300000000,2022-07-01,13,133,GA,Greene County,7466,7240,226,3
CN1313500000000,2022-07-01,13,135,GA,Gwinnett County,502375,488698,13677,2.7
CN1313700000000,2022-07-01,13,137,GA,Habersham County,18657,18079,578,3.1
CN1313900000000,2022-07-01,13,139,GA,Hall County,107103,104557,2546,2.4
CN1314100000000,2022-07-01,13,141,GA,Hancock County,2455,2320,135,5.5
CN1314300000000,2022-07-01,13,143,GA,Haralson County,13050,12659,391,3
CN1314500000000,2022-07-01,13,145,GA,Harris County,16811,16364,447,2.7
CN1314700000000,2022-07-01,13,147,GA,Hart County,12178,11793,385,3.2
CN1314900000000,2022-07-01,13,149,GA,Heard County,5343,5179,164,3.1
CN1315100000000,2022-07-01,13,151,GA,Henry County,120801,116900,3901,3.2
CN1315300000000,2022-07-01,13,153,GA,Houston County,70908,68574,2334,3.3
CN1315500000000,2022-07-01,13,155,GA,Irwin County,3464,3300,164,4.7
CN1315700000000,2022-07-01,13,157,GA,Jackson County,45109,44206,903,2
CN1315900000000,2022-07-01,13,159,GA,Jasper County,7228,7034,194,2.7
CN1316100000000,2022-07-01,13,161,GA,Jeff Davis County,6058,5834,224,3.7
CN1316300000000,2022-07-01,13,163,GA,Jefferson County,6566,6256,310,4.7
CN1316500000000,2022-07-01,13,165,GA,Jenkins County,3251,3088,163,5
CN1316700000000,2022-07-01,13,167,GA,Johnson County,3943,3827,116,2.9
CN1316900000000,2022-07-01,13,169,GA,Jones County,13190,12803,387,2.9
CN1317100000000,2022-07-01,13,171,GA,Lamar County,8429,8134,295,3.5
CN1317300000000,2022-07-01,13,173,GA,Lanier County,3774,3643,131,3.5
CN1317500000000,2022-07-01,13,175,GA,Laurens County,18921,18106,815,4.3
CN1317700000000,2022-07-01,13,177,GA,Lee County,14900,14451,449,3
CN1317900000000,2022-07-01,13,179,GA,Liberty County,26070,25173,897,3.4
CN1318100000000,2022-07-01,13,181,GA,Lincoln County,3498,3369,129,3.7
CN1318300000000,2022-07-01,13,183,GA,Long County,8462,8185,277,3.3
CN1318500000000,2022-07-01,13,185,GA,Lowndes County,50412,48683,1729,3.4
CN1318700000000,2022-07-01,13,187,GA,Lumpkin County,18302,17848,454,2.5
CN1318900000000,2022-07-01,13,189,GA,McDuffie County,8426,7970,456,5.4
CN1319100000000,2022-07-01,13,191,GA,McIntosh County,6309,6122,187,3
CN1319300000000,2022-07-01,13,193,GA,Macon County,4514,4308,206,4.6
CN1319500000000,2022-07-01,13,195,GA,Madison County,13096,12705,391,3
CN1319700000000,2022-07-01,13,197,GA,Marion County,3252,3136,116,3.6
CN1319900000000,2022-07-01,13,199,GA,Meriwether County,9042,8670,372,4.1
CN1320100000000,2022-07-01,13,201,GA,Miller County,2864,2787,77,2.7
CN1320500000000,2022-07-01,13,205,GA,Mitchell County,8208,7885,323,3.9
CN1320700000000,2022-07-01,13,207,GA,Monroe County,12699,12327,372,2.9
CN1320900000000,2022-07-01,13,209,GA,Montgomery County,3823,3649,174,4.6
CN1321100000000,2022-07-01,13,211,GA,Morgan County,9749,9476,273,2.8
CN1321300000000,2022-07-01,13,213,GA,Murray County,15433,14741,692,4.5
CN1321500000000,2022-07-01,13,215,GA,Muscogee County,75520,72348,3172,4.2
CN1321700000000,2022-07-01,13,217,GA,Newton County,54630,52516,2114,3.9
CN1321900000000,2022-07-01,13,219,GA,Oconee County,19568,19121,447,2.3
CN1322100000000,2022-07-01,13,221,GA,Oglethorpe County,6766,6581,185,2.7
CN1322300000000,2022-07-01,13,223,GA,Paulding County,91566,89129,2437,2.7
CN1322500000000,2022-07-01,13,225,GA,Peach County,11903,11432,471,4
CN1322700000000,2022-07-01,13,227,GA,Pickens County,15922,15531,391,2.5
CN1322900000000,2022-07-01,13,229,GA,Pierce County,8871,8628,243,2.7
CN1323100000000,2022-07-01,13,231,GA,Pike County,9228,8979,249,2.7
CN1323300000000,2022-07-01,13,233,GA,Polk County,18654,18108,546,2.9
CN1323500000000,2022-07-01,13,235,GA,Pulaski County,4026,3882,144,3.6
CN1323700000000,2022-07-01,13,237,GA,Putnam County,8731,8421,310,3.6
CN1323900000000,2022-07-01,13,239,GA,Quitman County,720,684,36,5
CN1324100000000,2022-07-01,13,241,GA,Rabun County,8041,7828,213,2.6
CN1324300000000,2022-07-01,13,243,GA,Randolph County,2329,2217,112,4.8
CN1324500000000,2022-07-01,13,245,GA,Richmond County,82302,78499,3803,4.6
CN1324700000000,2022-07-01,13,247,GA,Rockdale County,45422,43746,1676,3.7
CN1324900000000,2022-07-01,13,249,GA,Schley County,2139,2049,90,4.2
CN1325100000000,2022-07-01,13,251,GA,Screven County,5039,4770,269,5.3
CN1325300000000,2022-07-01,13,253,GA,Seminole County,3097,2987,110,3.6
CN1325500000000,2022-07-01,13,255,GA,Spalding County,29453,28416,1037,3.5
CN1325700000000,2022-07-01,13,257,GA,Stephens County,10563,10086,477,4.5
CN1325900000000,2022-07-01,13,259,GA,Stewart County,2581,2478,103,4
CN1326100000000,2022-07-01,13,261,GA,Sumter County,12143,11582,561,4.6
CN1326300000000,2022-07-01,13,263,GA,Talbot County,2831,2726,105,3.7
CN1326500000000,2022-07-01,13,265,GA,Taliaferro County,553,527,26,4.7
CN1326700000000,2022-07-01,13,267,GA,Tattnall County,9440,9148,292,3.1
CN1326900000000,2022-07-01,13,269,GA,Taylor County,2588,2457,131,5.1
CN1327100000000,2022-07-01,13,271,GA,Telfair County,3489,3283,206,5.9
CN1327300000000,2022-07-01,13,273,GA,Terrell County,3455,3292,163,4.7
CN1327500000000,2022-07-01,13,275,GA,Thomas County,17039,16417,622,3.7
CN1327700000000,2022-07-01,13,277,GA,Tift County,20777,20143,634,3.1
CN1327900000000,2022-07-01,13,279,GA,Toombs County,12025,11490,535,4.4
CN1328100000000,2022-07-01,13,281,GA,Towns County,4135,3971,164,4
CN1328300000000,2022-07-01,13,283,GA,Treutlen County,2628,2510,118,4.5
CN1328500000000,2022-07-01,13,285,GA,Troup County,36319,35065,1254,3.5
CN1328700000000,2022-07-01,13,287,GA,Turner County,3166,3028,138,4.4
CN1328900000000,2022-07-01,13,289,GA,Twiggs County,2707,2565,142,5.2
CN1329100000000,2022-07-01,13,291,GA,Union County,11460,11185,275,2.4
CN1329300000000,2022-07-01,13,293,GA,Upson County,11714,11265,449,3.8
CN1329500000000,2022-07-01,13,295,GA,Walker County,30966,30048,918,3
CN1329700000000,2022-07-01,13,297,GA,Walton County,48112,46740,1372,2.9
CN1329900000000,2022-07-01,13,299,GA,Ware County,15853,15326,527,3.3
CN1330100000000,2022-07-01,13,301,GA,Warren County,2675,2539,136,5.1
CN1330300000000,2022-07-01,13,303,GA,Washington County,6863,6573,290,4.2
CN1330500000000,2022-07-01,13,305,GA,Wayne County,11910,11531,379,3.2
CN1330700000000,2022-07-01,13,307,GA,Webster County,980,943,37,3.8
CN1330900000000,2022-07-01,13,309,GA,Wheeler County,1630,1550,80,4.9
CN1331100000000,2022-07-01,13,311,GA,White County,17039,16622,417,2.4
CN1331300000000,2022-07-01,13,313,GA,Whitfield County,43155,41449,1706,4
CN1331500000000,2022-07-01,13,315,GA,Wilcox County,2614,2500,114,4.4
CN1331700000000,2022-07-01,13,317,GA,Wilkes County,3792,3620,172,4.5
CN1331900000000,2022-07-01,13,319,GA,Wilkinson County,3870,3732,138,3.6
CN1332100000000,2022-07-01,13,321,GA,Worth County,8662,8398,264,3
CN1500100000000,2022-07-01,15,001,HI,Hawaii County,94219,90557,3662,3.9
CN1500300000000,2022-07-01,15,003,HI,Honolulu County/city,460747,444555,16192,3.5
CN1500700000000,2022-07-01,15,007,HI,Kauai County,36924,35635,1289,3.5
CN1500900000000,2022-07-01,15,009,HI,Maui County,87860,84871,2989,3.4
CN1600100000000,2022-07-01,16,001,ID,Ada County,275477,269135,6342,2.3
CN1600300000000,2022-07-01,16,003,ID,Adams County,1874,1795,79,4.2
CN1600500000000,2022-07-01,16,005,ID,Bannock County,42997,41826,1171,2.7
CN1600700000000,2022-07-01,16,007,ID,Bear Lake County,3414,3340,74,2.2
CN1600900000000,2022-07-01,16,009,ID,Benewah County,4195,4060,135,3.2
CN1601100000000,2022-07-01,16,011,ID,Bingham County,24670,24003,667,2.7
CN1601300000000,2022-07-01,16,013,ID,Blaine County,14060,13762,298,2.1
CN1601500000000,2022-07-01,16,015,ID,Boise County,3820,3689,131,3.4
CN1601700000000,2022-07-01,16,017,ID,Bonner County,22560,21899,661,2.9
CN1601900000000,2022-07-01,16,019,ID,Bonneville County,62973,61579,1394,2.2
CN1602100000000,2022-07-01,16,021,ID,Boundary County,5909,5726,183,3.1
CN1602300000000,2022-07-01,16,023,ID,Butte County,1493,1457,36,2.4
CN1602500000000,2022-07-01,16,025,ID,Camas County,746,730,16,2.1
CN1602700000000,2022-07-01,16,027,ID,Canyon County,116242,112591,3651,3.1
CN1602900000000,2022-07-01,16,029,ID,Caribou County,4221,4119,102,2.4
CN1603100000000,2022-07-01,16,031,ID,Cassia County,14268,13942,326,2.3
CN1603300000000,2022-07-01,16,033,ID,Clark County,396,386,10,2.5
CN1603500000000,2022-07-01,16,035,ID,Clearwater County,3082,2956,126,4.1
CN1603700000000,2022-07-01,16,037,ID,Custer County,2651,2589,62,2.3
CN1603900000000,2022-07-01,16,039,ID,Elmore County,12718,12337,381,3
CN1604100000000,2022-07-01,16,041,ID,Franklin County,7283,7140,143,2
CN1604300000000,2022-07-01,16,043,ID,Fremont County,8351,8168,183,2.2
CN1604500000000,2022-07-01,16,045,ID,Gem County,8955,8726,229,2.6
CN1604700000000,2022-07-01,16,047,ID,Gooding County,10236,10014,222,2.2
CN1604900000000,2022-07-01,16,049,ID,Idaho County,7042,6802,240,3.4
CN1605100000000,2022-07-01,16,051,ID,Jefferson County,15609,15262,347,2.2
CN1605300000000,2022-07-01,16,053,ID,Jerome County,15100,14753,347,2.3
CN1605500000000,2022-07-01,16,055,ID,Kootenai County,86525,84152,2373,2.7
CN1605700000000,2022-07-01,16,057,ID,Latah County,19456,18942,514,2.6
CN1605900000000,2022-07-01,16,059,ID,Lemhi County,3994,3877,117,2.9
CN1606100000000,2022-07-01,16,061,ID,Lewis County,1727,1655,72,4.2
CN1606300000000,2022-07-01,16,063,ID,Lincoln County,3230,3156,74,2.3
CN1606500000000,2022-07-01,16,065,ID,Madison County,24068,23561,507,2.1
CN1606700000000,2022-07-01,16,067,ID,Minidoka County,12967,12636,331,2.6
CN1606900000000,2022-07-01,16,069,ID,Nez Perce County,21475,20982,493,2.3
CN1607100000000,2022-07-01,16,071,ID,Oneida County,2719,2647,72,2.6
CN1607300000000,2022-07-01,16,073,ID,Owyhee County,6202,5997,205,3.3
CN1607500000000,2022-07-01,16,075,ID,Payette County,12235,11850,385,3.1
CN1607700000000,2022-07-01,16,077,ID,Power County,4280,4147,133,3.1
CN1607900000000,2022-07-01,16,079,ID,Shoshone County,5459,5250,209,3.8
CN1608100000000,2022-07-01,16,081,ID,Teton County,8548,8424,124,1.5
CN1608300000000,2022-07-01,16,083,ID,Twin Falls County,44762,43551,1211,2.7
CN1608500000000,2022-07-01,16,085,ID,Valley County,6401,6229,172,2.7
CN1608700000000,2022-07-01,16,087,ID,Washington County,5050,4876,174,3.4
CN1700100000000,2022-07-01,17,001,IL,Adams County,31475,30430,1045,3.3
CN1700300000000,2022-07-01,17,003,IL,Alexander County,1795,1667,128,7.1
CN1700500000000,2022-07-01,17,005,IL,Bond County,7691,7410,281,3.7
CN1700700000000,2022-07-01,17,007,IL,Boone County,25526,24149,1377,5.4
CN1700900000000,2022-07-01,17,009,IL,Brown County,3196,3119,77,2.4
CN1701100000000,2022-07-01,17,011,IL,Bureau County,16512,15859,653,4
CN1701300000000,2022-07-01,17,013,IL,Calhoun County,2233,2150,83,3.7
CN1701500000000,2022-07-01,17,015,IL,Carroll County,7809,7539,270,3.5
CN1701700000000,2022-07-01,17,017,IL,Cass County,5970,5737,233,3.9
CN1701900000000,2022-07-01,17,019,IL,Champaign County,108178,103843,4335,4
CN1702100000000,2022-07-01,17,021,IL,Christian County,13545,12938,607,4.5
CN1702300000000,2022-07-01,17,023,IL,Clark County,7513,7218,295,3.9
CN1702500000000,2022-07-01,17,025,IL,Clay County,5672,5369,303,5.3
CN1702700000000,2022-07-01,17,027,IL,Clinton County,20475,19871,604,2.9
CN1702900000000,2022-07-01,17,029,IL,Coles County,22088,21071,1017,4.6
CN1703100000000,2022-07-01,17,031,IL,Cook County,2700115,2553966,146149,5.4
CN1703300000000,2022-07-01,17,033,IL,Crawford County,8442,8086,356,4.2
CN1703500000000,2022-07-01,17,035,IL,Cumberland County,5926,5730,196,3.3
CN1703700000000,2022-07-01,17,037,IL,DeKalb County,55277,53034,2243,4.1
CN1703900000000,2022-07-01,17,039,IL,De Witt County,7440,7158,282,3.8
CN1704100000000,2022-07-01,17,041,IL,Douglas County,10408,10060,348,3.3
CN1704300000000,2022-07-01,17,043,IL,DuPage County,526775,505381,21394,4.1
CN1704500000000,2022-07-01,17,045,IL,Edgar County,9298,8962,336,3.6
CN1704700000000,2022-07-01,17,047,IL,Edwards County,2479,2366,113,4.6
CN1704900000000,2022-07-01,17,049,IL,Effingham County,20372,19806,566,2.8
CN1705100000000,2022-07-01,17,051,IL,Fayette County,9804,9401,403,4.1
CN1705300000000,2022-07-01,17,053,IL,Ford County,6327,6060,267,4.2
CN1705500000000,2022-07-01,17,055,IL,Franklin County,16181,15346,835,5.2
CN1705700000000,2022-07-01,17,057,IL,Fulton County,14694,14013,681,4.6
CN1705900000000,2022-07-01,17,059,IL,Gallatin County,2030,1921,109,5.4
CN1706100000000,2022-07-01,17,061,IL,Greene County,6057,5812,245,4
CN1706300000000,2022-07-01,17,063,IL,Grundy County,26599,25252,1347,5.1
CN1706500000000,2022-07-01,17,065,IL,Hamilton County,4353,4208,145,3.3
CN1706700000000,2022-07-01,17,067,IL,Hancock County,8229,7925,304,3.7
CN1706900000000,2022-07-01,17,069,IL,Hardin County,1462,1376,86,5.9
CN1707100000000,2022-07-01,17,071,IL,Henderson County,3611,3476,135,3.7
CN1707300000000,2022-07-01,17,073,IL,Henry County,24275,23306,969,4
CN1707500000000,2022-07-01,17,075,IL,Iroquois County,12906,12396,510,4
CN1707700000000,2022-07-01,17,077,IL,Jackson County,27505,26318,1187,4.3
CN1707900000000,2022-07-01,17,079,IL,Jasper County,4962,4783,179,3.6
CN1708100000000,2022-07-01,17,081,IL,Jefferson County,16740,15947,793,4.7
CN1708300000000,2022-07-01,17,083,IL,Jersey County,10863,10476,387,3.6
CN1708500000000,2022-07-01,17,085,IL,Jo Daviess County,10924,10580,344,3.1
CN1708700000000,2022-07-01,17,087,IL,Johnson County,4073,3863,210,5.2
CN1708900000000,2022-07-01,17,089,IL,Kane County,270347,259109,11238,4.2
CN1709100000000,2022-07-01,17,091,IL,Kankakee County,52974,50492,2482,4.7
CN1709300000000,2022-07-01,17,093,IL,Kendall County,73669,70382,3287,4.5
CN1709500000000,2022-07-01,17,095,IL,Knox County,20164,19189,975,4.8
CN1709700000000,2022-07-01,17,097,IL,Lake County,375169,361111,14058,3.7
CN1709900000000,2022-07-01,17,099,IL,LaSalle County,53072,50710,2362,4.5
CN1710100000000,2022-07-01,17,101,IL,Lawrence County,5221,4933,288,5.5
CN1710300000000,2022-07-01,17,103,IL,Lee County,17052,16392,660,3.9
CN1710500000000,2022-07-01,17,105,IL,Livingston County,15873,15296,577,3.6
CN1710700000000,2022-07-01,17,107,IL,Logan County,11706,11208,498,4.3
CN1710900000000,2022-07-01,17,109,IL,McDonough County,11896,11297,599,5
CN1711100000000,2022-07-01,17,111,IL,McHenry County,172083,164711,7372,4.3
CN1711300000000,2022-07-01,17,113,IL,McLean County,89671,86362,3309,3.7
CN1711500000000,2022-07-01,17,115,IL,Macon County,46301,43751,2550,5.5
CN1711700000000,2022-07-01,17,117,IL,Macoupin County,22688,21865,823,3.6
CN1711900000000,2022-07-01,17,119,IL,Madison County,134438,129128,5310,3.9
CN1712100000000,2022-07-01,17,121,IL,Marion County,17069,16268,801,4.7
CN1712300000000,2022-07-01,17,123,IL,Marshall County,5247,5022,225,4.3
CN1712500000000,2022-07-01,17,125,IL,Mason County,6100,5829,271,4.4
CN1712700000000,2022-07-01,17,127,IL,Massac County,5528,5240,288,5.2
CN1712900000000,2022-07-01,17,129,IL,Menard County,6282,6069,213,3.4
CN1713100000000,2022-07-01,17,131,IL,Mercer County,7731,7467,264,3.4
CN1713300000000,2022-07-01,17,133,IL,Monroe County,19146,18586,560,2.9
CN1713500000000,2022-07-01,17,135,IL,Montgomery County,11444,10951,493,4.3
CN1713700000000,2022-07-01,17,137,IL,Morgan County,15848,15234,614,3.9
CN1713900000000,2022-07-01,17,139,IL,Moultrie County,7553,7306,247,3.3
CN1714100000000,2022-07-01,17,141,IL,Ogle County,24401,23365,1036,4.2
CN1714300000000,2022-07-01,17,143,IL,Peoria County,83711,79714,3997,4.8
CN1714500000000,2022-07-01,17,145,IL,Perry County,7866,7441,425,5.4
CN1714700000000,2022-07-01,17,147,IL,Piatt County,8565,8263,302,3.5
CN1714900000000,2022-07-01,17,149,IL,Pike County,7053,6791,262,3.7
CN1715100000000,2022-07-01,17,151,IL,Pope County,1792,1701,91,5.1
CN1715300000000,2022-07-01,17,153,IL,Pulaski County,1657,1543,114,6.9
CN1715500000000,2022-07-01,17,155,IL,Putnam County,3062,2938,124,4
CN1715700000000,2022-07-01,17,157,IL,Randolph County,13702,13178,524,3.8
CN1715900000000,2022-07-01,17,159,IL,Richland County,7349,7064,285,3.9
CN1716100000000,2022-07-01,17,161,IL,Rock Island County,68628,65870,2758,4
CN1716300000000,2022-07-01,17,163,IL,St. Clair County,126000,120545,5455,4.3
CN1716500000000,2022-07-01,17,165,IL,Saline County,9355,8864,491,5.2
CN1716700000000,2022-07-01,17,167,IL,Sangamon County,98787,94829,3958,4
CN1716900000000,2022-07-01,17,169,IL,Schuyler County,3250,3120,130,4
CN1717100000000,2022-07-01,17,171,IL,Scott County,2345,2255,90,3.8
CN1717300000000,2022-07-01,17,173,IL,Shelby County,10225,9817,408,4
CN1717500000000,2022-07-01,17,175,IL,Stark County,2451,2350,101,4.1
CN1717700000000,2022-07-01,17,177,IL,Stephenson County,21525,20644,881,4.1
CN1717900000000,2022-07-01,17,179,IL,Tazewell County,63216,60647,2569,4.1
CN1718100000000,2022-07-01,17,181,IL,Union County,7083,6752,331,4.7
CN1718300000000,2022-07-01,17,183,IL,Vermilion County,32449,30846,1603,4.9
CN1718500000000,2022-07-01,17,185,IL,Wabash County,5945,5749,196,3.3
CN1718700000000,2022-07-01,17,187,IL,Warren County,7908,7596,312,3.9
CN1718900000000,2022-07-01,17,189,IL,Washington County,10240,9969,271,2.6
CN1719100000000,2022-07-01,17,191,IL,Wayne County,7080,6800,280,4
CN1719300000000,2022-07-01,17,193,IL,White County,6107,5877,230,3.8
CN1719500000000,2022-07-01,17,195,IL,Whiteside County,28121,26990,1131,4
CN1719700000000,2022-07-01,17,197,IL,Will County,372975,354903,18072,4.8
CN1719900000000,2022-07-01,17,199,IL,Williamson County,31371,30060,1311,4.2
CN1720100000000,2022-07-01,17,201,IL,Winnebago County,135904,128883,7021,5.2
CN1720300000000,2022-07-01,17,203,IL,Woodford County,18621,18008,613,3.3
CN1800100000000,2022-07-01,18,001,IN,Adams County,17520,17070,450,2.6
CN1800300000000,2022-07-01,18,003,IN,Allen County,192498,186312,6186,3.2
CN1800500000000,2022-07-01,18,005,IN,Bartholomew County,44941,43731,1210,2.7
CN1800700000000,2022-07-01,18,007,IN,Benton County,4511,4388,123,2.7
CN1800900000000,2022-07-01,18,009,IN,Blackford County,4747,4557,190,4
CN1801100000000,2022-07-01,18,011,IN,Boone County,39056,38149,907,2.3
CN1801300000000,2022-07-01,18,013,IN,Brown County,8067,7766,301,3.7
CN1801500000000,2022-07-01,18,015,IN,Carroll County,10111,9786,325,3.2
CN1801700000000,2022-07-01,18,017,IN,Cass County,17609,16990,619,3.5
CN1801900000000,2022-07-01,18,019,IN,Clark County,63774,61835,1939,3
CN1802100000000,2022-07-01,18,021,IN,Clay County,11849,11380,469,4
CN1802300000000,2022-07-01,18,023,IN,Clinton County,17540,17042,498,2.8
CN1802500000000,2022-07-01,18,025,IN,Crawford County,4901,4727,174,3.6
CN1802700000000,2022-07-01,18,027,IN,Daviess County,17179,16735,444,2.6
CN1802900000000,2022-07-01,18,029,IN,Dearborn County,26524,25746,778,2.9
CN1803100000000,2022-07-01,18,031,IN,Decatur County,14767,14361,406,2.7
CN1803300000000,2022-07-01,18,033,IN,DeKalb County,22996,22291,705,3.1
CN1803500000000,2022-07-01,18,035,IN,Delaware County,51376,49255,2121,4.1
CN1803700000000,2022-07-01,18,037,IN,Dubois County,22607,22042,565,2.5
CN1803900000000,2022-07-01,18,039,IN,Elkhart County,120830,117467,3363,2.8
CN1804100000000,2022-07-01,18,041,IN,Fayette County,8270,7835,435,5.3
CN1804300000000,2022-07-01,18,043,IN,Floyd County,42955,41773,1182,2.8
CN1804500000000,2022-07-01,18,045,IN,Fountain County,8139,7884,255,3.1
CN1804700000000,2022-07-01,18,047,IN,Franklin County,11586,11247,339,2.9
CN1804900000000,2022-07-01,18,049,IN,Fulton County,9811,9500,311,3.2
CN1805100000000,2022-07-01,18,051,IN,Gibson County,20438,19890,548,2.7
CN1805300000000,2022-07-01,18,053,IN,Grant County,30911,29740,1171,3.8
CN1805500000000,2022-07-01,18,055,IN,Greene County,13663,13085,578,4.2
CN1805700000000,2022-07-01,18,057,IN,Hamilton County,199060,194063,4997,2.5
CN1805900000000,2022-07-01,18,059,IN,Hancock County,43673,42398,1275,2.9
CN1806100000000,2022-07-01,18,061,IN,Harrison County,20842,20253,589,2.8
CN1806300000000,2022-07-01,18,063,IN,Hendricks County,96954,94254,2700,2.8
CN1806500000000,2022-07-01,18,065,IN,Henry County,22525,21747,778,3.5
CN1806700000000,2022-07-01,18,067,IN,Howard County,34438,32726,1712,5
CN1806900000000,2022-07-01,18,069,IN,Huntington County,18791,18245,546,2.9
CN1807100000000,2022-07-01,18,071,IN,Jackson County,23999,23234,765,3.2
CN1807300000000,2022-07-01,18,073,IN,Jasper County,16392,15824,568,3.5
CN1807500000000,2022-07-01,18,075,IN,Jay County,9056,8784,272,3
CN1807700000000,2022-07-01,18,077,IN,Jefferson County,15079,14586,493,3.3
CN1807900000000,2022-07-01,18,079,IN,Jennings County,13904,13406,498,3.6
CN1808100000000,2022-07-01,18,081,IN,Johnson County,88639,86237,2402,2.7
CN1808300000000,2022-07-01,18,083,IN,Knox County,18644,18043,601,3.2
CN1808500000000,2022-07-01,18,085,IN,Kosciusko County,41804,40662,1142,2.7
CN1808700000000,2022-07-01,18,087,IN,LaGrange County,22268,21697,571,2.6
CN1808900000000,2022-07-01,18,089,IN,Lake County,231967,220925,11042,4.8
CN1809100000000,2022-07-01,18,091,IN,LaPorte County,47888,46015,1873,3.9
CN1809300000000,2022-07-01,18,093,IN,Lawrence County,20723,19948,775,3.7
CN1809500000000,2022-07-01,18,095,IN,Madison County,61476,59257,2219,3.6
CN1809700000000,2022-07-01,18,097,IN,Marion County,517133,498821,18312,3.5
CN1809900000000,2022-07-01,18,099,IN,Marshall County,23715,23056,659,2.8
CN1810100000000,2022-07-01,18,101,IN,Martin County,5629,5455,174,3.1
CN1810300000000,2022-07-01,18,103,IN,Miami County,14676,14057,619,4.2
CN1810500000000,2022-07-01,18,105,IN,Monroe County,70450,67913,2537,3.6
CN1810700000000,2022-07-01,18,107,IN,Montgomery County,19204,18639,565,2.9
CN1810900000000,2022-07-01,18,109,IN,Morgan County,38171,36997,1174,3.1
CN1811100000000,2022-07-01,18,111,IN,Newton County,6987,6715,272,3.9
CN1811300000000,2022-07-01,18,113,IN,Noble County,22236,21542,694,3.1
CN1811500000000,2022-07-01,18,115,IN,Ohio County,3265,3189,76,2.3
CN1811700000000,2022-07-01,18,117,IN,Orange County,8392,8077,315,3.8
CN1811900000000,2022-07-01,18,119,IN,Owen County,9324,8990,334,3.6
CN1812100000000,2022-07-01,18,121,IN,Parke County,7437,7185,252,3.4
CN1812300000000,2022-07-01,18,123,IN,Perry County,8921,8615,306,3.4
CN1812500000000,2022-07-01,18,125,IN,Pike County,6087,5885,202,3.3
CN1812700000000,2022-07-01,18,127,IN,Porter County,87510,84439,3071,3.5
CN1812900000000,2022-07-01,18,129,IN,Posey County,13403,13044,359,2.7
CN1813100000000,2022-07-01,18,131,IN,Pulaski County,6840,6650,190,2.8
CN1813300000000,2022-07-01,18,133,IN,Putnam County,17363,16737,626,3.6
CN1813500000000,2022-07-01,18,135,IN,Randolph County,11629,11256,373,3.2
CN1813700000000,2022-07-01,18,137,IN,Ripley County,13012,12572,440,3.4
CN1813900000000,2022-07-01,18,139,IN,Rush County,9153,8905,248,2.7
CN1814100000000,2022-07-01,18,141,IN,St. Joseph County,134121,128934,5187,3.9
CN1814300000000,2022-07-01,18,143,IN,Scott County,10740,10351,389,3.6
CN1814500000000,2022-07-01,18,145,IN,Shelby County,24218,23544,674,2.8
CN1814700000000,2022-07-01,18,147,IN,Spencer County,11373,11048,325,2.9
CN1814900000000,2022-07-01,18,149,IN,Starke County,9659,9262,397,4.1
CN1815100000000,2022-07-01,18,151,IN,Steuben County,21529,21009,520,2.4
CN1815300000000,2022-07-01,18,153,IN,Sullivan County,8138,7802,336,4.1
CN1815500000000,2022-07-01,18,155,IN,Switzerland County,4839,4688,151,3.1
CN1815700000000,2022-07-01,18,157,IN,Tippecanoe County,97554,94171,3383,3.5
CN1815900000000,2022-07-01,18,159,IN,Tipton County,9250,8967,283,3.1
CN1816100000000,2022-07-01,18,161,IN,Union County,3688,3587,101,2.7
CN1816300000000,2022-07-01,18,163,IN,Vanderburgh County,94535,91356,3179,3.4
CN1816500000000,2022-07-01,18,165,IN,Vermillion County,6693,6431,262,3.9
CN1816700000000,2022-07-01,18,167,IN,Vigo County,46404,44545,1859,4
CN1816900000000,2022-07-01,18,169,IN,Wabash County,14739,14292,447,3
CN1817100000000,2022-07-01,18,171,IN,Warren County,4192,4071,121,2.9
CN1817300000000,2022-07-01,18,173,IN,Warrick County,33150,32180,970,2.9
CN1817500000000,2022-07-01,18,175,IN,Washington County,14189,13767,422,3
CN1817700000000,2022-07-01,18,177,IN,Wayne County,29985,28924,1061,3.5
CN1817900000000,2022-07-01,18,179,IN,Wells County,14661,14303,358,2.4
CN1818100000000,2022-07-01,18,181,IN,White County,13834,13461,373,2.7
CN1818300000000,2022-07-01,18,183,IN,Whitley County,18197,17715,482,2.6
CN1900100000000,2022-07-01,19,001,IA,Adair County,4389,4304,85,1.9
CN1900300000000,2022-07-01,19,003,IA,Adams County,2157,2114,43,2
CN1900500000000,2022-07-01,19,005,IA,Allamakee County,7128,6898,230,3.2
CN1900700000000,2022-07-01,19,007,IA,Appanoose County,6134,5961,173,2.8
CN1900900000000,2022-07-01,19,009,IA,Audubon County,3084,3016,68,2.2
CN1901100000000,2022-07-01,19,011,IA,Benton County,13305,12902,403,3
CN1901300000000,2022-07-01,19,013,IA,Black Hawk County,68128,66110,2018,3
CN1901500000000,2022-07-01,19,015,IA,Boone County,14932,14586,346,2.3
CN1901700000000,2022-07-01,19,017,IA,Bremer County,14029,13709,320,2.3
CN1901900000000,2022-07-01,19,019,IA,Buchanan County,11430,11121,309,2.7
CN1902100000000,2022-07-01,19,021,IA,Buena Vista County,11617,11265,352,3
CN1902300000000,2022-07-01,19,023,IA,Butler County,8350,8145,205,2.5
CN1902500000000,2022-07-01,19,025,IA,Calhoun County,4173,4064,109,2.6
CN1902700000000,2022-07-01,19,027,IA,Carroll County,10931,10709,222,2
CN1902900000000,2022-07-01,19,029,IA,Cass County,6975,6811,164,2.4
CN1903100000000,2022-07-01,19,031,IA,Cedar County,10479,10210,269,2.6
CN1903300000000,2022-07-01,19,033,IA,Cerro Gordo County,22903,22231,672,2.9
CN1903500000000,2022-07-01,19,035,IA,Cherokee County,6206,6069,137,2.2
CN1903700000000,2022-07-01,19,037,IA,Chickasaw County,6679,6519,160,2.4
CN1903900000000,2022-07-01,19,039,IA,Clarke County,4999,4858,141,2.8
CN1904100000000,2022-07-01,19,041,IA,Clay County,8675,8459,216,2.5
CN1904300000000,2022-07-01,19,043,IA,Clayton County,9557,9245,312,3.3
CN1904500000000,2022-07-01,19,045,IA,Clinton County,22588,21762,826,3.7
CN1904700000000,2022-07-01,19,047,IA,Crawford County,7765,7500,265,3.4
CN1904900000000,2022-07-01,19,049,IA,Dallas County,55067,53883,1184,2.2
CN1905100000000,2022-07-01,19,051,IA,Davis County,4325,4214,111,2.6
CN1905300000000,2022-07-01,19,053,IA,Decatur County,3996,3881,115,2.9
CN1905500000000,2022-07-01,19,055,IA,Delaware County,10565,10333,232,2.2
CN1905700000000,2022-07-01,19,057,IA,Des Moines County,19006,18193,813,4.3
CN1905900000000,2022-07-01,19,059,IA,Dickinson County,11897,11624,273,2.3
CN1906100000000,2022-07-01,19,061,IA,Dubuque County,56583,55007,1576,2.8
CN1906300000000,2022-07-01,19,063,IA,Emmet County,5031,4877,154,3.1
CN1906500000000,2022-07-01,19,065,IA,Fayette County,10112,9822,290,2.9
CN1906700000000,2022-07-01,19,067,IA,Floyd County,8501,8249,252,3
CN1906900000000,2022-07-01,19,069,IA,Franklin County,5669,5522,147,2.6
CN1907100000000,2022-07-01,19,071,IA,Fremont County,3784,3692,92,2.4
CN1907300000000,2022-07-01,19,073,IA,Greene County,5431,5314,117,2.2
CN1907500000000,2022-07-01,19,075,IA,Grundy County,6382,6235,147,2.3
CN1907700000000,2022-07-01,19,077,IA,Guthrie County,5696,5545,151,2.7
CN1907900000000,2022-07-01,19,079,IA,Hamilton County,6960,6762,198,2.8
CN1908100000000,2022-07-01,19,081,IA,Hancock County,5857,5714,143,2.4
CN1908300000000,2022-07-01,19,083,IA,Hardin County,7870,7635,235,3
CN1908500000000,2022-07-01,19,085,IA,Harrison County,7248,7043,205,2.8
CN1908700000000,2022-07-01,19,087,IA,Henry County,9439,9136,303,3.2
CN1908900000000,2022-07-01,19,089,IA,Howard County,5300,5164,136,2.6
CN1909100000000,2022-07-01,19,091,IA,Humboldt County,4949,4836,113,2.3
CN1909300000000,2022-07-01,19,093,IA,Ida County,4023,3933,90,2.2
CN1909500000000,2022-07-01,19,095,IA,Iowa County,9939,9687,252,2.5
CN1909700000000,2022-07-01,19,097,IA,Jackson County,10878,10566,312,2.9
CN1909900000000,2022-07-01,19,099,IA,Jasper County,18759,18223,536,2.9
CN1910100000000,2022-07-01,19,101,IA,Jefferson County,9836,9569,267,2.7
CN1910300000000,2022-07-01,19,103,IA,Johnson County,87121,84966,2155,2.5
CN1910500000000,2022-07-01,19,105,IA,Jones County,10478,10181,297,2.8
CN1910700000000,2022-07-01,19,107,IA,Keokuk County,5315,5153,162,3
CN1910900000000,2022-07-01,19,109,IA,Kossuth County,8469,8275,194,2.3
CN1911100000000,2022-07-01,19,111,IA,Lee County,14920,14192,728,4.9
CN1911300000000,2022-07-01,19,113,IA,Linn County,123037,119097,3940,3.2
CN1911500000000,2022-07-01,19,115,IA,Louisa County,6074,5893,181,3
CN1911700000000,2022-07-01,19,117,IA,Lucas County,4658,4545,113,2.4
CN1911900000000,2022-07-01,19,119,IA,Lyon County,7175,7049,126,1.8
CN1912100000000,2022-07-01,19,121,IA,Madison County,8884,8636,248,2.8
CN1912300000000,2022-07-01,19,123,IA,Mahaska County,12254,11913,341,2.8
CN1912500000000,2022-07-01,19,125,IA,Marion County,19606,19211,395,2
CN1912700000000,2022-07-01,19,127,IA,Marshall County,17471,16750,721,4.1
CN1912900000000,2022-07-01,19,129,IA,Mills County,7226,7062,164,2.3
CN1913100000000,2022-07-01,19,131,IA,Mitchell County,6001,5877,124,2.1
CN1913300000000,2022-07-01,19,133,IA,Monona County,4429,4309,120,2.7
CN1913500000000,2022-07-01,19,135,IA,Monroe County,4098,3970,128,3.1
CN1913700000000,2022-07-01,19,137,IA,Montgomery County,5088,4954,134,2.6
CN1913900000000,2022-07-01,19,139,IA,Muscatine County,21473,20854,619,2.9
CN1914100000000,2022-07-01,19,141,IA,O'Brien County,8121,7937,184,2.3
CN1914300000000,2022-07-01,19,143,IA,Osceola County,3665,3597,68,1.9
CN1914500000000,2022-07-01,19,145,IA,Page County,6598,6432,166,2.5
CN1914700000000,2022-07-01,19,147,IA,Palo Alto County,4507,4381,126,2.8
CN1914900000000,2022-07-01,19,149,IA,Plymouth County,14945,14608,337,2.3
CN1915100000000,2022-07-01,19,151,IA,Pocahontas County,4298,4202,96,2.2
CN1915300000000,2022-07-01,19,153,IA,Polk County,281987,274284,7703,2.7
CN1915500000000,2022-07-01,19,155,IA,Pottawattamie County,48624,47274,1350,2.8
CN1915700000000,2022-07-01,19,157,IA,Poweshiek County,10045,9757,288,2.9
CN1915900000000,2022-07-01,19,159,IA,Ringgold County,2378,2322,56,2.4
CN1916100000000,2022-07-01,19,161,IA,Sac County,5358,5226,132,2.5
CN1916300000000,2022-07-01,19,163,IA,Scott County,90441,87309,3132,3.5
CN1916500000000,2022-07-01,19,165,IA,Shelby County,6584,6435,149,2.3
CN1916700000000,2022-07-01,19,167,IA,Sioux County,21534,21120,414,1.9
CN1916900000000,2022-07-01,19,169,IA,Story County,57542,56157,1385,2.4
CN1917100000000,2022-07-01,19,171,IA,Tama County,9309,9064,245,2.6
CN1917300000000,2022-07-01,19,173,IA,Taylor County,3219,3149,70,2.2
CN1917500000000,2022-07-01,19,175,IA,Union County,6039,5864,175,2.9
CN1917700000000,2022-07-01,19,177,IA,Van Buren County,3753,3640,113,3
CN1917900000000,2022-07-01,19,179,IA,Wapello County,17280,16659,621,3.6
CN1918100000000,2022-07-01,19,181,IA,Warren County,29897,29138,759,2.5
CN1918300000000,2022-07-01,19,183,IA,Washington County,11727,11430,297,2.5
CN1918500000000,2022-07-01,19,185,IA,Wayne County,2957,2869,88,3
CN1918700000000,2022-07-01,19,187,IA,Webster County,19510,18883,627,3.2
CN1918900000000,2022-07-01,19,189,IA,Winnebago County,5157,5020,137,2.7
CN1919100000000,2022-07-01,19,191,IA,Winneshiek County,11298,10982,316,2.8
CN1919300000000,2022-07-01,19,193,IA,Woodbury County,56864,55183,1681,3
CN1919500000000,2022-07-01,19,195,IA,Worth County,4115,3998,117,2.8
CN1919700000000,2022-07-01,19,197,IA,Wright County,6521,6357,164,2.5
CN2000100000000,2022-07-01,20,001,KS,Allen County,6225,6000,225,3.6
CN2000300000000,2022-07-01,20,003,KS,Anderson County,4482,4345,137,3.1
CN2000500000000,2022-07-01,20,005,KS,Atchison County,6748,6426,322,4.8
CN2000700000000,2022-07-01,20,007,KS,Barber County,2315,2246,69,3
CN2000900000000,2022-07-01,20,009,KS,Barton County,13543,13116,427,3.2
CN2001100000000,2022-07-01,20,011,KS,Bourbon County,6289,6025,264,4.2
CN2001300000000,2022-07-01,20,013,KS,Brown County,5186,5039,147,2.8
CN2001500000000,2022-07-01,20,015,KS,Butler County,33144,31991,1153,3.5
CN2001700000000,2022-07-01,20,017,KS,Chase County,1479,1439,40,2.7
CN2001900000000,2022-07-01,20,019,KS,Chautauqua County,1423,1371,52,3.7
CN2002100000000,2022-07-01,20,021,KS,Cherokee County,10036,9694,342,3.4
CN2002300000000,2022-07-01,20,023,KS,Cheyenne County,1271,1231,40,3.1
CN2002500000000,2022-07-01,20,025,KS,Clark County,1116,1087,29,2.6
CN2002700000000,2022-07-01,20,027,KS,Clay County,3747,3610,137,3.7
CN2002900000000,2022-07-01,20,029,KS,Cloud County,3855,3706,149,3.9
CN2003100000000,2022-07-01,20,031,KS,Coffey County,3741,3580,161,4.3
CN2003300000000,2022-07-01,20,033,KS,Comanche County,870,846,24,2.8
CN2003500000000,2022-07-01,20,035,KS,Cowley County,16362,15727,635,3.9
CN2003700000000,2022-07-01,20,037,KS,Crawford County,19175,18433,742,3.9
CN2003900000000,2022-07-01,20,039,KS,Decatur County,1213,1163,50,4.1
CN2004100000000,2022-07-01,20,041,KS,Dickinson County,8766,8468,298,3.4
CN2004300000000,2022-07-01,20,043,KS,Doniphan County,4108,3968,140,3.4
CN2004500000000,2022-07-01,20,045,KS,Douglas County,65144,62874,2270,3.5
CN2004700000000,2022-07-01,20,047,KS,Edwards County,1379,1334,45,3.3
CN2004900000000,2022-07-01,20,049,KS,Elk County,1041,1005,36,3.5
CN2005100000000,2022-07-01,20,051,KS,Ellis County,16938,16465,473,2.8
CN2005300000000,2022-07-01,20,053,KS,Ellsworth County,2683,2602,81,3
CN2005500000000,2022-07-01,20,055,KS,Finney County,20698,20136,562,2.7
CN2005700000000,2022-07-01,20,057,KS,Ford County,17759,17267,492,2.8
CN2005900000000,2022-07-01,20,059,KS,Franklin County,15061,14588,473,3.1
CN2006100000000,2022-07-01,20,061,KS,Geary County,11230,10687,543,4.8
CN2006300000000,2022-07-01,20,063,KS,Gove County,1357,1317,40,2.9
CN2006500000000,2022-07-01,20,065,KS,Graham County,1228,1192,36,2.9
CN2006700000000,2022-07-01,20,067,KS,Grant County,2818,2697,121,4.3
CN2006900000000,2022-07-01,20,069,KS,Gray County,3001,2913,88,2.9
CN2007100000000,2022-07-01,20,071,KS,Greeley County,789,772,17,2.2
CN2007300000000,2022-07-01,20,073,KS,Greenwood County,2878,2786,92,3.2
CN2007500000000,2022-07-01,20,075,KS,Hamilton County,1630,1592,38,2.3
CN2007700000000,2022-07-01,20,077,KS,Harper County,2787,2711,76,2.7
CN2007900000000,2022-07-01,20,079,KS,Harvey County,17314,16757,557,3.2
CN2008100000000,2022-07-01,20,081,KS,Haskell County,2157,2100,57,2.6
CN2008300000000,2022-07-01,20,083,KS,Hodgeman County,1038,1007,31,3
CN2008500000000,2022-07-01,20,085,KS,Jackson County,7449,7239,210,2.8
CN2008700000000,2022-07-01,20,087,KS,Jefferson County,10615,10273,342,3.2
CN2008900000000,2022-07-01,20,089,KS,Jewell County,1191,1151,40,3.4
CN2009100000000,2022-07-01,20,091,KS,Johnson County,358202,347901,10301,2.9
CN2009300000000,2022-07-01,20,093,KS,Kearny County,1991,1939,52,2.6
CN2009500000000,2022-07-01,20,095,KS,Kingman County,3322,3213,109,3.3
CN2009700000000,2022-07-01,20,097,KS,Kiowa County,1122,1086,36,3.2
CN2009900000000,2022-07-01,20,099,KS,Labette County,9486,9117,369,3.9
CN2010100000000,2022-07-01,20,101,KS,Lane County,709,685,24,3.4
CN2010300000000,2022-07-01,20,103,KS,Leavenworth County,38411,37069,1342,3.5
CN2010500000000,2022-07-01,20,105,KS,Lincoln County,1658,1611,47,2.8
CN2010700000000,2022-07-01,20,107,KS,Linn County,4476,4277,199,4.4
CN2010900000000,2022-07-01,20,109,KS,Logan County,1548,1506,42,2.7
CN2011100000000,2022-07-01,20,111,KS,Lyon County,16961,16394,567,3.3
CN2011300000000,2022-07-01,20,113,KS,McPherson County,17623,17179,444,2.5
CN2011500000000,2022-07-01,20,115,KS,Marion County,5836,5635,201,3.4
CN2011700000000,2022-07-01,20,117,KS,Marshall County,5453,5311,142,2.6
CN2011900000000,2022-07-01,20,119,KS,Meade County,2127,2075,52,2.4
CN2012100000000,2022-07-01,20,121,KS,Miami County,18466,17911,555,3
CN2012300000000,2022-07-01,20,123,KS,Mitchell County,3395,3301,94,2.8
CN2012500000000,2022-07-01,20,125,KS,Montgomery County,14842,14263,579,3.9
CN2012700000000,2022-07-01,20,127,KS,Morris County,3067,2973,94,3.1
CN2012900000000,2022-07-01,20,129,KS,Morton County,1140,1102,38,3.3
CN2013100000000,2022-07-01,20,131,KS,Nemaha County,5732,5592,140,2.4
CN2013300000000,2022-07-01,20,133,KS,Neosho County,6131,5843,288,4.7
CN2013500000000,2022-07-01,20,135,KS,Ness County,1331,1291,40,3
CN2013700000000,2022-07-01,20,137,KS,Norton County,2655,2591,64,2.4
CN2013900000000,2022-07-01,20,139,KS,Osage County,8203,7933,270,3.3
CN2014100000000,2022-07-01,20,141,KS,Osborne County,1896,1844,52,2.7
CN2014300000000,2022-07-01,20,143,KS,Ottawa County,3046,2942,104,3.4
CN2014500000000,2022-07-01,20,145,KS,Pawnee County,2748,2670,78,2.8
CN2014700000000,2022-07-01,20,147,KS,Phillips County,2636,2558,78,3
CN2014900000000,2022-07-01,20,149,KS,Pottawatomie County,12119,11727,392,3.2
CN2015100000000,2022-07-01,20,151,KS,Pratt County,4892,4750,142,2.9
CN2015300000000,2022-07-01,20,153,KS,Rawlins County,1572,1534,38,2.4
CN2015500000000,2022-07-01,20,155,KS,Reno County,29229,28163,1066,3.6
CN2015700000000,2022-07-01,20,157,KS,Republic County,2456,2387,69,2.8
CN2015900000000,2022-07-01,20,159,KS,Rice County,5471,5298,173,3.2
CN2016100000000,2022-07-01,20,161,KS,Riley County,33558,32291,1267,3.8
CN2016300000000,2022-07-01,20,163,KS,Rooks County,2417,2341,76,3.1
CN2016500000000,2022-07-01,20,165,KS,Rush County,1598,1551,47,2.9
CN2016700000000,2022-07-01,20,167,KS,Russell County,3340,3241,99,3
CN2016900000000,2022-07-01,20,169,KS,Saline County,30559,29659,900,2.9
CN2017100000000,2022-07-01,20,171,KS,Scott County,2792,2721,71,2.5
CN2017300000000,2022-07-01,20,173,KS,Sedgwick County,258534,248805,9729,3.8
CN2017500000000,2022-07-01,20,175,KS,Seward County,9884,9542,342,3.5
CN2017700000000,2022-07-01,20,177,KS,Shawnee County,94035,90923,3112,3.3
CN2017900000000,2022-07-01,20,179,KS,Sheridan County,1424,1386,38,2.7
CN2018100000000,2022-07-01,20,181,KS,Sherman County,2857,2765,92,3.2
CN2018300000000,2022-07-01,20,183,KS,Smith County,1920,1865,55,2.9
CN2018500000000,2022-07-01,20,185,KS,Stafford County,1926,1865,61,3.2
CN2018700000000,2022-07-01,20,187,KS,Stanton County,1095,1067,28,2.6
CN2018900000000,2022-07-01,20,189,KS,Stevens County,2955,2879,76,2.6
CN2019100000000,2022-07-01,20,191,KS,Sumner County,10903,10508,395,3.6
CN2019300000000,2022-07-01,20,193,KS,Thomas County,4319,4199,120,2.8
CN2019500000000,2022-07-01,20,195,KS,Trego County,1362,1319,43,3.2
CN2019700000000,2022-07-01,20,197,KS,Wabaunsee County,3826,3712,114,3
CN2019900000000,2022-07-01,20,199,KS,Wallace County,856,833,23,2.7
CN2020100000000,2022-07-01,20,201,KS,Washington County,3025,2945,80,2.6
CN2020300000000,2022-07-01,20,203,KS,Wichita County,1142,1113,29,2.5
CN2020500000000,2022-07-01,20,205,KS,Wilson County,3755,3616,139,3.7
CN2020700000000,2022-07-01,20,207,KS,Woodson County,1530,1464,66,4.3
CN2020900000000,2022-07-01,20,209,KS,Wyandotte County,80246,76960,3286,4.1
CN2100100000000,2022-07-01,21,001,KY,Adair County,7134,6771,363,5.1
CN2100300000000,2022-07-01,21,003,KY,Allen County,8951,8556,395,4.4
CN2100500000000,2022-07-01,21,005,KY,Anderson County,12087,11667,420,3.5
CN2100700000000,2022-07-01,21,007,KY,Ballard County,3529,3339,190,5.4
CN2100900000000,2022-07-01,21,009,KY,Barren County,17987,17206,781,4.3
CN2101100000000,2022-07-01,21,011,KY,Bath County,4763,4520,243,5.1
CN2101300000000,2022-07-01,21,013,KY,Bell County,8196,7736,460,5.6
CN2101500000000,2022-07-01,21,015,KY,Boone County,73402,70886,2516,3.4
CN2101700000000,2022-07-01,21,017,KY,Bourbon County,9845,9459,386,3.9
CN2101900000000,2022-07-01,21,019,KY,Boyd County,17193,16207,986,5.7
CN2102100000000,2022-07-01,21,021,KY,Boyle County,12861,12302,559,4.3
CN2102300000000,2022-07-01,21,023,KY,Bracken County,3829,3671,158,4.1
CN2102500000000,2022-07-01,21,025,KY,Breathitt County,3159,2891,268,8.5
CN2102700000000,2022-07-01,21,027,KY,Breckinridge County,8089,7711,378,4.7
CN2102900000000,2022-07-01,21,029,KY,Bullitt County,43482,41587,1895,4.4
CN2103100000000,2022-07-01,21,031,KY,Butler County,4912,4688,224,4.6
CN2103300000000,2022-07-01,21,033,KY,Caldwell County,6092,5851,241,4
CN2103500000000,2022-07-01,21,035,KY,Calloway County,17420,16629,791,4.5
CN2103700000000,2022-07-01,21,037,KY,Campbell County,51494,49634,1860,3.6
CN2103900000000,2022-07-01,21,039,KY,Carlisle County,2277,2182,95,4.2
CN2104100000000,2022-07-01,21,041,KY,Carroll County,5738,5537,201,3.5
CN2104300000000,2022-07-01,21,043,KY,Carter County,9668,8870,798,8.3
CN2104500000000,2022-07-01,21,045,KY,Casey County,6716,6442,274,4.1
CN2104700000000,2022-07-01,21,047,KY,Christian County,24836,23460,1376,5.5
CN2104900000000,2022-07-01,21,049,KY,Clark County,17336,16675,661,3.8
CN2105100000000,2022-07-01,21,051,KY,Clay County,4987,4660,327,6.6
CN2105300000000,2022-07-01,21,053,KY,Clinton County,3751,3555,196,5.2
CN2105500000000,2022-07-01,21,055,KY,Crittenden County,3829,3645,184,4.8
CN2105700000000,2022-07-01,21,057,KY,Cumberland County,3418,3308,110,3.2
CN2105900000000,2022-07-01,21,059,KY,Daviess County,46696,44727,1969,4.2
CN2106100000000,2022-07-01,21,061,KY,Edmonson County,4694,4443,251,5.3
CN2106300000000,2022-07-01,21,063,KY,Elliott County,1861,1701,160,8.6
CN2106500000000,2022-07-01,21,065,KY,Estill County,5218,4937,281,5.4
CN2106700000000,2022-07-01,21,067,KY,Fayette County,176931,170723,6208,3.5
CN2106900000000,2022-07-01,21,069,KY,Fleming County,6089,5789,300,4.9
CN2107100000000,2022-07-01,21,071,KY,Floyd County,10774,10099,675,6.3
CN2107300000000,2022-07-01,21,073,KY,Franklin County,25332,24389,943,3.7
CN2107500000000,2022-07-01,21,075,KY,Fulton County,2154,2029,125,5.8
CN2107700000000,2022-07-01,21,077,KY,Gallatin County,4082,3928,154,3.8
CN2107900000000,2022-07-01,21,079,KY,Garrard County,7942,7615,327,4.1
CN2108100000000,2022-07-01,21,081,KY,Grant County,11891,11410,481,4
CN2108300000000,2022-07-01,21,083,KY,Graves County,15628,14872,756,4.8
CN2108500000000,2022-07-01,21,085,KY,Grayson County,10497,9980,517,4.9
CN2108700000000,2022-07-01,21,087,KY,Green County,4981,4766,215,4.3
CN2108900000000,2022-07-01,21,089,KY,Greenup County,12953,12134,819,6.3
CN2109100000000,2022-07-01,21,091,KY,Hancock County,3895,3720,175,4.5
CN2109300000000,2022-07-01,21,093,KY,Hardin County,48038,45807,2231,4.6
CN2109500000000,2022-07-01,21,095,KY,Harlan County,6330,5864,466,7.4
CN2109700000000,2022-07-01,21,097,KY,Harrison County,8892,8567,325,3.7
CN2109900000000,2022-07-01,21,099,KY,Hart County,7703,7363,340,4.4
CN2110100000000,2022-07-01,21,101,KY,Henderson County,21013,20116,897,4.3
CN2110300000000,2022-07-01,21,103,KY,Henry County,8281,7929,352,4.3
CN2110500000000,2022-07-01,21,105,KY,Hickman County,1662,1580,82,4.9
CN2110700000000,2022-07-01,21,107,KY,Hopkins County,18557,17683,874,4.7
CN2110900000000,2022-07-01,21,109,KY,Jackson County,4051,3783,268,6.6
CN2111100000000,2022-07-01,21,111,KY,Jefferson County,398916,381847,17069,4.3
CN2111300000000,2022-07-01,21,113,KY,Jessamine County,26697,25724,973,3.6
CN2111500000000,2022-07-01,21,115,KY,Johnson County,6667,6247,420,6.3
CN2111700000000,2022-07-01,21,117,KY,Kenton County,89251,86030,3221,3.6
CN2111900000000,2022-07-01,21,119,KY,Knott County,4264,3962,302,7.1
CN2112100000000,2022-07-01,21,121,KY,Knox County,9847,9245,602,6.1
CN2112300000000,2022-07-01,21,123,KY,Larue County,5846,5555,291,5
CN2112500000000,2022-07-01,21,125,KY,Laurel County,24834,23641,1193,4.8
CN2112700000000,2022-07-01,21,127,KY,Lawrence County,5568,5243,325,5.8
CN2112900000000,2022-07-01,21,129,KY,Lee County,2080,1949,131,6.3
CN2113100000000,2022-07-01,21,131,KY,Leslie County,2505,2319,186,7.4
CN2113300000000,2022-07-01,21,133,KY,Letcher County,5886,5498,388,6.6
CN2113500000000,2022-07-01,21,135,KY,Lewis County,4566,4224,342,7.5
CN2113700000000,2022-07-01,21,137,KY,Lincoln County,9440,8969,471,5
CN2113900000000,2022-07-01,21,139,KY,Livingston County,3676,3501,175,4.8
CN2114100000000,2022-07-01,21,141,KY,Logan County,12305,11813,492,4
CN2114300000000,2022-07-01,21,143,KY,Lyon County,3407,3266,141,4.1
CN2114500000000,2022-07-01,21,145,KY,McCracken County,30127,28810,1317,4.4
CN2114700000000,2022-07-01,21,147,KY,McCreary County,4690,4418,272,5.8
CN2114900000000,2022-07-01,21,149,KY,McLean County,4075,3879,196,4.8
CN2115100000000,2022-07-01,21,151,KY,Madison County,46543,44534,2009,4.3
CN2115300000000,2022-07-01,21,153,KY,Magoffin County,3062,2720,342,11.2
CN2115500000000,2022-07-01,21,155,KY,Marion County,9440,9094,346,3.7
CN2115700000000,2022-07-01,21,157,KY,Marshall County,14784,14155,629,4.3
CN2115900000000,2022-07-01,21,159,KY,Martin County,2189,2005,184,8.4
CN2116100000000,2022-07-01,21,161,KY,Mason County,6565,6229,336,5.1
CN2116300000000,2022-07-01,21,163,KY,Meade County,11876,11298,578,4.9
CN2116500000000,2022-07-01,21,165,KY,Menifee County,2391,2258,133,5.6
CN2116700000000,2022-07-01,21,167,KY,Mercer County,10083,9671,412,4.1
CN2116900000000,2022-07-01,21,169,KY,Metcalfe County,3952,3760,192,4.9
CN2117100000000,2022-07-01,21,171,KY,Monroe County,4610,4447,163,3.5
CN2117300000000,2022-07-01,21,173,KY,Montgomery County,12020,11442,578,4.8
CN2117500000000,2022-07-01,21,175,KY,Morgan County,4067,3843,224,5.5
CN2117700000000,2022-07-01,21,177,KY,Muhlenberg County,9693,9070,623,6.4
CN2117900000000,2022-07-01,21,179,KY,Nelson County,23828,22796,1032,4.3
CN2118100000000,2022-07-01,21,181,KY,Nicholas County,3267,3115,152,4.7
CN2118300000000,2022-07-01,21,183,KY,Ohio County,9146,8671,475,5.2
CN2118500000000,2022-07-01,21,185,KY,Oldham County,33594,32437,1157,3.4
CN2118700000000,2022-07-01,21,187,KY,Owen County,5363,5165,198,3.7
CN2118900000000,2022-07-01,21,189,KY,Owsley County,1084,1000,84,7.7
CN2119100000000,2022-07-01,21,191,KY,Pendleton County,7018,6756,262,3.7
CN2119300000000,2022-07-01,21,193,KY,Perry County,7909,7468,441,5.6
CN2119500000000,2022-07-01,21,195,KY,Pike County,18833,17773,1060,5.6
CN2119700000000,2022-07-01,21,197,KY,Powell County,5336,5108,228,4.3
CN2119900000000,2022-07-01,21,199,KY,Pulaski County,25516,24260,1256,4.9
CN2120100000000,2022-07-01,21,201,KY,Robertson County,835,789,46,5.5
CN2120300000000,2022-07-01,21,203,KY,Rockcastle County,6452,6106,346,5.4
CN2120500000000,2022-07-01,21,205,KY,Rowan County,10153,9602,551,5.4
CN2120700000000,2022-07-01,21,207,KY,Russell County,6361,6032,329,5.2
CN2120900000000,2022-07-01,21,209,KY,Scott County,30594,29541,1053,3.4
CN2121100000000,2022-07-01,21,211,KY,Shelby County,26317,25241,1076,4.1
CN2121300000000,2022-07-01,21,213,KY,Simpson County,8825,8468,357,4
CN2121500000000,2022-07-01,21,215,KY,Spencer County,10666,10240,426,4
CN2121700000000,2022-07-01,21,217,KY,Taylor County,11969,11452,517,4.3
CN2121900000000,2022-07-01,21,219,KY,Todd County,5741,5536,205,3.6
CN2122100000000,2022-07-01,21,221,KY,Trigg County,6090,5788,302,5
CN2122300000000,2022-07-01,21,223,KY,Trimble County,3873,3704,169,4.4
CN2122500000000,2022-07-01,21,225,KY,Union County,5959,5655,304,5.1
CN2122700000000,2022-07-01,21,227,KY,Warren County,65036,62328,2708,4.2
CN2122900000000,2022-07-01,21,229,KY,Washington County,6168,5938,230,3.7
CN2123100000000,2022-07-01,21,231,KY,Wayne County,7172,6801,371,5.2
CN2123300000000,2022-07-01,21,233,KY,Webster County,5229,4993,236,4.5
CN2123500000000,2022-07-01,21,235,KY,Whitley County,13812,13097,715,5.2
CN2123700000000,2022-07-01,21,237,KY,Wolfe County,2231,2085,146,6.5
CN2123900000000,2022-07-01,21,239,KY,Woodford County,15295,14786,509,3.3
CN2200100000000,2022-07-01,22,001,LA,Acadia Parish,24415,23369,1046,4.3
CN2200300000000,2022-07-01,22,003,LA,Allen Parish,8078,7658,420,5.2
CN2200500000000,2022-07-01,22,005,LA,Ascension Parish,67555,65249,2306,3.4
CN2200700000000,2022-07-01,22,007,LA,Assumption Parish,8940,8485,455,5.1
CN2200900000000,2022-07-01,22,009,LA,Avoyelles Parish,14737,13967,770,5.2
CN2201100000000,2022-07-01,22,011,LA,Beauregard Parish,14995,14421,574,3.8
CN2201300000000,2022-07-01,22,013,LA,Bienville Parish,5278,5027,251,4.8
CN2201500000000,2022-07-01,22,015,LA,Bossier Parish,59185,57125,2060,3.5
CN2201700000000,2022-07-01,22,017,LA,Caddo Parish,103997,99002,4995,4.8
CN2201900000000,2022-07-01,22,019,LA,Calcasieu Parish,93100,89327,3773,4.1
CN2202100000000,2022-07-01,22,021,LA,Caldwell Parish,3717,3559,158,4.3
CN2202300000000,2022-07-01,22,023,LA,Cameron Parish,3450,3345,105,3
CN2202500000000,2022-07-01,22,025,LA,Catahoula Parish,3483,3311,172,4.9
CN2202700000000,2022-07-01,22,027,LA,Claiborne Parish,5578,5315,263,4.7
CN2202900000000,2022-07-01,22,029,LA,Concordia Parish,7173,6758,415,5.8
CN2203100000000,2022-07-01,22,031,LA,De Soto Parish,11160,10669,491,4.4
CN2203300000000,2022-07-01,22,033,LA,East Baton Rouge Parish,236284,226505,9779,4.1
CN2203500000000,2022-07-01,22,035,LA,East Carroll Parish,1707,1546,161,9.4
CN2203700000000,2022-07-01,22,037,LA,East Feliciana Parish,7976,7688,288,3.6
CN2203900000000,2022-07-01,22,039,LA,Evangeline Parish,12040,11436,604,5
CN2204100000000,2022-07-01,22,041,LA,Franklin Parish,7475,7063,412,5.5
CN2204300000000,2022-07-01,22,043,LA,Grant Parish,8658,8294,364,4.2
CN2204500000000,2022-07-01,22,045,LA,Iberia Parish,28161,26824,1337,4.7
CN2204700000000,2022-07-01,22,047,LA,Iberville Parish,14115,13400,715,5.1
CN2204900000000,2022-07-01,22,049,LA,Jackson Parish,6985,6720,265,3.8
CN2205100000000,2022-07-01,22,051,LA,Jefferson Parish,212297,203748,8549,4
CN2205300000000,2022-07-01,22,053,LA,Jefferson Davis Parish,12551,12049,502,4
CN2205500000000,2022-07-01,22,055,LA,Lafayette Parish,118221,113932,4289,3.6
CN2205700000000,2022-07-01,22,057,LA,Lafourche Parish,41243,39646,1597,3.9
CN2205900000000,2022-07-01,22,059,LA,LaSalle Parish,6844,6634,210,3.1
CN2206100000000,2022-07-01,22,061,LA,Lincoln Parish,20823,19907,916,4.4
CN2206300000000,2022-07-01,22,063,LA,Livingston Parish,72469,70069,2400,3.3
CN2206500000000,2022-07-01,22,065,LA,Madison Parish,3676,3442,234,6.4
CN2206700000000,2022-07-01,22,067,LA,Morehouse Parish,9978,9379,599,6
CN2206900000000,2022-07-01,22,069,LA,Natchitoches Parish,16609,15770,839,5.1
CN2207100000000,2022-07-01,22,071,LA,Orleans Parish,178521,169322,9199,5.2
CN2207300000000,2022-07-01,22,073,LA,Ouachita Parish,71490,68464,3026,4.2
CN2207500000000,2022-07-01,22,075,LA,Plaquemines Parish,9939,9578,361,3.6
CN2207700000000,2022-07-01,22,077,LA,Pointe Coupee Parish,10005,9530,475,4.7
CN2207900000000,2022-07-01,22,079,LA,Rapides Parish,58202,56048,2154,3.7
CN2208100000000,2022-07-01,22,081,LA,Red River Parish,4023,3879,144,3.6
CN2208300000000,2022-07-01,22,083,LA,Richland Parish,8451,8053,398,4.7
CN2208500000000,2022-07-01,22,085,LA,Sabine Parish,9414,9061,353,3.7
CN2208700000000,2022-07-01,22,087,LA,St. Bernard Parish,20218,19310,908,4.5
CN2208900000000,2022-07-01,22,089,LA,St. Charles Parish,25042,24075,967,3.9
CN2209100000000,2022-07-01,22,091,LA,St. Helena Parish,4354,4078,276,6.3
CN2209300000000,2022-07-01,22,093,LA,St. James Parish,9041,8552,489,5.4
CN2209500000000,2022-07-01,22,095,LA,St. John the Baptist Parish,19282,18221,1061,5.5
CN2209700000000,2022-07-01,22,097,LA,St. Landry Parish,32519,30854,1665,5.1
CN2209900000000,2022-07-01,22,099,LA,St. Martin Parish,22464,21533,931,4.1
CN2210100000000,2022-07-01,22,101,LA,St. Mary Parish,19643,18684,959,4.9
CN2210300000000,2022-07-01,22,103,LA,St. Tammany Parish,120868,116687,4181,3.5
CN2210500000000,2022-07-01,22,105,LA,Tangipahoa Parish,56966,54075,2891,5.1
CN2210700000000,2022-07-01,22,107,LA,Tensas Parish,1404,1318,86,6.1
CN2210900000000,2022-07-01,22,109,LA,Terrebonne Parish,45404,43457,1947,4.3
CN2211100000000,2022-07-01,22,111,LA,Union Parish,9381,8973,408,4.3
CN2211300000000,2022-07-01,22,113,LA,Vermilion Parish,24522,23530,992,4
CN2211500000000,2022-07-01,22,115,LA,Vernon Parish,16806,16068,738,4.4
CN2211700000000,2022-07-01,22,117,LA,Washington Parish,17223,16370,853,5
CN2211900000000,2022-07-01,22,119,LA,Webster Parish,14506,13786,720,5
CN2212100000000,2022-07-01,22,121,LA,West Baton Rouge Parish,14159,13609,550,3.9
CN2212300000000,2022-07-01,22,123,LA,West Carroll Parish,3576,3364,212,5.9
CN2212500000000,2022-07-01,22,125,LA,West Feliciana Parish,5508,5343,165,3
CN2212700000000,2022-07-01,22,127,LA,Winn Parish,4713,4483,230,4.9
CN2300100000000,2022-07-01,23,001,ME,Androscoggin County,52542,51126,1416,2.7
CN2300300000000,2022-07-01,23,003,ME,Aroostook County,28783,27772,1011,3.5
CN2300500000000,2022-07-01,23,005,ME,Cumberland County,164170,160706,3464,2.1
CN2300700000000,2022-07-01,23,007,ME,Franklin County,13647,13234,413,3
CN2300900000000,2022-07-01,23,009,ME,Hancock County,31157,30461,696,2.2
CN2301100000000,2022-07-01,23,011,ME,Kennebec County,61381,59835,1546,2.5
CN2301300000000,2022-07-01,23,013,ME,Knox County,20949,20471,478,2.3
CN2301500000000,2022-07-01,23,015,ME,Lincoln County,17812,17433,379,2.1
CN2301700000000,2022-07-01,23,017,ME,Oxford County,26493,25739,754,2.8
CN2301900000000,2022-07-01,23,019,ME,Penobscot County,74463,72414,2049,2.8
CN2302100000000,2022-07-01,23,021,ME,Piscataquis County,7491,7262,229,3.1
CN2302300000000,2022-07-01,23,023,ME,Sagadahoc County,19122,18736,386,2
CN2302500000000,2022-07-01,23,025,ME,Somerset County,22374,21597,777,3.5
CN2302700000000,2022-07-01,23,027,ME,Waldo County,20756,20208,548,2.6
CN2302900000000,2022-07-01,23,029,ME,Washington County,13976,13510,466,3.3
CN2303100000000,2022-07-01,23,031,ME,York County,113481,111045,2436,2.1
CN2400100000000,2022-07-01,24,001,MD,Allegany County,30923,29581,1342,4.3
CN2400300000000,2022-07-01,24,003,MD,Anne Arundel County,316951,307165,9786,3.1
CN2400500000000,2022-07-01,24,005,MD,Baltimore County,448553,432863,15690,3.5
CN2400900000000,2022-07-01,24,009,MD,Calvert County,49928,48260,1668,3.3
CN2401100000000,2022-07-01,24,011,MD,Caroline County,17397,16848,549,3.2
CN2401300000000,2022-07-01,24,013,MD,Carroll County,95992,93137,2855,3
CN2401500000000,2022-07-01,24,015,MD,Cecil County,54084,52102,1982,3.7
CN2401700000000,2022-07-01,24,017,MD,Charles County,87460,84322,3138,3.6
CN2401900000000,2022-07-01,24,019,MD,Dorchester County,16821,16229,592,3.5
CN2402100000000,2022-07-01,24,021,MD,Frederick County,138452,134066,4386,3.2
CN2402300000000,2022-07-01,24,023,MD,Garrett County,15117,14571,546,3.6
CN2402500000000,2022-07-01,24,025,MD,Harford County,141666,136978,4688,3.3
CN2402700000000,2022-07-01,24,027,MD,Howard County,189485,183996,5489,2.9
CN2402900000000,2022-07-01,24,029,MD,Kent County,10167,9808,359,3.5
CN2403100000000,2022-07-01,24,031,MD,Montgomery County,554978,537818,17160,3.1
CN2403300000000,2022-07-01,24,033,MD,Prince George's County,500943,482785,18158,3.6
CN2403500000000,2022-07-01,24,035,MD,Queen Anne's County,28500,27656,844,3
CN2403700000000,2022-07-01,24,037,MD,St. Mary's County,58129,56049,2080,3.6
CN2403900000000,2022-07-01,24,039,MD,Somerset County,9667,9201,466,4.8
CN2404100000000,2022-07-01,24,041,MD,Talbot County,18003,17394,609,3.4
CN2404300000000,2022-07-01,24,043,MD,Washington County,72650,70053,2597,3.6
CN2404500000000,2022-07-01,24,045,MD,Wicomico County,54174,52130,2044,3.8
CN2404700000000,2022-07-01,24,047,MD,Worcester County,26399,25396,1003,3.8
CN2451000000000,2022-07-01,24,510,MD,Baltimore city,276610,264293,12317,4.5
CN2500100000000,2022-07-01,25,001,MA,Barnstable County,122974,118656,4318,3.5
CN2500300000000,2022-07-01,25,003,MA,Berkshire County,64160,61563,2597,4
CN2500500000000,2022-07-01,25,005,MA,Bristol County,300270,286277,13993,4.7
CN2500700000000,2022-07-01,25,007,MA,Dukes County,11978,11617,361,3
CN2500900000000,2022-07-01,25,009,MA,Essex County,424402,407105,17297,4.1
CN2501100000000,2022-07-01,25,011,MA,Franklin County,40545,39137,1408,3.5
CN2501300000000,2022-07-01,25,013,MA,Hampden County,223494,211658,11836,5.3
CN2501500000000,2022-07-01,25,015,MA,Hampshire County,89191,85903,3288,3.7
CN2501700000000,2022-07-01,25,017,MA,Middlesex County,916457,886048,30409,3.3
CN2501900000000,2022-07-01,25,019,MA,Nantucket County/town,10095,9829,266,2.6
CN2502100000000,2022-07-01,25,021,MA,Norfolk County,395051,381208,13843,3.5
CN2502300000000,2022-07-01,25,023,MA,Plymouth County,286131,274685,11446,4
CN2502500000000,2022-07-01,25,025,MA,Suffolk County,457970,438783,19187,4.2
CN2502700000000,2022-07-01,25,027,MA,Worcester County,444528,426076,18452,4.2
CN2600100000000,2022-07-01,26,001,MI,Alcona County,4063,3786,277,6.8
CN2600300000000,2022-07-01,26,003,MI,Alger County,3536,3312,224,6.3
CN2600500000000,2022-07-01,26,005,MI,Allegan County,62803,60286,2517,4
CN2600700000000,2022-07-01,26,007,MI,Alpena County,13082,12388,694,5.3
CN2600900000000,2022-07-01,26,009,MI,Antrim County,11285,10696,589,5.2
CN2601100000000,2022-07-01,26,011,MI,Arenac County,5989,5583,406,6.8
CN2601300000000,2022-07-01,26,013,MI,Baraga County,3149,2921,228,7.2
CN2601500000000,2022-07-01,26,015,MI,Barry County,31971,30617,1354,4.2
CN2601700000000,2022-07-01,26,017,MI,Bay County,49602,46782,2820,5.7
CN2601900000000,2022-07-01,26,019,MI,Benzie County,9286,8847,439,4.7
CN2602100000000,2022-07-01,26,021,MI,Berrien County,73172,69469,3703,5.1
CN2602300000000,2022-07-01,26,023,MI,Branch County,19897,18936,961,4.8
CN2602500000000,2022-07-01,26,025,MI,Calhoun County,60388,57020,3368,5.6
CN2602700000000,2022-07-01,26,027,MI,Cass County,23649,22465,1184,5
CN2602900000000,2022-07-01,26,029,MI,Charlevoix County,14062,13490,572,4.1
CN2603100000000,2022-07-01,26,031,MI,Cheboygan County,11308,10771,537,4.7
CN2603300000000,2022-07-01,26,033,MI,Chippewa County,16184,15167,1017,6.3
CN2603500000000,2022-07-01,26,035,MI,Clare County,11186,10359,827,7.4
CN2603700000000,2022-07-01,26,037,MI,Clinton County,40039,37946,2093,5.2
CN2603900000000,2022-07-01,26,039,MI,Crawford County,5668,5301,367,6.5
CN2604100000000,2022-07-01,26,041,MI,Delta County,16879,15908,971,5.8
CN2604300000000,2022-07-01,26,043,MI,Dickinson County,12457,11896,561,4.5
CN2604500000000,2022-07-01,26,045,MI,Eaton County,56040,52367,3673,6.6
CN2604700000000,2022-07-01,26,047,MI,Emmet County,18381,17521,860,4.7
CN2604900000000,2022-07-01,26,049,MI,Genesee County,180224,168775,11449,6.4
CN2605100000000,2022-07-01,26,051,MI,Gladwin County,10155,9525,630,6.2
CN2605300000000,2022-07-01,26,053,MI,Gogebic County,5620,5310,310,5.5
CN2605500000000,2022-07-01,26,055,MI,Grand Traverse County,52726,50779,1947,3.7
CN2605700000000,2022-07-01,26,057,MI,Gratiot County,17104,16141,963,5.6
CN2605900000000,2022-07-01,26,059,MI,Hillsdale County,20519,19462,1057,5.2
CN2606100000000,2022-07-01,26,061,MI,Houghton County,15867,15001,866,5.5
CN2606300000000,2022-07-01,26,063,MI,Huron County,15428,14650,778,5
CN2606500000000,2022-07-01,26,065,MI,Ingham County,145393,136773,8620,5.9
CN2606700000000,2022-07-01,26,067,MI,Ionia County,30511,29017,1494,4.9
CN2606900000000,2022-07-01,26,069,MI,Iosco County,10685,10015,670,6.3
CN2607100000000,2022-07-01,26,071,MI,Iron County,4831,4543,288,6
CN2607300000000,2022-07-01,26,073,MI,Isabella County,31124,29278,1846,5.9
CN2607500000000,2022-07-01,26,075,MI,Jackson County,73537,69731,3806,5.2
CN2607700000000,2022-07-01,26,077,MI,Kalamazoo County,131577,125532,6045,4.6
CN2607900000000,2022-07-01,26,079,MI,Kalkaska County,8347,7898,449,5.4
CN2608100000000,2022-07-01,26,081,MI,Kent County,361302,346630,14672,4.1
CN2608300000000,2022-07-01,26,083,MI,Keweenaw County,882,830,52,5.9
CN2608500000000,2022-07-01,26,085,MI,Lake County,3978,3699,279,7
CN2608700000000,2022-07-01,26,087,MI,Lapeer County,40358,38886,1472,3.6
CN2608900000000,2022-07-01,26,089,MI,Leelanau County,10986,10550,436,4
CN2609100000000,2022-07-01,26,091,MI,Lenawee County,45080,42475,2605,5.8
CN2609300000000,2022-07-01,26,093,MI,Livingston County,103512,100817,2695,2.6
CN2609500000000,2022-07-01,26,095,MI,Luce County,2229,2102,127,5.7
CN2609700000000,2022-07-01,26,097,MI,Mackinac County,6179,5964,215,3.5
CN2609900000000,2022-07-01,26,099,MI,Macomb County,442957,427601,15356,3.5
CN2610100000000,2022-07-01,26,101,MI,Manistee County,10262,9690,572,5.6
CN2610300000000,2022-07-01,26,103,MI,Marquette County,31860,30156,1704,5.3
CN2610500000000,2022-07-01,26,105,MI,Mason County,14083,13384,699,5
CN2610700000000,2022-07-01,26,107,MI,Mecosta County,17862,16745,1117,6.3
CN2610900000000,2022-07-01,26,109,MI,Menominee County,10853,10352,501,4.6
CN2611100000000,2022-07-01,26,111,MI,Midland County,40623,38667,1956,4.8
CN2611300000000,2022-07-01,26,113,MI,Missaukee County,7010,6638,372,5.3
CN2611500000000,2022-07-01,26,115,MI,Monroe County,74359,70144,4215,5.7
CN2611700000000,2022-07-01,26,117,MI,Montcalm County,28008,26551,1457,5.2
CN2611900000000,2022-07-01,26,119,MI,Montmorency County,3119,2881,238,7.6
CN2612100000000,2022-07-01,26,121,MI,Muskegon County,78117,73647,4470,5.7
CN2612300000000,2022-07-01,26,123,MI,Newaygo County,23491,22275,1216,5.2
CN2612500000000,2022-07-01,26,125,MI,Oakland County,669380,650537,18843,2.8
CN2612700000000,2022-07-01,26,127,MI,Oceana County,12375,11591,784,6.3
CN2612900000000,2022-07-01,26,129,MI,Ogemaw County,8539,7974,565,6.6
CN2613100000000,2022-07-01,26,131,MI,Ontonagon County,2055,1902,153,7.4
CN2613300000000,2022-07-01,26,133,MI,Osceola County,11325,10743,582,5.1
CN2613500000000,2022-07-01,26,135,MI,Oscoda County,2994,2747,247,8.2
CN2613700000000,2022-07-01,26,137,MI,Otsego County,11968,11293,675,5.6
CN2613900000000,2022-07-01,26,139,MI,Ottawa County,162558,156390,6168,3.8
CN2614100000000,2022-07-01,26,141,MI,Presque Isle County,5157,4817,340,6.6
CN2614300000000,2022-07-01,26,143,MI,Roscommon County,8419,7772,647,7.7
CN2614500000000,2022-07-01,26,145,MI,Saginaw County,83086,77834,5252,6.3
CN2614700000000,2022-07-01,26,147,MI,St. Clair County,74737,72140,2597,3.5
CN2614900000000,2022-07-01,26,149,MI,St. Joseph County,28876,27226,1650,5.7
CN2615100000000,2022-07-01,26,151,MI,Sanilac County,19319,18186,1133,5.9
CN2615300000000,2022-07-01,26,153,MI,Schoolcraft County,3203,2969,234,7.3
CN2615500000000,2022-07-01,26,155,MI,Shiawassee County,32296,30501,1795,5.6
CN2615700000000,2022-07-01,26,157,MI,Tuscola County,23194,21786,1408,6.1
CN2615900000000,2022-07-01,26,159,MI,Van Buren County,34327,32481,1846,5.4
CN2616100000000,2022-07-01,26,161,MI,Washtenaw County,194230,185534,8696,4.5
CN2616300000000,2022-07-01,26,163,MI,Wayne County,790537,753268,37269,4.7
CN2616500000000,2022-07-01,26,165,MI,Wexford County,15137,14308,829,5.5
CN2700100000000,2022-07-01,27,001,MN,Aitkin County,7465,7236,229,3.1
CN2700300000000,2022-07-01,27,003,MN,Anoka County,200002,194984,5018,2.5
CN2700500000000,2022-07-01,27,005,MN,Becker County,19785,19297,488,2.5
CN2700700000000,2022-07-01,27,007,MN,Beltrami County,25497,24782,715,2.8
CN2700900000000,2022-07-01,27,009,MN,Benton County,21483,20907,576,2.7
CN2701100000000,2022-07-01,27,011,MN,Big Stone County,2507,2444,63,2.5
CN2701300000000,2022-07-01,27,013,MN,Blue Earth County,39168,38265,903,2.3
CN2701500000000,2022-07-01,27,015,MN,Brown County,13805,13466,339,2.5
CN2701700000000,2022-07-01,27,017,MN,Carlton County,17430,16918,512,2.9
CN2701900000000,2022-07-01,27,019,MN,Carver County,59873,58625,1248,2.1
CN2702100000000,2022-07-01,27,021,MN,Cass County,15595,15112,483,3.1
CN2702300000000,2022-07-01,27,023,MN,Chippewa County,6416,6271,145,2.3
CN2702500000000,2022-07-01,27,025,MN,Chisago County,30070,29340,730,2.4
CN2702700000000,2022-07-01,27,027,MN,Clay County,37640,36855,785,2.1
CN2702900000000,2022-07-01,27,029,MN,Clearwater County,4470,4268,202,4.5
CN2703100000000,2022-07-01,27,031,MN,Cook County,3063,2995,68,2.2
CN2703300000000,2022-07-01,27,033,MN,Cottonwood County,6677,6270,407,6.1
CN2703500000000,2022-07-01,27,035,MN,Crow Wing County,34602,33789,813,2.3
CN2703700000000,2022-07-01,27,037,MN,Dakota County,244039,238281,5758,2.4
CN2703900000000,2022-07-01,27,039,MN,Dodge County,12122,11845,277,2.3
CN2704100000000,2022-07-01,27,041,MN,Douglas County,22088,21653,435,2
CN2704300000000,2022-07-01,27,043,MN,Faribault County,7273,7077,196,2.7
CN2704500000000,2022-07-01,27,045,MN,Fillmore County,11697,11439,258,2.2
CN2704700000000,2022-07-01,27,047,MN,Freeborn County,15896,15493,403,2.5
CN2704900000000,2022-07-01,27,049,MN,Goodhue County,27022,26404,618,2.3
CN2705100000000,2022-07-01,27,051,MN,Grant County,3264,3189,75,2.3
CN2705300000000,2022-07-01,27,053,MN,Hennepin County,711073,692892,18181,2.6
CN2705500000000,2022-07-01,27,055,MN,Houston County,10403,10206,197,1.9
CN2705700000000,2022-07-01,27,057,MN,Hubbard County,10792,10462,330,3.1
CN2705900000000,2022-07-01,27,059,MN,Isanti County,21732,21200,532,2.4
CN2706100000000,2022-07-01,27,061,MN,Itasca County,22104,21334,770,3.5
CN2706300000000,2022-07-01,27,063,MN,Jackson County,5575,5394,181,3.2
CN2706500000000,2022-07-01,27,065,MN,Kanabec County,9124,8865,259,2.8
CN2706700000000,2022-07-01,27,067,MN,Kandiyohi County,23267,22702,565,2.4
CN2706900000000,2022-07-01,27,069,MN,Kittson County,2260,2203,57,2.5
CN2707100000000,2022-07-01,27,071,MN,Koochiching County,5939,5726,213,3.6
CN2707300000000,2022-07-01,27,073,MN,Lac qui Parle County,3318,3239,79,2.4
CN2707500000000,2022-07-01,27,075,MN,Lake County,5599,5266,333,5.9
CN2707700000000,2022-07-01,27,077,MN,Lake of the Woods County,2459,2376,83,3.4
CN2707900000000,2022-07-01,27,079,MN,Le Sueur County,15937,15556,381,2.4
CN2708100000000,2022-07-01,27,081,MN,Lincoln County,3080,3015,65,2.1
CN2708300000000,2022-07-01,27,083,MN,Lyon County,14120,13781,339,2.4
CN2708500000000,2022-07-01,27,085,MN,McLeod County,19374,18910,464,2.4
CN2708700000000,2022-07-01,27,087,MN,Mahnomen County,2210,2120,90,4.1
CN2708900000000,2022-07-01,27,089,MN,Marshall County,5374,5231,143,2.7
CN2709100000000,2022-07-01,27,091,MN,Martin County,9927,9644,283,2.9
CN2709300000000,2022-07-01,27,093,MN,Meeker County,13627,13324,303,2.2
CN2709500000000,2022-07-01,27,095,MN,Mille Lacs County,12601,12246,355,2.8
CN2709700000000,2022-07-01,27,097,MN,Morrison County,17103,16589,514,3
CN2709900000000,2022-07-01,27,099,MN,Mower County,20585,20084,501,2.4
CN2710100000000,2022-07-01,27,101,MN,Murray County,4679,4566,113,2.4
CN2710300000000,2022-07-01,27,103,MN,Nicollet County,20143,19745,398,2
CN2710500000000,2022-07-01,27,105,MN,Nobles County,11211,10925,286,2.6
CN2710700000000,2022-07-01,27,107,MN,Norman County,3274,3162,112,3.4
CN2710900000000,2022-07-01,27,109,MN,Olmsted County,92473,90521,1952,2.1
CN2711100000000,2022-07-01,27,111,MN,Otter Tail County,32455,31712,743,2.3
CN2711300000000,2022-07-01,27,113,MN,Pennington County,8813,8595,218,2.5
CN2711500000000,2022-07-01,27,115,MN,Pine County,14376,13940,436,3
CN2711700000000,2022-07-01,27,117,MN,Pipestone County,4854,4763,91,1.9
CN2711900000000,2022-07-01,27,119,MN,Polk County,16041,15562,479,3
CN2712100000000,2022-07-01,27,121,MN,Pope County,6655,6532,123,1.8
CN2712300000000,2022-07-01,27,123,MN,Ramsey County,288195,280089,8106,2.8
CN2712500000000,2022-07-01,27,125,MN,Red Lake County,2148,2086,62,2.9
CN2712700000000,2022-07-01,27,127,MN,Redwood County,7766,7565,201,2.6
CN2712900000000,2022-07-01,27,129,MN,Renville County,8020,7743,277,3.5
CN2713100000000,2022-07-01,27,131,MN,Rice County,37402,36489,913,2.4
CN2713300000000,2022-07-01,27,133,MN,Rock County,6053,5955,98,1.6
CN2713500000000,2022-07-01,27,135,MN,Roseau County,7902,7707,195,2.5
CN2713700000000,2022-07-01,27,137,MN,St. Louis County,99840,96664,3176,3.2
CN2713900000000,2022-07-01,27,139,MN,Scott County,84975,83108,1867,2.2
CN2714100000000,2022-07-01,27,141,MN,Sherburne County,53338,52059,1279,2.4
CN2714300000000,2022-07-01,27,143,MN,Sibley County,8219,8010,209,2.5
CN2714500000000,2022-07-01,27,145,MN,Stearns County,89377,87199,2178,2.4
CN2714700000000,2022-07-01,27,147,MN,Steele County,19346,18818,528,2.7
CN2714900000000,2022-07-01,27,149,MN,Stevens County,5388,5291,97,1.8
CN2715100000000,2022-07-01,27,151,MN,Swift County,4904,4767,137,2.8
CN2715300000000,2022-07-01,27,153,MN,Todd County,13497,13151,346,2.6
CN2715500000000,2022-07-01,27,155,MN,Traverse County,1670,1639,31,1.9
CN2715700000000,2022-07-01,27,157,MN,Wabasha County,12450,12167,283,2.3
CN2715900000000,2022-07-01,27,159,MN,Wadena County,5887,5695,192,3.3
CN2716100000000,2022-07-01,27,161,MN,Waseca County,8781,8506,275,3.1
CN2716300000000,2022-07-01,27,163,MN,Washington County,145995,142660,3335,2.3
CN2716500000000,2022-07-01,27,165,MN,Watonwan County,6664,6466,198,3
CN2716700000000,2022-07-01,27,167,MN,Wilkin County,3419,3337,82,2.4
CN2716900000000,2022-07-01,27,169,MN,Winona County,28101,27470,631,2.2
CN2717100000000,2022-07-01,27,171,MN,Wright County,77066,75381,1685,2.2
CN2717300000000,2022-07-01,27,173,MN,Yellow Medicine County,5058,4926,132,2.6
CN2800100000000,2022-07-01,28,001,MS,Adams County,10723,10082,641,6
CN2800300000000,2022-07-01,28,003,MS,Alcorn County,15158,14529,629,4.1
CN2800500000000,2022-07-01,28,005,MS,Amite County,4384,4125,259,5.9
CN2800700000000,2022-07-01,28,007,MS,Attala County,6795,6450,345,5.1
CN2800900000000,2022-07-01,28,009,MS,Benton County,3108,2921,187,6
CN2801100000000,2022-07-01,28,011,MS,Bolivar County,11302,10574,728,6.4
CN2801300000000,2022-07-01,28,013,MS,Calhoun County,5533,5260,273,4.9
CN2801500000000,2022-07-01,28,015,MS,Carroll County,3418,3247,171,5
CN2801700000000,2022-07-01,28,017,MS,Chickasaw County,6655,6294,361,5.4
CN2801900000000,2022-07-01,28,019,MS,Choctaw County,3658,3504,154,4.2
CN2802100000000,2022-07-01,28,021,MS,Claiborne County,3010,2686,324,10.8
CN2802300000000,2022-07-01,28,023,MS,Clarke County,5634,5340,294,5.2
CN2802500000000,2022-07-01,28,025,MS,Clay County,8886,8477,409,4.6
CN2802700000000,2022-07-01,28,027,MS,Coahoma County,7636,7135,501,6.6
CN2802900000000,2022-07-01,28,029,MS,Copiah County,10999,10427,572,5.2
CN2803100000000,2022-07-01,28,031,MS,Covington County,8401,8061,340,4
CN2803300000000,2022-07-01,28,033,MS,DeSoto County,94537,90948,3589,3.8
CN2803500000000,2022-07-01,28,035,MS,Forrest County,33605,32126,1479,4.4
CN2803700000000,2022-07-01,28,037,MS,Franklin County,2639,2468,171,6.5
CN2803900000000,2022-07-01,28,039,MS,George County,8892,8382,510,5.7
CN2804100000000,2022-07-01,28,041,MS,Greene County,4267,3970,297,7
CN2804300000000,2022-07-01,28,043,MS,Grenada County,8987,8608,379,4.2
CN2804500000000,2022-07-01,28,045,MS,Hancock County,19113,18217,896,4.7
CN2804700000000,2022-07-01,28,047,MS,Harrison County,88372,84542,3830,4.3
CN2804900000000,2022-07-01,28,049,MS,Hinds County,103103,98362,4741,4.6
CN2805100000000,2022-07-01,28,051,MS,Holmes County,5118,4695,423,8.3
CN2805300000000,2022-07-01,28,053,MS,Humphreys County,2057,1873,184,8.9
CN2805500000000,2022-07-01,28,055,MS,Issaquena County,326,304,22,6.7
CN2805700000000,2022-07-01,28,057,MS,Itawamba County,10462,10021,441,4.2
CN2805900000000,2022-07-01,28,059,MS,Jackson County,59396,56498,2898,4.9
CN2806100000000,2022-07-01,28,061,MS,Jasper County,6014,5680,334,5.6
CN2806300000000,2022-07-01,28,063,MS,Jefferson County,1958,1658,300,15.3
CN2806500000000,2022-07-01,28,065,MS,Jefferson Davis County,3986,3764,222,5.6
CN2806700000000,2022-07-01,28,067,MS,Jones County,25520,24296,1224,4.8
CN2806900000000,2022-07-01,28,069,MS,Kemper County,3331,3097,234,7
CN2807100000000,2022-07-01,28,071,MS,Lafayette County,27704,26574,1130,4.1
CN2807300000000,2022-07-01,28,073,MS,Lamar County,31878,30748,1130,3.5
CN2807500000000,2022-07-01,28,075,MS,Lauderdale County,28992,27628,1364,4.7
CN2807700000000,2022-07-01,28,077,MS,Lawrence County,4927,4659,268,5.4
CN2807900000000,2022-07-01,28,079,MS,Leake County,8209,7834,375,4.6
CN2808100000000,2022-07-01,28,081,MS,Lee County,41314,39678,1636,4
CN2808300000000,2022-07-01,28,083,MS,Leflore County,9667,9059,608,6.3
CN2808500000000,2022-07-01,28,085,MS,Lincoln County,15045,14387,658,4.4
CN2808700000000,2022-07-01,28,087,MS,Lowndes County,24623,23438,1185,4.8
CN2808900000000,2022-07-01,28,089,MS,Madison County,53959,51945,2014,3.7
CN2809100000000,2022-07-01,28,091,MS,Marion County,10089,9642,447,4.4
CN2809300000000,2022-07-01,28,093,MS,Marshall County,14401,13698,703,4.9
CN2809500000000,2022-07-01,28,095,MS,Monroe County,15473,14701,772,5
CN2809700000000,2022-07-01,28,097,MS,Montgomery County,3959,3772,187,4.7
CN2809900000000,2022-07-01,28,099,MS,Neshoba County,10245,9723,522,5.1
CN2810100000000,2022-07-01,28,101,MS,Newton County,8028,7634,394,4.9
CN2810300000000,2022-07-01,28,103,MS,Noxubee County,3482,3241,241,6.9
CN2810500000000,2022-07-01,28,105,MS,Oktibbeha County,21757,20599,1158,5.3
CN2810700000000,2022-07-01,28,107,MS,Panola County,12491,11805,686,5.5
CN2810900000000,2022-07-01,28,109,MS,Pearl River County,23538,22477,1061,4.5
CN2811100000000,2022-07-01,28,111,MS,Perry County,4320,4067,253,5.9
CN2811300000000,2022-07-01,28,113,MS,Pike County,14188,13383,805,5.7
CN2811500000000,2022-07-01,28,115,MS,Pontotoc County,15114,14453,661,4.4
CN2811700000000,2022-07-01,28,117,MS,Prentiss County,11422,10969,453,4
CN2811900000000,2022-07-01,28,119,MS,Quitman County,2380,2224,156,6.6
CN2812100000000,2022-07-01,28,121,MS,Rankin County,77439,74805,2634,3.4
CN2812300000000,2022-07-01,28,123,MS,Scott County,12571,12069,502,4
CN2812500000000,2022-07-01,28,125,MS,Sharkey County,1383,1295,88,6.4
CN2812700000000,2022-07-01,28,127,MS,Simpson County,10772,10301,471,4.4
CN2812900000000,2022-07-01,28,129,MS,Smith County,6832,6547,285,4.2
CN2813100000000,2022-07-01,28,131,MS,Stone County,7080,6732,348,4.9
CN2813300000000,2022-07-01,28,133,MS,Sunflower County,7427,6970,457,6.2
CN2813500000000,2022-07-01,28,135,MS,Tallahatchie County,4695,4467,228,4.9
CN2813700000000,2022-07-01,28,137,MS,Tate County,12326,11752,574,4.7
CN2813900000000,2022-07-01,28,139,MS,Tippah County,9737,9331,406,4.2
CN2814100000000,2022-07-01,28,141,MS,Tishomingo County,8566,8206,360,4.2
CN2814300000000,2022-07-01,28,143,MS,Tunica County,4278,4053,225,5.3
CN2814500000000,2022-07-01,28,145,MS,Union County,14910,14377,533,3.6
CN2814700000000,2022-07-01,28,147,MS,Walthall County,4937,4645,292,5.9
CN2814900000000,2022-07-01,28,149,MS,Warren County,19548,18568,980,5
CN2815100000000,2022-07-01,28,151,MS,Washington County,15068,14079,989,6.6
CN2815300000000,2022-07-01,28,153,MS,Wayne County,7278,6869,409,5.6
CN2815500000000,2022-07-01,28,155,MS,Webster County,3894,3704,190,4.9
CN2815700000000,2022-07-01,28,157,MS,Wilkinson County,2523,2343,180,7.1
CN2815900000000,2022-07-01,28,159,MS,Winston County,7242,6870,372,5.1
CN2816100000000,2022-07-01,28,161,MS,Yalobusha County,4768,4539,229,4.8
CN2816300000000,2022-07-01,28,163,MS,Yazoo County,9094,8601,493,5.4
CN2900100000000,2022-07-01,29,001,MO,Adair County,9708,9358,350,3.6
CN2900300000000,2022-07-01,29,003,MO,Andrew County,9526,9294,232,2.4
CN2900500000000,2022-07-01,29,005,MO,Atchison County,2561,2479,82,3.2
CN2900700000000,2022-07-01,29,007,MO,Audrain County,9901,9571,330,3.3
CN2900900000000,2022-07-01,29,009,MO,Barry County,13948,13554,394,2.8
CN2901100000000,2022-07-01,29,011,MO,Barton County,5200,5063,137,2.6
CN2901300000000,2022-07-01,29,013,MO,Bates County,7790,7564,226,2.9
CN2901500000000,2022-07-01,29,015,MO,Benton County,7134,6874,260,3.6
CN2901700000000,2022-07-01,29,017,MO,Bollinger County,5189,5048,141,2.7
CN2901900000000,2022-07-01,29,019,MO,Boone County,100120,97877,2243,2.2
CN2902100000000,2022-07-01,29,021,MO,Buchanan County,42667,41559,1108,2.6
CN2902300000000,2022-07-01,29,023,MO,Butler County,17667,17072,595,3.4
CN2902500000000,2022-07-01,29,025,MO,Caldwell County,4343,4207,136,3.1
CN2902700000000,2022-07-01,29,027,MO,Callaway County,21870,21278,592,2.7
CN2902900000000,2022-07-01,29,029,MO,Camden County,20521,19985,536,2.6
CN2903100000000,2022-07-01,29,031,MO,Cape Girardeau County,39616,38580,1036,2.6
CN2903300000000,2022-07-01,29,033,MO,Carroll County,4289,4158,131,3.1
CN2903500000000,2022-07-01,29,035,MO,Carter County,2497,2397,100,4
CN2903700000000,2022-07-01,29,037,MO,Cass County,55982,54534,1448,2.6
CN2903900000000,2022-07-01,29,039,MO,Cedar County,5500,5305,195,3.5
CN2904100000000,2022-07-01,29,041,MO,Chariton County,3603,3523,80,2.2
CN2904300000000,2022-07-01,29,043,MO,Christian County,47729,46676,1053,2.2
CN2904500000000,2022-07-01,29,045,MO,Clark County,2908,2813,95,3.3
CN2904700000000,2022-07-01,29,047,MO,Clay County,141794,137643,4151,2.9
CN2904900000000,2022-07-01,29,049,MO,Clinton County,10902,10521,381,3.5
CN2905100000000,2022-07-01,29,051,MO,Cole County,39571,38706,865,2.2
CN2905300000000,2022-07-01,29,053,MO,Cooper County,6912,6717,195,2.8
CN2905500000000,2022-07-01,29,055,MO,Crawford County,10809,10471,338,3.1
CN2905700000000,2022-07-01,29,057,MO,Dade County,3349,3275,74,2.2
CN2905900000000,2022-07-01,29,059,MO,Dallas County,7274,7081,193,2.7
CN2906100000000,2022-07-01,29,061,MO,Daviess County,3853,3740,113,2.9
CN2906300000000,2022-07-01,29,063,MO,DeKalb County,4120,3986,134,3.3
CN2906500000000,2022-07-01,29,065,MO,Dent County,5883,5685,198,3.4
CN2906700000000,2022-07-01,29,067,MO,Douglas County,5080,4939,141,2.8
CN2906900000000,2022-07-01,29,069,MO,Dunklin County,10680,10190,490,4.6
CN2907100000000,2022-07-01,29,071,MO,Franklin County,53839,52533,1306,2.4
CN2907300000000,2022-07-01,29,073,MO,Gasconade County,7456,7270,186,2.5
CN2907500000000,2022-07-01,29,075,MO,Gentry County,3141,3051,90,2.9
CN2907700000000,2022-07-01,29,077,MO,Greene County,156053,152809,3244,2.1
CN2907900000000,2022-07-01,29,079,MO,Grundy County,3867,3759,108,2.8
CN2908100000000,2022-07-01,29,081,MO,Harrison County,3645,3568,77,2.1
CN2908300000000,2022-07-01,29,083,MO,Henry County,10061,9754,307,3.1
CN2908500000000,2022-07-01,29,085,MO,Hickory County,4128,4018,110,2.7
CN2908700000000,2022-07-01,29,087,MO,Holt County,2380,2321,59,2.5
CN2908900000000,2022-07-01,29,089,MO,Howard County,4583,4454,129,2.8
CN2909100000000,2022-07-01,29,091,MO,Howell County,15578,15043,535,3.4
CN2909300000000,2022-07-01,29,093,MO,Iron County,3363,3203,160,4.8
CN2909500000000,2022-07-01,29,095,MO,Jackson County,366911,355524,11387,3.1
CN2909700000000,2022-07-01,29,097,MO,Jasper County,57664,56235,1429,2.5
CN2909900000000,2022-07-01,29,099,MO,Jefferson County,119944,117024,2920,2.4
CN2910100000000,2022-07-01,29,101,MO,Johnson County,22278,21606,672,3
CN2910300000000,2022-07-01,29,103,MO,Knox County,1614,1567,47,2.9
CN2910500000000,2022-07-01,29,105,MO,Laclede County,16254,15813,441,2.7
CN2910700000000,2022-07-01,29,107,MO,Lafayette County,17157,16632,525,3.1
CN2910900000000,2022-07-01,29,109,MO,Lawrence County,16692,16226,466,2.8
CN2911100000000,2022-07-01,29,111,MO,Lewis County,4617,4509,108,2.3
CN2911300000000,2022-07-01,29,113,MO,Lincoln County,29777,28999,778,2.6
CN2911500000000,2022-07-01,29,115,MO,Linn County,4973,4816,157,3.2
CN2911700000000,2022-07-01,29,117,MO,Livingston County,7179,7043,136,1.9
CN2911900000000,2022-07-01,29,119,MO,McDonald County,11173,10841,332,3
CN2912100000000,2022-07-01,29,121,MO,Macon County,7112,6916,196,2.8
CN2912300000000,2022-07-01,29,123,MO,Madison County,5281,5101,180,3.4
CN2912500000000,2022-07-01,29,125,MO,Maries County,3698,3592,106,2.9
CN2912700000000,2022-07-01,29,127,MO,Marion County,13765,13409,356,2.6
CN2912900000000,2022-07-01,29,129,MO,Mercer County,1592,1549,43,2.7
CN2913100000000,2022-07-01,29,131,MO,Miller County,12753,12439,314,2.5
CN2913300000000,2022-07-01,29,133,MO,Mississippi County,5065,4854,211,4.2
CN2913500000000,2022-07-01,29,135,MO,Moniteau County,7182,7005,177,2.5
CN2913700000000,2022-07-01,29,137,MO,Monroe County,3628,3532,96,2.6
CN2913900000000,2022-07-01,29,139,MO,Montgomery County,5807,5665,142,2.4
CN2914100000000,2022-07-01,29,141,MO,Morgan County,8465,8226,239,2.8
CN2914300000000,2022-07-01,29,143,MO,New Madrid County,8050,7754,296,3.7
CN2914500000000,2022-07-01,29,145,MO,Newton County,27423,26640,783,2.9
CN2914700000000,2022-07-01,29,147,MO,Nodaway County,10626,10327,299,2.8
CN2914900000000,2022-07-01,29,149,MO,Oregon County,3640,3509,131,3.6
CN2915100000000,2022-07-01,29,151,MO,Osage County,7130,6981,149,2.1
CN2915300000000,2022-07-01,29,153,MO,Ozark County,3264,3146,118,3.6
CN2915500000000,2022-07-01,29,155,MO,Pemiscot County,5653,5385,268,4.7
CN2915700000000,2022-07-01,29,157,MO,Perry County,9514,9313,201,2.1
CN2915900000000,2022-07-01,29,159,MO,Pettis County,19612,18968,644,3.3
CN2916100000000,2022-07-01,29,161,MO,Phelps County,19601,19048,553,2.8
CN2916300000000,2022-07-01,29,163,MO,Pike County,7083,6890,193,2.7
CN2916500000000,2022-07-01,29,165,MO,Platte County,61143,59698,1445,2.4
CN2916700000000,2022-07-01,29,167,MO,Polk County,14843,14434,409,2.8
CN2916900000000,2022-07-01,29,169,MO,Pulaski County,13937,13468,469,3.4
CN2917100000000,2022-07-01,29,171,MO,Putnam County,2173,2122,51,2.3
CN2917300000000,2022-07-01,29,173,MO,Ralls County,5416,5290,126,2.3
CN2917500000000,2022-07-01,29,175,MO,Randolph County,10023,9742,281,2.8
CN2917700000000,2022-07-01,29,177,MO,Ray County,11294,10720,574,5.1
CN2917900000000,2022-07-01,29,179,MO,Reynolds County,2734,2649,85,3.1
CN2918100000000,2022-07-01,29,181,MO,Ripley County,4926,4746,180,3.7
CN2918300000000,2022-07-01,29,183,MO,St. Charles County,233120,228309,4811,2.1
CN2918500000000,2022-07-01,29,185,MO,St. Clair County,3708,3595,113,3
CN2918600000000,2022-07-01,29,186,MO,Ste. Genevieve County,9440,9201,239,2.5
CN2918700000000,2022-07-01,29,187,MO,St. Francois County,25399,24452,947,3.7
CN2918900000000,2022-07-01,29,189,MO,St. Louis County,535729,521772,13957,2.6
CN2919500000000,2022-07-01,29,195,MO,Saline County,9767,9471,296,3
CN2919700000000,2022-07-01,29,197,MO,Schuyler County,1780,1729,51,2.9
CN2919900000000,2022-07-01,29,199,MO,Scotland County,2280,2233,47,2.1
CN2920100000000,2022-07-01,29,201,MO,Scott County,19785,19206,579,2.9
CN2920300000000,2022-07-01,29,203,MO,Shannon County,3271,3140,131,4
CN2920500000000,2022-07-01,29,205,MO,Shelby County,2846,2776,70,2.5
CN2920700000000,2022-07-01,29,207,MO,Stoddard County,13025,12574,451,3.5
CN2920900000000,2022-07-01,29,209,MO,Stone County,14221,13793,428,3
CN2921100000000,2022-07-01,29,211,MO,Sullivan County,2474,2415,59,2.4
CN2921300000000,2022-07-01,29,213,MO,Taney County,27417,26583,834,3
CN2921500000000,2022-07-01,29,215,MO,Texas County,8534,8258,276,3.2
CN2921700000000,2022-07-01,29,217,MO,Vernon County,8903,8641,262,2.9
CN2921900000000,2022-07-01,29,219,MO,Warren County,19088,18606,482,2.5
CN2922100000000,2022-07-01,29,221,MO,Washington County,9784,9450,334,3.4
CN2922300000000,2022-07-01,29,223,MO,Wayne County,4640,4462,178,3.8
CN2922500000000,2022-07-01,29,225,MO,Webster County,17791,17356,435,2.4
CN2922700000000,2022-07-01,29,227,MO,Worth County,1100,1069,31,2.8
CN2922900000000,2022-07-01,29,229,MO,Wright County,7236,6997,239,3.3
CN2951000000000,2022-07-01,29,510,MO,St. Louis city,151643,146508,5135,3.4
CN3000100000000,2022-07-01,30,001,MT,Beaverhead County,5351,5237,114,2.1
CN3000300000000,2022-07-01,30,003,MT,Big Horn County,4618,4415,203,4.4
CN3000500000000,2022-07-01,30,005,MT,Blaine County,2061,1992,69,3.3
CN3000700000000,2022-07-01,30,007,MT,Broadwater County,2839,2748,91,3.2
CN3000900000000,2022-07-01,30,009,MT,Carbon County,5807,5666,141,2.4
CN3001100000000,2022-07-01,30,011,MT,Carter County,608,596,12,2
CN3001300000000,2022-07-01,30,013,MT,Cascade County,39184,38172,1012,2.6
CN3001500000000,2022-07-01,30,015,MT,Chouteau County,2338,2276,62,2.7
CN3001700000000,2022-07-01,30,017,MT,Custer County,6399,6247,152,2.4
CN3001900000000,2022-07-01,30,019,MT,Daniels County,887,870,17,1.9
CN3002100000000,2022-07-01,30,021,MT,Dawson County,4496,4386,110,2.4
CN3002300000000,2022-07-01,30,023,MT,Deer Lodge County,5545,5424,121,2.2
CN3002500000000,2022-07-01,30,025,MT,Fallon County,1592,1570,22,1.4
CN3002700000000,2022-07-01,30,027,MT,Fergus County,5831,5699,132,2.3
CN3002900000000,2022-07-01,30,029,MT,Flathead County,55241,53888,1353,2.4
CN3003100000000,2022-07-01,30,031,MT,Gallatin County,80982,79639,1343,1.7
CN3003300000000,2022-07-01,30,033,MT,Garfield County,712,695,17,2.4
CN3003500000000,2022-07-01,30,035,MT,Glacier County,6165,5862,303,4.9
CN3003700000000,2022-07-01,30,037,MT,Golden Valley County,368,357,11,3
CN3003900000000,2022-07-01,30,039,MT,Granite County,1696,1649,47,2.8
CN3004100000000,2022-07-01,30,041,MT,Hill County,7377,7167,210,2.8
CN3004300000000,2022-07-01,30,043,MT,Jefferson County,6250,6102,148,2.4
CN3004500000000,2022-07-01,30,045,MT,Judith Basin County,874,856,18,2.1
CN3004700000000,2022-07-01,30,047,MT,Lake County,14684,14245,439,3
CN3004900000000,2022-07-01,30,049,MT,Lewis and Clark County,39916,38984,932,2.3
CN3005100000000,2022-07-01,30,051,MT,Liberty County,924,902,22,2.4
CN3005300000000,2022-07-01,30,053,MT,Lincoln County,8830,8478,352,4
CN3005500000000,2022-07-01,30,055,MT,McCone County,911,893,18,2
CN3005700000000,2022-07-01,30,057,MT,Madison County,5201,5102,99,1.9
CN3005900000000,2022-07-01,30,059,MT,Meagher County,1016,995,21,2.1
CN3006100000000,2022-07-01,30,061,MT,Mineral County,2053,1967,86,4.2
CN3006300000000,2022-07-01,30,063,MT,Missoula County,66916,65289,1627,2.4
CN3006500000000,2022-07-01,30,065,MT,Musselshell County,2274,2213,61,2.7
CN3006700000000,2022-07-01,30,067,MT,Park County,10713,10459,254,2.4
CN3006900000000,2022-07-01,30,069,MT,Petroleum County,248,241,7,2.8
CN3007100000000,2022-07-01,30,071,MT,Phillips County,1714,1652,62,3.6
CN3007300000000,2022-07-01,30,073,MT,Pondera County,2488,2412,76,3.1
CN3007500000000,2022-07-01,30,075,MT,Powder River County,936,918,18,1.9
CN3007700000000,2022-07-01,30,077,MT,Powell County,2976,2907,69,2.3
CN3007900000000,2022-07-01,30,079,MT,Prairie County,472,460,12,2.5
CN3008100000000,2022-07-01,30,081,MT,Ravalli County,22176,21630,546,2.5
CN3008300000000,2022-07-01,30,083,MT,Richland County,5614,5450,164,2.9
CN3008500000000,2022-07-01,30,085,MT,Roosevelt County,4251,4097,154,3.6
CN3008700000000,2022-07-01,30,087,MT,Rosebud County,3604,3472,132,3.7
CN3008900000000,2022-07-01,30,089,MT,Sanders County,5436,5248,188,3.5
CN3009100000000,2022-07-01,30,091,MT,Sheridan County,1706,1678,28,1.6
CN3009300000000,2022-07-01,30,093,MT,Silver Bow County,18223,17726,497,2.7
CN3009500000000,2022-07-01,30,095,MT,Stillwater County,5416,5306,110,2
CN3009700000000,2022-07-01,30,097,MT,Sweet Grass County,1869,1832,37,2
CN3009900000000,2022-07-01,30,099,MT,Teton County,2699,2629,70,2.6
CN3010100000000,2022-07-01,30,101,MT,Toole County,2068,2021,47,2.3
CN3010300000000,2022-07-01,30,103,MT,Treasure County,312,304,8,2.6
CN3010500000000,2022-07-01,30,105,MT,Valley County,3989,3903,86,2.2
CN3010700000000,2022-07-01,30,107,MT,Wheatland County,724,702,22,3
CN3010900000000,2022-07-01,30,109,MT,Wibaux County,482,472,10,2.1
CN3011100000000,2022-07-01,30,111,MT,Yellowstone County,88106,85912,2194,2.5
CN3100100000000,2022-07-01,31,001,NE,Adams County,17541,17104,437,2.5
CN3100300000000,2022-07-01,31,003,NE,Antelope County,3693,3621,72,1.9
CN3100500000000,2022-07-01,31,005,NE,Arthur County,237,232,5,2.1
CN3100700000000,2022-07-01,31,007,NE,Banner County,383,372,11,2.9
CN3100900000000,2022-07-01,31,009,NE,Blaine County,249,238,11,4.4
CN3101100000000,2022-07-01,31,011,NE,Boone County,3096,3032,64,2.1
CN3101300000000,2022-07-01,31,013,NE,Box Butte County,5461,5302,159,2.9
CN3101500000000,2022-07-01,31,015,NE,Boyd County,1011,985,26,2.6
CN3101700000000,2022-07-01,31,017,NE,Brown County,1484,1442,42,2.8
CN3101900000000,2022-07-01,31,019,NE,Buffalo County,28575,27952,623,2.2
CN3102100000000,2022-07-01,31,021,NE,Burt County,3591,3509,82,2.3
CN3102300000000,2022-07-01,31,023,NE,Butler County,4817,4724,93,1.9
CN3102500000000,2022-07-01,31,025,NE,Cass County,13923,13526,397,2.9
CN3102700000000,2022-07-01,31,027,NE,Cedar County,4753,4658,95,2
CN3102900000000,2022-07-01,31,029,NE,Chase County,2322,2269,53,2.3
CN3103100000000,2022-07-01,31,031,NE,Cherry County,3503,3437,66,1.9
CN3103300000000,2022-07-01,31,033,NE,Cheyenne County,4335,4216,119,2.7
CN3103500000000,2022-07-01,31,035,NE,Clay County,3194,3122,72,2.3
CN3103700000000,2022-07-01,31,037,NE,Colfax County,5819,5708,111,1.9
CN3103900000000,2022-07-01,31,039,NE,Cuming County,4914,4819,95,1.9
CN3104100000000,2022-07-01,31,041,NE,Custer County,6447,6338,109,1.7
CN3104300000000,2022-07-01,31,043,NE,Dakota County,11223,10781,442,3.9
CN3104500000000,2022-07-01,31,045,NE,Dawes County,4960,4835,125,2.5
CN3104700000000,2022-07-01,31,047,NE,Dawson County,13964,13588,376,2.7
CN3104900000000,2022-07-01,31,049,NE,Deuel County,1071,1037,34,3.2
CN3105100000000,2022-07-01,31,051,NE,Dixon County,3068,2994,74,2.4
CN3105300000000,2022-07-01,31,053,NE,Dodge County,21038,20564,474,2.3
CN3105500000000,2022-07-01,31,055,NE,Douglas County,311137,301729,9408,3
CN3105700000000,2022-07-01,31,057,NE,Dundy County,1186,1165,21,1.8
CN3105900000000,2022-07-01,31,059,NE,Fillmore County,3416,3342,74,2.2
CN3106100000000,2022-07-01,31,061,NE,Franklin County,1581,1539,42,2.7
CN3106300000000,2022-07-01,31,063,NE,Frontier County,1503,1469,34,2.3
CN3106500000000,2022-07-01,31,065,NE,Furnas County,2596,2530,66,2.5
CN3106700000000,2022-07-01,31,067,NE,Gage County,11128,10648,480,4.3
CN3106900000000,2022-07-01,31,069,NE,Garden County,1183,1162,21,1.8
CN3107100000000,2022-07-01,31,071,NE,Garfield County,1188,1159,29,2.4
CN3107300000000,2022-07-01,31,073,NE,Gosper County,1300,1274,26,2
CN3107500000000,2022-07-01,31,075,NE,Grant County,429,421,8,1.9
CN3107700000000,2022-07-01,31,077,NE,Greeley County,1345,1319,26,1.9
CN3107900000000,2022-07-01,31,079,NE,Hall County,33537,32687,850,2.5
CN3108100000000,2022-07-01,31,081,NE,Hamilton County,5009,4911,98,2
CN3108300000000,2022-07-01,31,083,NE,Harlan County,1906,1869,37,1.9
CN3108500000000,2022-07-01,31,085,NE,Hayes County,587,576,11,1.9
CN3108700000000,2022-07-01,31,087,NE,Hitchcock County,1316,1287,29,2.2
CN3108900000000,2022-07-01,31,089,NE,Holt County,5816,5713,103,1.8
CN3109100000000,2022-07-01,31,091,NE,Hooker County,462,446,16,3.5
CN3109300000000,2022-07-01,31,093,NE,Howard County,3547,3475,72,2
CN3109500000000,2022-07-01,31,095,NE,Jefferson County,4297,4196,101,2.4
CN3109700000000,2022-07-01,31,097,NE,Johnson County,2059,1993,66,3.2
CN3109900000000,2022-07-01,31,099,NE,Kearney County,3763,3689,74,2
CN3110100000000,2022-07-01,31,101,NE,Keith County,4930,4829,101,2
CN3110300000000,2022-07-01,31,103,NE,Keya Paha County,542,526,16,3
CN3110500000000,2022-07-01,31,105,NE,Kimball County,1995,1958,37,1.9
CN3110700000000,2022-07-01,31,107,NE,Knox County,4802,4677,125,2.6
CN3110900000000,2022-07-01,31,109,NE,Lancaster County,180556,176325,4231,2.3
CN3111100000000,2022-07-01,31,111,NE,Lincoln County,18855,18341,514,2.7
CN3111300000000,2022-07-01,31,113,NE,Logan County,486,475,11,2.3
CN3111500000000,2022-07-01,31,115,NE,Loup County,411,398,13,3.2
CN3111700000000,2022-07-01,31,117,NE,McPherson County,433,425,8,1.8
CN3111900000000,2022-07-01,31,119,NE,Madison County,20214,19740,474,2.3
CN3112100000000,2022-07-01,31,121,NE,Merrick County,4261,4184,77,1.8
CN3112300000000,2022-07-01,31,123,NE,Morrill County,2738,2677,61,2.2
CN3112500000000,2022-07-01,31,125,NE,Nance County,2026,1981,45,2.2
CN3112700000000,2022-07-01,31,127,NE,Nemaha County,3547,3454,93,2.6
CN3112900000000,2022-07-01,31,129,NE,Nuckolls County,2538,2482,56,2.2
CN3113100000000,2022-07-01,31,131,NE,Otoe County,8656,8423,233,2.7
CN3113300000000,2022-07-01,31,133,NE,Pawnee County,1514,1469,45,3
CN3113500000000,2022-07-01,31,135,NE,Perkins County,1907,1875,32,1.7
CN3113700000000,2022-07-01,31,137,NE,Phelps County,5133,5016,117,2.3
CN3113900000000,2022-07-01,31,139,NE,Pierce County,4326,4228,98,2.3
CN3114100000000,2022-07-01,31,141,NE,Platte County,18746,18319,427,2.3
CN3114300000000,2022-07-01,31,143,NE,Polk County,2895,2839,56,1.9
CN3114500000000,2022-07-01,31,145,NE,Red Willow County,6004,5858,146,2.4
CN3114700000000,2022-07-01,31,147,NE,Richardson County,4297,4191,106,2.5
CN3114900000000,2022-07-01,31,149,NE,Rock County,928,912,16,1.7
CN3115100000000,2022-07-01,31,151,NE,Saline County,7232,7012,220,3
CN3115300000000,2022-07-01,31,153,NE,Sarpy County,101035,98640,2395,2.4
CN3115500000000,2022-07-01,31,155,NE,Saunders County,11774,11520,254,2.2
CN3115700000000,2022-07-01,31,157,NE,Scotts Bluff County,18189,17619,570,3.1
CN3115900000000,2022-07-01,31,159,NE,Seward County,8988,8744,244,2.7
CN3116100000000,2022-07-01,31,161,NE,Sheridan County,2836,2770,66,2.3
CN3116300000000,2022-07-01,31,163,NE,Sherman County,1692,1644,48,2.8
CN3116500000000,2022-07-01,31,165,NE,Sioux County,791,775,16,2
CN3116700000000,2022-07-01,31,167,NE,Stanton County,3620,3533,87,2.4
CN3116900000000,2022-07-01,31,169,NE,Thayer County,2750,2689,61,2.2
CN3117100000000,2022-07-01,31,171,NE,Thomas County,478,467,11,2.3
CN3117300000000,2022-07-01,31,173,NE,Thurston County,3389,3211,178,5.3
CN3117500000000,2022-07-01,31,175,NE,Valley County,2205,2147,58,2.6
CN3117700000000,2022-07-01,31,177,NE,Washington County,11658,11375,283,2.4
CN3117900000000,2022-07-01,31,179,NE,Wayne County,5474,5315,159,2.9
CN3118100000000,2022-07-01,31,181,NE,Webster County,1676,1634,42,2.5
CN3118300000000,2022-07-01,31,183,NE,Wheeler County,542,534,8,1.5
CN3118500000000,2022-07-01,31,185,NE,York County,7608,7415,193,2.5
CN3200100000000,2022-07-01,32,001,NV,Churchill County,10773,10360,413,3.8
CN3200300000000,2022-07-01,32,003,NV,Clark County,1154210,1083205,71005,6.2
CN3200500000000,2022-07-01,32,005,NV,Douglas County,22650,21742,908,4
CN3200700000000,2022-07-01,32,007,NV,Elko County,25721,24818,903,3.5
CN3200900000000,2022-07-01,32,009,NV,Esmeralda County,367,349,18,4.9
CN3201100000000,2022-07-01,32,011,NV,Eureka County,881,852,29,3.3
CN3201300000000,2022-07-01,32,013,NV,Humboldt County,7550,7276,274,3.6
CN3201500000000,2022-07-01,32,015,NV,Lander County,3015,2905,110,3.6
CN3201700000000,2022-07-01,32,017,NV,Lincoln County,1965,1873,92,4.7
CN3201900000000,2022-07-01,32,019,NV,Lyon County,23474,22303,1171,5
CN3202100000000,2022-07-01,32,021,NV,Mineral County,1989,1900,89,4.5
CN3202300000000,2022-07-01,32,023,NV,Nye County,17528,16470,1058,6
CN3202700000000,2022-07-01,32,027,NV,Pershing County,2344,2254,90,3.8
CN3202900000000,2022-07-01,32,029,NV,Storey County,2096,2011,85,4.1
CN3203100000000,2022-07-01,32,031,NV,Washoe County,256570,247457,9113,3.6
CN3203300000000,2022-07-01,32,033,NV,White Pine County,4585,4438,147,3.2
CN3251000000000,2022-07-01,32,510,NV,Carson City,25482,24451,1031,4
CN3300100000000,2022-07-01,33,001,NH,Belknap County,32872,32153,719,2.2
CN3300300000000,2022-07-01,33,003,NH,Carroll County,25272,24724,548,2.2
CN3300500000000,2022-07-01,33,005,NH,Cheshire County,39464,38422,1042,2.6
CN3300700000000,2022-07-01,33,007,NH,Coos County,14858,14311,547,3.7
CN3300900000000,2022-07-01,33,009,NH,Grafton County,50318,49159,1159,2.3
CN3301100000000,2022-07-01,33,011,NH,Hillsborough County,241955,235857,6098,2.5
CN3301300000000,2022-07-01,33,013,NH,Merrimack County,83167,81302,1865,2.2
CN3301500000000,2022-07-01,33,015,NH,Rockingham County,192393,187675,4718,2.5
CN3301700000000,2022-07-01,33,017,NH,Strafford County,75192,73377,1815,2.4
CN3301900000000,2022-07-01,33,019,NH,Sullivan County,23004,22454,550,2.4
CN3400100000000,2022-07-01,34,001,NJ,Atlantic County,125196,119412,5784,4.6
CN3400300000000,2022-07-01,34,003,NJ,Bergen County,506742,489923,16819,3.3
CN3400500000000,2022-07-01,34,005,NJ,Burlington County,248807,240495,8312,3.3
CN3400700000000,2022-07-01,34,007,NJ,Camden County,271797,261022,10775,4
CN3400900000000,2022-07-01,34,009,NJ,Cape May County,58917,56804,2113,3.6
CN3401100000000,2022-07-01,34,011,NJ,Cumberland County,68275,64905,3370,4.9
CN3401300000000,2022-07-01,34,013,NJ,Essex County,390388,373292,17096,4.4
CN3401500000000,2022-07-01,34,015,NJ,Gloucester County,161996,156099,5897,3.6
CN3401700000000,2022-07-01,34,017,NJ,Hudson County,379155,365817,13338,3.5
CN3401900000000,2022-07-01,34,019,NJ,Hunterdon County,68406,66418,1988,2.9
CN3402100000000,2022-07-01,34,021,NJ,Mercer County,218382,211334,7048,3.2
CN3402300000000,2022-07-01,34,023,NJ,Middlesex County,472369,456834,15535,3.3
CN3402500000000,2022-07-01,34,025,NJ,Monmouth County,354171,342842,11329,3.2
CN3402700000000,2022-07-01,34,027,NJ,Morris County,270524,262370,8154,3
CN3402900000000,2022-07-01,34,029,NJ,Ocean County,303182,292764,10418,3.4
CN3403100000000,2022-07-01,34,031,NJ,Passaic County,253962,242822,11140,4.4
CN3403300000000,2022-07-01,34,033,NJ,Salem County,30667,29255,1412,4.6
CN3403500000000,2022-07-01,34,035,NJ,Somerset County,180466,174949,5517,3.1
CN3403700000000,2022-07-01,34,037,NJ,Sussex County,77921,75154,2767,3.6
CN3403900000000,2022-07-01,34,039,NJ,Union County,291193,280381,10812,3.7
CN3404100000000,2022-07-01,34,041,NJ,Warren County,59015,56933,2082,3.5
CN3500100000000,2022-07-01,35,001,NM,Bernalillo County,335397,322544,12853,3.8
CN3500300000000,2022-07-01,35,003,NM,Catron County,1176,1111,65,5.5
CN3500500000000,2022-07-01,35,005,NM,Chaves County,27693,26432,1261,4.6
CN3500600000000,2022-07-01,35,006,NM,Cibola County,8041,7581,460,5.7
CN3500700000000,2022-07-01,35,007,NM,Colfax County,6356,6136,220,3.5
CN3500900000000,2022-07-01,35,009,NM,Curry County,22369,21584,785,3.5
CN3501100000000,2022-07-01,35,011,NM,De Baca County,770,745,25,3.2
CN3501300000000,2022-07-01,35,013,NM,Dona Ana County,98157,93620,4537,4.6
CN3501500000000,2022-07-01,35,015,NM,Eddy County,31094,30016,1078,3.5
CN3501700000000,2022-07-01,35,017,NM,Grant County,11440,10957,483,4.2
CN3501900000000,2022-07-01,35,019,NM,Guadalupe County,1501,1417,84,5.6
CN3502100000000,2022-07-01,35,021,NM,Harding County,282,273,9,3.2
CN3502300000000,2022-07-01,35,023,NM,Hidalgo County,1947,1881,66,3.4
CN3502500000000,2022-07-01,35,025,NM,Lea County,29399,28064,1335,4.5
CN3502700000000,2022-07-01,35,027,NM,Lincoln County,9225,8868,357,3.9
CN3502800000000,2022-07-01,35,028,NM,Los Alamos County,10912,10646,266,2.4
CN3502900000000,2022-07-01,35,029,NM,Luna County,10248,9462,786,7.7
CN3503100000000,2022-07-01,35,031,NM,McKinley County,22582,21221,1361,6
CN3503300000000,2022-07-01,35,033,NM,Mora County,1985,1864,121,6.1
CN3503500000000,2022-07-01,35,035,NM,Otero County,25012,23905,1107,4.4
CN3503700000000,2022-07-01,35,037,NM,Quay County,2977,2843,134,4.5
CN3503900000000,2022-07-01,35,039,NM,Rio Arriba County,16867,16127,740,4.4
CN3504100000000,2022-07-01,35,041,NM,Roosevelt County,7681,7342,339,4.4
CN3504300000000,2022-07-01,35,043,NM,Sandoval County,67868,65110,2758,4.1
CN3504500000000,2022-07-01,35,045,NM,San Juan County,48010,45613,2397,5
CN3504700000000,2022-07-01,35,047,NM,San Miguel County,10215,9649,566,5.5
CN3504900000000,2022-07-01,35,049,NM,Santa Fe County,73195,70427,2768,3.8
CN3505100000000,2022-07-01,35,051,NM,Sierra County,3948,3735,213,5.4
CN3505300000000,2022-07-01,35,053,NM,Socorro County,6174,5899,275,4.5
CN3505500000000,2022-07-01,35,055,NM,Taos County,14843,14125,718,4.8
CN3505700000000,2022-07-01,35,057,NM,Torrance County,5393,5079,314,5.8
CN3505900000000,2022-07-01,35,059,NM,Union County,1561,1514,47,3
CN3506100000000,2022-07-01,35,061,NM,Valencia County,31045,29618,1427,4.6
CN3600100000000,2022-07-01,36,001,NY,Albany County,160927,155548,5379,3.3
CN3600300000000,2022-07-01,36,003,NY,Allegany County,18157,17369,788,4.3
CN3600500000000,2022-07-01,36,005,NY,Bronx County,604882,560263,44619,7.4
CN3600700000000,2022-07-01,36,007,NY,Broome County,82234,78853,3381,4.1
CN3600900000000,2022-07-01,36,009,NY,Cattaraugus County,32100,30747,1353,4.2
CN3601100000000,2022-07-01,36,011,NY,Cayuga County,35646,34354,1292,3.6
CN3601300000000,2022-07-01,36,013,NY,Chautauqua County,53325,51178,2147,4
CN3601500000000,2022-07-01,36,015,NY,Chemung County,35136,33779,1357,3.9
CN3601700000000,2022-07-01,36,017,NY,Chenango County,21488,20764,724,3.4
CN3601900000000,2022-07-01,36,019,NY,Clinton County,34623,33308,1315,3.8
CN3602100000000,2022-07-01,36,021,NY,Columbia County,31102,30206,896,2.9
CN3602300000000,2022-07-01,36,023,NY,Cortland County,21819,20946,873,4
CN3602500000000,2022-07-01,36,025,NY,Delaware County,18239,17514,725,4
CN3602700000000,2022-07-01,36,027,NY,Dutchess County,147982,143100,4882,3.3
CN3602900000000,2022-07-01,36,029,NY,Erie County,445402,428347,17055,3.8
CN3603100000000,2022-07-01,36,031,NY,Essex County,17323,16766,557,3.2
CN3603300000000,2022-07-01,36,033,NY,Franklin County,19059,18358,701,3.7
CN3603500000000,2022-07-01,36,035,NY,Fulton County,21981,21101,880,4
CN3603700000000,2022-07-01,36,037,NY,Genesee County,29889,28973,916,3.1
CN3603900000000,2022-07-01,36,039,NY,Greene County,20294,19558,736,3.6
CN3604100000000,2022-07-01,36,041,NY,Hamilton County,2479,2407,72,2.9
CN3604300000000,2022-07-01,36,043,NY,Herkimer County,27802,26768,1034,3.7
CN3604500000000,2022-07-01,36,045,NY,Jefferson County,45818,44057,1761,3.8
CN3604700000000,2022-07-01,36,047,NY,Kings County,1213163,1144467,68696,5.7
CN3604900000000,2022-07-01,36,049,NY,Lewis County,11701,11274,427,3.6
CN3605100000000,2022-07-01,36,051,NY,Livingston County,30552,29507,1045,3.4
CN3605300000000,2022-07-01,36,053,NY,Madison County,33293,32132,1161,3.5
CN3605500000000,2022-07-01,36,055,NY,Monroe County,366959,353091,13868,3.8
CN3605700000000,2022-07-01,36,057,NY,Montgomery County,22158,21248,910,4.1
CN3605900000000,2022-07-01,36,059,NY,Nassau County,746548,723100,23448,3.1
CN3606100000000,2022-07-01,36,061,NY,New York County,922887,881913,40974,4.4
CN3606300000000,2022-07-01,36,063,NY,Niagara County,98283,94417,3866,3.9
CN3606500000000,2022-07-01,36,065,NY,Oneida County,102093,98230,3863,3.8
CN3606700000000,2022-07-01,36,067,NY,Onondaga County,226416,218419,7997,3.5
CN3606900000000,2022-07-01,36,069,NY,Ontario County,56110,54372,1738,3.1
CN3607100000000,2022-07-01,36,071,NY,Orange County,194392,187647,6745,3.5
CN3607300000000,2022-07-01,36,073,NY,Orleans County,17393,16677,716,4.1
CN3607500000000,2022-07-01,36,075,NY,Oswego County,53411,51175,2236,4.2
CN3607700000000,2022-07-01,36,077,NY,Otsego County,26972,25982,990,3.7
CN3607900000000,2022-07-01,36,079,NY,Putnam County,52488,50808,1680,3.2
CN3608100000000,2022-07-01,36,081,NY,Queens County,1144291,1088005,56286,4.9
CN3608300000000,2022-07-01,36,083,NY,Rensselaer County,82934,80226,2708,3.3
CN3608500000000,2022-07-01,36,085,NY,Richmond County,228712,216077,12635,5.5
CN3608700000000,2022-07-01,36,087,NY,Rockland County,162344,157197,5147,3.2
CN3608900000000,2022-07-01,36,089,NY,St. Lawrence County,40952,38977,1975,4.8
CN3609100000000,2022-07-01,36,091,NY,Saratoga County,122668,119198,3470,2.8
CN3609300000000,2022-07-01,36,093,NY,Schenectady County,78605,75823,2782,3.5
CN3609500000000,2022-07-01,36,095,NY,Schoharie County,14941,14399,542,3.6
CN3609700000000,2022-07-01,36,097,NY,Schuyler County,8279,8014,265,3.2
CN3609900000000,2022-07-01,36,099,NY,Seneca County,15090,14625,465,3.1
CN3610100000000,2022-07-01,36,101,NY,Steuben County,41174,39693,1481,3.6
CN3610300000000,2022-07-01,36,103,NY,Suffolk County,820080,792364,27716,3.4
CN3610500000000,2022-07-01,36,105,NY,Sullivan County,38855,37581,1274,3.3
CN3610700000000,2022-07-01,36,107,NY,Tioga County,22216,21486,730,3.3
CN3610900000000,2022-07-01,36,109,NY,Tompkins County,48786,47158,1628,3.3
CN3611100000000,2022-07-01,36,111,NY,Ulster County,88311,85305,3006,3.4
CN3611300000000,2022-07-01,36,113,NY,Warren County,32703,31688,1015,3.1
CN3611500000000,2022-07-01,36,115,NY,Washington County,28949,28054,895,3.1
CN3611700000000,2022-07-01,36,117,NY,Wayne County,43808,42369,1439,3.3
CN3611900000000,2022-07-01,36,119,NY,Westchester County,505283,488020,17263,3.4
CN3612100000000,2022-07-01,36,121,NY,Wyoming County,17634,17078,556,3.2
CN3612300000000,2022-07-01,36,123,NY,Yates County,11814,11473,341,2.9
CN3700100000000,2022-07-01,37,001,NC,Alamance County,83924,80459,3465,4.1
CN3700300000000,2022-07-01,37,003,NC,Alexander County,18178,17577,601,3.3
CN3700500000000,2022-07-01,37,005,NC,Alleghany County,4628,4451,177,3.8
CN3700700000000,2022-07-01,37,007,NC,Anson County,10161,9693,468,4.6
CN3700900000000,2022-07-01,37,009,NC,Ashe County,12808,12344,464,3.6
CN3701100000000,2022-07-01,37,011,NC,Avery County,8105,7840,265,3.3
CN3701300000000,2022-07-01,37,013,NC,Beaufort County,19428,18596,832,4.3
CN3701500000000,2022-07-01,37,015,NC,Bertie County,7091,6721,370,5.2
CN3701700000000,2022-07-01,37,017,NC,Bladen County,14410,13762,648,4.5
CN3701900000000,2022-07-01,37,019,NC,Brunswick County,60129,57437,2692,4.5
CN3702100000000,2022-07-01,37,021,NC,Buncombe County,143192,138763,4429,3.1
CN3702300000000,2022-07-01,37,023,NC,Burke County,41276,39785,1491,3.6
CN3702500000000,2022-07-01,37,025,NC,Cabarrus County,117586,113295,4291,3.6
CN3702700000000,2022-07-01,37,027,NC,Caldwell County,36772,35387,1385,3.8
CN3702900000000,2022-07-01,37,029,NC,Camden County,4626,4439,187,4
CN3703100000000,2022-07-01,37,031,NC,Carteret County,32938,31790,1148,3.5
CN3703300000000,2022-07-01,37,033,NC,Caswell County,9629,9188,441,4.6
CN3703500000000,2022-07-01,37,035,NC,Catawba County,80290,77354,2936,3.7
CN3703700000000,2022-07-01,37,037,NC,Chatham County,38114,36863,1251,3.3
CN3703900000000,2022-07-01,37,039,NC,Cherokee County,10993,10515,478,4.3
CN3704100000000,2022-07-01,37,041,NC,Chowan County,5758,5513,245,4.3
CN3704300000000,2022-07-01,37,043,NC,Clay County,4186,4009,177,4.2
CN3704500000000,2022-07-01,37,045,NC,Cleveland County,48456,46437,2019,4.2
CN3704700000000,2022-07-01,37,047,NC,Columbus County,23847,22795,1052,4.4
CN3704900000000,2022-07-01,37,049,NC,Craven County,42673,41020,1653,3.9
CN3705100000000,2022-07-01,37,051,NC,Cumberland County,126929,119830,7099,5.6
CN3705300000000,2022-07-01,37,053,NC,Currituck County,15038,14501,537,3.6
CN3705500000000,2022-07-01,37,055,NC,Dare County,22305,21574,731,3.3
CN3705700000000,2022-07-01,37,057,NC,Davidson County,82047,78979,3068,3.7
CN3705900000000,2022-07-01,37,059,NC,Davie County,20912,20162,750,3.6
CN3706100000000,2022-07-01,37,061,NC,Duplin County,24042,23031,1011,4.2
CN3706300000000,2022-07-01,37,063,NC,Durham County,182125,176016,6109,3.4
CN3706500000000,2022-07-01,37,065,NC,Edgecombe County,20315,18914,1401,6.9
CN3706700000000,2022-07-01,37,067,NC,Forsyth County,190277,182520,7757,4.1
CN3706900000000,2022-07-01,37,069,NC,Franklin County,34782,33465,1317,3.8
CN3707100000000,2022-07-01,37,071,NC,Gaston County,116030,111596,4434,3.8
CN3707300000000,2022-07-01,37,073,NC,Gates County,5252,5054,198,3.8
CN3707500000000,2022-07-01,37,075,NC,Graham County,2907,2752,155,5.3
CN3707700000000,2022-07-01,37,077,NC,Granville County,30424,29340,1084,3.6
CN3707900000000,2022-07-01,37,079,NC,Greene County,9459,9128,331,3.5
CN3708100000000,2022-07-01,37,081,NC,Guilford County,258758,247058,11700,4.5
CN3708300000000,2022-07-01,37,083,NC,Halifax County,19073,17908,1165,6.1
CN3708500000000,2022-07-01,37,085,NC,Harnett County,54417,51967,2450,4.5
CN3708700000000,2022-07-01,37,087,NC,Haywood County,30428,29437,991,3.3
CN3708900000000,2022-07-01,37,089,NC,Henderson County,56006,54144,1862,3.3
CN3709100000000,2022-07-01,37,091,NC,Hertford County,8402,7909,493,5.9
CN3709300000000,2022-07-01,37,093,NC,Hoke County,20164,19085,1079,5.4
CN3709500000000,2022-07-01,37,095,NC,Hyde County,1911,1828,83,4.3
CN3709700000000,2022-07-01,37,097,NC,Iredell County,95821,92353,3468,3.6
CN3709900000000,2022-07-01,37,099,NC,Jackson County,19850,18989,861,4.3
CN3710100000000,2022-07-01,37,101,NC,Johnston County,110612,106706,3906,3.5
CN3710300000000,2022-07-01,37,103,NC,Jones County,4369,4215,154,3.5
CN3710500000000,2022-07-01,37,105,NC,Lee County,25802,24644,1158,4.5
CN3710700000000,2022-07-01,37,107,NC,Lenoir County,27643,26574,1069,3.9
CN3710900000000,2022-07-01,37,109,NC,Lincoln County,46973,45396,1577,3.4
CN3711100000000,2022-07-01,37,111,NC,McDowell County,20001,19255,746,3.7
CN3711300000000,2022-07-01,37,113,NC,Macon County,16130,15553,577,3.6
CN3711500000000,2022-07-01,37,115,NC,Madison County,10176,9803,373,3.7
CN3711700000000,2022-07-01,37,117,NC,Martin County,8319,7927,392,4.7
CN3711900000000,2022-07-01,37,119,NC,Mecklenburg County,660056,635888,24168,3.7
CN3712100000000,2022-07-01,37,121,NC,Mitchell County,5845,5592,253,4.3
CN3712300000000,2022-07-01,37,123,NC,Montgomery County,11213,10747,466,4.2
CN3712500000000,2022-07-01,37,125,NC,Moore County,41927,40260,1667,4
CN3712700000000,2022-07-01,37,127,NC,Nash County,42469,40179,2290,5.4
CN3712900000000,2022-07-01,37,129,NC,New Hanover County,131871,127363,4508,3.4
CN3713100000000,2022-07-01,37,131,NC,Northampton County,7186,6804,382,5.3
CN3713300000000,2022-07-01,37,133,NC,Onslow County,66724,63546,3178,4.8
CN3713500000000,2022-07-01,37,135,NC,Orange County,83248,80305,2943,3.5
CN3713700000000,2022-07-01,37,137,NC,Pamlico County,5567,5363,204,3.7
CN3713900000000,2022-07-01,37,139,NC,Pasquotank County,16576,15737,839,5.1
CN3714100000000,2022-07-01,37,141,NC,Pender County,31318,30168,1150,3.7
CN3714300000000,2022-07-01,37,143,NC,Perquimans County,4920,4687,233,4.7
CN3714500000000,2022-07-01,37,145,NC,Person County,19138,18392,746,3.9
CN3714700000000,2022-07-01,37,147,NC,Pitt County,88669,84586,4083,4.6
CN3714900000000,2022-07-01,37,149,NC,Polk County,9399,9026,373,4
CN3715100000000,2022-07-01,37,151,NC,Randolph County,64938,62360,2578,4
CN3715300000000,2022-07-01,37,153,NC,Richmond County,16655,15769,886,5.3
CN3715500000000,2022-07-01,37,155,NC,Robeson County,47152,44273,2879,6.1
CN3715700000000,2022-07-01,37,157,NC,Rockingham County,39201,37480,1721,4.4
CN3715900000000,2022-07-01,37,159,NC,Rowan County,68590,65963,2627,3.8
CN3716100000000,2022-07-01,37,161,NC,Rutherford County,24836,23568,1268,5.1
CN3716300000000,2022-07-01,37,163,NC,Sampson County,27778,26584,1194,4.3
CN3716500000000,2022-07-01,37,165,NC,Scotland County,10906,10148,758,7
CN3716700000000,2022-07-01,37,167,NC,Stanly County,30825,29726,1099,3.6
CN3716900000000,2022-07-01,37,169,NC,Stokes County,21815,21040,775,3.6
CN3717100000000,2022-07-01,37,171,NC,Surry County,32328,31097,1231,3.8
CN3717300000000,2022-07-01,37,173,NC,Swain County,7412,7179,233,3.1
CN3717500000000,2022-07-01,37,175,NC,Transylvania County,15335,14806,529,3.4
CN3717700000000,2022-07-01,37,177,NC,Tyrrell County,1450,1384,66,4.6
CN3717900000000,2022-07-01,37,179,NC,Union County,132149,127536,4613,3.5
CN3718100000000,2022-07-01,37,181,NC,Vance County,16744,15709,1035,6.2
CN3718300000000,2022-07-01,37,183,NC,Wake County,646087,625038,21049,3.3
CN3718500000000,2022-07-01,37,185,NC,Warren County,6351,5925,426,6.7
CN3718700000000,2022-07-01,37,187,NC,Washington County,4348,4117,231,5.3
CN3718900000000,2022-07-01,37,189,NC,Watauga County,29312,28169,1143,3.9
CN3719100000000,2022-07-01,37,191,NC,Wayne County,51115,48883,2232,4.4
CN3719300000000,2022-07-01,37,193,NC,Wilkes County,26331,25205,1126,4.3
CN3719500000000,2022-07-01,37,195,NC,Wilson County,33248,31326,1922,5.8
CN3719700000000,2022-07-01,37,197,NC,Yadkin County,17739,17128,611,3.4
CN3719900000000,2022-07-01,37,199,NC,Yancey County,8173,7867,306,3.7
CN3800100000000,2022-07-01,38,001,ND,Adams County,956,936,20,2.1
CN3800300000000,2022-07-01,38,003,ND,Barnes County,5109,4985,124,2.4
CN3800500000000,2022-07-01,38,005,ND,Benson County,2261,2201,60,2.7
CN3800700000000,2022-07-01,38,007,ND,Billings County,605,596,9,1.5
CN3800900000000,2022-07-01,38,009,ND,Bottineau County,3058,2976,82,2.7
CN3801100000000,2022-07-01,38,011,ND,Bowman County,1530,1502,28,1.8
CN3801300000000,2022-07-01,38,013,ND,Burke County,1004,986,18,1.8
CN3801500000000,2022-07-01,38,015,ND,Burleigh County,54083,53147,936,1.7
CN3801700000000,2022-07-01,38,017,ND,Cass County,113115,111356,1759,1.6
CN3801900000000,2022-07-01,38,019,ND,Cavalier County,1793,1758,35,2
CN3802100000000,2022-07-01,38,021,ND,Dickey County,2248,2212,36,1.6
CN3802300000000,2022-07-01,38,023,ND,Divide County,1443,1427,16,1.1
CN3802500000000,2022-07-01,38,025,ND,Dunn County,3246,3206,40,1.2
CN3802700000000,2022-07-01,38,027,ND,Eddy County,1155,1126,29,2.5
CN3802900000000,2022-07-01,38,029,ND,Emmons County,1383,1341,42,3
CN3803100000000,2022-07-01,38,031,ND,Foster County,1527,1501,26,1.7
CN3803300000000,2022-07-01,38,033,ND,Golden Valley County,826,813,13,1.6
CN3803500000000,2022-07-01,38,035,ND,Grand Forks County,38190,37490,700,1.8
CN3803700000000,2022-07-01,38,037,ND,Grant County,1202,1179,23,1.9
CN3803900000000,2022-07-01,38,039,ND,Griggs County,993,977,16,1.6
CN3804100000000,2022-07-01,38,041,ND,Hettinger County,1348,1320,28,2.1
CN3804300000000,2022-07-01,38,043,ND,Kidder County,1272,1230,42,3.3
CN3804500000000,2022-07-01,38,045,ND,LaMoure County,2047,2012,35,1.7
CN3804700000000,2022-07-01,38,047,ND,Logan County,839,825,14,1.7
CN3804900000000,2022-07-01,38,049,ND,McHenry County,3042,2968,74,2.4
CN3805100000000,2022-07-01,38,051,ND,McIntosh County,1071,1052,19,1.8
CN3805300000000,2022-07-01,38,053,ND,McKenzie County,9355,9186,169,1.8
CN3805500000000,2022-07-01,38,055,ND,McLean County,4778,4635,143,3
CN3805700000000,2022-07-01,38,057,ND,Mercer County,3771,3650,121,3.2
CN3805900000000,2022-07-01,38,059,ND,Morton County,17678,17308,370,2.1
CN3806100000000,2022-07-01,38,061,ND,Mountrail County,6437,6339,98,1.5
CN3806300000000,2022-07-01,38,063,ND,Nelson County,1456,1415,41,2.8
CN3806500000000,2022-07-01,38,065,ND,Oliver County,902,876,26,2.9
CN3806700000000,2022-07-01,38,067,ND,Pembina County,3258,3155,103,3.2
CN3806900000000,2022-07-01,38,069,ND,Pierce County,1623,1584,39,2.4
CN3807100000000,2022-07-01,38,071,ND,Ramsey County,5815,5704,111,1.9
CN3807300000000,2022-07-01,38,073,ND,Ransom County,2668,2629,39,1.5
CN3807500000000,2022-07-01,38,075,ND,Renville County,1198,1176,22,1.8
CN3807700000000,2022-07-01,38,077,ND,Richland County,8908,8738,170,1.9
CN3807900000000,2022-07-01,38,079,ND,Rolette County,4847,4340,507,10.5
CN3808100000000,2022-07-01,38,081,ND,Sargent County,2328,2289,39,1.7
CN3808300000000,2022-07-01,38,083,ND,Sheridan County,636,625,11,1.7
CN3808500000000,2022-07-01,38,085,ND,Sioux County,1280,1234,46,3.6
CN3808700000000,2022-07-01,38,087,ND,Slope County,332,325,7,2.1
CN3808900000000,2022-07-01,38,089,ND,Stark County,18795,18478,317,1.7
CN3809100000000,2022-07-01,38,091,ND,Steele County,943,924,19,2
CN3809300000000,2022-07-01,38,093,ND,Stutsman County,10857,10652,205,1.9
CN3809500000000,2022-07-01,38,095,ND,Towner County,1112,1090,22,2
CN3809700000000,2022-07-01,38,097,ND,Traill County,4451,4344,107,2.4
CN3809900000000,2022-07-01,38,099,ND,Walsh County,5269,5098,171,3.2
CN3810100000000,2022-07-01,38,101,ND,Ward County,33289,32634,655,2
CN3810300000000,2022-07-01,38,103,ND,Wells County,1917,1870,47,2.5
CN3810500000000,2022-07-01,38,105,ND,Williams County,22313,21867,446,2
CN3900100000000,2022-07-01,39,001,OH,Adams County,10980,10381,599,5.5
CN3900300000000,2022-07-01,39,003,OH,Allen County,47379,45370,2009,4.2
CN3900500000000,2022-07-01,39,005,OH,Ashland County,26217,25210,1007,3.8
CN3900700000000,2022-07-01,39,007,OH,Ashtabula County,43765,41841,1924,4.4
CN3900900000000,2022-07-01,39,009,OH,Athens County,24001,22585,1416,5.9
CN3901100000000,2022-07-01,39,011,OH,Auglaize County,24325,23516,809,3.3
CN3901300000000,2022-07-01,39,013,OH,Belmont County,27116,25719,1397,5.2
CN3901500000000,2022-07-01,39,015,OH,Brown County,19666,18724,942,4.8
CN3901700000000,2022-07-01,39,017,OH,Butler County,199859,191781,8078,4
CN3901900000000,2022-07-01,39,019,OH,Carroll County,12708,12152,556,4.4
CN3902100000000,2022-07-01,39,021,OH,Champaign County,19392,18602,790,4.1
CN3902300000000,2022-07-01,39,023,OH,Clark County,63102,60176,2926,4.6
CN3902500000000,2022-07-01,39,025,OH,Clermont County,109498,105087,4411,4
CN3902700000000,2022-07-01,39,027,OH,Clinton County,17961,17139,822,4.6
CN3902900000000,2022-07-01,39,029,OH,Columbiana County,45110,42811,2299,5.1
CN3903100000000,2022-07-01,39,031,OH,Coshocton County,13844,13111,733,5.3
CN3903300000000,2022-07-01,39,033,OH,Crawford County,18093,17069,1024,5.7
CN3903500000000,2022-07-01,39,035,OH,Cuyahoga County,613608,582217,31391,5.1
CN3903700000000,2022-07-01,39,037,OH,Darke County,25547,24595,952,3.7
CN3903900000000,2022-07-01,39,039,OH,Defiance County,17503,16748,755,4.3
CN3904100000000,2022-07-01,39,041,OH,Delaware County,117197,113334,3863,3.3
CN3904300000000,2022-07-01,39,043,OH,Erie County,39364,37519,1845,4.7
CN3904500000000,2022-07-01,39,045,OH,Fairfield County,81525,78344,3181,3.9
CN3904700000000,2022-07-01,39,047,OH,Fayette County,13753,13196,557,4.1
CN3904900000000,2022-07-01,39,049,OH,Franklin County,719413,692574,26839,3.7
CN3905100000000,2022-07-01,39,051,OH,Fulton County,21690,20710,980,4.5
CN3905300000000,2022-07-01,39,053,OH,Gallia County,11769,11155,614,5.2
CN3905500000000,2022-07-01,39,055,OH,Geauga County,49199,47173,2026,4.1
CN3905700000000,2022-07-01,39,057,OH,Greene County,82882,79603,3279,4
CN3905900000000,2022-07-01,39,059,OH,Guernsey County,18019,17147,872,4.8
CN3906100000000,2022-07-01,39,061,OH,Hamilton County,423139,405979,17160,4.1
CN3906300000000,2022-07-01,39,063,OH,Hancock County,40441,39043,1398,3.5
CN3906500000000,2022-07-01,39,065,OH,Hardin County,12786,12146,640,5
CN3906700000000,2022-07-01,39,067,OH,Harrison County,6501,6195,306,4.7
CN3906900000000,2022-07-01,39,069,OH,Henry County,12766,12194,572,4.5
CN3907100000000,2022-07-01,39,071,OH,Highland County,17451,16602,849,4.9
CN3907300000000,2022-07-01,39,073,OH,Hocking County,13116,12562,554,4.2
CN3907500000000,2022-07-01,39,075,OH,Holmes County,21958,21315,643,2.9
CN3907700000000,2022-07-01,39,077,OH,Huron County,28657,27094,1563,5.5
CN3907900000000,2022-07-01,39,079,OH,Jackson County,12324,11687,637,5.2
CN3908100000000,2022-07-01,39,081,OH,Jefferson County,27269,25651,1618,5.9
CN3908300000000,2022-07-01,39,083,OH,Knox County,30801,29621,1180,3.8
CN3908500000000,2022-07-01,39,085,OH,Lake County,127324,121729,5595,4.4
CN3908700000000,2022-07-01,39,087,OH,Lawrence County,23315,22085,1230,5.3
CN3908900000000,2022-07-01,39,089,OH,Licking County,93365,89769,3596,3.9
CN3909100000000,2022-07-01,39,091,OH,Logan County,22860,22037,823,3.6
CN3909300000000,2022-07-01,39,093,OH,Lorain County,157572,149114,8458,5.4
CN3909500000000,2022-07-01,39,095,OH,Lucas County,203227,193831,9396,4.6
CN3909700000000,2022-07-01,39,097,OH,Madison County,21226,20491,735,3.5
CN3909900000000,2022-07-01,39,099,OH,Mahoning County,98694,93705,4989,5.1
CN3910100000000,2022-07-01,39,101,OH,Marion County,28026,26099,1927,6.9
CN3910300000000,2022-07-01,39,103,OH,Medina County,99731,95572,4159,4.2
CN3910500000000,2022-07-01,39,105,OH,Meigs County,8428,7905,523,6.2
CN3910700000000,2022-07-01,39,107,OH,Mercer County,23117,22465,652,2.8
CN3910900000000,2022-07-01,39,109,OH,Miami County,53765,51775,1990,3.7
CN3911100000000,2022-07-01,39,111,OH,Monroe County,5188,4871,317,6.1
CN3911300000000,2022-07-01,39,113,OH,Montgomery County,248200,237047,11153,4.5
CN3911500000000,2022-07-01,39,115,OH,Morgan County,6838,6504,334,4.9
CN3911700000000,2022-07-01,39,117,OH,Morrow County,17261,16518,743,4.3
CN3911900000000,2022-07-01,39,119,OH,Muskingum County,40943,39219,1724,4.2
CN3912100000000,2022-07-01,39,121,OH,Noble County,4658,4384,274,5.9
CN3912300000000,2022-07-01,39,123,OH,Ottawa County,21924,20991,933,4.3
CN3912500000000,2022-07-01,39,125,OH,Paulding County,8755,8426,329,3.8
CN3912700000000,2022-07-01,39,127,OH,Perry County,16159,15426,733,4.5
CN3912900000000,2022-07-01,39,129,OH,Pickaway County,27123,26081,1042,3.8
CN3913100000000,2022-07-01,39,131,OH,Pike County,11186,10618,568,5.1
CN3913300000000,2022-07-01,39,133,OH,Portage County,85285,81827,3458,4.1
CN3913500000000,2022-07-01,39,135,OH,Preble County,22062,21264,798,3.6
CN3913700000000,2022-07-01,39,137,OH,Putnam County,19066,18482,584,3.1
CN3913900000000,2022-07-01,39,139,OH,Richland County,51096,48624,2472,4.8
CN3914100000000,2022-07-01,39,141,OH,Ross County,35562,34189,1373,3.9
CN3914300000000,2022-07-01,39,143,OH,Sandusky County,30243,28751,1492,4.9
CN3914500000000,2022-07-01,39,145,OH,Scioto County,29246,27690,1556,5.3
CN3914700000000,2022-07-01,39,147,OH,Seneca County,26519,25314,1205,4.5
CN3914900000000,2022-07-01,39,149,OH,Shelby County,23807,22917,890,3.7
CN3915100000000,2022-07-01,39,151,OH,Stark County,183077,175472,7605,4.2
CN3915300000000,2022-07-01,39,153,OH,Summit County,265838,254242,11596,4.4
CN3915500000000,2022-07-01,39,155,OH,Trumbull County,83308,79017,4291,5.2
CN3915700000000,2022-07-01,39,157,OH,Tuscarawas County,45187,43483,1704,3.8
CN3915900000000,2022-07-01,39,159,OH,Union County,30557,29542,1015,3.3
CN3916100000000,2022-07-01,39,161,OH,Van Wert County,14479,13963,516,3.6
CN3916300000000,2022-07-01,39,163,OH,Vinton County,5413,5141,272,5
CN3916500000000,2022-07-01,39,165,OH,Warren County,124053,119556,4497,3.6
CN3916700000000,2022-07-01,39,167,OH,Washington County,26856,25556,1300,4.8
CN3916900000000,2022-07-01,39,169,OH,Wayne County,60123,58087,2036,3.4
CN3917100000000,2022-07-01,39,171,OH,Williams County,18378,17700,678,3.7
CN3917300000000,2022-07-01,39,173,OH,Wood County,69391,66767,2624,3.8
CN3917500000000,2022-07-01,39,175,OH,Wyandot County,13312,12880,432,3.2
CN4000100000000,2022-07-01,40,001,OK,Adair County,8465,8149,316,3.7
CN4000300000000,2022-07-01,40,003,OK,Alfalfa County,2715,2667,48,1.8
CN4000500000000,2022-07-01,40,005,OK,Atoka County,5015,4808,207,4.1
CN4000700000000,2022-07-01,40,007,OK,Beaver County,2695,2643,52,1.9
CN4000900000000,2022-07-01,40,009,OK,Beckham County,10423,10143,280,2.7
CN4001100000000,2022-07-01,40,011,OK,Blaine County,4312,4194,118,2.7
CN4001300000000,2022-07-01,40,013,OK,Bryan County,23226,22564,662,2.9
CN4001500000000,2022-07-01,40,015,OK,Caddo County,11525,11127,398,3.5
CN4001700000000,2022-07-01,40,017,OK,Canadian County,81209,79094,2115,2.6
CN4001900000000,2022-07-01,40,019,OK,Carter County,21280,20515,765,3.6
CN4002100000000,2022-07-01,40,021,OK,Cherokee County,20208,19405,803,4
CN4002300000000,2022-07-01,40,023,OK,Choctaw County,6048,5735,313,5.2
CN4002500000000,2022-07-01,40,025,OK,Cimarron County,1706,1684,22,1.3
CN4002700000000,2022-07-01,40,027,OK,Cleveland County,149015,145103,3912,2.6
CN4002900000000,2022-07-01,40,029,OK,Coal County,2193,2105,88,4
CN4003100000000,2022-07-01,40,031,OK,Comanche County,47992,46197,1795,3.7
CN4003300000000,2022-07-01,40,033,OK,Cotton County,2770,2692,78,2.8
CN4003500000000,2022-07-01,40,035,OK,Craig County,6009,5811,198,3.3
CN4003700000000,2022-07-01,40,037,OK,Creek County,31774,30634,1140,3.6
CN4003900000000,2022-07-01,40,039,OK,Custer County,14967,14543,424,2.8
CN4004100000000,2022-07-01,40,041,OK,Delaware County,20521,19947,574,2.8
CN4004300000000,2022-07-01,40,043,OK,Dewey County,3024,2963,61,2
CN4004500000000,2022-07-01,40,045,OK,Ellis County,2134,2086,48,2.2
CN4004700000000,2022-07-01,40,047,OK,Garfield County,27056,26260,796,2.9
CN4004900000000,2022-07-01,40,049,OK,Garvin County,12485,12115,370,3
CN4005100000000,2022-07-01,40,051,OK,Grady County,27774,27000,774,2.8
CN4005300000000,2022-07-01,40,053,OK,Grant County,2867,2815,52,1.8
CN4005500000000,2022-07-01,40,055,OK,Greer County,1895,1820,75,4
CN4005700000000,2022-07-01,40,057,OK,Harmon County,1258,1227,31,2.5
CN4005900000000,2022-07-01,40,059,OK,Harper County,1874,1837,37,2
CN4006100000000,2022-07-01,40,061,OK,Haskell County,4108,3924,184,4.5
CN4006300000000,2022-07-01,40,063,OK,Hughes County,4964,4761,203,4.1
CN4006500000000,2022-07-01,40,065,OK,Jackson County,10511,10218,293,2.8
CN4006700000000,2022-07-01,40,067,OK,Jefferson County,2446,2355,91,3.7
CN4006900000000,2022-07-01,40,069,OK,Johnston County,3821,3683,138,3.6
CN4007100000000,2022-07-01,40,071,OK,Kay County,18939,18265,674,3.6
CN4007300000000,2022-07-01,40,073,OK,Kingfisher County,9041,8855,186,2.1
CN4007500000000,2022-07-01,40,075,OK,Kiowa County,3720,3594,126,3.4
CN4007700000000,2022-07-01,40,077,OK,Latimer County,3093,2904,189,6.1
CN4007900000000,2022-07-01,40,079,OK,Le Flore County,19765,18985,780,3.9
CN4008100000000,2022-07-01,40,081,OK,Lincoln County,16450,15940,510,3.1
CN4008300000000,2022-07-01,40,083,OK,Logan County,23662,23003,659,2.8
CN4008500000000,2022-07-01,40,085,OK,Love County,5898,5743,155,2.6
CN4008700000000,2022-07-01,40,087,OK,McClain County,21328,20743,585,2.7
CN4008900000000,2022-07-01,40,089,OK,McCurtain County,15858,15179,679,4.3
CN4009100000000,2022-07-01,40,091,OK,McIntosh County,7264,6871,393,5.4
CN4009300000000,2022-07-01,40,093,OK,Major County,3959,3871,88,2.2
CN4009500000000,2022-07-01,40,095,OK,Marshall County,7268,7045,223,3.1
CN4009700000000,2022-07-01,40,097,OK,Mayes County,19476,18823,653,3.4
CN4009900000000,2022-07-01,40,099,OK,Murray County,6105,5905,200,3.3
CN4010100000000,2022-07-01,40,101,OK,Muskogee County,28890,27826,1064,3.7
CN4010300000000,2022-07-01,40,103,OK,Noble County,5833,5699,134,2.3
CN4010500000000,2022-07-01,40,105,OK,Nowata County,4672,4531,141,3
CN4010700000000,2022-07-01,40,107,OK,Okfuskee County,4382,4208,174,4
CN4010900000000,2022-07-01,40,109,OK,Oklahoma County,400360,388232,12128,3
CN4011100000000,2022-07-01,40,111,OK,Okmulgee County,15839,15160,679,4.3
CN4011300000000,2022-07-01,40,113,OK,Osage County,20856,20074,782,3.7
CN4011500000000,2022-07-01,40,115,OK,Ottawa County,15032,14571,461,3.1
CN4011700000000,2022-07-01,40,117,OK,Pawnee County,7511,7225,286,3.8
CN4011900000000,2022-07-01,40,119,OK,Payne County,38815,37625,1190,3.1
CN4012100000000,2022-07-01,40,121,OK,Pittsburg County,15946,15221,725,4.5
CN4012300000000,2022-07-01,40,123,OK,Pontotoc County,18982,18409,573,3
CN4012500000000,2022-07-01,40,125,OK,Pottawatomie County,32667,31448,1219,3.7
CN4012700000000,2022-07-01,40,127,OK,Pushmataha County,4546,4356,190,4.2
CN4012900000000,2022-07-01,40,129,OK,Roger Mills County,1825,1779,46,2.5
CN4013100000000,2022-07-01,40,131,OK,Rogers County,45919,44534,1385,3
CN4013300000000,2022-07-01,40,133,OK,Seminole County,9023,8605,418,4.6
CN4013500000000,2022-07-01,40,135,OK,Sequoyah County,16957,16360,597,3.5
CN4013700000000,2022-07-01,40,137,OK,Stephens County,19204,18605,599,3.1
CN4013900000000,2022-07-01,40,139,OK,Texas County,12409,12166,243,2
CN4014100000000,2022-07-01,40,141,OK,Tillman County,3004,2906,98,3.3
CN4014300000000,2022-07-01,40,143,OK,Tulsa County,328869,318716,10153,3.1
CN4014500000000,2022-07-01,40,145,OK,Wagoner County,39546,38307,1239,3.1
CN4014700000000,2022-07-01,40,147,OK,Washington County,22549,21775,774,3.4
CN4014900000000,2022-07-01,40,149,OK,Washita County,5283,5116,167,3.2
CN4015100000000,2022-07-01,40,151,OK,Woods County,4551,4451,100,2.2
CN4015300000000,2022-07-01,40,153,OK,Woodward County,8763,8500,263,3
CN4100100000000,2022-07-01,41,001,OR,Baker County,7342,7011,331,4.5
CN4100300000000,2022-07-01,41,003,OR,Benton County,47718,45781,1937,4.1
CN4100500000000,2022-07-01,41,005,OR,Clackamas County,228519,219581,8938,3.9
CN4100700000000,2022-07-01,41,007,OR,Clatsop County,20398,19543,855,4.2
CN4100900000000,2022-07-01,41,009,OR,Columbia County,25252,24026,1226,4.9
CN4101100000000,2022-07-01,41,011,OR,Coos County,26549,25079,1470,5.5
CN4101300000000,2022-07-01,41,013,OR,Crook County,11404,10795,609,5.3
CN4101500000000,2022-07-01,41,015,OR,Curry County,9360,8865,495,5.3
CN4101700000000,2022-07-01,41,017,OR,Deschutes County,104100,99823,4277,4.1
CN4101900000000,2022-07-01,41,019,OR,Douglas County,48039,45441,2598,5.4
CN4102100000000,2022-07-01,41,021,OR,Gilliam County,927,890,37,4
CN4102300000000,2022-07-01,41,023,OR,Grant County,3261,3102,159,4.9
CN4102500000000,2022-07-01,41,025,OR,Harney County,3784,3618,166,4.4
CN4102700000000,2022-07-01,41,027,OR,Hood River County,15290,14777,513,3.4
CN4102900000000,2022-07-01,41,029,OR,Jackson County,106873,101621,5252,4.9
CN4103100000000,2022-07-01,41,031,OR,Jefferson County,10281,9720,561,5.5
CN4103300000000,2022-07-01,41,033,OR,Josephine County,36553,34445,2108,5.8
CN4103500000000,2022-07-01,41,035,OR,Klamath County,30276,28493,1783,5.9
CN4103700000000,2022-07-01,41,037,OR,Lake County,3802,3604,198,5.2
CN4103900000000,2022-07-01,41,039,OR,Lane County,182118,173315,8803,4.8
CN4104100000000,2022-07-01,41,041,OR,Lincoln County,21723,20596,1127,5.2
CN4104300000000,2022-07-01,41,043,OR,Linn County,62004,59056,2948,4.8
CN4104500000000,2022-07-01,41,045,OR,Malheur County,12818,12201,617,4.8
CN4104700000000,2022-07-01,41,047,OR,Marion County,172290,164571,7719,4.5
CN4104900000000,2022-07-01,41,049,OR,Morrow County,6086,5817,269,4.4
CN4105100000000,2022-07-01,41,051,OR,Multnomah County,470994,452168,18826,4
CN4105300000000,2022-07-01,41,053,OR,Polk County,42942,41024,1918,4.5
CN4105500000000,2022-07-01,41,055,OR,Sherman County,996,965,31,3.1
CN4105700000000,2022-07-01,41,057,OR,Tillamook County,12475,11921,554,4.4
CN4105900000000,2022-07-01,41,059,OR,Umatilla County,38465,36725,1740,4.5
CN4106100000000,2022-07-01,41,061,OR,Union County,12301,11751,550,4.5
CN4106300000000,2022-07-01,41,063,OR,Wallowa County,3841,3682,159,4.1
CN4106500000000,2022-07-01,41,065,OR,Wasco County,17431,16880,551,3.2
CN4106700000000,2022-07-01,41,067,OR,Washington County,337088,324833,12255,3.6
CN4106900000000,2022-07-01,41,069,OR,Wheeler County,754,730,24,3.2
CN4107100000000,2022-07-01,41,071,OR,Yamhill County,56964,54621,2343,4.1
CN4200100000000,2022-07-01,42,001,PA,Adams County,55254,53020,2234,4
CN4200300000000,2022-07-01,42,003,PA,Allegheny County,638307,608068,30239,4.7
CN4200500000000,2022-07-01,42,005,PA,Armstrong County,31554,29753,1801,5.7
CN4200700000000,2022-07-01,42,007,PA,Beaver County,82850,77926,4924,5.9
CN4200900000000,2022-07-01,42,009,PA,Bedford County,24776,23609,1167,4.7
CN4201100000000,2022-07-01,42,011,PA,Berks County,215909,205469,10440,4.8
CN4201300000000,2022-07-01,42,013,PA,Blair County,59949,56840,3109,5.2
CN4201500000000,2022-07-01,42,015,PA,Bradford County,28708,27351,1357,4.7
CN4201700000000,2022-07-01,42,017,PA,Bucks County,355384,340194,15190,4.3
CN4201900000000,2022-07-01,42,019,PA,Butler County,99923,95222,4701,4.7
CN4202100000000,2022-07-01,42,021,PA,Cambria County,55577,51983,3594,6.5
CN4202300000000,2022-07-01,42,023,PA,Cameron County,1987,1867,120,6
CN4202500000000,2022-07-01,42,025,PA,Carbon County,32782,30915,1867,5.7
CN4202700000000,2022-07-01,42,027,PA,Centre County,75849,72495,3354,4.4
CN4202900000000,2022-07-01,42,029,PA,Chester County,300370,289013,11357,3.8
CN4203100000000,2022-07-01,42,031,PA,Clarion County,16231,15288,943,5.8
CN4203300000000,2022-07-01,42,033,PA,Clearfield County,35430,33419,2011,5.7
CN4203500000000,2022-07-01,42,035,PA,Clinton County,17052,16087,965,5.7
CN4203700000000,2022-07-01,42,037,PA,Columbia County,33999,32252,1747,5.1
CN4203900000000,2022-07-01,42,039,PA,Crawford County,38508,36455,2053,5.3
CN4204100000000,2022-07-01,42,041,PA,Cumberland County,137207,131626,5581,4.1
CN4204300000000,2022-07-01,42,043,PA,Dauphin County,148023,141334,6689,4.5
CN4204500000000,2022-07-01,42,045,PA,Delaware County,302783,288668,14115,4.7
CN4204700000000,2022-07-01,42,047,PA,Elk County,15046,14173,873,5.8
CN4204900000000,2022-07-01,42,049,PA,Erie County,127083,120288,6795,5.3
CN4205100000000,2022-07-01,42,051,PA,Fayette County,55837,52091,3746,6.7
CN4205300000000,2022-07-01,42,053,PA,Forest County,1754,1621,133,7.6
CN4205500000000,2022-07-01,42,055,PA,Franklin County,79212,75823,3389,4.3
CN4205700000000,2022-07-01,42,057,PA,Fulton County,7324,6997,327,4.5
CN4205900000000,2022-07-01,42,059,PA,Greene County,15490,14522,968,6.2
CN4206100000000,2022-07-01,42,061,PA,Huntingdon County,19549,18365,1184,6.1
CN4206300000000,2022-07-01,42,063,PA,Indiana County,36220,33907,2313,6.4
CN4206500000000,2022-07-01,42,065,PA,Jefferson County,19785,18762,1023,5.2
CN4206700000000,2022-07-01,42,067,PA,Juniata County,12596,12004,592,4.7
CN4206900000000,2022-07-01,42,069,PA,Lackawanna County,105842,100191,5651,5.3
CN4207100000000,2022-07-01,42,071,PA,Lancaster County,294873,282625,12248,4.2
CN4207300000000,2022-07-01,42,073,PA,Lawrence County,39692,37463,2229,5.6
CN4207500000000,2022-07-01,42,075,PA,Lebanon County,74140,70881,3259,4.4
CN4207700000000,2022-07-01,42,077,PA,Lehigh County,198198,188694,9504,4.8
CN4207900000000,2022-07-01,42,079,PA,Luzerne County,159087,149923,9164,5.8
CN4208100000000,2022-07-01,42,081,PA,Lycoming County,55292,52442,2850,5.2
CN4208300000000,2022-07-01,42,083,PA,McKean County,17091,16075,1016,5.9
CN4208500000000,2022-07-01,42,085,PA,Mercer County,48481,45689,2792,5.8
CN4208700000000,2022-07-01,42,087,PA,Mifflin County,21328,20207,1121,5.3
CN4208900000000,2022-07-01,42,089,PA,Monroe County,84711,79462,5249,6.2
CN4209100000000,2022-07-01,42,091,PA,Montgomery County,472753,453823,18930,4
CN4209300000000,2022-07-01,42,093,PA,Montour County,9256,8864,392,4.2
CN4209500000000,2022-07-01,42,095,PA,Northampton County,165343,157424,7919,4.8
CN4209700000000,2022-07-01,42,097,PA,Northumberland County,43239,40967,2272,5.3
CN4209900000000,2022-07-01,42,099,PA,Perry County,25184,24111,1073,4.3
CN4210100000000,2022-07-01,42,101,PA,Philadelphia County/city,732119,688480,43639,6
CN4210300000000,2022-07-01,42,103,PA,Pike County,26150,24583,1567,6
CN4210500000000,2022-07-01,42,105,PA,Potter County,7006,6578,428,6.1
CN4210700000000,2022-07-01,42,107,PA,Schuylkill County,67104,63353,3751,5.6
CN4210900000000,2022-07-01,42,109,PA,Snyder County,19936,18955,981,4.9
CN4211100000000,2022-07-01,42,111,PA,Somerset County,32801,30870,1931,5.9
CN4211300000000,2022-07-01,42,113,PA,Sullivan County,2705,2557,148,5.5
CN4211500000000,2022-07-01,42,115,PA,Susquehanna County,20620,19694,926,4.5
CN4211700000000,2022-07-01,42,117,PA,Tioga County,19180,18103,1077,5.6
CN4211900000000,2022-07-01,42,119,PA,Union County,19764,18855,909,4.6
CN4212100000000,2022-07-01,42,121,PA,Venango County,21840,20633,1207,5.5
CN4212300000000,2022-07-01,42,123,PA,Warren County,17930,17033,897,5
CN4212500000000,2022-07-01,42,125,PA,Washington County,106022,100531,5491,5.2
CN4212700000000,2022-07-01,42,127,PA,Wayne County,24668,23464,1204,4.9
CN4212900000000,2022-07-01,42,129,PA,Westmoreland County,177951,168802,9149,5.1
CN4213100000000,2022-07-01,42,131,PA,Wyoming County,13662,12939,723,5.3
CN4213300000000,2022-07-01,42,133,PA,York County,241158,230265,10893,4.5
CN4400100000000,2022-07-01,44,001,RI,Bristol County,26755,25999,756,2.8
CN4400300000000,2022-07-01,44,003,RI,Kent County,94298,91505,2793,3
CN4400500000000,2022-07-01,44,005,RI,Newport County,45322,44117,1205,2.7
CN4400700000000,2022-07-01,44,007,RI,Providence County,337254,324831,12423,3.7
CN4400900000000,2022-07-01,44,009,RI,Washington County,71467,69499,1968,2.8
CN4500100000000,2022-07-01,45,001,SC,Abbeville County,9198,8807,391,4.3
CN4500300000000,2022-07-01,45,003,SC,Aiken County,73104,70752,2352,3.2
CN4500500000000,2022-07-01,45,005,SC,Allendale County,2231,2093,138,6.2
CN4500700000000,2022-07-01,45,007,SC,Anderson County,91797,88880,2917,3.2
CN4500900000000,2022-07-01,45,009,SC,Bamberg County,4411,4148,263,6
CN4501100000000,2022-07-01,45,011,SC,Barnwell County,7536,7182,354,4.7
CN4501300000000,2022-07-01,45,013,SC,Beaufort County,78313,75772,2541,3.2
CN4501500000000,2022-07-01,45,015,SC,Berkeley County,111337,107899,3438,3.1
CN4501700000000,2022-07-01,45,017,SC,Calhoun County,6420,6185,235,3.7
CN4501900000000,2022-07-01,45,019,SC,Charleston County,218461,212281,6180,2.8
CN4502100000000,2022-07-01,45,021,SC,Cherokee County,23240,22223,1017,4.4
CN4502300000000,2022-07-01,45,023,SC,Chester County,13337,12745,592,4.4
CN4502500000000,2022-07-01,45,025,SC,Chesterfield County,21346,20597,749,3.5
CN4502700000000,2022-07-01,45,027,SC,Clarendon County,11426,10939,487,4.3
CN4502900000000,2022-07-01,45,029,SC,Colleton County,15947,15377,570,3.6
CN4503100000000,2022-07-01,45,031,SC,Darlington County,29826,28677,1149,3.9
CN4503300000000,2022-07-01,45,033,SC,Dillon County,12445,11853,592,4.8
CN4503500000000,2022-07-01,45,035,SC,Dorchester County,80741,78357,2384,3
CN4503700000000,2022-07-01,45,037,SC,Edgefield County,10259,9921,338,3.3
CN4503900000000,2022-07-01,45,039,SC,Fairfield County,9221,8785,436,4.7
CN4504100000000,2022-07-01,45,041,SC,Florence County,65984,63713,2271,3.4
CN4504300000000,2022-07-01,45,043,SC,Georgetown County,26869,25863,1006,3.7
CN4504500000000,2022-07-01,45,045,SC,Greenville County,260701,253117,7584,2.9
CN4504700000000,2022-07-01,45,047,SC,Greenwood County,28865,27738,1127,3.9
CN4504900000000,2022-07-01,45,049,SC,Hampton County,7711,7448,263,3.4
CN4505100000000,2022-07-01,45,051,SC,Horry County,156516,150905,5611,3.6
CN4505300000000,2022-07-01,45,053,SC,Jasper County,13481,13045,436,3.2
CN4505500000000,2022-07-01,45,055,SC,Kershaw County,29399,28387,1012,3.4
CN4505700000000,2022-07-01,45,057,SC,Lancaster County,43490,41903,1587,3.6
CN4505900000000,2022-07-01,45,059,SC,Laurens County,30187,29132,1055,3.5
CN4506100000000,2022-07-01,45,061,SC,Lee County,6474,6167,307,4.7
CN4506300000000,2022-07-01,45,063,SC,Lexington County,151211,146974,4237,2.8
CN4506500000000,2022-07-01,45,065,SC,McCormick County,3450,3321,129,3.7
CN4506700000000,2022-07-01,45,067,SC,Marion County,12658,12028,630,5
CN4506900000000,2022-07-01,45,069,SC,Marlboro County,8204,7685,519,6.3
CN4507100000000,2022-07-01,45,071,SC,Newberry County,19070,18510,560,2.9
CN4507300000000,2022-07-01,45,073,SC,Oconee County,33847,32719,1128,3.3
CN4507500000000,2022-07-01,45,075,SC,Orangeburg County,31677,29956,1721,5.4
CN4507700000000,2022-07-01,45,077,SC,Pickens County,58222,56259,1963,3.4
CN4507900000000,2022-07-01,45,079,SC,Richland County,197303,190437,6866,3.5
CN4508100000000,2022-07-01,45,081,SC,Saluda County,8437,8197,240,2.8
CN4508300000000,2022-07-01,45,083,SC,Spartanburg County,153713,148434,5279,3.4
CN4508500000000,2022-07-01,45,085,SC,Sumter County,42078,40442,1636,3.9
CN4508700000000,2022-07-01,45,087,SC,Union County,11234,10606,628,5.6
CN4508900000000,2022-07-01,45,089,SC,Williamsburg County,10866,10320,546,5
CN4509100000000,2022-07-01,45,091,SC,York County,147805,143038,4767,3.2
CN4600300000000,2022-07-01,46,003,SD,Aurora County,1520,1497,23,1.5
CN4600500000000,2022-07-01,46,005,SD,Beadle County,9399,9252,147,1.6
CN4600700000000,2022-07-01,46,007,SD,Bennett County,1083,1049,34,3.1
CN4600900000000,2022-07-01,46,009,SD,Bon Homme County,2924,2879,45,1.5
CN4601100000000,2022-07-01,46,011,SD,Brookings County,18713,18367,346,1.8
CN4601300000000,2022-07-01,46,013,SD,Brown County,20188,19793,395,2
CN4601500000000,2022-07-01,46,015,SD,Brule County,2674,2635,39,1.5
CN4601700000000,2022-07-01,46,017,SD,Buffalo County,776,721,55,7.1
CN4601900000000,2022-07-01,46,019,SD,Butte County,5151,5080,71,1.4
CN4602100000000,2022-07-01,46,021,SD,Campbell County,771,752,19,2.5
CN4602300000000,2022-07-01,46,023,SD,Charles Mix County,3965,3864,101,2.5
CN4602500000000,2022-07-01,46,025,SD,Clark County,1996,1960,36,1.8
CN4602700000000,2022-07-01,46,027,SD,Clay County,6899,6758,141,2
CN4602900000000,2022-07-01,46,029,SD,Codington County,15999,15749,250,1.6
CN4603100000000,2022-07-01,46,031,SD,Corson County,1284,1241,43,3.3
CN4603300000000,2022-07-01,46,033,SD,Custer County,4353,4252,101,2.3
CN4603500000000,2022-07-01,46,035,SD,Davison County,11180,11000,180,1.6
CN4603700000000,2022-07-01,46,037,SD,Day County,2793,2735,58,2.1
CN4603900000000,2022-07-01,46,039,SD,Deuel County,2399,2350,49,2
CN4604100000000,2022-07-01,46,041,SD,Dewey County,2399,2100,299,12.5
CN4604300000000,2022-07-01,46,043,SD,Douglas County,1529,1501,28,1.8
CN4604500000000,2022-07-01,46,045,SD,Edmunds County,2012,1982,30,1.5
CN4604700000000,2022-07-01,46,047,SD,Fall River County,3173,3109,64,2
CN4604900000000,2022-07-01,46,049,SD,Faulk County,1114,1093,21,1.9
CN4605100000000,2022-07-01,46,051,SD,Grant County,4434,4366,68,1.5
CN4605300000000,2022-07-01,46,053,SD,Gregory County,2114,2084,30,1.4
CN4605500000000,2022-07-01,46,055,SD,Haakon County,1090,1075,15,1.4
CN4605700000000,2022-07-01,46,057,SD,Hamlin County,3657,3602,55,1.5
CN4605900000000,2022-07-01,46,059,SD,Hand County,1733,1705,28,1.6
CN4606100000000,2022-07-01,46,061,SD,Hanson County,1795,1765,30,1.7
CN4606300000000,2022-07-01,46,063,SD,Harding County,777,764,13,1.7
CN4606500000000,2022-07-01,46,065,SD,Hughes County,10034,9902,132,1.3
CN4606700000000,2022-07-01,46,067,SD,Hutchinson County,3675,3615,60,1.6
CN4606900000000,2022-07-01,46,069,SD,Hyde County,656,641,15,2.3
CN4607100000000,2022-07-01,46,071,SD,Jackson County,1320,1294,26,2
CN4607300000000,2022-07-01,46,073,SD,Jerauld County,1337,1318,19,1.4
CN4607500000000,2022-07-01,46,075,SD,Jones County,572,563,9,1.6
CN4607700000000,2022-07-01,46,077,SD,Kingsbury County,2748,2705,43,1.6
CN4607900000000,2022-07-01,46,079,SD,Lake County,6708,6561,147,2.2
CN4608100000000,2022-07-01,46,081,SD,Lawrence County,14598,14369,229,1.6
CN4608300000000,2022-07-01,46,083,SD,Lincoln County,38010,37480,530,1.4
CN4608500000000,2022-07-01,46,085,SD,Lyman County,1729,1684,45,2.6
CN4608700000000,2022-07-01,46,087,SD,McCook County,3154,3115,39,1.2
CN4608900000000,2022-07-01,46,089,SD,McPherson County,981,955,26,2.7
CN4609100000000,2022-07-01,46,091,SD,Marshall County,2570,2512,58,2.3
CN4609300000000,2022-07-01,46,093,SD,Meade County,14977,14714,263,1.8
CN4609500000000,2022-07-01,46,095,SD,Mellette County,786,750,36,4.6
CN4609700000000,2022-07-01,46,097,SD,Miner County,1235,1214,21,1.7
CN4609900000000,2022-07-01,46,099,SD,Minnehaha County,117913,116141,1772,1.5
CN4610100000000,2022-07-01,46,101,SD,Moody County,4104,3967,137,3.3
CN4610200000000,2022-07-01,46,102,SD,Oglala Lakota County,3936,3662,274,7
CN4610300000000,2022-07-01,46,103,SD,Pennington County,61695,60661,1034,1.7
CN4610500000000,2022-07-01,46,105,SD,Perkins County,1458,1434,24,1.6
CN4610700000000,2022-07-01,46,107,SD,Potter County,1106,1083,23,2.1
CN4610900000000,2022-07-01,46,109,SD,Roberts County,4523,4395,128,2.8
CN4611100000000,2022-07-01,46,111,SD,Sanborn County,1228,1211,17,1.4
CN4611500000000,2022-07-01,46,115,SD,Spink County,3093,3031,62,2
CN4611700000000,2022-07-01,46,117,SD,Stanley County,1954,1926,28,1.4
CN4611900000000,2022-07-01,46,119,SD,Sully County,831,818,13,1.6
CN4612100000000,2022-07-01,46,121,SD,Todd County,3174,3014,160,5
CN4612300000000,2022-07-01,46,123,SD,Tripp County,3130,3087,43,1.4
CN4612500000000,2022-07-01,46,125,SD,Turner County,4831,4756,75,1.6
CN4612700000000,2022-07-01,46,127,SD,Union County,8675,8500,175,2
CN4612900000000,2022-07-01,46,129,SD,Walworth County,2145,2083,62,2.9
CN4613500000000,2022-07-01,46,135,SD,Yankton County,11913,11725,188,1.6
CN4613700000000,2022-07-01,46,137,SD,Ziebach County,944,891,53,5.6
CN4700100000000,2022-07-01,47,001,TN,Anderson County,35430,34133,1297,3.7
CN4700300000000,2022-07-01,47,003,TN,Bedford County,21699,20870,829,3.8
CN4700500000000,2022-07-01,47,005,TN,Benton County,6720,6428,292,4.3
CN4700700000000,2022-07-01,47,007,TN,Bledsoe County,4312,4058,254,5.9
CN4700900000000,2022-07-01,47,009,TN,Blount County,65817,63611,2206,3.4
CN4701100000000,2022-07-01,47,011,TN,Bradley County,50136,48153,1983,4
CN4701300000000,2022-07-01,47,013,TN,Campbell County,15076,14381,695,4.6
CN4701500000000,2022-07-01,47,015,TN,Cannon County,6921,6675,246,3.6
CN4701700000000,2022-07-01,47,017,TN,Carroll County,11660,11133,527,4.5
CN4701900000000,2022-07-01,47,019,TN,Carter County,23907,22950,957,4
CN4702100000000,2022-07-01,47,021,TN,Cheatham County,22782,22161,621,2.7
CN4702300000000,2022-07-01,47,023,TN,Chester County,8564,8279,285,3.3
CN4702500000000,2022-07-01,47,025,TN,Claiborne County,12778,12190,588,4.6
CN4702700000000,2022-07-01,47,027,TN,Clay County,2755,2612,143,5.2
CN4702900000000,2022-07-01,47,029,TN,Cocke County,14874,14121,753,5.1
CN4703100000000,2022-07-01,47,031,TN,Coffee County,25182,24252,930,3.7
CN4703300000000,2022-07-01,47,033,TN,Crockett County,6897,6658,239,3.5
CN4703500000000,2022-07-01,47,035,TN,Cumberland County,23601,22571,1030,4.4
CN4703700000000,2022-07-01,47,037,TN,Davidson County,414227,402156,12071,2.9
CN4703900000000,2022-07-01,47,039,TN,Decatur County,4500,4292,208,4.6
CN4704100000000,2022-07-01,47,041,TN,DeKalb County,8028,7686,342,4.3
CN4704300000000,2022-07-01,47,043,TN,Dickson County,28025,27150,875,3.1
CN4704500000000,2022-07-01,47,045,TN,Dyer County,16568,15940,628,3.8
CN4704700000000,2022-07-01,47,047,TN,Fayette County,19345,18636,709,3.7
CN4704900000000,2022-07-01,47,049,TN,Fentress County,7729,7400,329,4.3
CN4705100000000,2022-07-01,47,051,TN,Franklin County,19291,18535,756,3.9
CN4705300000000,2022-07-01,47,053,TN,Gibson County,21559,20678,881,4.1
CN4705500000000,2022-07-01,47,055,TN,Giles County,14826,14276,550,3.7
CN4705700000000,2022-07-01,47,057,TN,Grainger County,9827,9405,422,4.3
CN4705900000000,2022-07-01,47,059,TN,Greene County,28684,27414,1270,4.4
CN4706100000000,2022-07-01,47,061,TN,Grundy County,4916,4656,260,5.3
CN4706300000000,2022-07-01,47,063,TN,Hamblen County,28399,27278,1121,3.9
CN4706500000000,2022-07-01,47,065,TN,Hamilton County,183869,177147,6722,3.7
CN4706700000000,2022-07-01,47,067,TN,Hancock County,2229,2124,105,4.7
CN4706900000000,2022-07-01,47,069,TN,Hardeman County,9018,8607,411,4.6
CN4707100000000,2022-07-01,47,071,TN,Hardin County,10094,9636,458,4.5
CN4707300000000,2022-07-01,47,073,TN,Hawkins County,23250,22238,1012,4.4
CN4707500000000,2022-07-01,47,075,TN,Haywood County,7515,7125,390,5.2
CN4707700000000,2022-07-01,47,077,TN,Henderson County,11652,11178,474,4.1
CN4707900000000,2022-07-01,47,079,TN,Henry County,13945,13357,588,4.2
CN4708100000000,2022-07-01,47,081,TN,Hickman County,11836,11479,357,3
CN4708300000000,2022-07-01,47,083,TN,Houston County,3148,2997,151,4.8
CN4708500000000,2022-07-01,47,085,TN,Humphreys County,8639,8320,319,3.7
CN4708700000000,2022-07-01,47,087,TN,Jackson County,4733,4529,204,4.3
CN4708900000000,2022-07-01,47,089,TN,Jefferson County,25201,24252,949,3.8
CN4709100000000,2022-07-01,47,091,TN,Johnson County,7435,7183,252,3.4
CN4709300000000,2022-07-01,47,093,TN,Knox County,251910,243885,8025,3.2
CN4709500000000,2022-07-01,47,095,TN,Lake County,1629,1551,78,4.8
CN4709700000000,2022-07-01,47,097,TN,Lauderdale County,9368,8881,487,5.2
CN4709900000000,2022-07-01,47,099,TN,Lawrence County,19111,18360,751,3.9
CN4710100000000,2022-07-01,47,101,TN,Lewis County,5636,5409,227,4
CN4710300000000,2022-07-01,47,103,TN,Lincoln County,16743,16170,573,3.4
CN4710500000000,2022-07-01,47,105,TN,Loudon County,24506,23637,869,3.5
CN4710700000000,2022-07-01,47,107,TN,McMinn County,21381,20414,967,4.5
CN4710900000000,2022-07-01,47,109,TN,McNairy County,8345,7908,437,5.2
CN4711100000000,2022-07-01,47,111,TN,Macon County,11826,11375,451,3.8
CN4711300000000,2022-07-01,47,113,TN,Madison County,49290,47368,1922,3.9
CN4711500000000,2022-07-01,47,115,TN,Marion County,12384,11834,550,4.4
CN4711700000000,2022-07-01,47,117,TN,Marshall County,15542,14977,565,3.6
CN4711900000000,2022-07-01,47,119,TN,Maury County,53191,51468,1723,3.2
CN4712100000000,2022-07-01,47,121,TN,Meigs County,5156,4871,285,5.5
CN4712300000000,2022-07-01,47,123,TN,Monroe County,21085,20267,818,3.9
CN4712500000000,2022-07-01,47,125,TN,Montgomery County,87595,84029,3566,4.1
CN4712700000000,2022-07-01,47,127,TN,Moore County,3680,3581,99,2.7
CN4712900000000,2022-07-01,47,129,TN,Morgan County,7853,7538,315,4
CN4713100000000,2022-07-01,47,131,TN,Obion County,12903,12299,604,4.7
CN4713300000000,2022-07-01,47,133,TN,Overton County,9946,9583,363,3.6
CN4713500000000,2022-07-01,47,135,TN,Perry County,2750,2607,143,5.2
CN4713700000000,2022-07-01,47,137,TN,Pickett County,2228,2134,94,4.2
CN4713900000000,2022-07-01,47,139,TN,Polk County,7039,6756,283,4
CN4714100000000,2022-07-01,47,141,TN,Putnam County,35130,33831,1299,3.7
CN4714300000000,2022-07-01,47,143,TN,Rhea County,13464,12767,697,5.2
CN4714500000000,2022-07-01,47,145,TN,Roane County,23857,22883,974,4.1
CN4714700000000,2022-07-01,47,147,TN,Robertson County,39510,38201,1309,3.3
CN4714900000000,2022-07-01,47,149,TN,Rutherford County,196104,190385,5719,2.9
CN4715100000000,2022-07-01,47,151,TN,Scott County,8200,7751,449,5.5
CN4715300000000,2022-07-01,47,153,TN,Sequatchie County,6238,5950,288,4.6
CN4715500000000,2022-07-01,47,155,TN,Sevier County,56435,54851,1584,2.8
CN4715700000000,2022-07-01,47,157,TN,Shelby County,440727,418746,21981,5
CN4715900000000,2022-07-01,47,159,TN,Smith County,9825,9508,317,3.2
CN4716100000000,2022-07-01,47,161,TN,Stewart County,5445,5210,235,4.3
CN4716300000000,2022-07-01,47,163,TN,Sullivan County,69039,66378,2661,3.9
CN4716500000000,2022-07-01,47,165,TN,Sumner County,109236,106138,3098,2.8
CN4716700000000,2022-07-01,47,167,TN,Tipton County,27764,26654,1110,4
CN4716900000000,2022-07-01,47,169,TN,Trousdale County,5755,5570,185,3.2
CN4717100000000,2022-07-01,47,171,TN,Unicoi County,7022,6684,338,4.8
CN4717300000000,2022-07-01,47,173,TN,Union County,7952,7608,344,4.3
CN4717500000000,2022-07-01,47,175,TN,Van Buren County,2019,1925,94,4.7
CN4717700000000,2022-07-01,47,177,TN,Warren County,16470,15622,848,5.1
CN4717900000000,2022-07-01,47,179,TN,Washington County,60670,58508,2162,3.6
CN4718100000000,2022-07-01,47,181,TN,Wayne County,6541,6226,315,4.8
CN4718300000000,2022-07-01,47,183,TN,Weakley County,14933,14104,829,5.6
CN4718500000000,2022-07-01,47,185,TN,White County,11882,11425,457,3.8
CN4718700000000,2022-07-01,47,187,TN,Williamson County,138981,135426,3555,2.6
CN4718900000000,2022-07-01,47,189,TN,Wilson County,82240,79923,2317,2.8
CN4800100000000,2022-07-01,48,001,TX,Anderson County,22990,22143,847,3.7
CN4800300000000,2022-07-01,48,003,TX,Andrews County,9495,9199,296,3.1
CN4800500000000,2022-07-01,48,005,TX,Angelina County,36278,34612,1666,4.6
CN4800700000000,2022-07-01,48,007,TX,Aransas County,9374,8877,497,5.3
CN4800900000000,2022-07-01,48,009,TX,Archer County,4060,3920,140,3.4
CN4801100000000,2022-07-01,48,011,TX,Armstrong County,955,929,26,2.7
CN4801300000000,2022-07-01,48,013,TX,Atascosa County,22697,21745,952,4.2
CN4801500000000,2022-07-01,48,015,TX,Austin County,14248,13660,588,4.1
CN4801700000000,2022-07-01,48,017,TX,Bailey County,2566,2447,119,4.6
CN4801900000000,2022-07-01,48,019,TX,Bandera County,10704,10307,397,3.7
CN4802100000000,2022-07-01,48,021,TX,Bastrop County,48585,46851,1734,3.6
CN4802300000000,2022-07-01,48,023,TX,Baylor County,1934,1884,50,2.6
CN4802500000000,2022-07-01,48,025,TX,Bee County,9235,8668,567,6.1
CN4802700000000,2022-07-01,48,027,TX,Bell County,148776,141837,6939,4.7
CN4802900000000,2022-07-01,48,029,TX,Bexar County,978400,940819,37581,3.8
CN4803100000000,2022-07-01,48,031,TX,Blanco County,7281,7070,211,2.9
CN4803300000000,2022-07-01,48,033,TX,Borden County,671,660,11,1.6
CN4803500000000,2022-07-01,48,035,TX,Bosque County,8889,8549,340,3.8
CN4803700000000,2022-07-01,48,037,TX,Bowie County,38354,36518,1836,4.8
CN4803900000000,2022-07-01,48,039,TX,Brazoria County,184427,175867,8560,4.6
CN4804100000000,2022-07-01,48,041,TX,Brazos County,124411,120259,4152,3.3
CN4804300000000,2022-07-01,48,043,TX,Brewster County,4229,4088,141,3.3
CN4804500000000,2022-07-01,48,045,TX,Briscoe County,620,599,21,3.4
CN4804700000000,2022-07-01,48,047,TX,Brooks County,2363,2210,153,6.5
CN4804900000000,2022-07-01,48,049,TX,Brown County,15334,14655,679,4.4
CN4805100000000,2022-07-01,48,051,TX,Burleson County,8645,8320,325,3.8
CN4805300000000,2022-07-01,48,053,TX,Burnet County,26125,25373,752,2.9
CN4805500000000,2022-07-01,48,055,TX,Caldwell County,21471,20662,809,3.8
CN4805700000000,2022-07-01,48,057,TX,Calhoun County,12302,11790,512,4.2
CN4805900000000,2022-07-01,48,059,TX,Callahan County,6305,6073,232,3.7
CN4806100000000,2022-07-01,48,061,TX,Cameron County,178466,168077,10389,5.8
CN4806300000000,2022-07-01,48,063,TX,Camp County,5212,4980,232,4.5
CN4806500000000,2022-07-01,48,065,TX,Carson County,3063,2970,93,3
CN4806700000000,2022-07-01,48,067,TX,Cass County,12042,11446,596,4.9
CN4806900000000,2022-07-01,48,069,TX,Castro County,3514,3408,106,3
CN4807100000000,2022-07-01,48,071,TX,Chambers County,21027,19865,1162,5.5
CN4807300000000,2022-07-01,48,073,TX,Cherokee County,20801,19883,918,4.4
CN4807500000000,2022-07-01,48,075,TX,Childress County,3303,3212,91,2.8
CN4807700000000,2022-07-01,48,077,TX,Clay County,4942,4745,197,4
CN4807900000000,2022-07-01,48,079,TX,Cochran County,1230,1173,57,4.6
CN4808100000000,2022-07-01,48,081,TX,Coke County,1599,1540,59,3.7
CN4808300000000,2022-07-01,48,083,TX,Coleman County,3119,2981,138,4.4
CN4808500000000,2022-07-01,48,085,TX,Collin County,625245,604601,20644,3.3
CN4808700000000,2022-07-01,48,087,TX,Collingsworth County,1154,1113,41,3.6
CN4808900000000,2022-07-01,48,089,TX,Colorado County,10595,10234,361,3.4
CN4809100000000,2022-07-01,48,091,TX,Comal County,82476,79439,3037,3.7
CN4809300000000,2022-07-01,48,093,TX,Comanche County,6396,6173,223,3.5
CN4809500000000,2022-07-01,48,095,TX,Concho County,1418,1376,42,3
CN4809700000000,2022-07-01,48,097,TX,Cooke County,20289,19587,702,3.5
CN4809900000000,2022-07-01,48,099,TX,Coryell County,24595,23449,1146,4.7
CN4810100000000,2022-07-01,48,101,TX,Cottle County,901,877,24,2.7
CN4810300000000,2022-07-01,48,103,TX,Crane County,1663,1582,81,4.9
CN4810500000000,2022-07-01,48,105,TX,Crockett County,1479,1420,59,4
CN4810700000000,2022-07-01,48,107,TX,Crosby County,2536,2419,117,4.6
CN4810900000000,2022-07-01,48,109,TX,Culberson County,1199,1166,33,2.8
CN4811100000000,2022-07-01,48,111,TX,Dallam County,4013,3912,101,2.5
CN4811300000000,2022-07-01,48,113,TX,Dallas County,1420591,1366128,54463,3.8
CN4811500000000,2022-07-01,48,115,TX,Dawson County,4527,4319,208,4.6
CN4811700000000,2022-07-01,48,117,TX,Deaf Smith County,9340,9052,288,3.1
CN4811900000000,2022-07-01,48,119,TX,Delta County,2515,2413,102,4.1
CN4812100000000,2022-07-01,48,121,TX,Denton County,551437,532886,18551,3.4
CN4812300000000,2022-07-01,48,123,TX,DeWitt County,9300,8968,332,3.6
CN4812500000000,2022-07-01,48,125,TX,Dickens County,761,719,42,5.5
CN4812700000000,2022-07-01,48,127,TX,Dimmit County,6200,5937,263,4.2
CN4812900000000,2022-07-01,48,129,TX,Donley County,1496,1434,62,4.1
CN4813100000000,2022-07-01,48,131,TX,Duval County,5112,4881,231,4.5
CN4813300000000,2022-07-01,48,133,TX,Eastland County,6581,6269,312,4.7
CN4813500000000,2022-07-01,48,135,TX,Ector County,83463,80274,3189,3.8
CN4813700000000,2022-07-01,48,137,TX,Edwards County,1222,1188,34,2.8
CN4813900000000,2022-07-01,48,139,TX,Ellis County,103491,99706,3785,3.7
CN4814100000000,2022-07-01,48,141,TX,El Paso County,369821,353880,15941,4.3
CN4814300000000,2022-07-01,48,143,TX,Erath County,20840,20063,777,3.7
CN4814500000000,2022-07-01,48,145,TX,Falls County,6864,6567,297,4.3
CN4814700000000,2022-07-01,48,147,TX,Fannin County,17428,16862,566,3.2
CN4814900000000,2022-07-01,48,149,TX,Fayette County,12027,11590,437,3.6
CN4815100000000,2022-07-01,48,151,TX,Fisher County,1707,1645,62,3.6
CN4815300000000,2022-07-01,48,153,TX,Floyd County,2591,2489,102,3.9
CN4815500000000,2022-07-01,48,155,TX,Foard County,555,537,18,3.2
CN4815700000000,2022-07-01,48,157,TX,Fort Bend County,418452,401598,16854,4
CN4815900000000,2022-07-01,48,159,TX,Franklin County,5381,5205,176,3.3
CN4816100000000,2022-07-01,48,161,TX,Freestone County,6470,6122,348,5.4
CN4816300000000,2022-07-01,48,163,TX,Frio County,9641,9285,356,3.7
CN4816500000000,2022-07-01,48,165,TX,Gaines County,10331,10027,304,2.9
CN4816700000000,2022-07-01,48,167,TX,Galveston County,169246,161533,7713,4.6
CN4816900000000,2022-07-01,48,169,TX,Garza County,2024,1909,115,5.7
CN4817100000000,2022-07-01,48,171,TX,Gillespie County,14769,14384,385,2.6
CN4817300000000,2022-07-01,48,173,TX,Glasscock County,916,892,24,2.6
CN4817500000000,2022-07-01,48,175,TX,Goliad County,3194,3048,146,4.6
CN4817700000000,2022-07-01,48,177,TX,Gonzales County,9732,9415,317,3.3
CN4817900000000,2022-07-01,48,179,TX,Gray County,7809,7448,361,4.6
CN4818100000000,2022-07-01,48,181,TX,Grayson County,66150,63665,2485,3.8
CN4818300000000,2022-07-01,48,183,TX,Gregg County,56687,54178,2509,4.4
CN4818500000000,2022-07-01,48,185,TX,Grimes County,11535,10991,544,4.7
CN4818700000000,2022-07-01,48,187,TX,Guadalupe County,85679,82648,3031,3.5
CN4818900000000,2022-07-01,48,189,TX,Hale County,11742,11092,650,5.5
CN4819100000000,2022-07-01,48,191,TX,Hall County,1155,1108,47,4.1
CN4819300000000,2022-07-01,48,193,TX,Hamilton County,3908,3767,141,3.6
CN4819500000000,2022-07-01,48,195,TX,Hansford County,3246,3174,72,2.2
CN4819700000000,2022-07-01,48,197,TX,Hardeman County,1850,1783,67,3.6
CN4819900000000,2022-07-01,48,199,TX,Hardin County,24710,23382,1328,5.4
CN4820100000000,2022-07-01,48,201,TX,Harris County,2340351,2238174,102177,4.4
CN4820300000000,2022-07-01,48,203,TX,Harrison County,28795,27451,1344,4.7
CN4820500000000,2022-07-01,48,205,TX,Hartley County,2682,2630,52,1.9
CN4820700000000,2022-07-01,48,207,TX,Haskell County,2826,2746,80,2.8
CN4820900000000,2022-07-01,48,209,TX,Hays County,139202,134869,4333,3.1
CN4821100000000,2022-07-01,48,211,TX,Hemphill County,1615,1563,52,3.2
CN4821300000000,2022-07-01,48,213,TX,Henderson County,39344,37805,1539,3.9
CN4821500000000,2022-07-01,48,215,TX,Hidalgo County,370173,344946,25227,6.8
CN4821700000000,2022-07-01,48,217,TX,Hill County,17971,17284,687,3.8
CN4821900000000,2022-07-01,48,219,TX,Hockley County,10751,10341,410,3.8
CN4822100000000,2022-07-01,48,221,TX,Hood County,30082,28938,1144,3.8
CN4822300000000,2022-07-01,48,223,TX,Hopkins County,18309,17703,606,3.3
CN4822500000000,2022-07-01,48,225,TX,Houston County,10670,10277,393,3.7
CN4822700000000,2022-07-01,48,227,TX,Howard County,12999,12297,702,5.4
CN4822900000000,2022-07-01,48,229,TX,Hudspeth County,1949,1871,78,4
CN4823100000000,2022-07-01,48,231,TX,Hunt County,46884,45028,1856,4
CN4823300000000,2022-07-01,48,233,TX,Hutchinson County,8378,8006,372,4.4
CN4823500000000,2022-07-01,48,235,TX,Irion County,809,786,23,2.8
CN4823700000000,2022-07-01,48,237,TX,Jack County,3433,3303,130,3.8
CN4823900000000,2022-07-01,48,239,TX,Jackson County,7219,6956,263,3.6
CN4824100000000,2022-07-01,48,241,TX,Jasper County,12859,12050,809,6.3
CN4824300000000,2022-07-01,48,243,TX,Jeff Davis County,1075,1041,34,3.2
CN4824500000000,2022-07-01,48,245,TX,Jefferson County,100465,93955,6510,6.5
CN4824700000000,2022-07-01,48,247,TX,Jim Hogg County,1764,1671,93,5.3
CN4824900000000,2022-07-01,48,249,TX,Jim Wells County,15389,14458,931,6
CN4825100000000,2022-07-01,48,251,TX,Johnson County,89339,85994,3345,3.7
CN4825300000000,2022-07-01,48,253,TX,Jones County,5923,5640,283,4.8
CN4825500000000,2022-07-01,48,255,TX,Karnes County,6680,6444,236,3.5
CN4825700000000,2022-07-01,48,257,TX,Kaufman County,75173,72189,2984,4
CN4825900000000,2022-07-01,48,259,TX,Kendall County,23983,23205,778,3.2
CN4826100000000,2022-07-01,48,261,TX,Kenedy County,140,132,8,5.7
CN4826300000000,2022-07-01,48,263,TX,Kent County,762,749,13,1.7
CN4826500000000,2022-07-01,48,265,TX,Kerr County,23061,22252,809,3.5
CN4826700000000,2022-07-01,48,267,TX,Kimble County,1947,1884,63,3.2
CN4826900000000,2022-07-01,48,269,TX,King County,524,519,5,1
CN4827100000000,2022-07-01,48,271,TX,Kinney County,1295,1233,62,4.8
CN4827300000000,2022-07-01,48,273,TX,Kleberg County,12833,12186,647,5
CN4827500000000,2022-07-01,48,275,TX,Knox County,1562,1495,67,4.3
CN4827700000000,2022-07-01,48,277,TX,Lamar County,24676,23636,1040,4.2
CN4827900000000,2022-07-01,48,279,TX,Lamb County,5524,5296,228,4.1
CN4828100000000,2022-07-01,48,281,TX,Lampasas County,9444,9082,362,3.8
CN4828300000000,2022-07-01,48,283,TX,La Salle County,4185,4053,132,3.2
CN4828500000000,2022-07-01,48,285,TX,Lavaca County,9282,8970,312,3.4
CN4828700000000,2022-07-01,48,287,TX,Lee County,9062,8729,333,3.7
CN4828900000000,2022-07-01,48,289,TX,Leon County,6199,5876,323,5.2
CN4829100000000,2022-07-01,48,291,TX,Liberty County,35460,33287,2173,6.1
CN4829300000000,2022-07-01,48,293,TX,Limestone County,8461,8071,390,4.6
CN4829500000000,2022-07-01,48,295,TX,Lipscomb County,1486,1440,46,3.1
CN4829700000000,2022-07-01,48,297,TX,Live Oak County,4890,4690,200,4.1
CN4829900000000,2022-07-01,48,299,TX,Llano County,9591,9224,367,3.8
CN4830100000000,2022-07-01,48,301,TX,Loving County,1147,1142,5,0.4
CN4830300000000,2022-07-01,48,303,TX,Lubbock County,163517,157385,6132,3.8
CN4830500000000,2022-07-01,48,305,TX,Lynn County,2979,2864,115,3.9
CN4830700000000,2022-07-01,48,307,TX,McCulloch County,3195,3065,130,4.1
CN4830900000000,2022-07-01,48,309,TX,McLennan County,125854,121019,4835,3.8
CN4831100000000,2022-07-01,48,311,TX,McMullen County,928,910,18,1.9
CN4831300000000,2022-07-01,48,313,TX,Madison County,4796,4572,224,4.7
CN4831500000000,2022-07-01,48,315,TX,Marion County,4212,3988,224,5.3
CN4831700000000,2022-07-01,48,317,TX,Martin County,2874,2786,88,3.1
CN4831900000000,2022-07-01,48,319,TX,Mason County,1914,1852,62,3.2
CN4832100000000,2022-07-01,48,321,TX,Matagorda County,17325,16235,1090,6.3
CN4832300000000,2022-07-01,48,323,TX,Maverick County,23102,21384,1718,7.4
CN4832500000000,2022-07-01,48,325,TX,Medina County,22876,21969,907,4
CN4832700000000,2022-07-01,48,327,TX,Menard County,904,873,31,3.4
CN4832900000000,2022-07-01,48,329,TX,Midland County,106593,103460,3133,2.9
CN4833100000000,2022-07-01,48,331,TX,Milam County,10547,10082,465,4.4
CN4833300000000,2022-07-01,48,333,TX,Mills County,1935,1852,83,4.3
CN4833500000000,2022-07-01,48,335,TX,Mitchell County,2310,2214,96,4.2
CN4833700000000,2022-07-01,48,337,TX,Montague County,9296,8958,338,3.6
CN4833900000000,2022-07-01,48,339,TX,Montgomery County,301951,289958,11993,4
CN4834100000000,2022-07-01,48,341,TX,Moore County,11656,11355,301,2.6
CN4834300000000,2022-07-01,48,343,TX,Morris County,4499,4228,271,6
CN4834500000000,2022-07-01,48,345,TX,Motley County,565,544,21,3.7
CN4834700000000,2022-07-01,48,347,TX,Nacogdoches County,28095,26844,1251,4.5
CN4834900000000,2022-07-01,48,349,TX,Navarro County,23486,22550,936,4
CN4835100000000,2022-07-01,48,351,TX,Newton County,4855,4523,332,6.8
CN4835300000000,2022-07-01,48,353,TX,Nolan County,6771,6511,260,3.8
CN4835500000000,2022-07-01,48,355,TX,Nueces County,164514,156717,7797,4.7
CN4835700000000,2022-07-01,48,357,TX,Ochiltree County,4050,3918,132,3.3
CN4835900000000,2022-07-01,48,359,TX,Oldham County,959,931,28,2.9
CN4836100000000,2022-07-01,48,361,TX,Orange County,34563,32525,2038,5.9
CN4836300000000,2022-07-01,48,363,TX,Palo Pinto County,13307,12805,502,3.8
CN4836500000000,2022-07-01,48,365,TX,Panola County,9588,9123,465,4.8
CN4836700000000,2022-07-01,48,367,TX,Parker County,74849,72366,2483,3.3
CN4836900000000,2022-07-01,48,369,TX,Parmer County,5307,5170,137,2.6
CN4837100000000,2022-07-01,48,371,TX,Pecos County,6447,6200,247,3.8
CN4837300000000,2022-07-01,48,373,TX,Polk County,18620,17573,1047,5.6
CN4837500000000,2022-07-01,48,375,TX,Potter County,54850,53022,1828,3.3
CN4837700000000,2022-07-01,48,377,TX,Presidio County,3160,2952,208,6.6
CN4837900000000,2022-07-01,48,379,TX,Rains County,6461,6230,231,3.6
CN4838100000000,2022-07-01,48,381,TX,Randall County,75821,73590,2231,2.9
CN4838300000000,2022-07-01,48,383,TX,Reagan County,1655,1596,59,3.6
CN4838500000000,2022-07-01,48,385,TX,Real County,1292,1238,54,4.2
CN4838700000000,2022-07-01,48,387,TX,Red River County,5221,4945,276,5.3
CN4838900000000,2022-07-01,48,389,TX,Reeves County,8676,8383,293,3.4
CN4839100000000,2022-07-01,48,391,TX,Refugio County,3030,2882,148,4.9
CN4839300000000,2022-07-01,48,393,TX,Roberts County,414,398,16,3.9
CN4839500000000,2022-07-01,48,395,TX,Robertson County,7837,7501,336,4.3
CN4839700000000,2022-07-01,48,397,TX,Rockwall County,59241,57208,2033,3.4
CN4839900000000,2022-07-01,48,399,TX,Runnels County,4764,4606,158,3.3
CN4840100000000,2022-07-01,48,401,TX,Rusk County,22418,21449,969,4.3
CN4840300000000,2022-07-01,48,403,TX,Sabine County,3926,3651,275,7
CN4840500000000,2022-07-01,48,405,TX,San Augustine County,3131,2947,184,5.9
CN4840700000000,2022-07-01,48,407,TX,San Jacinto County,12065,11459,606,5
CN4840900000000,2022-07-01,48,409,TX,San Patricio County,29465,27658,1807,6.1
CN4841100000000,2022-07-01,48,411,TX,San Saba County,2253,2165,88,3.9
CN4841300000000,2022-07-01,48,413,TX,Schleicher County,1265,1219,46,3.6
CN4841500000000,2022-07-01,48,415,TX,Scurry County,6333,6052,281,4.4
CN4841700000000,2022-07-01,48,417,TX,Shackelford County,1908,1858,50,2.6
CN4841900000000,2022-07-01,48,419,TX,Shelby County,11318,10821,497,4.4
CN4842100000000,2022-07-01,48,421,TX,Sherman County,1433,1394,39,2.7
CN4842300000000,2022-07-01,48,423,TX,Smith County,112409,108125,4284,3.8
CN4842500000000,2022-07-01,48,425,TX,Somervell County,4591,4404,187,4.1
CN4842700000000,2022-07-01,48,427,TX,Starr County,24345,21732,2613,10.7
CN4842900000000,2022-07-01,48,429,TX,Stephens County,4098,3945,153,3.7
CN4843100000000,2022-07-01,48,431,TX,Sterling County,566,548,18,3.2
CN4843300000000,2022-07-01,48,433,TX,Stonewall County,840,819,21,2.5
CN4843500000000,2022-07-01,48,435,TX,Sutton County,1063,1004,59,5.6
CN4843700000000,2022-07-01,48,437,TX,Swisher County,2696,2594,102,3.8
CN4843900000000,2022-07-01,48,439,TX,Tarrant County,1141501,1098619,42882,3.8
CN4844100000000,2022-07-01,48,441,TX,Taylor County,68782,66413,2369,3.4
CN4844300000000,2022-07-01,48,443,TX,Terrell County,409,394,15,3.7
CN4844500000000,2022-07-01,48,445,TX,Terry County,4826,4629,197,4.1
CN4844700000000,2022-07-01,48,447,TX,Throckmorton County,762,738,24,3.1
CN4844900000000,2022-07-01,48,449,TX,Titus County,13921,13302,619,4.4
CN4845100000000,2022-07-01,48,451,TX,Tom Green County,55402,53463,1939,3.5
CN4845300000000,2022-07-01,48,453,TX,Travis County,825956,802109,23847,2.9
CN4845500000000,2022-07-01,48,455,TX,Trinity County,5458,5182,276,5.1
CN4845700000000,2022-07-01,48,457,TX,Tyler County,7321,6890,431,5.9
CN4845900000000,2022-07-01,48,459,TX,Upshur County,17811,17034,777,4.4
CN4846100000000,2022-07-01,48,461,TX,Upton County,2347,2285,62,2.6
CN4846300000000,2022-07-01,48,463,TX,Uvalde County,11575,11034,541,4.7
CN4846500000000,2022-07-01,48,465,TX,Val Verde County,22242,21100,1142,5.1
CN4846700000000,2022-07-01,48,467,TX,Van Zandt County,28315,27294,1021,3.6
CN4846900000000,2022-07-01,48,469,TX,Victoria County,40959,39220,1739,4.2
CN4847100000000,2022-07-01,48,471,TX,Walker County,23801,22607,1194,5
CN4847300000000,2022-07-01,48,473,TX,Waller County,25595,24462,1133,4.4
CN4847500000000,2022-07-01,48,475,TX,Ward County,6314,6082,232,3.7
CN4847700000000,2022-07-01,48,477,TX,Washington County,15495,14825,670,4.3
CN4847900000000,2022-07-01,48,479,TX,Webb County,117219,112379,4840,4.1
CN4848100000000,2022-07-01,48,481,TX,Wharton County,21797,20957,840,3.9
CN4848300000000,2022-07-01,48,483,TX,Wheeler County,2034,1954,80,3.9
CN4848500000000,2022-07-01,48,485,TX,Wichita County,55518,53233,2285,4.1
CN4848700000000,2022-07-01,48,487,TX,Wilbarger County,4778,4541,237,5
CN4848900000000,2022-07-01,48,489,TX,Willacy County,7337,6680,657,9
CN4849100000000,2022-07-01,48,491,TX,Williamson County,365720,354845,10875,3
CN4849300000000,2022-07-01,48,493,TX,Wilson County,26091,25202,889,3.4
CN4849500000000,2022-07-01,48,495,TX,Winkler County,3896,3743,153,3.9
CN4849700000000,2022-07-01,48,497,TX,Wise County,34500,33254,1246,3.6
CN4849900000000,2022-07-01,48,499,TX,Wood County,18396,17559,837,4.5
CN4850100000000,2022-07-01,48,501,TX,Yoakum County,3382,3245,137,4.1
CN4850300000000,2022-07-01,48,503,TX,Young County,8200,7924,276,3.4
CN4850500000000,2022-07-01,48,505,TX,Zapata County,4393,4096,297,6.8
CN4850700000000,2022-07-01,48,507,TX,Zavala County,3415,3103,312,9.1
CN4900100000000,2022-07-01,49,001,UT,Beaver County,2860,2783,77,2.7
CN4900300000000,2022-07-01,49,003,UT,Box Elder County,27967,27378,589,2.1
CN4900500000000,2022-07-01,49,005,UT,Cache County,68742,67377,1365,2
CN4900700000000,2022-07-01,49,007,UT,Carbon County,8443,8138,305,3.6
CN4900900000000,2022-07-01,49,009,UT,Daggett County,503,486,17,3.4
CN4901100000000,2022-07-01,49,011,UT,Davis County,186553,182598,3955,2.1
CN4901300000000,2022-07-01,49,013,UT,Duchesne County,8085,7830,255,3.2
CN4901500000000,2022-07-01,49,015,UT,Emery County,4575,4409,166,3.6
CN4901700000000,2022-07-01,49,017,UT,Garfield County,3370,3243,127,3.8
CN4901900000000,2022-07-01,49,019,UT,Grand County,7558,7390,168,2.2
CN4902100000000,2022-07-01,49,021,UT,Iron County,26830,26175,655,2.4
CN4902300000000,2022-07-01,49,023,UT,Juab County,6328,6204,124,2
CN4902500000000,2022-07-01,49,025,UT,Kane County,4425,4334,91,2.1
CN4902700000000,2022-07-01,49,027,UT,Millard County,6396,6257,139,2.2
CN4902900000000,2022-07-01,49,029,UT,Morgan County,6019,5907,112,1.9
CN4903100000000,2022-07-01,49,031,UT,Piute County,510,493,17,3.3
CN4903300000000,2022-07-01,49,033,UT,Rich County,1617,1592,25,1.5
CN4903500000000,2022-07-01,49,035,UT,Salt Lake County,684055,667976,16079,2.4
CN4903700000000,2022-07-01,49,037,UT,San Juan County,5558,5317,241,4.3
CN4903900000000,2022-07-01,49,039,UT,Sanpete County,13192,12817,375,2.8
CN4904100000000,2022-07-01,49,041,UT,Sevier County,10417,10120,297,2.9
CN4904300000000,2022-07-01,49,043,UT,Summit County,25976,25451,525,2
CN4904500000000,2022-07-01,49,045,UT,Tooele County,38557,37561,996,2.6
CN4904700000000,2022-07-01,49,047,UT,Uintah County,14406,13873,533,3.7
CN4904900000000,2022-07-01,49,049,UT,Utah County,340802,333399,7403,2.2
CN4905100000000,2022-07-01,49,051,UT,Wasatch County,18087,17699,388,2.1
CN4905300000000,2022-07-01,49,053,UT,Washington County,85569,83360,2209,2.6
CN4905500000000,2022-07-01,49,055,UT,Wayne County,1650,1600,50,3
CN4905700000000,2022-07-01,49,057,UT,Weber County,136875,133556,3319,2.4
CN5000100000000,2022-07-01,50,001,VT,Addison County,21392,20911,481,2.2
CN5000300000000,2022-07-01,50,003,VT,Bennington County,17860,17310,550,3.1
CN5000500000000,2022-07-01,50,005,VT,Caledonia County,15010,14553,457,3
CN5000700000000,2022-07-01,50,007,VT,Chittenden County,98615,96496,2119,2.1
CN5000900000000,2022-07-01,50,009,VT,Essex County,2763,2642,121,4.4
CN5001100000000,2022-07-01,50,011,VT,Franklin County,28147,27385,762,2.7
CN5001300000000,2022-07-01,50,013,VT,Grand Isle County,4161,4048,113,2.7
CN5001500000000,2022-07-01,50,015,VT,Lamoille County,14216,13812,404,2.8
CN5001700000000,2022-07-01,50,017,VT,Orange County,16132,15755,377,2.3
CN5001900000000,2022-07-01,50,019,VT,Orleans County,13456,12939,517,3.8
CN5002100000000,2022-07-01,50,021,VT,Rutland County,30543,29503,1040,3.4
CN5002300000000,2022-07-01,50,023,VT,Washington County,34444,33593,851,2.5
CN5002500000000,2022-07-01,50,025,VT,Windham County,21433,20830,603,2.8
CN5002700000000,2022-07-01,50,027,VT,Windsor County,29595,28910,685,2.3
CN5100100000000,2022-07-01,51,001,VA,Accomack County,16489,15967,522,3.2
CN5100300000000,2022-07-01,51,003,VA,Albemarle County,58069,56360,1709,2.9
CN5100500000000,2022-07-01,51,005,VA,Alleghany County,6788,6554,234,3.4
CN5100700000000,2022-07-01,51,007,VA,Amelia County,6466,6260,206,3.2
CN5100900000000,2022-07-01,51,009,VA,Amherst County,14880,14405,475,3.2
CN5101100000000,2022-07-01,51,011,VA,Appomattox County,7205,6958,247,3.4
CN5101300000000,2022-07-01,51,013,VA,Arlington County,158715,155284,3431,2.2
CN5101500000000,2022-07-01,51,015,VA,Augusta County,38495,37426,1069,2.8
CN5101700000000,2022-07-01,51,017,VA,Bath County,2540,2477,63,2.5
CN5101900000000,2022-07-01,51,019,VA,Bedford County,38515,37341,1174,3
CN5102100000000,2022-07-01,51,021,VA,Bland County,2840,2750,90,3.2
CN5102300000000,2022-07-01,51,023,VA,Botetourt County,17839,17345,494,2.8
CN5102500000000,2022-07-01,51,025,VA,Brunswick County,5955,5678,277,4.7
CN5102700000000,2022-07-01,51,027,VA,Buchanan County,6354,6035,319,5
CN5102900000000,2022-07-01,51,029,VA,Buckingham County,6457,6202,255,3.9
CN5103100000000,2022-07-01,51,031,VA,Campbell County,25857,25000,857,3.3
CN5103300000000,2022-07-01,51,033,VA,Caroline County,15659,15140,519,3.3
CN5103500000000,2022-07-01,51,035,VA,Carroll County,12929,12467,462,3.6
CN5103600000000,2022-07-01,51,036,VA,Charles City County,3712,3594,118,3.2
CN5103700000000,2022-07-01,51,037,VA,Charlotte County,5882,5704,178,3
CN5104100000000,2022-07-01,51,041,VA,Chesterfield County,197074,191337,5737,2.9
CN5104300000000,2022-07-01,51,043,VA,Clarke County,7863,7643,220,2.8
CN5104500000000,2022-07-01,51,045,VA,Craig County,2330,2253,77,3.3
CN5104700000000,2022-07-01,51,047,VA,Culpeper County,25898,25143,755,2.9
CN5104900000000,2022-07-01,51,049,VA,Cumberland County,4887,4713,174,3.6
CN5105100000000,2022-07-01,51,051,VA,Dickenson County,4503,4285,218,4.8
CN5105300000000,2022-07-01,51,053,VA,Dinwiddie County,14068,13587,481,3.4
CN5105700000000,2022-07-01,51,057,VA,Essex County,5598,5405,193,3.4
CN5105900000000,2022-07-01,51,059,VA,Fairfax County,645629,628865,16764,2.6
CN5106100000000,2022-07-01,51,061,VA,Fauquier County,38549,37524,1025,2.7
CN5106300000000,2022-07-01,51,063,VA,Floyd County,8448,8237,211,2.5
CN5106500000000,2022-07-01,51,065,VA,Fluvanna County,14154,13758,396,2.8
CN5106700000000,2022-07-01,51,067,VA,Franklin County,26742,25921,821,3.1
CN5106900000000,2022-07-01,51,069,VA,Frederick County,51988,50679,1309,2.5
CN5107100000000,2022-07-01,51,071,VA,Giles County,7994,7725,269,3.4
CN5107300000000,2022-07-01,51,073,VA,Gloucester County,19828,19257,571,2.9
CN5107500000000,2022-07-01,51,075,VA,Goochland County,12031,11688,343,2.9
CN5107700000000,2022-07-01,51,077,VA,Grayson County,7870,7647,223,2.8
CN5107900000000,2022-07-01,51,079,VA,Greene County,10603,10336,267,2.5
CN5108100000000,2022-07-01,51,081,VA,Greensville County,4372,4201,171,3.9
CN5108300000000,2022-07-01,51,083,VA,Halifax County,15520,14871,649,4.2
CN5108500000000,2022-07-01,51,085,VA,Hanover County,61267,59675,1592,2.6
CN5108700000000,2022-07-01,51,087,VA,Henrico County,188678,183104,5574,3
CN5108900000000,2022-07-01,51,089,VA,Henry County,23691,22839,852,3.6
CN5109100000000,2022-07-01,51,091,VA,Highland County,1504,1473,31,2.1
CN5109300000000,2022-07-01,51,093,VA,Isle of Wight County,20018,19419,599,3
CN5109500000000,2022-07-01,51,095,VA,James City County,37428,36279,1149,3.1
CN5109700000000,2022-07-01,51,097,VA,King and Queen County,4058,3942,116,2.9
CN5109900000000,2022-07-01,51,099,VA,King George County,14602,14211,391,2.7
CN5110100000000,2022-07-01,51,101,VA,King William County,9723,9462,261,2.7
CN5110300000000,2022-07-01,51,103,VA,Lancaster County,5621,5448,173,3.1
CN5110500000000,2022-07-01,51,105,VA,Lee County,8121,7794,327,4
CN5110700000000,2022-07-01,51,107,VA,Loudoun County,235613,229643,5970,2.5
CN5110900000000,2022-07-01,51,109,VA,Louisa County,20992,20382,610,2.9
CN5111100000000,2022-07-01,51,111,VA,Lunenburg County,5323,5131,192,3.6
CN5111300000000,2022-07-01,51,113,VA,Madison County,7709,7528,181,2.3
CN5111500000000,2022-07-01,51,115,VA,Mathews County,4142,4018,124,3
CN5111700000000,2022-07-01,51,117,VA,Mecklenburg County,13302,12818,484,3.6
CN5111900000000,2022-07-01,51,119,VA,Middlesex County,5517,5355,162,2.9
CN5112100000000,2022-07-01,51,121,VA,Montgomery County,51035,49432,1603,3.1
CN5112500000000,2022-07-01,51,125,VA,Nelson County,7392,7166,226,3.1
CN5112700000000,2022-07-01,51,127,VA,New Kent County,13467,13143,324,2.4
CN5113100000000,2022-07-01,51,131,VA,Northampton County,6002,5810,192,3.2
CN5113300000000,2022-07-01,51,133,VA,Northumberland County,5701,5501,200,3.5
CN5113500000000,2022-07-01,51,135,VA,Nottoway County,7359,7107,252,3.4
CN5113700000000,2022-07-01,51,137,VA,Orange County,17729,17173,556,3.1
CN5113900000000,2022-07-01,51,139,VA,Page County,12452,12062,390,3.1
CN5114100000000,2022-07-01,51,141,VA,Patrick County,7183,6914,269,3.7
CN5114300000000,2022-07-01,51,143,VA,Pittsylvania County,29750,28670,1080,3.6
CN5114500000000,2022-07-01,51,145,VA,Powhatan County,14908,14509,399,2.7
CN5114700000000,2022-07-01,51,147,VA,Prince Edward County,9986,9519,467,4.7
CN5114900000000,2022-07-01,51,149,VA,Prince George County,15711,15151,560,3.6
CN5115300000000,2022-07-01,51,153,VA,Prince William County,254173,246908,7265,2.9
CN5115500000000,2022-07-01,51,155,VA,Pulaski County,16291,15753,538,3.3
CN5115700000000,2022-07-01,51,157,VA,Rappahannock County,3768,3663,105,2.8
CN5115900000000,2022-07-01,51,159,VA,Richmond County,4096,3983,113,2.8
CN5116100000000,2022-07-01,51,161,VA,Roanoke County,50040,48690,1350,2.7
CN5116300000000,2022-07-01,51,163,VA,Rockbridge County,10986,10648,338,3.1
CN5116500000000,2022-07-01,51,165,VA,Rockingham County,42910,41674,1236,2.9
CN5116700000000,2022-07-01,51,167,VA,Russell County,10888,10473,415,3.8
CN5116900000000,2022-07-01,51,169,VA,Scott County,9252,8930,322,3.5
CN5117100000000,2022-07-01,51,171,VA,Shenandoah County,22345,21693,652,2.9
CN5117300000000,2022-07-01,51,173,VA,Smyth County,13417,12969,448,3.3
CN5117500000000,2022-07-01,51,175,VA,Southampton County,9128,8856,272,3
CN5117700000000,2022-07-01,51,177,VA,Spotsylvania County,70415,68217,2198,3.1
CN5117900000000,2022-07-01,51,179,VA,Stafford County,76791,74468,2323,3
CN5118100000000,2022-07-01,51,181,VA,Surry County,3621,3505,116,3.2
CN5118300000000,2022-07-01,51,183,VA,Sussex County,3892,3725,167,4.3
CN5118500000000,2022-07-01,51,185,VA,Tazewell County,15331,14617,714,4.7
CN5118700000000,2022-07-01,51,187,VA,Warren County,21028,20376,652,3.1
CN5119100000000,2022-07-01,51,191,VA,Washington County,26469,25615,854,3.2
CN5119300000000,2022-07-01,51,193,VA,Westmoreland County,9831,9521,310,3.2
CN5119500000000,2022-07-01,51,195,VA,Wise County,12588,12002,586,4.7
CN5119700000000,2022-07-01,51,197,VA,Wythe County,14276,13822,454,3.2
CN5119900000000,2022-07-01,51,199,VA,York County,33628,32639,989,2.9
CN5151000000000,2022-07-01,51,510,VA,Alexandria city,101953,99476,2477,2.4
CN5152000000000,2022-07-01,51,520,VA,Bristol city,7517,7254,263,3.5
CN5153000000000,2022-07-01,51,530,VA,Buena Vista city,3121,3017,104,3.3
CN5154000000000,2022-07-01,51,540,VA,Charlottesville city,25693,24935,758,3
CN5155000000000,2022-07-01,51,550,VA,Chesapeake city,125782,121833,3949,3.1
CN5157000000000,2022-07-01,51,570,VA,Colonial Heights city,8681,8392,289,3.3
CN5158000000000,2022-07-01,51,580,VA,Covington city,2323,2227,96,4.1
CN5159000000000,2022-07-01,51,590,VA,Danville city,18586,17545,1041,5.6
CN5159500000000,2022-07-01,51,595,VA,Emporia city,2373,2260,113,4.8
CN5160000000000,2022-07-01,51,600,VA,Fairfax city,13026,12705,321,2.5
CN5161000000000,2022-07-01,51,610,VA,Falls Church city,8649,8443,206,2.4
CN5162000000000,2022-07-01,51,620,VA,Franklin city,3464,3315,149,4.3
CN5163000000000,2022-07-01,51,630,VA,Fredericksburg city,14566,14050,516,3.5
CN5164000000000,2022-07-01,51,640,VA,Galax city,2848,2746,102,3.6
CN5165000000000,2022-07-01,51,650,VA,Hampton city,65348,62712,2636,4
CN5166000000000,2022-07-01,51,660,VA,Harrisonburg city,24725,23721,1004,4.1
CN5167000000000,2022-07-01,51,670,VA,Hopewell city,9830,9384,446,4.5
CN5167800000000,2022-07-01,51,678,VA,Lexington city,2168,2061,107,4.9
CN5168000000000,2022-07-01,51,680,VA,Lynchburg city,35886,34303,1583,4.4
CN5168300000000,2022-07-01,51,683,VA,Manassas city,21986,21389,597,2.7
CN5168500000000,2022-07-01,51,685,VA,Manassas Park city,9892,9628,264,2.7
CN5169000000000,2022-07-01,51,690,VA,Martinsville city,5510,5263,247,4.5
CN5170000000000,2022-07-01,51,700,VA,Newport News city,89679,86265,3414,3.8
CN5171000000000,2022-07-01,51,710,VA,Norfolk city,111716,107588,4128,3.7
CN5172000000000,2022-07-01,51,720,VA,Norton city,1570,1501,69,4.4
CN5173000000000,2022-07-01,51,730,VA,Petersburg city,12832,12115,717,5.6
CN5173500000000,2022-07-01,51,735,VA,Poquoson city,6495,6321,174,2.7
CN5174000000000,2022-07-01,51,740,VA,Portsmouth city,44699,42887,1812,4.1
CN5175000000000,2022-07-01,51,750,VA,Radford city,8850,8482,368,4.2
CN5176000000000,2022-07-01,51,760,VA,Richmond city,122795,118485,4310,3.5
CN5177000000000,2022-07-01,51,770,VA,Roanoke city,49241,47578,1663,3.4
CN5177500000000,2022-07-01,51,775,VA,Salem city,12966,12564,402,3.1
CN5179000000000,2022-07-01,51,790,VA,Staunton city,12415,12057,358,2.9
CN5180000000000,2022-07-01,51,800,VA,Suffolk city,46332,44807,1525,3.3
CN5181000000000,2022-07-01,51,810,VA,Virginia Beach city,234791,227871,6920,2.9
CN5182000000000,2022-07-01,51,820,VA,Waynesboro city,10791,10440,351,3.3
CN5183000000000,2022-07-01,51,830,VA,Williamsburg city,6912,6598,314,4.5
CN5184000000000,2022-07-01,51,840,VA,Winchester city,15319,14873,446,2.9
CN5300100000000,2022-07-01,53,001,WA,Adams County,11209,10769,440,3.9
CN5300300000000,2022-07-01,53,003,WA,Asotin County,10620,10236,384,3.6
CN5300500000000,2022-07-01,53,005,WA,Benton County,107862,103175,4687,4.3
CN5300700000000,2022-07-01,53,007,WA,Chelan County,50052,48368,1684,3.4
CN5300900000000,2022-07-01,53,009,WA,Clallam County,28959,27415,1544,5.3
CN5301100000000,2022-07-01,53,011,WA,Clark County,246293,235441,10852,4.4
CN5301300000000,2022-07-01,53,013,WA,Columbia County,1774,1694,80,4.5
CN5301500000000,2022-07-01,53,015,WA,Cowlitz County,48483,45990,2493,5.1
CN5301700000000,2022-07-01,53,017,WA,Douglas County,24146,23229,917,3.8
CN5301900000000,2022-07-01,53,019,WA,Ferry County,2286,2110,176,7.7
CN5302100000000,2022-07-01,53,021,WA,Franklin County,45685,43409,2276,5
CN5302300000000,2022-07-01,53,023,WA,Garfield County,824,777,47,5.7
CN5302500000000,2022-07-01,53,025,WA,Grant County,52694,50323,2371,4.5
CN5302700000000,2022-07-01,53,027,WA,Grays Harbor County,29203,27536,1667,5.7
CN5302900000000,2022-07-01,53,029,WA,Island County,36073,34427,1646,4.6
CN5303100000000,2022-07-01,53,031,WA,Jefferson County,12427,11791,636,5.1
CN5303300000000,2022-07-01,53,033,WA,King County,1323055,1280440,42615,3.2
CN5303500000000,2022-07-01,53,035,WA,Kitsap County,128050,122758,5292,4.1
CN5303700000000,2022-07-01,53,037,WA,Kittitas County,21683,20544,1139,5.3
CN5303900000000,2022-07-01,53,039,WA,Klickitat County,10284,9773,511,5
CN5304100000000,2022-07-01,53,041,WA,Lewis County,34517,32666,1851,5.4
CN5304300000000,2022-07-01,53,043,WA,Lincoln County,4592,4389,203,4.4
CN5304500000000,2022-07-01,53,045,WA,Mason County,25065,23646,1419,5.7
CN5304700000000,2022-07-01,53,047,WA,Okanogan County,20905,19938,967,4.6
CN5304900000000,2022-07-01,53,049,WA,Pacific County,8749,8235,514,5.9
CN5305100000000,2022-07-01,53,051,WA,Pend Oreille County,5040,4752,288,5.7
CN5305300000000,2022-07-01,53,053,WA,Pierce County,447993,427308,20685,4.6
CN5305500000000,2022-07-01,53,055,WA,San Juan County,9571,9264,307,3.2
CN5305700000000,2022-07-01,53,057,WA,Skagit County,62050,59169,2881,4.6
CN5305900000000,2022-07-01,53,059,WA,Skamania County,5477,5221,256,4.7
CN5306100000000,2022-07-01,53,061,WA,Snohomish County,451209,435060,16149,3.6
CN5306300000000,2022-07-01,53,063,WA,Spokane County,258916,247959,10957,4.2
CN5306500000000,2022-07-01,53,065,WA,Stevens County,18786,17760,1026,5.5
CN5306700000000,2022-07-01,53,067,WA,Thurston County,145945,139746,6199,4.2
CN5306900000000,2022-07-01,53,069,WA,Wahkiakum County,1398,1314,84,6
CN5307100000000,2022-07-01,53,071,WA,Walla Walla County,31024,29756,1268,4.1
CN5307300000000,2022-07-01,53,073,WA,Whatcom County,114730,109644,5086,4.4
CN5307500000000,2022-07-01,53,075,WA,Whitman County,20492,19426,1066,5.2
CN5307700000000,2022-07-01,53,077,WA,Yakima County,137837,131156,6681,4.8
CN5400100000000,2022-07-01,54,001,WV,Barbour County,7201,6838,363,5
CN5400300000000,2022-07-01,54,003,WV,Berkeley County,61270,59338,1932,3.2
CN5400500000000,2022-07-01,54,005,WV,Boone County,7190,6838,352,4.9
CN5400700000000,2022-07-01,54,007,WV,Braxton County,5202,4907,295,5.7
CN5400900000000,2022-07-01,54,009,WV,Brooke County,10071,9585,486,4.8
CN5401100000000,2022-07-01,54,011,WV,Cabell County,42052,40425,1627,3.9
CN5401300000000,2022-07-01,54,013,WV,Calhoun County,2361,2206,155,6.6
CN5401500000000,2022-07-01,54,015,WV,Clay County,2992,2815,177,5.9
CN5401700000000,2022-07-01,54,017,WV,Doddridge County,3908,3788,120,3.1
CN5401900000000,2022-07-01,54,019,WV,Fayette County,16144,15383,761,4.7
CN5402100000000,2022-07-01,54,021,WV,Gilmer County,2222,2106,116,5.2
CN5402300000000,2022-07-01,54,023,WV,Grant County,5980,5755,225,3.8
CN5402500000000,2022-07-01,54,025,WV,Greenbrier County,15742,15073,669,4.2
CN5402700000000,2022-07-01,54,027,WV,Hampshire County,11336,10998,338,3
CN5402900000000,2022-07-01,54,029,WV,Hancock County,13325,12631,694,5.2
CN5403100000000,2022-07-01,54,031,WV,Hardy County,5637,5398,239,4.2
CN5403300000000,2022-07-01,54,033,WV,Harrison County,34107,32850,1257,3.7
CN5403500000000,2022-07-01,54,035,WV,Jackson County,11699,11184,515,4.4
CN5403700000000,2022-07-01,54,037,WV,Jefferson County,31419,30560,859,2.7
CN5403900000000,2022-07-01,54,039,WV,Kanawha County,80916,77800,3116,3.9
CN5404100000000,2022-07-01,54,041,WV,Lewis County,6423,6113,310,4.8
CN5404300000000,2022-07-01,54,043,WV,Lincoln County,7151,6779,372,5.2
CN5404500000000,2022-07-01,54,045,WV,Logan County,11257,10721,536,4.8
CN5404700000000,2022-07-01,54,047,WV,McDowell County,4072,3776,296,7.3
CN5404900000000,2022-07-01,54,049,WV,Marion County,25366,24183,1183,4.7
CN5405100000000,2022-07-01,54,051,WV,Marshall County,13171,12558,613,4.7
CN5405300000000,2022-07-01,54,053,WV,Mason County,10242,9767,475,4.6
CN5405500000000,2022-07-01,54,055,WV,Mercer County,20472,19462,1010,4.9
CN5405700000000,2022-07-01,54,057,WV,Mineral County,12585,12085,500,4
CN5405900000000,2022-07-01,54,059,WV,Mingo County,6542,6134,408,6.2
CN5406100000000,2022-07-01,54,061,WV,Monongalia County,55602,53498,2104,3.8
CN5406300000000,2022-07-01,54,063,WV,Monroe County,6188,5835,353,5.7
CN5406500000000,2022-07-01,54,065,WV,Morgan County,8648,8390,258,3
CN5406700000000,2022-07-01,54,067,WV,Nicholas County,9137,8705,432,4.7
CN5406900000000,2022-07-01,54,069,WV,Ohio County,20177,19337,840,4.2
CN5407100000000,2022-07-01,54,071,WV,Pendleton County,3839,3736,103,2.7
CN5407300000000,2022-07-01,54,073,WV,Pleasants County,2658,2525,133,5
CN5407500000000,2022-07-01,54,075,WV,Pocahontas County,3826,3697,129,3.4
CN5407700000000,2022-07-01,54,077,WV,Preston County,15491,14832,659,4.3
CN5407900000000,2022-07-01,54,079,WV,Putnam County,27306,26337,969,3.5
CN5408100000000,2022-07-01,54,081,WV,Raleigh County,30441,29279,1162,3.8
CN5408300000000,2022-07-01,54,083,WV,Randolph County,11763,11234,529,4.5
CN5408500000000,2022-07-01,54,085,WV,Ritchie County,4225,4059,166,3.9
CN5408700000000,2022-07-01,54,087,WV,Roane County,4948,4667,281,5.7
CN5408900000000,2022-07-01,54,089,WV,Summers County,4750,4535,215,4.5
CN5409100000000,2022-07-01,54,091,WV,Taylor County,7985,7665,320,4
CN5409300000000,2022-07-01,54,093,WV,Tucker County,3597,3468,129,3.6
CN5409500000000,2022-07-01,54,095,WV,Tyler County,2873,2696,177,6.2
CN5409700000000,2022-07-01,54,097,WV,Upshur County,9686,9172,514,5.3
CN5409900000000,2022-07-01,54,099,WV,Wayne County,15787,15119,668,4.2
CN5410100000000,2022-07-01,54,101,WV,Webster County,3105,2957,148,4.8
CN5410300000000,2022-07-01,54,103,WV,Wetzel County,6343,6002,341,5.4
CN5410500000000,2022-07-01,54,105,WV,Wirt County,2266,2139,127,5.6
CN5410700000000,2022-07-01,54,107,WV,Wood County,36997,35495,1502,4.1
CN5410900000000,2022-07-01,54,109,WV,Wyoming County,6950,6573,377,5.4
CN5500100000000,2022-07-01,55,001,WI,Adams County,7915,7534,381,4.8
CN5500300000000,2022-07-01,55,003,WI,Ashland County,7781,7451,330,4.2
CN5500500000000,2022-07-01,55,005,WI,Barron County,23494,22797,697,3
CN5500700000000,2022-07-01,55,007,WI,Bayfield County,7578,7232,346,4.6
CN5500900000000,2022-07-01,55,009,WI,Brown County,143042,139007,4035,2.8
CN5501100000000,2022-07-01,55,011,WI,Buffalo County,6130,5893,237,3.9
CN5501300000000,2022-07-01,55,013,WI,Burnett County,7277,6986,291,4
CN5501500000000,2022-07-01,55,015,WI,Calumet County,27796,27079,717,2.6
CN5501700000000,2022-07-01,55,017,WI,Chippewa County,33624,32571,1053,3.1
CN5501900000000,2022-07-01,55,019,WI,Clark County,17447,16985,462,2.6
CN5502100000000,2022-07-01,55,021,WI,Columbia County,32097,31225,872,2.7
CN5502300000000,2022-07-01,55,023,WI,Crawford County,7011,6772,239,3.4
CN5502500000000,2022-07-01,55,025,WI,Dane County,334001,326139,7862,2.4
CN5502700000000,2022-07-01,55,027,WI,Dodge County,48138,46803,1335,2.8
CN5502900000000,2022-07-01,55,029,WI,Door County,16593,16164,429,2.6
CN5503100000000,2022-07-01,55,031,WI,Douglas County,22621,21681,940,4.2
CN5503300000000,2022-07-01,55,033,WI,Dunn County,23087,22364,723,3.1
CN5503500000000,2022-07-01,55,035,WI,Eau Claire County,60088,58464,1624,2.7
CN5503700000000,2022-07-01,55,037,WI,Florence County,2181,2109,72,3.3
CN5503900000000,2022-07-01,55,039,WI,Fond du Lac County,57352,55679,1673,2.9
CN5504100000000,2022-07-01,55,041,WI,Forest County,3845,3682,163,4.2
CN5504300000000,2022-07-01,55,043,WI,Grant County,26133,25393,740,2.8
CN5504500000000,2022-07-01,55,045,WI,Green County,20955,20419,536,2.6
CN5504700000000,2022-07-01,55,047,WI,Green Lake County,9309,9014,295,3.2
CN5504900000000,2022-07-01,55,049,WI,Iowa County,13627,13277,350,2.6
CN5505100000000,2022-07-01,55,051,WI,Iron County,2505,2381,124,5
CN5505300000000,2022-07-01,55,053,WI,Jackson County,9329,8997,332,3.6
CN5505500000000,2022-07-01,55,055,WI,Jefferson County,46428,45136,1292,2.8
CN5505700000000,2022-07-01,55,057,WI,Juneau County,13316,12869,447,3.4
CN5505900000000,2022-07-01,55,059,WI,Kenosha County,91907,88690,3217,3.5
CN5506100000000,2022-07-01,55,061,WI,Kewaunee County,10842,10578,264,2.4
CN5506300000000,2022-07-01,55,063,WI,La Crosse County,65902,64121,1781,2.7
CN5506500000000,2022-07-01,55,065,WI,Lafayette County,9797,9539,258,2.6
CN5506700000000,2022-07-01,55,067,WI,Langlade County,9168,8807,361,3.9
CN5506900000000,2022-07-01,55,069,WI,Lincoln County,14747,14234,513,3.5
CN5507100000000,2022-07-01,55,071,WI,Manitowoc County,40625,39438,1187,2.9
CN5507300000000,2022-07-01,55,073,WI,Marathon County,73725,71685,2040,2.8
CN5507500000000,2022-07-01,55,075,WI,Marinette County,18979,18202,777,4.1
CN5507700000000,2022-07-01,55,077,WI,Marquette County,7630,7366,264,3.5
CN5507800000000,2022-07-01,55,078,WI,Menominee County,1564,1436,128,8.2
CN5507900000000,2022-07-01,55,079,WI,Milwaukee County,466170,446885,19285,4.1
CN5508100000000,2022-07-01,55,081,WI,Monroe County,23345,22665,680,2.9
CN5508300000000,2022-07-01,55,083,WI,Oconto County,20727,20078,649,3.1
CN5508500000000,2022-07-01,55,085,WI,Oneida County,18726,18159,567,3
CN5508700000000,2022-07-01,55,087,WI,Outagamie County,105452,102441,3011,2.9
CN5508900000000,2022-07-01,55,089,WI,Ozaukee County,49335,47946,1389,2.8
CN5509100000000,2022-07-01,55,091,WI,Pepin County,3993,3873,120,3
CN5509300000000,2022-07-01,55,093,WI,Pierce County,24606,23821,785,3.2
CN5509500000000,2022-07-01,55,095,WI,Polk County,24347,23568,779,3.2
CN5509700000000,2022-07-01,55,097,WI,Portage County,37128,35960,1168,3.1
CN5509900000000,2022-07-01,55,099,WI,Price County,6118,5912,206,3.4
CN5510100000000,2022-07-01,55,101,WI,Racine County,100041,96154,3887,3.9
CN5510300000000,2022-07-01,55,103,WI,Richland County,8881,8605,276,3.1
CN5510500000000,2022-07-01,55,105,WI,Rock County,86544,83401,3143,3.6
CN5510700000000,2022-07-01,55,107,WI,Rusk County,6400,6179,221,3.5
CN5510900000000,2022-07-01,55,109,WI,St. Croix County,49983,48501,1482,3
CN5511100000000,2022-07-01,55,111,WI,Sauk County,35377,34384,993,2.8
CN5511300000000,2022-07-01,55,113,WI,Sawyer County,8250,7939,311,3.8
CN5511500000000,2022-07-01,55,115,WI,Shawano County,20599,19966,633,3.1
CN5511700000000,2022-07-01,55,117,WI,Sheboygan County,62633,61007,1626,2.6
CN5511900000000,2022-07-01,55,119,WI,Taylor County,10281,9984,297,2.9
CN5512100000000,2022-07-01,55,121,WI,Trempealeau County,14642,14207,435,3
CN5512300000000,2022-07-01,55,123,WI,Vernon County,14987,14593,394,2.6
CN5512500000000,2022-07-01,55,125,WI,Vilas County,10849,10445,404,3.7
CN5512700000000,2022-07-01,55,127,WI,Walworth County,57939,56144,1795,3.1
CN5512900000000,2022-07-01,55,129,WI,Washburn County,7885,7611,274,3.5
CN5513100000000,2022-07-01,55,131,WI,Washington County,77342,75223,2119,2.7
CN5513300000000,2022-07-01,55,133,WI,Waukesha County,226221,219793,6428,2.8
CN5513500000000,2022-07-01,55,135,WI,Waupaca County,25551,24745,806,3.2
CN5513700000000,2022-07-01,55,137,WI,Waushara County,10914,10541,373,3.4
CN5513900000000,2022-07-01,55,139,WI,Winnebago County,93543,90841,2702,2.9
CN5514100000000,2022-07-01,55,141,WI,Wood County,33491,32265,1226,3.7
CN5600100000000,2022-07-01,56,001,WY,Albany County,20124,19476,648,3.2
CN5600300000000,2022-07-01,56,003,WY,Big Horn County,5492,5284,208,3.8
CN5600500000000,2022-07-01,56,005,WY,Campbell County,22249,21479,770,3.5
CN5600700000000,2022-07-01,56,007,WY,Carbon County,7753,7507,246,3.2
CN5600900000000,2022-07-01,56,009,WY,Converse County,7720,7489,231,3
CN5601100000000,2022-07-01,56,011,WY,Crook County,4202,4096,106,2.5
CN5601300000000,2022-07-01,56,013,WY,Fremont County,18753,17988,765,4.1
CN5601500000000,2022-07-01,56,015,WY,Goshen County,6783,6597,186,2.7
CN5601700000000,2022-07-01,56,017,WY,Hot Springs County,2334,2271,63,2.7
CN5601900000000,2022-07-01,56,019,WY,Johnson County,4504,4371,133,3
CN5602100000000,2022-07-01,56,021,WY,Laramie County,48718,47079,1639,3.4
CN5602300000000,2022-07-01,56,023,WY,Lincoln County,9841,9546,295,3
CN5602500000000,2022-07-01,56,025,WY,Natrona County,39124,37659,1465,3.7
CN5602700000000,2022-07-01,56,027,WY,Niobrara County,1267,1233,34,2.7
CN5602900000000,2022-07-01,56,029,WY,Park County,16958,16452,506,3
CN5603100000000,2022-07-01,56,031,WY,Platte County,4591,4430,161,3.5
CN5603300000000,2022-07-01,56,033,WY,Sheridan County,16597,16084,513,3.1
CN5603500000000,2022-07-01,56,035,WY,Sublette County,4112,3964,148,3.6
CN5603700000000,2022-07-01,56,037,WY,Sweetwater County,18903,18140,763,4
CN5603900000000,2022-07-01,56,039,WY,Teton County,18733,18391,342,1.8
CN5604100000000,2022-07-01,56,041,WY,Uinta County,8759,8445,314,3.6
CN5604300000000,2022-07-01,56,043,WY,Washakie County,3929,3779,150,3.8
CN5604500000000,2022-07-01,56,045,WY,Weston County,3728,3634,94,2.5
CN7200100000000,2022-07-01,72,001,PR,Adjuntas Municipio,4164,3865,299,7.2
CN7200300000000,2022-07-01,72,003,PR,Aguada Municipio,12945,12099,846,6.5
CN7200500000000,2022-07-01,72,005,PR,Aguadilla Municipio,15794,14540,1254,7.9
CN7200700000000,2022-07-01,72,007,PR,Aguas Buenas Municipio,6884,6433,451,6.6
CN7200900000000,2022-07-01,72,009,PR,Aibonito Municipio,6657,6152,505,7.6
CN7201100000000,2022-07-01,72,011,PR,Anasco Municipio,9728,9159,569,5.8
CN7201300000000,2022-07-01,72,013,PR,Arecibo Municipio,24835,23241,1594,6.4
CN7201500000000,2022-07-01,72,015,PR,Arroyo Municipio,4807,4403,404,8.4
CN7201700000000,2022-07-01,72,017,PR,Barceloneta Municipio,6193,5718,475,7.7
CN7201900000000,2022-07-01,72,019,PR,Barranquitas Municipio,7640,7080,560,7.3
CN7202100000000,2022-07-01,72,021,PR,Bayamon Municipio,68081,64994,3087,4.5
CN7202300000000,2022-07-01,72,023,PR,Cabo Rojo Municipio,14547,13614,933,6.4
CN7202500000000,2022-07-01,72,025,PR,Caguas Municipio,50291,47876,2415,4.8
CN7202700000000,2022-07-01,72,027,PR,Camuy Municipio,10083,9376,707,7
CN7202900000000,2022-07-01,72,029,PR,Canovanas Municipio,17094,16351,743,4.3
CN7203100000000,2022-07-01,72,031,PR,Carolina Municipio,64446,61560,2886,4.5
CN7203300000000,2022-07-01,72,033,PR,Catano Municipio,8111,7756,355,4.4
CN7203500000000,2022-07-01,72,035,PR,Cayey Municipio,17061,16208,853,5
CN7203700000000,2022-07-01,72,037,PR,Ceiba Municipio,3748,3523,225,6
CN7203900000000,2022-07-01,72,039,PR,Ciales Municipio,3847,3488,359,9.3
CN7204100000000,2022-07-01,72,041,PR,Cidra Municipio,16272,15511,761,4.7
CN7204300000000,2022-07-01,72,043,PR,Coamo Municipio,10679,9927,752,7
CN7204500000000,2022-07-01,72,045,PR,Comerio Municipio,5141,4771,370,7.2
CN7204700000000,2022-07-01,72,047,PR,Corozal Municipio,9269,8575,694,7.5
CN7204900000000,2022-07-01,72,049,PR,Culebra Municipio,976,960,16,1.6
CN7205100000000,2022-07-01,72,051,PR,Dorado Municipio,14174,13611,563,4
CN7205300000000,2022-07-01,72,053,PR,Fajardo Municipio,11064,10365,699,6.3
CN7205400000000,2022-07-01,72,054,PR,Florida Municipio,3432,3160,272,7.9
CN7205500000000,2022-07-01,72,055,PR,Guanica Municipio,3901,3559,342,8.8
CN7205700000000,2022-07-01,72,057,PR,Guayama Municipio,11352,10524,828,7.3
CN7205900000000,2022-07-01,72,059,PR,Guayanilla Municipio,5075,4662,413,8.1
CN7206100000000,2022-07-01,72,061,PR,Guaynabo Municipio,40037,38905,1132,2.8
CN7206300000000,2022-07-01,72,063,PR,Gurabo Municipio,19883,19031,852,4.3
CN7206500000000,2022-07-01,72,065,PR,Hatillo Municipio,14377,13036,1341,9.3
CN7206700000000,2022-07-01,72,067,PR,Hormigueros Municipio,5776,5423,353,6.1
CN7206900000000,2022-07-01,72,069,PR,Humacao Municipio,18238,17173,1065,5.8
CN7207100000000,2022-07-01,72,071,PR,Isabela Municipio,12935,12044,891,6.9
CN7207300000000,2022-07-01,72,073,PR,Jayuya Municipio,4346,4047,299,6.9
CN7207500000000,2022-07-01,72,075,PR,Juana Diaz Municipio,16222,15180,1042,6.4
CN7207700000000,2022-07-01,72,077,PR,Juncos Municipio,13028,12262,766,5.9
CN7207900000000,2022-07-01,72,079,PR,Lajas Municipio,5374,4867,507,9.4
CN7208100000000,2022-07-01,72,081,PR,Lares Municipio,7405,6506,899,12.1
CN7208300000000,2022-07-01,72,083,PR,Las Marias Municipio,2680,2392,288,10.7
CN7208500000000,2022-07-01,72,085,PR,Las Piedras Municipio,12089,11346,743,6.1
CN7208700000000,2022-07-01,72,087,PR,Loiza Municipio,8685,8223,462,5.3
CN7208900000000,2022-07-01,72,089,PR,Luquillo Municipio,6438,6058,380,5.9
CN7209100000000,2022-07-01,72,091,PR,Manati Municipio,11777,11090,687,5.8
CN7209300000000,2022-07-01,72,093,PR,Maricao Municipio,1990,1811,179,9
CN7209500000000,2022-07-01,72,095,PR,Maunabo Municipio,2934,2662,272,9.3
CN7209700000000,2022-07-01,72,097,PR,Mayaguez Municipio,23031,21409,1622,7
CN7209900000000,2022-07-01,72,099,PR,Moca Municipio,11460,10525,935,8.2
CN7210100000000,2022-07-01,72,101,PR,Morovis Municipio,8497,7881,616,7.2
CN7210300000000,2022-07-01,72,103,PR,Naguabo Municipio,8662,8164,498,5.7
CN7210500000000,2022-07-01,72,105,PR,Naranjito Municipio,7444,6913,531,7.1
CN7210700000000,2022-07-01,72,107,PR,Orocovis Municipio,5100,4660,440,8.6
CN7210900000000,2022-07-01,72,109,PR,Patillas Municipio,4263,3879,384,9
CN7211100000000,2022-07-01,72,111,PR,Penuelas Municipio,5898,5402,496,8.4
CN7211300000000,2022-07-01,72,113,PR,Ponce Municipio,47103,44085,3018,6.4
CN7211500000000,2022-07-01,72,115,PR,Quebradillas Municipio,6403,5850,553,8.6
CN7211700000000,2022-07-01,72,117,PR,Rincon Municipio,4967,4664,303,6.1
CN7211900000000,2022-07-01,72,119,PR,Rio Grande Municipio,17832,16901,931,5.2
CN7212100000000,2022-07-01,72,121,PR,Sabana Grande Municipio,6177,5672,505,8.2
CN7212300000000,2022-07-01,72,123,PR,Salinas Municipio,7177,6585,592,8.2
CN7212500000000,2022-07-01,72,125,PR,San German Municipio,10031,9301,730,7.3
CN7212700000000,2022-07-01,72,127,PR,San Juan Municipio,140362,135008,5354,3.8
CN7212900000000,2022-07-01,72,129,PR,San Lorenzo Municipio,12199,11418,781,6.4
CN7213100000000,2022-07-01,72,131,PR,San Sebastian Municipio,10780,9762,1018,9.4
CN7213300000000,2022-07-01,72,133,PR,Santa Isabel Municipio,8067,7485,582,7.2
CN7213500000000,2022-07-01,72,135,PR,Toa Alta Municipio,29299,28096,1203,4.1
CN7213700000000,2022-07-01,72,137,PR,Toa Baja Municipio,30395,29150,1245,4.1
CN7213900000000,2022-07-01,72,139,PR,Trujillo Alto Municipio,28634,27585,1049,3.7
CN7214100000000,2022-07-01,72,141,PR,Utuado Municipio,7098,6525,573,8.1
CN7214300000000,2022-07-01,72,143,PR,Vega Alta Municipio,10350,9634,716,6.9
CN7214500000000,2022-07-01,72,145,PR,Vega Baja Municipio,13700,12696,1004,7.3
CN7214700000000,2022-07-01,72,147,PR,Vieques Municipio,2636,2500,136,5.2
CN7214900000000,2022-07-01,72,149,PR,Villalba Municipio,7480,6773,707,9.5
CN7215100000000,2022-07-01,72,151,PR,Yabucoa Municipio,8920,8232,688,7.7
CN7215300000000,2022-07-01,72,153,PR,Yauco Municipio,9811,8932,879,9
CN0100100000000,2022-08-01,01,001,AL,Autauga County,27025,26334,691,2.6
CN0100300000000,2022-08-01,01,003,AL,Baldwin County,104243,101517,2726,2.6
CN0100500000000,2022-08-01,01,005,AL,Barbour County,8323,7958,365,4.4
CN0100700000000,2022-08-01,01,007,AL,Bibb County,8783,8522,261,3
CN0100900000000,2022-08-01,01,009,AL,Blount County,25965,25321,644,2.5
CN0101100000000,2022-08-01,01,011,AL,Bullock County,4657,4510,147,3.2
CN0101300000000,2022-08-01,01,013,AL,Butler County,9011,8668,343,3.8
CN0101500000000,2022-08-01,01,015,AL,Calhoun County,46371,44826,1545,3.3
CN0101700000000,2022-08-01,01,017,AL,Chambers County,16011,15541,470,2.9
CN0101900000000,2022-08-01,01,019,AL,Cherokee County,11741,11448,293,2.5
CN0102100000000,2022-08-01,01,021,AL,Chilton County,20387,19876,511,2.5
CN0102300000000,2022-08-01,01,023,AL,Choctaw County,4267,4088,179,4.2
CN0102500000000,2022-08-01,01,025,AL,Clarke County,7687,7262,425,5.5
CN0102700000000,2022-08-01,01,027,AL,Clay County,6178,6020,158,2.6
CN0102900000000,2022-08-01,01,029,AL,Cleburne County,6221,6049,172,2.8
CN0103100000000,2022-08-01,01,031,AL,Coffee County,21909,21271,638,2.9
CN0103300000000,2022-08-01,01,033,AL,Colbert County,23880,23063,817,3.4
CN0103500000000,2022-08-01,01,035,AL,Conecuh County,4297,4122,175,4.1
CN0103700000000,2022-08-01,01,037,AL,Coosa County,4494,4376,118,2.6
CN0103900000000,2022-08-01,01,039,AL,Covington County,15302,14839,463,3
CN0104100000000,2022-08-01,01,041,AL,Crenshaw County,6074,5889,185,3
CN0104300000000,2022-08-01,01,043,AL,Cullman County,39095,38182,913,2.3
CN0104500000000,2022-08-01,01,045,AL,Dale County,21388,20766,622,2.9
CN0104700000000,2022-08-01,01,047,AL,Dallas County,13960,13100,860,6.2
CN0104900000000,2022-08-01,01,049,AL,DeKalb County,31250,30430,820,2.6
CN0105100000000,2022-08-01,01,051,AL,Elmore County,38563,37588,975,2.5
CN0105300000000,2022-08-01,01,053,AL,Escambia County,14363,13863,500,3.5
CN0105500000000,2022-08-01,01,055,AL,Etowah County,39305,38003,1302,3.3
CN0105700000000,2022-08-01,01,057,AL,Fayette County,6456,6259,197,3.1
CN0105900000000,2022-08-01,01,059,AL,Franklin County,14699,14317,382,2.6
CN0106100000000,2022-08-01,01,061,AL,Geneva County,11400,11097,303,2.7
CN0106300000000,2022-08-01,01,063,AL,Greene County,2755,2634,121,4.4
CN0106500000000,2022-08-01,01,065,AL,Hale County,6072,5786,286,4.7
CN0106700000000,2022-08-01,01,067,AL,Henry County,7113,6902,211,3
CN0106900000000,2022-08-01,01,069,AL,Houston County,48257,46838,1419,2.9
CN0107100000000,2022-08-01,01,071,AL,Jackson County,23362,22707,655,2.8
CN0107300000000,2022-08-01,01,073,AL,Jefferson County,324577,315089,9488,2.9
CN0107500000000,2022-08-01,01,075,AL,Lamar County,5760,5609,151,2.6
CN0107700000000,2022-08-01,01,077,AL,Lauderdale County,43039,41721,1318,3.1
CN0107900000000,2022-08-01,01,079,AL,Lawrence County,14847,14433,414,2.8
CN0108100000000,2022-08-01,01,081,AL,Lee County,79934,77714,2220,2.8
CN0108300000000,2022-08-01,01,083,AL,Limestone County,48447,47295,1152,2.4
CN0108500000000,2022-08-01,01,085,AL,Lowndes County,3572,3348,224,6.3
CN0108700000000,2022-08-01,01,087,AL,Macon County,7942,7580,362,4.6
CN0108900000000,2022-08-01,01,089,AL,Madison County,199485,194651,4834,2.4
CN0109100000000,2022-08-01,01,091,AL,Marengo County,7665,7367,298,3.9
CN0109300000000,2022-08-01,01,093,AL,Marion County,13765,13399,366,2.7
CN0109500000000,2022-08-01,01,095,AL,Marshall County,45713,44637,1076,2.4
CN0109700000000,2022-08-01,01,097,AL,Mobile County,193070,185976,7094,3.7
CN0109900000000,2022-08-01,01,099,AL,Monroe County,7224,6889,335,4.6
CN0110100000000,2022-08-01,01,101,AL,Montgomery County,108006,104327,3679,3.4
CN0110300000000,2022-08-01,01,103,AL,Morgan County,61078,59625,1453,2.4
CN0110500000000,2022-08-01,01,105,AL,Perry County,3125,2936,189,6
CN0110700000000,2022-08-01,01,107,AL,Pickens County,7756,7469,287,3.7
CN0110900000000,2022-08-01,01,109,AL,Pike County,16077,15557,520,3.2
CN0111100000000,2022-08-01,01,111,AL,Randolph County,9685,9424,261,2.7
CN0111300000000,2022-08-01,01,113,AL,Russell County,23821,23105,716,3
CN0111500000000,2022-08-01,01,115,AL,St. Clair County,42400,41344,1056,2.5
CN0111700000000,2022-08-01,01,117,AL,Shelby County,121723,119208,2515,2.1
CN0111900000000,2022-08-01,01,119,AL,Sumter County,4670,4488,182,3.9
CN0112100000000,2022-08-01,01,121,AL,Talladega County,36525,35266,1259,3.4
CN0112300000000,2022-08-01,01,123,AL,Tallapoosa County,17746,17145,601,3.4
CN0112500000000,2022-08-01,01,125,AL,Tuscaloosa County,103860,100853,3007,2.9
CN0112700000000,2022-08-01,01,127,AL,Walker County,25730,24923,807,3.1
CN0112900000000,2022-08-01,01,129,AL,Washington County,6588,6330,258,3.9
CN0113100000000,2022-08-01,01,131,AL,Wilcox County,2556,2339,217,8.5
CN0113300000000,2022-08-01,01,133,AL,Winston County,10360,10068,292,2.8
CN0201300000000,2022-08-01,02,013,AK,Aleutians East Borough,3156,3118,38,1.2
CN0201600000000,2022-08-01,02,016,AK,Aleutians West Census Area,4009,3937,72,1.8
CN0202000000000,2022-08-01,02,020,AK,Anchorage Borough/municipality,148816,145000,3816,2.6
CN0205000000000,2022-08-01,02,050,AK,Bethel Census Area,6453,5963,490,7.6
CN0206000000000,2022-08-01,02,060,AK,Bristol Bay Borough,550,538,12,2.2
CN0206300000000,2022-08-01,02,063,AK,Chugach Census Area,4490,4418,72,1.6
CN0206600000000,2022-08-01,02,066,AK,Copper River Census Area,1775,1696,79,4.5
CN0206800000000,2022-08-01,02,068,AK,Denali Borough,1615,1579,36,2.2
CN0207000000000,2022-08-01,02,070,AK,Dillingham Census Area,2004,1927,77,3.8
CN0209000000000,2022-08-01,02,090,AK,Fairbanks North Star Borough,45184,43994,1190,2.6
CN0210000000000,2022-08-01,02,100,AK,Haines Borough,1273,1227,46,3.6
CN0210500000000,2022-08-01,02,105,AK,Hoonah-Angoon Census Area,1581,1545,36,2.3
CN0211000000000,2022-08-01,02,110,AK,Juneau Borough/city,18203,17844,359,2
CN0212200000000,2022-08-01,02,122,AK,Kenai Peninsula Borough,29751,28876,875,2.9
CN0213000000000,2022-08-01,02,130,AK,Ketchikan Gateway Borough,7588,7404,184,2.4
CN0215000000000,2022-08-01,02,150,AK,Kodiak Island Borough,6436,6276,160,2.5
CN0215800000000,2022-08-01,02,158,AK,Kusilvak Census Area,2138,1883,255,11.9
CN0216400000000,2022-08-01,02,164,AK,Lake and Peninsula Borough,742,718,24,3.2
CN0217000000000,2022-08-01,02,170,AK,Matanuska-Susitna Borough,48799,47153,1646,3.4
CN0218000000000,2022-08-01,02,180,AK,Nome Census Area,4022,3792,230,5.7
CN0218500000000,2022-08-01,02,185,AK,North Slope Borough,2879,2757,122,4.2
CN0218800000000,2022-08-01,02,188,AK,Northwest Arctic Borough,2700,2497,203,7.5
CN0219500000000,2022-08-01,02,195,AK,Petersburg Borough,1522,1463,59,3.9
CN0219800000000,2022-08-01,02,198,AK,Prince of Wales-Hyder Census Area,2647,2532,115,4.3
CN0222000000000,2022-08-01,02,220,AK,Sitka Borough/city,5326,5238,88,1.7
CN0223000000000,2022-08-01,02,230,AK,Skagway Municipality,941,920,21,2.2
CN0224000000000,2022-08-01,02,240,AK,Southeast Fairbanks Census Area,3207,3090,117,3.6
CN0227500000000,2022-08-01,02,275,AK,Wrangell Borough/city,858,829,29,3.4
CN0228200000000,2022-08-01,02,282,AK,Yakutat Borough/city,354,342,12,3.4
CN0229000000000,2022-08-01,02,290,AK,Yukon-Koyukuk Census Area,2311,2184,127,5.5
CN0400100000000,2022-08-01,04,001,AZ,Apache County,19604,17939,1665,8.5
CN0400300000000,2022-08-01,04,003,AZ,Cochise County,48839,46365,2474,5.1
CN0400500000000,2022-08-01,04,005,AZ,Coconino County,73725,70108,3617,4.9
CN0400700000000,2022-08-01,04,007,AZ,Gila County,20932,19966,966,4.6
CN0400900000000,2022-08-01,04,009,AZ,Graham County,16190,15531,659,4.1
CN0401100000000,2022-08-01,04,011,AZ,Greenlee County,4907,4752,155,3.2
CN0401200000000,2022-08-01,04,012,AZ,La Paz County,8771,8280,491,5.6
CN0401300000000,2022-08-01,04,013,AZ,Maricopa County,2390270,2299327,90943,3.8
CN0401500000000,2022-08-01,04,015,AZ,Mohave County,90869,86216,4653,5.1
CN0401700000000,2022-08-01,04,017,AZ,Navajo County,40547,38244,2303,5.7
CN0401900000000,2022-08-01,04,019,AZ,Pima County,491927,470789,21138,4.3
CN0402100000000,2022-08-01,04,021,AZ,Pinal County,199452,190556,8896,4.5
CN0402300000000,2022-08-01,04,023,AZ,Santa Cruz County,18818,16802,2016,10.7
CN0402500000000,2022-08-01,04,025,AZ,Yavapai County,108975,104717,4258,3.9
CN0402700000000,2022-08-01,04,027,AZ,Yuma County,101382,83230,18152,17.9
CN0500100000000,2022-08-01,05,001,AR,Arkansas County,9597,9301,296,3.1
CN0500300000000,2022-08-01,05,003,AR,Ashley County,6865,6474,391,5.7
CN0500500000000,2022-08-01,05,005,AR,Baxter County,16457,15822,635,3.9
CN0500700000000,2022-08-01,05,007,AR,Benton County,152201,148360,3841,2.5
CN0500900000000,2022-08-01,05,009,AR,Boone County,15686,15181,505,3.2
CN0501100000000,2022-08-01,05,011,AR,Bradley County,4164,3912,252,6.1
CN0501300000000,2022-08-01,05,013,AR,Calhoun County,2371,2295,76,3.2
CN0501500000000,2022-08-01,05,015,AR,Carroll County,12897,12528,369,2.9
CN0501700000000,2022-08-01,05,017,AR,Chicot County,3060,2863,197,6.4
CN0501900000000,2022-08-01,05,019,AR,Clark County,8551,8103,448,5.2
CN0502100000000,2022-08-01,05,021,AR,Clay County,5568,5357,211,3.8
CN0502300000000,2022-08-01,05,023,AR,Cleburne County,9044,8659,385,4.3
CN0502500000000,2022-08-01,05,025,AR,Cleveland County,3120,2997,123,3.9
CN0502700000000,2022-08-01,05,027,AR,Columbia County,8704,8302,402,4.6
CN0502900000000,2022-08-01,05,029,AR,Conway County,8378,8048,330,3.9
CN0503100000000,2022-08-01,05,031,AR,Craighead County,57581,55842,1739,3
CN0503300000000,2022-08-01,05,033,AR,Crawford County,26337,25457,880,3.3
CN0503500000000,2022-08-01,05,035,AR,Crittenden County,20866,19887,979,4.7
CN0503700000000,2022-08-01,05,037,AR,Cross County,7063,6784,279,4
CN0503900000000,2022-08-01,05,039,AR,Dallas County,2713,2590,123,4.5
CN0504100000000,2022-08-01,05,041,AR,Desha County,5037,4763,274,5.4
CN0504300000000,2022-08-01,05,043,AR,Drew County,7636,7277,359,4.7
CN0504500000000,2022-08-01,05,045,AR,Faulkner County,63234,61216,2018,3.2
CN0504700000000,2022-08-01,05,047,AR,Franklin County,7535,7265,270,3.6
CN0504900000000,2022-08-01,05,049,AR,Fulton County,4878,4700,178,3.6
CN0505100000000,2022-08-01,05,051,AR,Garland County,42501,40792,1709,4
CN0505300000000,2022-08-01,05,053,AR,Grant County,8493,8209,284,3.3
CN0505500000000,2022-08-01,05,055,AR,Greene County,19819,19176,643,3.2
CN0505700000000,2022-08-01,05,057,AR,Hempstead County,9271,8956,315,3.4
CN0505900000000,2022-08-01,05,059,AR,Hot Spring County,13844,13302,542,3.9
CN0506100000000,2022-08-01,05,061,AR,Howard County,5342,5143,199,3.7
CN0506300000000,2022-08-01,05,063,AR,Independence County,16453,15860,593,3.6
CN0506500000000,2022-08-01,05,065,AR,Izard County,4602,4343,259,5.6
CN0506700000000,2022-08-01,05,067,AR,Jackson County,5637,5348,289,5.1
CN0506900000000,2022-08-01,05,069,AR,Jefferson County,25640,24188,1452,5.7
CN0507100000000,2022-08-01,05,071,AR,Johnson County,9869,9410,459,4.7
CN0507300000000,2022-08-01,05,073,AR,Lafayette County,2281,2179,102,4.5
CN0507500000000,2022-08-01,05,075,AR,Lawrence County,6835,6580,255,3.7
CN0507700000000,2022-08-01,05,077,AR,Lee County,2622,2501,121,4.6
CN0507900000000,2022-08-01,05,079,AR,Lincoln County,3759,3584,175,4.7
CN0508100000000,2022-08-01,05,081,AR,Little River County,5201,4990,211,4.1
CN0508300000000,2022-08-01,05,083,AR,Logan County,8421,8087,334,4
CN0508500000000,2022-08-01,05,085,AR,Lonoke County,34409,33373,1036,3
CN0508700000000,2022-08-01,05,087,AR,Madison County,7930,7738,192,2.4
CN0508900000000,2022-08-01,05,089,AR,Marion County,6337,6097,240,3.8
CN0509100000000,2022-08-01,05,091,AR,Miller County,18792,18029,763,4.1
CN0509300000000,2022-08-01,05,093,AR,Mississippi County,16543,15589,954,5.8
CN0509500000000,2022-08-01,05,095,AR,Monroe County,2622,2515,107,4.1
CN0509700000000,2022-08-01,05,097,AR,Montgomery County,3012,2867,145,4.8
CN0509900000000,2022-08-01,05,099,AR,Nevada County,3397,3257,140,4.1
CN0510100000000,2022-08-01,05,101,AR,Newton County,3187,3092,95,3
CN0510300000000,2022-08-01,05,103,AR,Ouachita County,9530,9161,369,3.9
CN0510500000000,2022-08-01,05,105,AR,Perry County,4252,4096,156,3.7
CN0510700000000,2022-08-01,05,107,AR,Phillips County,5639,5261,378,6.7
CN0510900000000,2022-08-01,05,109,AR,Pike County,4119,3977,142,3.4
CN0511100000000,2022-08-01,05,111,AR,Poinsett County,10077,9710,367,3.6
CN0511300000000,2022-08-01,05,113,AR,Polk County,8041,7745,296,3.7
CN0511500000000,2022-08-01,05,115,AR,Pope County,27877,26663,1214,4.4
CN0511700000000,2022-08-01,05,117,AR,Prairie County,3607,3500,107,3
CN0511900000000,2022-08-01,05,119,AR,Pulaski County,189427,182457,6970,3.7
CN0512100000000,2022-08-01,05,121,AR,Randolph County,7253,6998,255,3.5
CN0512300000000,2022-08-01,05,123,AR,St. Francis County,7628,7224,404,5.3
CN0512500000000,2022-08-01,05,125,AR,Saline County,59951,58215,1736,2.9
CN0512700000000,2022-08-01,05,127,AR,Scott County,4379,4251,128,2.9
CN0512900000000,2022-08-01,05,129,AR,Searcy County,2965,2829,136,4.6
CN0513100000000,2022-08-01,05,131,AR,Sebastian County,55262,53454,1808,3.3
CN0513300000000,2022-08-01,05,133,AR,Sevier County,5568,5339,229,4.1
CN0513500000000,2022-08-01,05,135,AR,Sharp County,5754,5506,248,4.3
CN0513700000000,2022-08-01,05,137,AR,Stone County,4760,4568,192,4
CN0513900000000,2022-08-01,05,139,AR,Union County,14809,14065,744,5
CN0514100000000,2022-08-01,05,141,AR,Van Buren County,5973,5708,265,4.4
CN0514300000000,2022-08-01,05,143,AR,Washington County,134562,131237,3325,2.5
CN0514500000000,2022-08-01,05,145,AR,White County,34200,32973,1227,3.6
CN0514700000000,2022-08-01,05,147,AR,Woodruff County,2872,2766,106,3.7
CN0514900000000,2022-08-01,05,149,AR,Yell County,8063,7733,330,4.1
CN0600100000000,2022-08-01,06,001,CA,Alameda County,827555,800155,27400,3.3
CN0600300000000,2022-08-01,06,003,CA,Alpine County,453,428,25,5.5
CN0600500000000,2022-08-01,06,005,CA,Amador County,14373,13775,598,4.2
CN0600700000000,2022-08-01,06,007,CA,Butte County,90948,86977,3971,4.4
CN0600900000000,2022-08-01,06,009,CA,Calaveras County,22552,21764,788,3.5
CN0601100000000,2022-08-01,06,011,CA,Colusa County,10529,9702,827,7.9
CN0601300000000,2022-08-01,06,013,CA,Contra Costa County,552709,533292,19417,3.5
CN0601500000000,2022-08-01,06,015,CA,Del Norte County,9551,9080,471,4.9
CN0601700000000,2022-08-01,06,017,CA,El Dorado County,93915,90882,3033,3.2
CN0601900000000,2022-08-01,06,019,CA,Fresno County,454353,428064,26289,5.8
CN0602100000000,2022-08-01,06,021,CA,Glenn County,12965,12289,676,5.2
CN0602300000000,2022-08-01,06,023,CA,Humboldt County,58403,55982,2421,4.1
CN0602500000000,2022-08-01,06,025,CA,Imperial County,71527,59395,12132,17
CN0602700000000,2022-08-01,06,027,CA,Inyo County,8296,8008,288,3.5
CN0602900000000,2022-08-01,06,029,CA,Kern County,397201,371459,25742,6.5
CN0603100000000,2022-08-01,06,031,CA,Kings County,56661,53191,3470,6.1
CN0603300000000,2022-08-01,06,033,CA,Lake County,28598,27308,1290,4.5
CN0603500000000,2022-08-01,06,035,CA,Lassen County,8741,8366,375,4.3
CN0603700000000,2022-08-01,06,037,CA,Los Angeles County,4927912,4697244,230668,4.7
CN0603900000000,2022-08-01,06,039,CA,Madera County,64318,60813,3505,5.4
CN0604100000000,2022-08-01,06,041,CA,Marin County,132440,128836,3604,2.7
CN0604300000000,2022-08-01,06,043,CA,Mariposa County,7845,7549,296,3.8
CN0604500000000,2022-08-01,06,045,CA,Mendocino County,37379,35938,1441,3.9
CN0604700000000,2022-08-01,06,047,CA,Merced County,115533,107658,7875,6.8
CN0604900000000,2022-08-01,06,049,CA,Modoc County,3272,3128,144,4.4
CN0605100000000,2022-08-01,06,051,CA,Mono County,8944,8629,315,3.5
CN0605300000000,2022-08-01,06,053,CA,Monterey County,229271,219644,9627,4.2
CN0605500000000,2022-08-01,06,055,CA,Napa County,71999,69856,2143,3
CN0605700000000,2022-08-01,06,057,CA,Nevada County,49180,47557,1623,3.3
CN0605900000000,2022-08-01,06,059,CA,Orange County,1588191,1536953,51238,3.2
CN0606100000000,2022-08-01,06,061,CA,Placer County,195250,189211,6039,3.1
CN0606300000000,2022-08-01,06,063,CA,Plumas County,7980,7605,375,4.7
CN0606500000000,2022-08-01,06,065,CA,Riverside County,1147243,1097281,49962,4.4
CN0606700000000,2022-08-01,06,067,CA,Sacramento County,733202,704832,28370,3.9
CN0606900000000,2022-08-01,06,069,CA,San Benito County,32526,31102,1424,4.4
CN0607100000000,2022-08-01,06,071,CA,San Bernardino County,1003647,962087,41560,4.1
CN0607300000000,2022-08-01,06,073,CA,San Diego County,1591557,1536112,55445,3.5
CN0607500000000,2022-08-01,06,075,CA,San Francisco County/city,575857,561137,14720,2.6
CN0607700000000,2022-08-01,06,077,CA,San Joaquin County,345358,328261,17097,5
CN0607900000000,2022-08-01,06,079,CA,San Luis Obispo County,136138,131950,4188,3.1
CN0608100000000,2022-08-01,06,081,CA,San Mateo County,456010,444910,11100,2.4
CN0608300000000,2022-08-01,06,083,CA,Santa Barbara County,223939,216749,7190,3.2
CN0608500000000,2022-08-01,06,085,CA,Santa Clara County,1047414,1019516,27898,2.7
CN0608700000000,2022-08-01,06,087,CA,Santa Cruz County,136615,131248,5367,3.9
CN0608900000000,2022-08-01,06,089,CA,Shasta County,73406,70191,3215,4.4
CN0609100000000,2022-08-01,06,091,CA,Sierra County,1380,1333,47,3.4
CN0609300000000,2022-08-01,06,093,CA,Siskiyou County,16799,15988,811,4.8
CN0609500000000,2022-08-01,06,095,CA,Solano County,202547,194278,8269,4.1
CN0609700000000,2022-08-01,06,097,CA,Sonoma County,250255,242515,7740,3.1
CN0609900000000,2022-08-01,06,099,CA,Stanislaus County,244565,232146,12419,5.1
CN0610100000000,2022-08-01,06,101,CA,Sutter County,47086,44537,2549,5.4
CN0610300000000,2022-08-01,06,103,CA,Tehama County,26210,24978,1232,4.7
CN0610500000000,2022-08-01,06,105,CA,Trinity County,4727,4542,185,3.9
CN0610700000000,2022-08-01,06,107,CA,Tulare County,209078,192415,16663,8
CN0610900000000,2022-08-01,06,109,CA,Tuolumne County,20248,19394,854,4.2
CN0611100000000,2022-08-01,06,111,CA,Ventura County,411362,396024,15338,3.7
CN0611300000000,2022-08-01,06,113,CA,Yolo County,109909,105752,4157,3.8
CN0611500000000,2022-08-01,06,115,CA,Yuba County,31869,30232,1637,5.1
CN0800100000000,2022-08-01,08,001,CO,Adams County,283247,274684,8563,3
CN0800300000000,2022-08-01,08,003,CO,Alamosa County,8254,7980,274,3.3
CN0800500000000,2022-08-01,08,005,CO,Arapahoe County,376658,366068,10590,2.8
CN0800700000000,2022-08-01,08,007,CO,Archuleta County,7156,6964,192,2.7
CN0800900000000,2022-08-01,08,009,CO,Baca County,2122,2087,35,1.6
CN0801100000000,2022-08-01,08,011,CO,Bent County,1852,1793,59,3.2
CN0801300000000,2022-08-01,08,013,CO,Boulder County,200886,196251,4635,2.3
CN0801400000000,2022-08-01,08,014,CO,Broomfield County/city,42721,41681,1040,2.4
CN0801500000000,2022-08-01,08,015,CO,Chaffee County,10153,9917,236,2.3
CN0801700000000,2022-08-01,08,017,CO,Cheyenne County,1074,1054,20,1.9
CN0801900000000,2022-08-01,08,019,CO,Clear Creek County,6193,6017,176,2.8
CN0802100000000,2022-08-01,08,021,CO,Conejos County,4051,3925,126,3.1
CN0802300000000,2022-08-01,08,023,CO,Costilla County,1805,1738,67,3.7
CN0802500000000,2022-08-01,08,025,CO,Crowley County,1383,1333,50,3.6
CN0802700000000,2022-08-01,08,027,CO,Custer County,2376,2316,60,2.5
CN0802900000000,2022-08-01,08,029,CO,Delta County,13457,13022,435,3.2
CN0803100000000,2022-08-01,08,031,CO,Denver County/city,438014,425594,12420,2.8
CN0803300000000,2022-08-01,08,033,CO,Dolores County,1197,1168,29,2.4
CN0803500000000,2022-08-01,08,035,CO,Douglas County,208776,203899,4877,2.3
CN0803700000000,2022-08-01,08,037,CO,Eagle County,34862,34097,765,2.2
CN0803900000000,2022-08-01,08,039,CO,Elbert County,16179,15815,364,2.2
CN0804100000000,2022-08-01,08,041,CO,El Paso County,358651,347753,10898,3
CN0804300000000,2022-08-01,08,043,CO,Fremont County,14623,13996,627,4.3
CN0804500000000,2022-08-01,08,045,CO,Garfield County,31369,30570,799,2.5
CN0804700000000,2022-08-01,08,047,CO,Gilpin County,3943,3846,97,2.5
CN0804900000000,2022-08-01,08,049,CO,Grand County,9405,9183,222,2.4
CN0805100000000,2022-08-01,08,051,CO,Gunnison County,11644,11416,228,2
CN0805300000000,2022-08-01,08,053,CO,Hinsdale County,509,498,11,2.2
CN0805500000000,2022-08-01,08,055,CO,Huerfano County,2517,2368,149,5.9
CN0805700000000,2022-08-01,08,057,CO,Jackson County,1064,1046,18,1.7
CN0805900000000,2022-08-01,08,059,CO,Jefferson County,344426,335615,8811,2.6
CN0806100000000,2022-08-01,08,061,CO,Kiowa County,949,935,14,1.5
CN0806300000000,2022-08-01,08,063,CO,Kit Carson County,4245,4177,68,1.6
CN0806500000000,2022-08-01,08,065,CO,Lake County,4778,4665,113,2.4
CN0806700000000,2022-08-01,08,067,CO,La Plata County,31068,30269,799,2.6
CN0806900000000,2022-08-01,08,069,CO,Larimer County,212080,206840,5240,2.5
CN0807100000000,2022-08-01,08,071,CO,Las Animas County,6033,5756,277,4.6
CN0807300000000,2022-08-01,08,073,CO,Lincoln County,2258,2198,60,2.7
CN0807500000000,2022-08-01,08,075,CO,Logan County,10164,9892,272,2.7
CN0807700000000,2022-08-01,08,077,CO,Mesa County,76992,74675,2317,3
CN0807900000000,2022-08-01,08,079,CO,Mineral County,456,443,13,2.9
CN0808100000000,2022-08-01,08,081,CO,Moffat County,6805,6633,172,2.5
CN0808300000000,2022-08-01,08,083,CO,Montezuma County,12403,12008,395,3.2
CN0808500000000,2022-08-01,08,085,CO,Montrose County,21493,20875,618,2.9
CN0808700000000,2022-08-01,08,087,CO,Morgan County,15565,15102,463,3
CN0808900000000,2022-08-01,08,089,CO,Otero County,7934,7633,301,3.8
CN0809100000000,2022-08-01,08,091,CO,Ouray County,2646,2578,68,2.6
CN0809300000000,2022-08-01,08,093,CO,Park County,11666,11384,282,2.4
CN0809500000000,2022-08-01,08,095,CO,Phillips County,2612,2566,46,1.8
CN0809700000000,2022-08-01,08,097,CO,Pitkin County,10674,10410,264,2.5
CN0809900000000,2022-08-01,08,099,CO,Prowers County,6206,6048,158,2.5
CN0810100000000,2022-08-01,08,101,CO,Pueblo County,75895,72767,3128,4.1
CN0810300000000,2022-08-01,08,103,CO,Rio Blanco County,2869,2768,101,3.5
CN0810500000000,2022-08-01,08,105,CO,Rio Grande County,5515,5293,222,4
CN0810700000000,2022-08-01,08,107,CO,Routt County,15743,15406,337,2.1
CN0810900000000,2022-08-01,08,109,CO,Saguache County,3489,3381,108,3.1
CN0811100000000,2022-08-01,08,111,CO,San Juan County,666,654,12,1.8
CN0811300000000,2022-08-01,08,113,CO,San Miguel County,5904,5778,126,2.1
CN0811500000000,2022-08-01,08,115,CO,Sedgwick County,1119,1094,25,2.2
CN0811700000000,2022-08-01,08,117,CO,Summit County,20742,20304,438,2.1
CN0811900000000,2022-08-01,08,119,CO,Teller County,13373,12998,375,2.8
CN0812100000000,2022-08-01,08,121,CO,Washington County,2821,2763,58,2.1
CN0812300000000,2022-08-01,08,123,CO,Weld County,170522,165488,5034,3
CN0812500000000,2022-08-01,08,125,CO,Yuma County,5816,5709,107,1.8
CN0900100000000,2022-08-01,09,001,CT,Fairfield County,490731,470933,19798,4
CN0900300000000,2022-08-01,09,003,CT,Hartford County,480035,459612,20423,4.3
CN0900500000000,2022-08-01,09,005,CT,Litchfield County,105961,102212,3749,3.5
CN0900700000000,2022-08-01,09,007,CT,Middlesex County,94038,90794,3244,3.4
CN0900900000000,2022-08-01,09,009,CT,New Haven County,470286,450036,20250,4.3
CN0901100000000,2022-08-01,09,011,CT,New London County,136346,130985,5361,3.9
CN0901300000000,2022-08-01,09,013,CT,Tolland County,86630,83442,3188,3.7
CN0901500000000,2022-08-01,09,015,CT,Windham County,64895,62126,2769,4.3
CN1000100000000,2022-08-01,10,001,DE,Kent County,79249,74464,4785,6
CN1000300000000,2022-08-01,10,003,DE,New Castle County,303259,288783,14476,4.8
CN1000500000000,2022-08-01,10,005,DE,Sussex County,115938,111071,4867,4.2
CN1100100000000,2022-08-01,11,001,DC,District of Columbia,391193,373359,17834,4.6
CN1200100000000,2022-08-01,12,001,FL,Alachua County,138889,134790,4099,3
CN1200300000000,2022-08-01,12,003,FL,Baker County,12779,12413,366,2.9
CN1200500000000,2022-08-01,12,005,FL,Bay County,89934,87535,2399,2.7
CN1200700000000,2022-08-01,12,007,FL,Bradford County,11203,10825,378,3.4
CN1200900000000,2022-08-01,12,009,FL,Brevard County,298450,289715,8735,2.9
CN1201100000000,2022-08-01,12,011,FL,Broward County,1073283,1041657,31626,2.9
CN1201300000000,2022-08-01,12,013,FL,Calhoun County,4855,4693,162,3.3
CN1201500000000,2022-08-01,12,015,FL,Charlotte County,76845,74245,2600,3.4
CN1201700000000,2022-08-01,12,017,FL,Citrus County,49701,47543,2158,4.3
CN1201900000000,2022-08-01,12,019,FL,Clay County,114392,111227,3165,2.8
CN1202100000000,2022-08-01,12,021,FL,Collier County,188321,182556,5765,3.1
CN1202300000000,2022-08-01,12,023,FL,Columbia County,29389,28407,982,3.3
CN1202700000000,2022-08-01,12,027,FL,DeSoto County,13838,13368,470,3.4
CN1202900000000,2022-08-01,12,029,FL,Dixie County,5922,5739,183,3.1
CN1203100000000,2022-08-01,12,031,FL,Duval County,518710,501719,16991,3.3
CN1203300000000,2022-08-01,12,033,FL,Escambia County,150566,145918,4648,3.1
CN1203500000000,2022-08-01,12,035,FL,Flagler County,50931,49165,1766,3.5
CN1203700000000,2022-08-01,12,037,FL,Franklin County,4868,4743,125,2.6
CN1203900000000,2022-08-01,12,039,FL,Gadsden County,19068,18304,764,4
CN1204100000000,2022-08-01,12,041,FL,Gilchrist County,7283,7049,234,3.2
CN1204300000000,2022-08-01,12,043,FL,Glades County,5112,4929,183,3.6
CN1204500000000,2022-08-01,12,045,FL,Gulf County,5554,5398,156,2.8
CN1204700000000,2022-08-01,12,047,FL,Hamilton County,4149,3981,168,4
CN1204900000000,2022-08-01,12,049,FL,Hardee County,8765,8379,386,4.4
CN1205100000000,2022-08-01,12,051,FL,Hendry County,15509,14566,943,6.1
CN1205300000000,2022-08-01,12,053,FL,Hernando County,77522,74645,2877,3.7
CN1205500000000,2022-08-01,12,055,FL,Highlands County,36010,34420,1590,4.4
CN1205700000000,2022-08-01,12,057,FL,Hillsborough County,809094,785883,23211,2.9
CN1205900000000,2022-08-01,12,059,FL,Holmes County,7103,6883,220,3.1
CN1206100000000,2022-08-01,12,061,FL,Indian River County,68075,65561,2514,3.7
CN1206300000000,2022-08-01,12,063,FL,Jackson County,16605,16065,540,3.3
CN1206500000000,2022-08-01,12,065,FL,Jefferson County,5736,5527,209,3.6
CN1206700000000,2022-08-01,12,067,FL,Lafayette County,2831,2741,90,3.2
CN1206900000000,2022-08-01,12,069,FL,Lake County,173230,167938,5292,3.1
CN1207100000000,2022-08-01,12,071,FL,Lee County,374686,363610,11076,3
CN1207300000000,2022-08-01,12,073,FL,Leon County,159300,154461,4839,3
CN1207500000000,2022-08-01,12,075,FL,Levy County,17060,16423,637,3.7
CN1207700000000,2022-08-01,12,077,FL,Liberty County,2638,2552,86,3.3
CN1207900000000,2022-08-01,12,079,FL,Madison County,7857,7598,259,3.3
CN1208100000000,2022-08-01,12,081,FL,Manatee County,187201,181564,5637,3
CN1208300000000,2022-08-01,12,083,FL,Marion County,149169,143772,5397,3.6
CN1208500000000,2022-08-01,12,085,FL,Martin County,76515,74303,2212,2.9
CN1208600000000,2022-08-01,12,086,FL,Miami-Dade County,1380890,1340712,40178,2.9
CN1208700000000,2022-08-01,12,087,FL,Monroe County,49297,48375,922,1.9
CN1208900000000,2022-08-01,12,089,FL,Nassau County,45171,43984,1187,2.6
CN1209100000000,2022-08-01,12,091,FL,Okaloosa County,105052,102479,2573,2.4
CN1209300000000,2022-08-01,12,093,FL,Okeechobee County,17847,17276,571,3.2
CN1209500000000,2022-08-01,12,095,FL,Orange County,803230,779863,23367,2.9
CN1209700000000,2022-08-01,12,097,FL,Osceola County,200216,193336,6880,3.4
CN1209900000000,2022-08-01,12,099,FL,Palm Beach County,766384,742520,23864,3.1
CN1210100000000,2022-08-01,12,101,FL,Pasco County,260146,251970,8176,3.1
CN1210300000000,2022-08-01,12,103,FL,Pinellas County,514269,500277,13992,2.7
CN1210500000000,2022-08-01,12,105,FL,Polk County,341248,328732,12516,3.7
CN1210700000000,2022-08-01,12,107,FL,Putnam County,27603,26463,1140,4.1
CN1210900000000,2022-08-01,12,109,FL,St. Johns County,150550,146968,3582,2.4
CN1211100000000,2022-08-01,12,111,FL,St. Lucie County,156573,150886,5687,3.6
CN1211300000000,2022-08-01,12,113,FL,Santa Rosa County,88352,85976,2376,2.7
CN1211500000000,2022-08-01,12,115,FL,Sarasota County,196791,191032,5759,2.9
CN1211700000000,2022-08-01,12,117,FL,Seminole County,267498,260207,7291,2.7
CN1211900000000,2022-08-01,12,119,FL,Sumter County,37781,36177,1604,4.2
CN1212100000000,2022-08-01,12,121,FL,Suwannee County,17680,17091,589,3.3
CN1212300000000,2022-08-01,12,123,FL,Taylor County,8156,7883,273,3.3
CN1212500000000,2022-08-01,12,125,FL,Union County,4547,4405,142,3.1
CN1212700000000,2022-08-01,12,127,FL,Volusia County,268408,259774,8634,3.2
CN1212900000000,2022-08-01,12,129,FL,Wakulla County,15909,15500,409,2.6
CN1213100000000,2022-08-01,12,131,FL,Walton County,35615,34687,928,2.6
CN1213300000000,2022-08-01,12,133,FL,Washington County,9920,9602,318,3.2
CN1300100000000,2022-08-01,13,001,GA,Appling County,9209,8814,395,4.3
CN1300300000000,2022-08-01,13,003,GA,Atkinson County,4324,4190,134,3.1
CN1300500000000,2022-08-01,13,005,GA,Bacon County,4870,4711,159,3.3
CN1300700000000,2022-08-01,13,007,GA,Baker County,1085,1033,52,4.8
CN1300900000000,2022-08-01,13,009,GA,Baldwin County,17622,16819,803,4.6
CN1301100000000,2022-08-01,13,011,GA,Banks County,10688,10419,269,2.5
CN1301300000000,2022-08-01,13,013,GA,Barrow County,42998,41781,1217,2.8
CN1301500000000,2022-08-01,13,015,GA,Bartow County,52162,50522,1640,3.1
CN1301700000000,2022-08-01,13,017,GA,Ben Hill County,5572,5303,269,4.8
CN1301900000000,2022-08-01,13,019,GA,Berrien County,7639,7361,278,3.6
CN1302100000000,2022-08-01,13,021,GA,Bibb County,64954,62258,2696,4.2
CN1302300000000,2022-08-01,13,023,GA,Bleckley County,4471,4239,232,5.2
CN1302500000000,2022-08-01,13,025,GA,Brantley County,7508,7214,294,3.9
CN1302700000000,2022-08-01,13,027,GA,Brooks County,6610,6376,234,3.5
CN1302900000000,2022-08-01,13,029,GA,Bryan County,19990,19415,575,2.9
CN1303100000000,2022-08-01,13,031,GA,Bulloch County,38140,36658,1482,3.9
CN1303300000000,2022-08-01,13,033,GA,Burke County,8900,8405,495,5.6
CN1303500000000,2022-08-01,13,035,GA,Butts County,11300,10953,347,3.1
CN1303700000000,2022-08-01,13,037,GA,Calhoun County,2141,2053,88,4.1
CN1303900000000,2022-08-01,13,039,GA,Camden County,22012,21279,733,3.3
CN1304300000000,2022-08-01,13,043,GA,Candler County,5958,5794,164,2.8
CN1304500000000,2022-08-01,13,045,GA,Carroll County,57300,55326,1974,3.4
CN1304700000000,2022-08-01,13,047,GA,Catoosa County,33209,32232,977,2.9
CN1304900000000,2022-08-01,13,049,GA,Charlton County,5040,4862,178,3.5
CN1305100000000,2022-08-01,13,051,GA,Chatham County,143036,138253,4783,3.3
CN1305300000000,2022-08-01,13,053,GA,Chattahoochee County,1889,1789,100,5.3
CN1305500000000,2022-08-01,13,055,GA,Chattooga County,9152,8736,416,4.5
CN1305700000000,2022-08-01,13,057,GA,Cherokee County,142864,139069,3795,2.7
CN1305900000000,2022-08-01,13,059,GA,Clarke County,57458,55249,2209,3.8
CN1306100000000,2022-08-01,13,061,GA,Clay County,805,744,61,7.6
CN1306300000000,2022-08-01,13,063,GA,Clayton County,139817,133987,5830,4.2
CN1306500000000,2022-08-01,13,065,GA,Clinch County,2886,2795,91,3.2
CN1306700000000,2022-08-01,13,067,GA,Cobb County,431563,419135,12428,2.9
CN1306900000000,2022-08-01,13,069,GA,Coffee County,18790,18092,698,3.7
CN1307100000000,2022-08-01,13,071,GA,Colquitt County,21601,20885,716,3.3
CN1307300000000,2022-08-01,13,073,GA,Columbia County,75550,73112,2438,3.2
CN1307500000000,2022-08-01,13,075,GA,Cook County,8216,7934,282,3.4
CN1307700000000,2022-08-01,13,077,GA,Coweta County,77632,75309,2323,3
CN1307900000000,2022-08-01,13,079,GA,Crawford County,5319,5125,194,3.6
CN1308100000000,2022-08-01,13,081,GA,Crisp County,9659,9181,478,4.9
CN1308300000000,2022-08-01,13,083,GA,Dade County,8079,7848,231,2.9
CN1308500000000,2022-08-01,13,085,GA,Dawson County,13454,13087,367,2.7
CN1308700000000,2022-08-01,13,087,GA,Decatur County,11648,11208,440,3.8
CN1308900000000,2022-08-01,13,089,GA,DeKalb County,404773,391099,13674,3.4
CN1309100000000,2022-08-01,13,091,GA,Dodge County,6926,6647,279,4
CN1309300000000,2022-08-01,13,093,GA,Dooly County,4719,4487,232,4.9
CN1309500000000,2022-08-01,13,095,GA,Dougherty County,36197,34326,1871,5.2
CN1309700000000,2022-08-01,13,097,GA,Douglas County,75130,72444,2686,3.6
CN1309900000000,2022-08-01,13,099,GA,Early County,4317,4143,174,4
CN1310100000000,2022-08-01,13,101,GA,Echols County,1819,1767,52,2.9
CN1310300000000,2022-08-01,13,103,GA,Effingham County,33320,32382,938,2.8
CN1310500000000,2022-08-01,13,105,GA,Elbert County,7731,7421,310,4
CN1310700000000,2022-08-01,13,107,GA,Emanuel County,8570,8172,398,4.6
CN1310900000000,2022-08-01,13,109,GA,Evans County,5028,4850,178,3.5
CN1311100000000,2022-08-01,13,111,GA,Fannin County,12033,11663,370,3.1
CN1311300000000,2022-08-01,13,113,GA,Fayette County,59489,57753,1736,2.9
CN1311500000000,2022-08-01,13,115,GA,Floyd County,43855,42362,1493,3.4
CN1311700000000,2022-08-01,13,117,GA,Forsyth County,130197,126731,3466,2.7
CN1311900000000,2022-08-01,13,119,GA,Franklin County,9924,9574,350,3.5
CN1312100000000,2022-08-01,13,121,GA,Fulton County,575227,555236,19991,3.5
CN1312300000000,2022-08-01,13,123,GA,Gilmer County,12416,11991,425,3.4
CN1312500000000,2022-08-01,13,125,GA,Glascock County,1244,1195,49,3.9
CN1312700000000,2022-08-01,13,127,GA,Glynn County,39999,38715,1284,3.2
CN1312900000000,2022-08-01,13,129,GA,Gordon County,28976,28107,869,3
CN1313100000000,2022-08-01,13,131,GA,Grady County,10705,10332,373,3.5
CN1313300000000,2022-08-01,13,133,GA,Greene County,7435,7176,259,3.5
CN1313500000000,2022-08-01,13,135,GA,Gwinnett County,501547,486629,14918,3
CN1313700000000,2022-08-01,13,137,GA,Habersham County,18723,18081,642,3.4
CN1313900000000,2022-08-01,13,139,GA,Hall County,106792,103817,2975,2.8
CN1314100000000,2022-08-01,13,141,GA,Hancock County,2464,2327,137,5.6
CN1314300000000,2022-08-01,13,143,GA,Haralson County,13052,12610,442,3.4
CN1314500000000,2022-08-01,13,145,GA,Harris County,16713,16174,539,3.2
CN1314700000000,2022-08-01,13,147,GA,Hart County,12064,11663,401,3.3
CN1314900000000,2022-08-01,13,149,GA,Heard County,5319,5143,176,3.3
CN1315100000000,2022-08-01,13,151,GA,Henry County,120221,116074,4147,3.4
CN1315300000000,2022-08-01,13,153,GA,Houston County,69951,67464,2487,3.6
CN1315500000000,2022-08-01,13,155,GA,Irwin County,3455,3302,153,4.4
CN1315700000000,2022-08-01,13,157,GA,Jackson County,45461,44411,1050,2.3
CN1315900000000,2022-08-01,13,159,GA,Jasper County,7196,6985,211,2.9
CN1316100000000,2022-08-01,13,161,GA,Jeff Davis County,6062,5812,250,4.1
CN1316300000000,2022-08-01,13,163,GA,Jefferson County,6570,6276,294,4.5
CN1316500000000,2022-08-01,13,165,GA,Jenkins County,3301,3145,156,4.7
CN1316700000000,2022-08-01,13,167,GA,Johnson County,3924,3800,124,3.2
CN1316900000000,2022-08-01,13,169,GA,Jones County,13211,12772,439,3.3
CN1317100000000,2022-08-01,13,171,GA,Lamar County,8407,8108,299,3.6
CN1317300000000,2022-08-01,13,173,GA,Lanier County,3765,3616,149,4
CN1317500000000,2022-08-01,13,175,GA,Laurens County,18870,18058,812,4.3
CN1317700000000,2022-08-01,13,177,GA,Lee County,14860,14382,478,3.2
CN1317900000000,2022-08-01,13,179,GA,Liberty County,26093,25142,951,3.6
CN1318100000000,2022-08-01,13,181,GA,Lincoln County,3471,3333,138,4
CN1318300000000,2022-08-01,13,183,GA,Long County,8435,8142,293,3.5
CN1318500000000,2022-08-01,13,185,GA,Lowndes County,50108,48284,1824,3.6
CN1318700000000,2022-08-01,13,187,GA,Lumpkin County,18596,18071,525,2.8
CN1318900000000,2022-08-01,13,189,GA,McDuffie County,8337,7939,398,4.8
CN1319100000000,2022-08-01,13,191,GA,McIntosh County,6224,6007,217,3.5
CN1319300000000,2022-08-01,13,193,GA,Macon County,4427,4207,220,5
CN1319500000000,2022-08-01,13,195,GA,Madison County,13271,12849,422,3.2
CN1319700000000,2022-08-01,13,197,GA,Marion County,3237,3102,135,4.2
CN1319900000000,2022-08-01,13,199,GA,Meriwether County,9032,8616,416,4.6
CN1320100000000,2022-08-01,13,201,GA,Miller County,2814,2734,80,2.8
CN1320500000000,2022-08-01,13,205,GA,Mitchell County,8200,7721,479,5.8
CN1320700000000,2022-08-01,13,207,GA,Monroe County,12733,12310,423,3.3
CN1320900000000,2022-08-01,13,209,GA,Montgomery County,3770,3605,165,4.4
CN1321100000000,2022-08-01,13,211,GA,Morgan County,9694,9410,284,2.9
CN1321300000000,2022-08-01,13,213,GA,Murray County,15224,14619,605,4
CN1321500000000,2022-08-01,13,215,GA,Muscogee County,75148,71607,3541,4.7
CN1321700000000,2022-08-01,13,217,GA,Newton County,54232,52187,2045,3.8
CN1321900000000,2022-08-01,13,219,GA,Oconee County,19872,19335,537,2.7
CN1322100000000,2022-08-01,13,221,GA,Oglethorpe County,6820,6608,212,3.1
CN1322300000000,2022-08-01,13,223,GA,Paulding County,91246,88565,2681,2.9
CN1322500000000,2022-08-01,13,225,GA,Peach County,11719,11224,495,4.2
CN1322700000000,2022-08-01,13,227,GA,Pickens County,15917,15447,470,3
CN1322900000000,2022-08-01,13,229,GA,Pierce County,8787,8506,281,3.2
CN1323100000000,2022-08-01,13,231,GA,Pike County,9207,8934,273,3
CN1323300000000,2022-08-01,13,233,GA,Polk County,18692,18041,651,3.5
CN1323500000000,2022-08-01,13,235,GA,Pulaski County,3953,3809,144,3.6
CN1323700000000,2022-08-01,13,237,GA,Putnam County,8614,8277,337,3.9
CN1323900000000,2022-08-01,13,239,GA,Quitman County,738,696,42,5.7
CN1324100000000,2022-08-01,13,241,GA,Rabun County,7952,7703,249,3.1
CN1324300000000,2022-08-01,13,243,GA,Randolph County,2379,2258,121,5.1
CN1324500000000,2022-08-01,13,245,GA,Richmond County,82037,78230,3807,4.6
CN1324700000000,2022-08-01,13,247,GA,Rockdale County,45208,43524,1684,3.7
CN1324900000000,2022-08-01,13,249,GA,Schley County,2142,2054,88,4.1
CN1325100000000,2022-08-01,13,251,GA,Screven County,4997,4751,246,4.9
CN1325300000000,2022-08-01,13,253,GA,Seminole County,3077,2956,121,3.9
CN1325500000000,2022-08-01,13,255,GA,Spalding County,29321,28247,1074,3.7
CN1325700000000,2022-08-01,13,257,GA,Stephens County,10474,10075,399,3.8
CN1325900000000,2022-08-01,13,259,GA,Stewart County,2574,2456,118,4.6
CN1326100000000,2022-08-01,13,261,GA,Sumter County,12117,11571,546,4.5
CN1326300000000,2022-08-01,13,263,GA,Talbot County,2854,2689,165,5.8
CN1326500000000,2022-08-01,13,265,GA,Taliaferro County,548,522,26,4.7
CN1326700000000,2022-08-01,13,267,GA,Tattnall County,9277,8954,323,3.5
CN1326900000000,2022-08-01,13,269,GA,Taylor County,2637,2481,156,5.9
CN1327100000000,2022-08-01,13,271,GA,Telfair County,3490,3261,229,6.6
CN1327300000000,2022-08-01,13,273,GA,Terrell County,3437,3270,167,4.9
CN1327500000000,2022-08-01,13,275,GA,Thomas County,16820,16146,674,4
CN1327700000000,2022-08-01,13,277,GA,Tift County,20784,20124,660,3.2
CN1327900000000,2022-08-01,13,279,GA,Toombs County,11891,11368,523,4.4
CN1328100000000,2022-08-01,13,281,GA,Towns County,4237,4043,194,4.6
CN1328300000000,2022-08-01,13,283,GA,Treutlen County,2616,2493,123,4.7
CN1328500000000,2022-08-01,13,285,GA,Troup County,36165,34956,1209,3.3
CN1328700000000,2022-08-01,13,287,GA,Turner County,3132,2973,159,5.1
CN1328900000000,2022-08-01,13,289,GA,Twiggs County,2686,2551,135,5
CN1329100000000,2022-08-01,13,291,GA,Union County,11372,11037,335,2.9
CN1329300000000,2022-08-01,13,293,GA,Upson County,11579,11112,467,4
CN1329500000000,2022-08-01,13,295,GA,Walker County,31017,29999,1018,3.3
CN1329700000000,2022-08-01,13,297,GA,Walton County,47939,46449,1490,3.1
CN1329900000000,2022-08-01,13,299,GA,Ware County,15646,15101,545,3.5
CN1330100000000,2022-08-01,13,301,GA,Warren County,2655,2537,118,4.4
CN1330300000000,2022-08-01,13,303,GA,Washington County,6894,6584,310,4.5
CN1330500000000,2022-08-01,13,305,GA,Wayne County,11862,11445,417,3.5
CN1330700000000,2022-08-01,13,307,GA,Webster County,965,918,47,4.9
CN1330900000000,2022-08-01,13,309,GA,Wheeler County,1639,1540,99,6
CN1331100000000,2022-08-01,13,311,GA,White County,16981,16512,469,2.8
CN1331300000000,2022-08-01,13,313,GA,Whitfield County,42875,41160,1715,4
CN1331500000000,2022-08-01,13,315,GA,Wilcox County,2617,2500,117,4.5
CN1331700000000,2022-08-01,13,317,GA,Wilkes County,3736,3565,171,4.6
CN1331900000000,2022-08-01,13,319,GA,Wilkinson County,4002,3858,144,3.6
CN1332100000000,2022-08-01,13,321,GA,Worth County,8617,8314,303,3.5
CN1500100000000,2022-08-01,15,001,HI,Hawaii County,94614,90947,3667,3.9
CN1500300000000,2022-08-01,15,003,HI,Honolulu County/city,460437,443266,17171,3.7
CN1500700000000,2022-08-01,15,007,HI,Kauai County,37120,35741,1379,3.7
CN1500900000000,2022-08-01,15,009,HI,Maui County,88914,85870,3044,3.4
CN1600100000000,2022-08-01,16,001,ID,Ada County,276306,269683,6623,2.4
CN1600300000000,2022-08-01,16,003,ID,Adams County,1865,1785,80,4.3
CN1600500000000,2022-08-01,16,005,ID,Bannock County,43159,41917,1242,2.9
CN1600700000000,2022-08-01,16,007,ID,Bear Lake County,3423,3348,75,2.2
CN1600900000000,2022-08-01,16,009,ID,Benewah County,4181,4041,140,3.3
CN1601100000000,2022-08-01,16,011,ID,Bingham County,24952,24184,768,3.1
CN1601300000000,2022-08-01,16,013,ID,Blaine County,13969,13645,324,2.3
CN1601500000000,2022-08-01,16,015,ID,Boise County,3847,3710,137,3.6
CN1601700000000,2022-08-01,16,017,ID,Bonner County,22537,21844,693,3.1
CN1601900000000,2022-08-01,16,019,ID,Bonneville County,62569,61144,1425,2.3
CN1602100000000,2022-08-01,16,021,ID,Boundary County,5857,5676,181,3.1
CN1602300000000,2022-08-01,16,023,ID,Butte County,1496,1458,38,2.5
CN1602500000000,2022-08-01,16,025,ID,Camas County,749,732,17,2.3
CN1602700000000,2022-08-01,16,027,ID,Canyon County,116364,112907,3457,3
CN1602900000000,2022-08-01,16,029,ID,Caribou County,4224,4130,94,2.2
CN1603100000000,2022-08-01,16,031,ID,Cassia County,14370,14052,318,2.2
CN1603300000000,2022-08-01,16,033,ID,Clark County,400,389,11,2.8
CN1603500000000,2022-08-01,16,035,ID,Clearwater County,3117,2983,134,4.3
CN1603700000000,2022-08-01,16,037,ID,Custer County,2661,2597,64,2.4
CN1603900000000,2022-08-01,16,039,ID,Elmore County,12697,12320,377,3
CN1604100000000,2022-08-01,16,041,ID,Franklin County,7349,7187,162,2.2
CN1604300000000,2022-08-01,16,043,ID,Fremont County,7743,7568,175,2.3
CN1604500000000,2022-08-01,16,045,ID,Gem County,8971,8737,234,2.6
CN1604700000000,2022-08-01,16,047,ID,Gooding County,10251,10030,221,2.2
CN1604900000000,2022-08-01,16,049,ID,Idaho County,7077,6831,246,3.5
CN1605100000000,2022-08-01,16,051,ID,Jefferson County,15432,15109,323,2.1
CN1605300000000,2022-08-01,16,053,ID,Jerome County,15034,14694,340,2.3
CN1605500000000,2022-08-01,16,055,ID,Kootenai County,86126,83675,2451,2.8
CN1605700000000,2022-08-01,16,057,ID,Latah County,20343,19860,483,2.4
CN1605900000000,2022-08-01,16,059,ID,Lemhi County,4013,3891,122,3
CN1606100000000,2022-08-01,16,061,ID,Lewis County,1734,1666,68,3.9
CN1606300000000,2022-08-01,16,063,ID,Lincoln County,3214,3133,81,2.5
CN1606500000000,2022-08-01,16,065,ID,Madison County,21943,21523,420,1.9
CN1606700000000,2022-08-01,16,067,ID,Minidoka County,13142,12830,312,2.4
CN1606900000000,2022-08-01,16,069,ID,Nez Perce County,21449,20907,542,2.5
CN1607100000000,2022-08-01,16,071,ID,Oneida County,2744,2676,68,2.5
CN1607300000000,2022-08-01,16,073,ID,Owyhee County,6190,6002,188,3
CN1607500000000,2022-08-01,16,075,ID,Payette County,12296,11913,383,3.1
CN1607700000000,2022-08-01,16,077,ID,Power County,4436,4315,121,2.7
CN1607900000000,2022-08-01,16,079,ID,Shoshone County,5450,5240,210,3.9
CN1608100000000,2022-08-01,16,081,ID,Teton County,8471,8339,132,1.6
CN1608300000000,2022-08-01,16,083,ID,Twin Falls County,44658,43465,1193,2.7
CN1608500000000,2022-08-01,16,085,ID,Valley County,6259,6081,178,2.8
CN1608700000000,2022-08-01,16,087,ID,Washington County,5043,4870,173,3.4
CN1700100000000,2022-08-01,17,001,IL,Adams County,31039,30011,1028,3.3
CN1700300000000,2022-08-01,17,003,IL,Alexander County,1807,1688,119,6.6
CN1700500000000,2022-08-01,17,005,IL,Bond County,7553,7267,286,3.8
CN1700700000000,2022-08-01,17,007,IL,Boone County,25164,23747,1417,5.6
CN1700900000000,2022-08-01,17,009,IL,Brown County,3157,3087,70,2.2
CN1701100000000,2022-08-01,17,011,IL,Bureau County,16213,15542,671,4.1
CN1701300000000,2022-08-01,17,013,IL,Calhoun County,2195,2111,84,3.8
CN1701500000000,2022-08-01,17,015,IL,Carroll County,7582,7305,277,3.7
CN1701700000000,2022-08-01,17,017,IL,Cass County,5774,5542,232,4
CN1701900000000,2022-08-01,17,019,IL,Champaign County,105750,101372,4378,4.1
CN1702100000000,2022-08-01,17,021,IL,Christian County,13515,12893,622,4.6
CN1702300000000,2022-08-01,17,023,IL,Clark County,7456,7129,327,4.4
CN1702500000000,2022-08-01,17,025,IL,Clay County,5612,5345,267,4.8
CN1702700000000,2022-08-01,17,027,IL,Clinton County,20102,19530,572,2.8
CN1702900000000,2022-08-01,17,029,IL,Coles County,21961,20948,1013,4.6
CN1703100000000,2022-08-01,17,031,IL,Cook County,2697223,2547677,149546,5.5
CN1703300000000,2022-08-01,17,033,IL,Crawford County,8338,7997,341,4.1
CN1703500000000,2022-08-01,17,035,IL,Cumberland County,5925,5719,206,3.5
CN1703700000000,2022-08-01,17,037,IL,DeKalb County,54614,52291,2323,4.3
CN1703900000000,2022-08-01,17,039,IL,De Witt County,7380,7096,284,3.8
CN1704100000000,2022-08-01,17,041,IL,Douglas County,10190,9844,346,3.4
CN1704300000000,2022-08-01,17,043,IL,DuPage County,525435,504104,21331,4.1
CN1704500000000,2022-08-01,17,045,IL,Edgar County,9214,8896,318,3.5
CN1704700000000,2022-08-01,17,047,IL,Edwards County,2448,2339,109,4.5
CN1704900000000,2022-08-01,17,049,IL,Effingham County,19949,19387,562,2.8
CN1705100000000,2022-08-01,17,051,IL,Fayette County,9691,9302,389,4
CN1705300000000,2022-08-01,17,053,IL,Ford County,6127,5866,261,4.3
CN1705500000000,2022-08-01,17,055,IL,Franklin County,15933,15107,826,5.2
CN1705700000000,2022-08-01,17,057,IL,Fulton County,14544,13868,676,4.6
CN1705900000000,2022-08-01,17,059,IL,Gallatin County,2026,1914,112,5.5
CN1706100000000,2022-08-01,17,061,IL,Greene County,5938,5700,238,4
CN1706300000000,2022-08-01,17,063,IL,Grundy County,26468,25156,1312,5
CN1706500000000,2022-08-01,17,065,IL,Hamilton County,4299,4151,148,3.4
CN1706700000000,2022-08-01,17,067,IL,Hancock County,8038,7697,341,4.2
CN1706900000000,2022-08-01,17,069,IL,Hardin County,1474,1393,81,5.5
CN1707100000000,2022-08-01,17,071,IL,Henderson County,3542,3407,135,3.8
CN1707300000000,2022-08-01,17,073,IL,Henry County,23844,22895,949,4
CN1707500000000,2022-08-01,17,075,IL,Iroquois County,12595,12060,535,4.2
CN1707700000000,2022-08-01,17,077,IL,Jackson County,26982,25804,1178,4.4
CN1707900000000,2022-08-01,17,079,IL,Jasper County,4906,4732,174,3.5
CN1708100000000,2022-08-01,17,081,IL,Jefferson County,16484,15692,792,4.8
CN1708300000000,2022-08-01,17,083,IL,Jersey County,10689,10316,373,3.5
CN1708500000000,2022-08-01,17,085,IL,Jo Daviess County,10732,10393,339,3.2
CN1708700000000,2022-08-01,17,087,IL,Johnson County,4088,3867,221,5.4
CN1708900000000,2022-08-01,17,089,IL,Kane County,267060,255759,11301,4.2
CN1709100000000,2022-08-01,17,091,IL,Kankakee County,52356,49582,2774,5.3
CN1709300000000,2022-08-01,17,093,IL,Kendall County,73440,70147,3293,4.5
CN1709500000000,2022-08-01,17,095,IL,Knox County,20110,19112,998,5
CN1709700000000,2022-08-01,17,097,IL,Lake County,370198,355849,14349,3.9
CN1709900000000,2022-08-01,17,099,IL,LaSalle County,52530,50100,2430,4.6
CN1710100000000,2022-08-01,17,101,IL,Lawrence County,5134,4843,291,5.7
CN1710300000000,2022-08-01,17,103,IL,Lee County,16885,16225,660,3.9
CN1710500000000,2022-08-01,17,105,IL,Livingston County,15786,15197,589,3.7
CN1710700000000,2022-08-01,17,107,IL,Logan County,11566,11064,502,4.3
CN1710900000000,2022-08-01,17,109,IL,McDonough County,12205,11616,589,4.8
CN1711100000000,2022-08-01,17,111,IL,McHenry County,171470,164196,7274,4.2
CN1711300000000,2022-08-01,17,113,IL,McLean County,89338,86017,3321,3.7
CN1711500000000,2022-08-01,17,115,IL,Macon County,46291,43744,2547,5.5
CN1711700000000,2022-08-01,17,117,IL,Macoupin County,22298,21495,803,3.6
CN1711900000000,2022-08-01,17,119,IL,Madison County,132554,127341,5213,3.9
CN1712100000000,2022-08-01,17,121,IL,Marion County,16794,16022,772,4.6
CN1712300000000,2022-08-01,17,123,IL,Marshall County,5202,4972,230,4.4
CN1712500000000,2022-08-01,17,125,IL,Mason County,6043,5772,271,4.5
CN1712700000000,2022-08-01,17,127,IL,Massac County,5455,5180,275,5
CN1712900000000,2022-08-01,17,129,IL,Menard County,6297,6082,215,3.4
CN1713100000000,2022-08-01,17,131,IL,Mercer County,7572,7319,253,3.3
CN1713300000000,2022-08-01,17,133,IL,Monroe County,18862,18314,548,2.9
CN1713500000000,2022-08-01,17,135,IL,Montgomery County,11311,10815,496,4.4
CN1713700000000,2022-08-01,17,137,IL,Morgan County,15754,15132,622,3.9
CN1713900000000,2022-08-01,17,139,IL,Moultrie County,7514,7272,242,3.2
CN1714100000000,2022-08-01,17,141,IL,Ogle County,24025,22964,1061,4.4
CN1714300000000,2022-08-01,17,143,IL,Peoria County,83483,79451,4032,4.8
CN1714500000000,2022-08-01,17,145,IL,Perry County,7769,7387,382,4.9
CN1714700000000,2022-08-01,17,147,IL,Piatt County,8321,8034,287,3.4
CN1714900000000,2022-08-01,17,149,IL,Pike County,6854,6587,267,3.9
CN1715100000000,2022-08-01,17,151,IL,Pope County,1786,1696,90,5
CN1715300000000,2022-08-01,17,153,IL,Pulaski County,1639,1519,120,7.3
CN1715500000000,2022-08-01,17,155,IL,Putnam County,3048,2912,136,4.5
CN1715700000000,2022-08-01,17,157,IL,Randolph County,13784,13294,490,3.6
CN1715900000000,2022-08-01,17,159,IL,Richland County,7236,6949,287,4
CN1716100000000,2022-08-01,17,161,IL,Rock Island County,67794,64959,2835,4.2
CN1716300000000,2022-08-01,17,163,IL,St. Clair County,124530,118915,5615,4.5
CN1716500000000,2022-08-01,17,165,IL,Saline County,9413,8927,486,5.2
CN1716700000000,2022-08-01,17,167,IL,Sangamon County,99364,95321,4043,4.1
CN1716900000000,2022-08-01,17,169,IL,Schuyler County,3108,2989,119,3.8
CN1717100000000,2022-08-01,17,171,IL,Scott County,2304,2219,85,3.7
CN1717300000000,2022-08-01,17,173,IL,Shelby County,10088,9696,392,3.9
CN1717500000000,2022-08-01,17,175,IL,Stark County,2416,2316,100,4.1
CN1717700000000,2022-08-01,17,177,IL,Stephenson County,20929,20044,885,4.2
CN1717900000000,2022-08-01,17,179,IL,Tazewell County,62881,60369,2512,4
CN1718100000000,2022-08-01,17,181,IL,Union County,7015,6682,333,4.7
CN1718300000000,2022-08-01,17,183,IL,Vermilion County,31956,30337,1619,5.1
CN1718500000000,2022-08-01,17,185,IL,Wabash County,5803,5608,195,3.4
CN1718700000000,2022-08-01,17,187,IL,Warren County,7860,7562,298,3.8
CN1718900000000,2022-08-01,17,189,IL,Washington County,9946,9710,236,2.4
CN1719100000000,2022-08-01,17,191,IL,Wayne County,6892,6615,277,4
CN1719300000000,2022-08-01,17,193,IL,White County,6019,5774,245,4.1
CN1719500000000,2022-08-01,17,195,IL,Whiteside County,27641,26515,1126,4.1
CN1719700000000,2022-08-01,17,197,IL,Will County,372280,353830,18450,5
CN1719900000000,2022-08-01,17,199,IL,Williamson County,30796,29495,1301,4.2
CN1720100000000,2022-08-01,17,201,IL,Winnebago County,134271,126903,7368,5.5
CN1720300000000,2022-08-01,17,203,IL,Woodford County,18514,17901,613,3.3
CN1800100000000,2022-08-01,18,001,IN,Adams County,17093,16706,387,2.3
CN1800300000000,2022-08-01,18,003,IN,Allen County,191418,185709,5709,3
CN1800500000000,2022-08-01,18,005,IN,Bartholomew County,45031,43913,1118,2.5
CN1800700000000,2022-08-01,18,007,IN,Benton County,4332,4222,110,2.5
CN1800900000000,2022-08-01,18,009,IN,Blackford County,4768,4591,177,3.7
CN1801100000000,2022-08-01,18,011,IN,Boone County,38845,38014,831,2.1
CN1801300000000,2022-08-01,18,013,IN,Brown County,8077,7794,283,3.5
CN1801500000000,2022-08-01,18,015,IN,Carroll County,9927,9626,301,3
CN1801700000000,2022-08-01,18,017,IN,Cass County,17449,16819,630,3.6
CN1801900000000,2022-08-01,18,019,IN,Clark County,63494,61704,1790,2.8
CN1802100000000,2022-08-01,18,021,IN,Clay County,11778,11325,453,3.8
CN1802300000000,2022-08-01,18,023,IN,Clinton County,17245,16788,457,2.7
CN1802500000000,2022-08-01,18,025,IN,Crawford County,4942,4778,164,3.3
CN1802700000000,2022-08-01,18,027,IN,Daviess County,16766,16369,397,2.4
CN1802900000000,2022-08-01,18,029,IN,Dearborn County,26229,25535,694,2.6
CN1803100000000,2022-08-01,18,031,IN,Decatur County,14645,14273,372,2.5
CN1803300000000,2022-08-01,18,033,IN,DeKalb County,22625,21970,655,2.9
CN1803500000000,2022-08-01,18,035,IN,Delaware County,51122,49183,1939,3.8
CN1803700000000,2022-08-01,18,037,IN,Dubois County,22072,21552,520,2.4
CN1803900000000,2022-08-01,18,039,IN,Elkhart County,119316,115934,3382,2.8
CN1804100000000,2022-08-01,18,041,IN,Fayette County,8331,7928,403,4.8
CN1804300000000,2022-08-01,18,043,IN,Floyd County,42712,41631,1081,2.5
CN1804500000000,2022-08-01,18,045,IN,Fountain County,7974,7752,222,2.8
CN1804700000000,2022-08-01,18,047,IN,Franklin County,11439,11144,295,2.6
CN1804900000000,2022-08-01,18,049,IN,Fulton County,9590,9299,291,3
CN1805100000000,2022-08-01,18,051,IN,Gibson County,20175,19668,507,2.5
CN1805300000000,2022-08-01,18,053,IN,Grant County,30829,29709,1120,3.6
CN1805500000000,2022-08-01,18,055,IN,Greene County,13784,13215,569,4.1
CN1805700000000,2022-08-01,18,057,IN,Hamilton County,198644,194152,4492,2.3
CN1805900000000,2022-08-01,18,059,IN,Hancock County,43462,42296,1166,2.7
CN1806100000000,2022-08-01,18,061,IN,Harrison County,20705,20169,536,2.6
CN1806300000000,2022-08-01,18,063,IN,Hendricks County,96730,94277,2453,2.5
CN1806500000000,2022-08-01,18,065,IN,Henry County,22587,21826,761,3.4
CN1806700000000,2022-08-01,18,067,IN,Howard County,33784,31398,2386,7.1
CN1806900000000,2022-08-01,18,069,IN,Huntington County,18602,18085,517,2.8
CN1807100000000,2022-08-01,18,071,IN,Jackson County,23605,22907,698,3
CN1807300000000,2022-08-01,18,073,IN,Jasper County,15906,15357,549,3.5
CN1807500000000,2022-08-01,18,075,IN,Jay County,8787,8546,241,2.7
CN1807700000000,2022-08-01,18,077,IN,Jefferson County,14976,14521,455,3
CN1807900000000,2022-08-01,18,079,IN,Jennings County,13763,13299,464,3.4
CN1808100000000,2022-08-01,18,081,IN,Johnson County,88271,86084,2187,2.5
CN1808300000000,2022-08-01,18,083,IN,Knox County,17973,17441,532,3
CN1808500000000,2022-08-01,18,085,IN,Kosciusko County,41438,40363,1075,2.6
CN1808700000000,2022-08-01,18,087,IN,LaGrange County,21775,21237,538,2.5
CN1808900000000,2022-08-01,18,089,IN,Lake County,230430,218972,11458,5
CN1809100000000,2022-08-01,18,091,IN,LaPorte County,47243,45480,1763,3.7
CN1809300000000,2022-08-01,18,093,IN,Lawrence County,20831,20118,713,3.4
CN1809500000000,2022-08-01,18,095,IN,Madison County,61187,59084,2103,3.4
CN1809700000000,2022-08-01,18,097,IN,Marion County,517492,499929,17563,3.4
CN1809900000000,2022-08-01,18,099,IN,Marshall County,23125,22518,607,2.6
CN1810100000000,2022-08-01,18,101,IN,Martin County,5464,5300,164,3
CN1810300000000,2022-08-01,18,103,IN,Miami County,14569,13852,717,4.9
CN1810500000000,2022-08-01,18,105,IN,Monroe County,71446,69318,2128,3
CN1810700000000,2022-08-01,18,107,IN,Montgomery County,18970,18473,497,2.6
CN1810900000000,2022-08-01,18,109,IN,Morgan County,38046,36969,1077,2.8
CN1811100000000,2022-08-01,18,111,IN,Newton County,6790,6516,274,4
CN1811300000000,2022-08-01,18,113,IN,Noble County,22116,21459,657,3
CN1811500000000,2022-08-01,18,115,IN,Ohio County,3245,3178,67,2.1
CN1811700000000,2022-08-01,18,117,IN,Orange County,8383,8096,287,3.4
CN1811900000000,2022-08-01,18,119,IN,Owen County,9388,9091,297,3.2
CN1812100000000,2022-08-01,18,121,IN,Parke County,7225,6994,231,3.2
CN1812300000000,2022-08-01,18,123,IN,Perry County,8827,8544,283,3.2
CN1812500000000,2022-08-01,18,125,IN,Pike County,5999,5789,210,3.5
CN1812700000000,2022-08-01,18,127,IN,Porter County,86719,83666,3053,3.5
CN1812900000000,2022-08-01,18,129,IN,Posey County,13095,12767,328,2.5
CN1813100000000,2022-08-01,18,131,IN,Pulaski County,6563,6391,172,2.6
CN1813300000000,2022-08-01,18,133,IN,Putnam County,17202,16630,572,3.3
CN1813500000000,2022-08-01,18,135,IN,Randolph County,11498,11140,358,3.1
CN1813700000000,2022-08-01,18,137,IN,Ripley County,12943,12556,387,3
CN1813900000000,2022-08-01,18,139,IN,Rush County,8876,8647,229,2.6
CN1814100000000,2022-08-01,18,141,IN,St. Joseph County,133306,128347,4959,3.7
CN1814300000000,2022-08-01,18,143,IN,Scott County,10690,10305,385,3.6
CN1814500000000,2022-08-01,18,145,IN,Shelby County,24077,23454,623,2.6
CN1814700000000,2022-08-01,18,147,IN,Spencer County,10838,10547,291,2.7
CN1814900000000,2022-08-01,18,149,IN,Starke County,9693,9325,368,3.8
CN1815100000000,2022-08-01,18,151,IN,Steuben County,21010,20542,468,2.2
CN1815300000000,2022-08-01,18,153,IN,Sullivan County,7987,7671,316,4
CN1815500000000,2022-08-01,18,155,IN,Switzerland County,4828,4689,139,2.9
CN1815700000000,2022-08-01,18,157,IN,Tippecanoe County,98102,95173,2929,3
CN1815900000000,2022-08-01,18,159,IN,Tipton County,8972,8664,308,3.4
CN1816100000000,2022-08-01,18,161,IN,Union County,3594,3513,81,2.3
CN1816300000000,2022-08-01,18,163,IN,Vanderburgh County,93398,90393,3005,3.2
CN1816500000000,2022-08-01,18,165,IN,Vermillion County,6612,6352,260,3.9
CN1816700000000,2022-08-01,18,167,IN,Vigo County,46415,44667,1748,3.8
CN1816900000000,2022-08-01,18,169,IN,Wabash County,14439,14021,418,2.9
CN1817100000000,2022-08-01,18,171,IN,Warren County,4099,3995,104,2.5
CN1817300000000,2022-08-01,18,173,IN,Warrick County,32746,31877,869,2.7
CN1817500000000,2022-08-01,18,175,IN,Washington County,13842,13455,387,2.8
CN1817700000000,2022-08-01,18,177,IN,Wayne County,29761,28792,969,3.3
CN1817900000000,2022-08-01,18,179,IN,Wells County,14370,14048,322,2.2
CN1818100000000,2022-08-01,18,181,IN,White County,13509,13172,337,2.5
CN1818300000000,2022-08-01,18,183,IN,Whitley County,17953,17529,424,2.4
CN1900100000000,2022-08-01,19,001,IA,Adair County,4234,4147,87,2.1
CN1900300000000,2022-08-01,19,003,IA,Adams County,2130,2078,52,2.4
CN1900500000000,2022-08-01,19,005,IA,Allamakee County,6894,6693,201,2.9
CN1900700000000,2022-08-01,19,007,IA,Appanoose County,5978,5799,179,3
CN1900900000000,2022-08-01,19,009,IA,Audubon County,2951,2878,73,2.5
CN1901100000000,2022-08-01,19,011,IA,Benton County,13134,12725,409,3.1
CN1901300000000,2022-08-01,19,013,IA,Black Hawk County,68116,65992,2124,3.1
CN1901500000000,2022-08-01,19,015,IA,Boone County,14774,14417,357,2.4
CN1901700000000,2022-08-01,19,017,IA,Bremer County,13913,13575,338,2.4
CN1901900000000,2022-08-01,19,019,IA,Buchanan County,11225,10918,307,2.7
CN1902100000000,2022-08-01,19,021,IA,Buena Vista County,11390,11064,326,2.9
CN1902300000000,2022-08-01,19,023,IA,Butler County,8174,7954,220,2.7
CN1902500000000,2022-08-01,19,025,IA,Calhoun County,4029,3921,108,2.7
CN1902700000000,2022-08-01,19,027,IA,Carroll County,10766,10521,245,2.3
CN1902900000000,2022-08-01,19,029,IA,Cass County,6835,6659,176,2.6
CN1903100000000,2022-08-01,19,031,IA,Cedar County,10344,10058,286,2.8
CN1903300000000,2022-08-01,19,033,IA,Cerro Gordo County,22639,21952,687,3
CN1903500000000,2022-08-01,19,035,IA,Cherokee County,6041,5894,147,2.4
CN1903700000000,2022-08-01,19,037,IA,Chickasaw County,6522,6368,154,2.4
CN1903900000000,2022-08-01,19,039,IA,Clarke County,4979,4836,143,2.9
CN1904100000000,2022-08-01,19,041,IA,Clay County,8498,8257,241,2.8
CN1904300000000,2022-08-01,19,043,IA,Clayton County,9415,9133,282,3
CN1904500000000,2022-08-01,19,045,IA,Clinton County,22298,21447,851,3.8
CN1904700000000,2022-08-01,19,047,IA,Crawford County,7572,7300,272,3.6
CN1904900000000,2022-08-01,19,049,IA,Dallas County,54771,53542,1229,2.2
CN1905100000000,2022-08-01,19,051,IA,Davis County,4299,4185,114,2.7
CN1905300000000,2022-08-01,19,053,IA,Decatur County,4024,3910,114,2.8
CN1905500000000,2022-08-01,19,055,IA,Delaware County,10290,10055,235,2.3
CN1905700000000,2022-08-01,19,057,IA,Des Moines County,18561,17726,835,4.5
CN1905900000000,2022-08-01,19,059,IA,Dickinson County,11533,11269,264,2.3
CN1906100000000,2022-08-01,19,061,IA,Dubuque County,56497,54923,1574,2.8
CN1906300000000,2022-08-01,19,063,IA,Emmet County,4852,4713,139,2.9
CN1906500000000,2022-08-01,19,065,IA,Fayette County,10154,9870,284,2.8
CN1906700000000,2022-08-01,19,067,IA,Floyd County,8286,8016,270,3.3
CN1906900000000,2022-08-01,19,069,IA,Franklin County,5530,5393,137,2.5
CN1907100000000,2022-08-01,19,071,IA,Fremont County,3698,3592,106,2.9
CN1907300000000,2022-08-01,19,073,IA,Greene County,5172,5050,122,2.4
CN1907500000000,2022-08-01,19,075,IA,Grundy County,6265,6109,156,2.5
CN1907700000000,2022-08-01,19,077,IA,Guthrie County,5582,5420,162,2.9
CN1907900000000,2022-08-01,19,079,IA,Hamilton County,6863,6657,206,3
CN1908100000000,2022-08-01,19,081,IA,Hancock County,5657,5516,141,2.5
CN1908300000000,2022-08-01,19,083,IA,Hardin County,7657,7425,232,3
CN1908500000000,2022-08-01,19,085,IA,Harrison County,7152,6934,218,3
CN1908700000000,2022-08-01,19,087,IA,Henry County,9306,9013,293,3.1
CN1908900000000,2022-08-01,19,089,IA,Howard County,5109,4974,135,2.6
CN1909100000000,2022-08-01,19,091,IA,Humboldt County,4794,4667,127,2.6
CN1909300000000,2022-08-01,19,093,IA,Ida County,3896,3805,91,2.3
CN1909500000000,2022-08-01,19,095,IA,Iowa County,9619,9387,232,2.4
CN1909700000000,2022-08-01,19,097,IA,Jackson County,10533,10201,332,3.2
CN1909900000000,2022-08-01,19,099,IA,Jasper County,18369,17811,558,3
CN1910100000000,2022-08-01,19,101,IA,Jefferson County,9787,9523,264,2.7
CN1910300000000,2022-08-01,19,103,IA,Johnson County,87763,85450,2313,2.6
CN1910500000000,2022-08-01,19,105,IA,Jones County,10305,10002,303,2.9
CN1910700000000,2022-08-01,19,107,IA,Keokuk County,5172,5018,154,3
CN1910900000000,2022-08-01,19,109,IA,Kossuth County,8216,8015,201,2.4
CN1911100000000,2022-08-01,19,111,IA,Lee County,14747,13919,828,5.6
CN1911300000000,2022-08-01,19,113,IA,Linn County,122721,118569,4152,3.4
CN1911500000000,2022-08-01,19,115,IA,Louisa County,5916,5723,193,3.3
CN1911700000000,2022-08-01,19,117,IA,Lucas County,4551,4431,120,2.6
CN1911900000000,2022-08-01,19,119,IA,Lyon County,7000,6865,135,1.9
CN1912100000000,2022-08-01,19,121,IA,Madison County,8812,8542,270,3.1
CN1912300000000,2022-08-01,19,123,IA,Mahaska County,12157,11823,334,2.7
CN1912500000000,2022-08-01,19,125,IA,Marion County,19420,19001,419,2.2
CN1912700000000,2022-08-01,19,127,IA,Marshall County,17114,16406,708,4.1
CN1912900000000,2022-08-01,19,129,IA,Mills County,7161,6985,176,2.5
CN1913100000000,2022-08-01,19,131,IA,Mitchell County,5780,5653,127,2.2
CN1913300000000,2022-08-01,19,133,IA,Monona County,4331,4206,125,2.9
CN1913500000000,2022-08-01,19,135,IA,Monroe County,4015,3886,129,3.2
CN1913700000000,2022-08-01,19,137,IA,Montgomery County,4946,4813,133,2.7
CN1913900000000,2022-08-01,19,139,IA,Muscatine County,21180,20514,666,3.1
CN1914100000000,2022-08-01,19,141,IA,O'Brien County,7909,7724,185,2.3
CN1914300000000,2022-08-01,19,143,IA,Osceola County,3546,3471,75,2.1
CN1914500000000,2022-08-01,19,145,IA,Page County,6444,6265,179,2.8
CN1914700000000,2022-08-01,19,147,IA,Palo Alto County,4350,4228,122,2.8
CN1914900000000,2022-08-01,19,149,IA,Plymouth County,14671,14314,357,2.4
CN1915100000000,2022-08-01,19,151,IA,Pocahontas County,4305,4203,102,2.4
CN1915300000000,2022-08-01,19,153,IA,Polk County,281236,273214,8022,2.9
CN1915500000000,2022-08-01,19,155,IA,Pottawattamie County,48601,47086,1515,3.1
CN1915700000000,2022-08-01,19,157,IA,Poweshiek County,9910,9628,282,2.8
CN1915900000000,2022-08-01,19,159,IA,Ringgold County,2283,2221,62,2.7
CN1916100000000,2022-08-01,19,161,IA,Sac County,5186,5051,135,2.6
CN1916300000000,2022-08-01,19,163,IA,Scott County,89938,86886,3052,3.4
CN1916500000000,2022-08-01,19,165,IA,Shelby County,6449,6291,158,2.4
CN1916700000000,2022-08-01,19,167,IA,Sioux County,21045,20634,411,2
CN1916900000000,2022-08-01,19,169,IA,Story County,58500,57005,1495,2.6
CN1917100000000,2022-08-01,19,171,IA,Tama County,9031,8778,253,2.8
CN1917300000000,2022-08-01,19,173,IA,Taylor County,3128,3055,73,2.3
CN1917500000000,2022-08-01,19,175,IA,Union County,5973,5786,187,3.1
CN1917700000000,2022-08-01,19,177,IA,Van Buren County,3644,3528,116,3.2
CN1917900000000,2022-08-01,19,179,IA,Wapello County,17064,16470,594,3.5
CN1918100000000,2022-08-01,19,181,IA,Warren County,29773,29005,768,2.6
CN1918300000000,2022-08-01,19,183,IA,Washington County,11656,11351,305,2.6
CN1918500000000,2022-08-01,19,185,IA,Wayne County,2868,2787,81,2.8
CN1918700000000,2022-08-01,19,187,IA,Webster County,19027,18354,673,3.5
CN1918900000000,2022-08-01,19,189,IA,Winnebago County,5014,4865,149,3
CN1919100000000,2022-08-01,19,191,IA,Winneshiek County,10972,10661,311,2.8
CN1919300000000,2022-08-01,19,193,IA,Woodbury County,56382,54669,1713,3
CN1919500000000,2022-08-01,19,195,IA,Worth County,4002,3900,102,2.5
CN1919700000000,2022-08-01,19,197,IA,Wright County,6453,6276,177,2.7
CN2000100000000,2022-08-01,20,001,KS,Allen County,6133,5920,213,3.5
CN2000300000000,2022-08-01,20,003,KS,Anderson County,4351,4242,109,2.5
CN2000500000000,2022-08-01,20,005,KS,Atchison County,6720,6452,268,4
CN2000700000000,2022-08-01,20,007,KS,Barber County,2246,2188,58,2.6
CN2000900000000,2022-08-01,20,009,KS,Barton County,13066,12682,384,2.9
CN2001100000000,2022-08-01,20,011,KS,Bourbon County,6187,5950,237,3.8
CN2001300000000,2022-08-01,20,013,KS,Brown County,5089,4947,142,2.8
CN2001500000000,2022-08-01,20,015,KS,Butler County,32678,31611,1067,3.3
CN2001700000000,2022-08-01,20,017,KS,Chase County,1433,1397,36,2.5
CN2001900000000,2022-08-01,20,019,KS,Chautauqua County,1388,1341,47,3.4
CN2002100000000,2022-08-01,20,021,KS,Cherokee County,9903,9581,322,3.3
CN2002300000000,2022-08-01,20,023,KS,Cheyenne County,1236,1196,40,3.2
CN2002500000000,2022-08-01,20,025,KS,Clark County,1109,1078,31,2.8
CN2002700000000,2022-08-01,20,027,KS,Clay County,3724,3604,120,3.2
CN2002900000000,2022-08-01,20,029,KS,Cloud County,3711,3585,126,3.4
CN2003100000000,2022-08-01,20,031,KS,Coffey County,3618,3460,158,4.4
CN2003300000000,2022-08-01,20,033,KS,Comanche County,859,835,24,2.8
CN2003500000000,2022-08-01,20,035,KS,Cowley County,16346,15765,581,3.6
CN2003700000000,2022-08-01,20,037,KS,Crawford County,18770,18109,661,3.5
CN2003900000000,2022-08-01,20,039,KS,Decatur County,1183,1134,49,4.1
CN2004100000000,2022-08-01,20,041,KS,Dickinson County,8518,8247,271,3.2
CN2004300000000,2022-08-01,20,043,KS,Doniphan County,4016,3890,126,3.1
CN2004500000000,2022-08-01,20,045,KS,Douglas County,65590,63555,2035,3.1
CN2004700000000,2022-08-01,20,047,KS,Edwards County,1364,1320,44,3.2
CN2004900000000,2022-08-01,20,049,KS,Elk County,1042,1006,36,3.5
CN2005100000000,2022-08-01,20,051,KS,Ellis County,16856,16428,428,2.5
CN2005300000000,2022-08-01,20,053,KS,Ellsworth County,2651,2573,78,2.9
CN2005500000000,2022-08-01,20,055,KS,Finney County,20428,19909,519,2.5
CN2005700000000,2022-08-01,20,057,KS,Ford County,17912,17459,453,2.5
CN2005900000000,2022-08-01,20,059,KS,Franklin County,14741,14330,411,2.8
CN2006100000000,2022-08-01,20,061,KS,Geary County,11041,10539,502,4.5
CN2006300000000,2022-08-01,20,063,KS,Gove County,1318,1282,36,2.7
CN2006500000000,2022-08-01,20,065,KS,Graham County,1195,1160,35,2.9
CN2006700000000,2022-08-01,20,067,KS,Grant County,2795,2693,102,3.6
CN2006900000000,2022-08-01,20,069,KS,Gray County,3028,2948,80,2.6
CN2007100000000,2022-08-01,20,071,KS,Greeley County,770,755,15,1.9
CN2007300000000,2022-08-01,20,073,KS,Greenwood County,2990,2903,87,2.9
CN2007500000000,2022-08-01,20,075,KS,Hamilton County,1624,1589,35,2.2
CN2007700000000,2022-08-01,20,077,KS,Harper County,2775,2700,75,2.7
CN2007900000000,2022-08-01,20,079,KS,Harvey County,17079,16562,517,3
CN2008100000000,2022-08-01,20,081,KS,Haskell County,2143,2090,53,2.5
CN2008300000000,2022-08-01,20,083,KS,Hodgeman County,1018,991,27,2.7
CN2008500000000,2022-08-01,20,085,KS,Jackson County,7330,7143,187,2.6
CN2008700000000,2022-08-01,20,087,KS,Jefferson County,10451,10143,308,2.9
CN2008900000000,2022-08-01,20,089,KS,Jewell County,1192,1154,38,3.2
CN2009100000000,2022-08-01,20,091,KS,Johnson County,351023,341394,9629,2.7
CN2009300000000,2022-08-01,20,093,KS,Kearny County,1969,1922,47,2.4
CN2009500000000,2022-08-01,20,095,KS,Kingman County,3285,3181,104,3.2
CN2009700000000,2022-08-01,20,097,KS,Kiowa County,1143,1110,33,2.9
CN2009900000000,2022-08-01,20,099,KS,Labette County,9265,8926,339,3.7
CN2010100000000,2022-08-01,20,101,KS,Lane County,675,651,24,3.6
CN2010300000000,2022-08-01,20,103,KS,Leavenworth County,37635,36364,1271,3.4
CN2010500000000,2022-08-01,20,105,KS,Lincoln County,1625,1579,46,2.8
CN2010700000000,2022-08-01,20,107,KS,Linn County,4390,4203,187,4.3
CN2010900000000,2022-08-01,20,109,KS,Logan County,1505,1467,38,2.5
CN2011100000000,2022-08-01,20,111,KS,Lyon County,16884,16393,491,2.9
CN2011300000000,2022-08-01,20,113,KS,McPherson County,17259,16846,413,2.4
CN2011500000000,2022-08-01,20,115,KS,Marion County,5841,5670,171,2.9
CN2011700000000,2022-08-01,20,117,KS,Marshall County,5309,5178,131,2.5
CN2011900000000,2022-08-01,20,119,KS,Meade County,2086,2035,51,2.4
CN2012100000000,2022-08-01,20,121,KS,Miami County,18082,17574,508,2.8
CN2012300000000,2022-08-01,20,123,KS,Mitchell County,3328,3246,82,2.5
CN2012500000000,2022-08-01,20,125,KS,Montgomery County,14488,13973,515,3.6
CN2012700000000,2022-08-01,20,127,KS,Morris County,2905,2819,86,3
CN2012900000000,2022-08-01,20,129,KS,Morton County,1081,1045,36,3.3
CN2013100000000,2022-08-01,20,131,KS,Nemaha County,5567,5440,127,2.3
CN2013300000000,2022-08-01,20,133,KS,Neosho County,6030,5772,258,4.3
CN2013500000000,2022-08-01,20,135,KS,Ness County,1298,1262,36,2.8
CN2013700000000,2022-08-01,20,137,KS,Norton County,2631,2569,62,2.4
CN2013900000000,2022-08-01,20,139,KS,Osage County,8092,7837,255,3.2
CN2014100000000,2022-08-01,20,141,KS,Osborne County,1850,1803,47,2.5
CN2014300000000,2022-08-01,20,143,KS,Ottawa County,2993,2907,86,2.9
CN2014500000000,2022-08-01,20,145,KS,Pawnee County,2669,2591,78,2.9
CN2014700000000,2022-08-01,20,147,KS,Phillips County,2546,2477,69,2.7
CN2014900000000,2022-08-01,20,149,KS,Pottawatomie County,12163,11804,359,3
CN2015100000000,2022-08-01,20,151,KS,Pratt County,4819,4684,135,2.8
CN2015300000000,2022-08-01,20,153,KS,Rawlins County,1541,1506,35,2.3
CN2015500000000,2022-08-01,20,155,KS,Reno County,28467,27511,956,3.4
CN2015700000000,2022-08-01,20,157,KS,Republic County,2445,2387,58,2.4
CN2015900000000,2022-08-01,20,159,KS,Rice County,5313,5166,147,2.8
CN2016100000000,2022-08-01,20,161,KS,Riley County,33645,32504,1141,3.4
CN2016300000000,2022-08-01,20,163,KS,Rooks County,2378,2303,75,3.2
CN2016500000000,2022-08-01,20,165,KS,Rush County,1555,1511,44,2.8
CN2016700000000,2022-08-01,20,167,KS,Russell County,3228,3139,89,2.8
CN2016900000000,2022-08-01,20,169,KS,Saline County,30599,29745,854,2.8
CN2017100000000,2022-08-01,20,171,KS,Scott County,2710,2641,69,2.5
CN2017300000000,2022-08-01,20,173,KS,Sedgwick County,254987,245836,9151,3.6
CN2017500000000,2022-08-01,20,175,KS,Seward County,9884,9600,284,2.9
CN2017700000000,2022-08-01,20,177,KS,Shawnee County,92600,89704,2896,3.1
CN2017900000000,2022-08-01,20,179,KS,Sheridan County,1427,1394,33,2.3
CN2018100000000,2022-08-01,20,181,KS,Sherman County,2787,2707,80,2.9
CN2018300000000,2022-08-01,20,183,KS,Smith County,1892,1837,55,2.9
CN2018500000000,2022-08-01,20,185,KS,Stafford County,1898,1838,60,3.2
CN2018700000000,2022-08-01,20,187,KS,Stanton County,1079,1054,25,2.3
CN2018900000000,2022-08-01,20,189,KS,Stevens County,2910,2844,66,2.3
CN2019100000000,2022-08-01,20,191,KS,Sumner County,10763,10383,380,3.5
CN2019300000000,2022-08-01,20,193,KS,Thomas County,4263,4156,107,2.5
CN2019500000000,2022-08-01,20,195,KS,Trego County,1335,1293,42,3.1
CN2019700000000,2022-08-01,20,197,KS,Wabaunsee County,3768,3662,106,2.8
CN2019900000000,2022-08-01,20,199,KS,Wallace County,835,813,22,2.6
CN2020100000000,2022-08-01,20,201,KS,Washington County,2958,2887,71,2.4
CN2020300000000,2022-08-01,20,203,KS,Wichita County,1123,1094,29,2.6
CN2020500000000,2022-08-01,20,205,KS,Wilson County,3718,3589,129,3.5
CN2020700000000,2022-08-01,20,207,KS,Woodson County,1496,1438,58,3.9
CN2020900000000,2022-08-01,20,209,KS,Wyandotte County,78550,75481,3069,3.9
CN2100100000000,2022-08-01,21,001,KY,Adair County,7070,6757,313,4.4
CN2100300000000,2022-08-01,21,003,KY,Allen County,9045,8684,361,4
CN2100500000000,2022-08-01,21,005,KY,Anderson County,12066,11679,387,3.2
CN2100700000000,2022-08-01,21,007,KY,Ballard County,3511,3336,175,5
CN2100900000000,2022-08-01,21,009,KY,Barren County,17835,17116,719,4
CN2101100000000,2022-08-01,21,011,KY,Bath County,4764,4546,218,4.6
CN2101300000000,2022-08-01,21,013,KY,Bell County,8087,7668,419,5.2
CN2101500000000,2022-08-01,21,015,KY,Boone County,73195,70904,2291,3.1
CN2101700000000,2022-08-01,21,017,KY,Bourbon County,9806,9457,349,3.6
CN2101900000000,2022-08-01,21,019,KY,Boyd County,17093,16186,907,5.3
CN2102100000000,2022-08-01,21,021,KY,Boyle County,12850,12345,505,3.9
CN2102300000000,2022-08-01,21,023,KY,Bracken County,3814,3666,148,3.9
CN2102500000000,2022-08-01,21,025,KY,Breathitt County,3121,2884,237,7.6
CN2102700000000,2022-08-01,21,027,KY,Breckinridge County,8037,7686,351,4.4
CN2102900000000,2022-08-01,21,029,KY,Bullitt County,43151,41693,1458,3.4
CN2103100000000,2022-08-01,21,031,KY,Butler County,4969,4756,213,4.3
CN2103300000000,2022-08-01,21,033,KY,Caldwell County,6074,5871,203,3.3
CN2103500000000,2022-08-01,21,035,KY,Calloway County,17382,16718,664,3.8
CN2103700000000,2022-08-01,21,037,KY,Campbell County,51358,49635,1723,3.4
CN2103900000000,2022-08-01,21,039,KY,Carlisle County,2286,2204,82,3.6
CN2104100000000,2022-08-01,21,041,KY,Carroll County,5810,5626,184,3.2
CN2104300000000,2022-08-01,21,043,KY,Carter County,9585,8877,708,7.4
CN2104500000000,2022-08-01,21,045,KY,Casey County,6679,6434,245,3.7
CN2104700000000,2022-08-01,21,047,KY,Christian County,24801,23562,1239,5
CN2104900000000,2022-08-01,21,049,KY,Clark County,17318,16701,617,3.6
CN2105100000000,2022-08-01,21,051,KY,Clay County,5090,4788,302,5.9
CN2105300000000,2022-08-01,21,053,KY,Clinton County,3673,3500,173,4.7
CN2105500000000,2022-08-01,21,055,KY,Crittenden County,3867,3694,173,4.5
CN2105700000000,2022-08-01,21,057,KY,Cumberland County,3385,3288,97,2.9
CN2105900000000,2022-08-01,21,059,KY,Daviess County,46186,44328,1858,4
CN2106100000000,2022-08-01,21,061,KY,Edmonson County,4766,4523,243,5.1
CN2106300000000,2022-08-01,21,063,KY,Elliott County,1880,1738,142,7.6
CN2106500000000,2022-08-01,21,065,KY,Estill County,5199,4945,254,4.9
CN2106700000000,2022-08-01,21,067,KY,Fayette County,176621,171091,5530,3.1
CN2106900000000,2022-08-01,21,069,KY,Fleming County,6082,5826,256,4.2
CN2107100000000,2022-08-01,21,071,KY,Floyd County,10785,10142,643,6
CN2107300000000,2022-08-01,21,073,KY,Franklin County,25222,24412,810,3.2
CN2107500000000,2022-08-01,21,075,KY,Fulton County,2143,2037,106,4.9
CN2107700000000,2022-08-01,21,077,KY,Gallatin County,4065,3925,140,3.4
CN2107900000000,2022-08-01,21,079,KY,Garrard County,7930,7640,290,3.7
CN2108100000000,2022-08-01,21,081,KY,Grant County,11825,11406,419,3.5
CN2108300000000,2022-08-01,21,083,KY,Graves County,15555,14876,679,4.4
CN2108500000000,2022-08-01,21,085,KY,Grayson County,10513,10044,469,4.5
CN2108700000000,2022-08-01,21,087,KY,Green County,5077,4874,203,4
CN2108900000000,2022-08-01,21,089,KY,Greenup County,12851,12118,733,5.7
CN2109100000000,2022-08-01,21,091,KY,Hancock County,3851,3688,163,4.2
CN2109300000000,2022-08-01,21,093,KY,Hardin County,47423,45489,1934,4.1
CN2109500000000,2022-08-01,21,095,KY,Harlan County,6297,5887,410,6.5
CN2109700000000,2022-08-01,21,097,KY,Harrison County,8868,8589,279,3.1
CN2109900000000,2022-08-01,21,099,KY,Hart County,7619,7313,306,4
CN2110100000000,2022-08-01,21,101,KY,Henderson County,20846,20005,841,4
CN2110300000000,2022-08-01,21,103,KY,Henry County,8196,7936,260,3.2
CN2110500000000,2022-08-01,21,105,KY,Hickman County,1650,1576,74,4.5
CN2110700000000,2022-08-01,21,107,KY,Hopkins County,18176,17398,778,4.3
CN2110900000000,2022-08-01,21,109,KY,Jackson County,4080,3833,247,6.1
CN2111100000000,2022-08-01,21,111,KY,Jefferson County,396698,382720,13978,3.5
CN2111300000000,2022-08-01,21,113,KY,Jessamine County,26645,25764,881,3.3
CN2111500000000,2022-08-01,21,115,KY,Johnson County,6626,6248,378,5.7
CN2111700000000,2022-08-01,21,117,KY,Kenton County,89048,86053,2995,3.4
CN2111900000000,2022-08-01,21,119,KY,Knott County,4279,3998,281,6.6
CN2112100000000,2022-08-01,21,121,KY,Knox County,9917,9355,562,5.7
CN2112300000000,2022-08-01,21,123,KY,Larue County,5765,5507,258,4.5
CN2112500000000,2022-08-01,21,125,KY,Laurel County,25064,23925,1139,4.5
CN2112700000000,2022-08-01,21,127,KY,Lawrence County,5622,5332,290,5.2
CN2112900000000,2022-08-01,21,129,KY,Lee County,2101,1991,110,5.2
CN2113100000000,2022-08-01,21,131,KY,Leslie County,2516,2338,178,7.1
CN2113300000000,2022-08-01,21,133,KY,Letcher County,5870,5483,387,6.6
CN2113500000000,2022-08-01,21,135,KY,Lewis County,4567,4237,330,7.2
CN2113700000000,2022-08-01,21,137,KY,Lincoln County,9461,9002,459,4.9
CN2113900000000,2022-08-01,21,139,KY,Livingston County,3671,3504,167,4.5
CN2114100000000,2022-08-01,21,141,KY,Logan County,12455,12007,448,3.6
CN2114300000000,2022-08-01,21,143,KY,Lyon County,3425,3283,142,4.1
CN2114500000000,2022-08-01,21,145,KY,McCracken County,30040,28825,1215,4
CN2114700000000,2022-08-01,21,147,KY,McCreary County,4666,4423,243,5.2
CN2114900000000,2022-08-01,21,149,KY,McLean County,4030,3844,186,4.6
CN2115100000000,2022-08-01,21,151,KY,Madison County,46612,44902,1710,3.7
CN2115300000000,2022-08-01,21,153,KY,Magoffin County,3250,2886,364,11.2
CN2115500000000,2022-08-01,21,155,KY,Marion County,9484,9182,302,3.2
CN2115700000000,2022-08-01,21,157,KY,Marshall County,14651,14049,602,4.1
CN2115900000000,2022-08-01,21,159,KY,Martin County,2174,1999,175,8
CN2116100000000,2022-08-01,21,161,KY,Mason County,6646,6323,323,4.9
CN2116300000000,2022-08-01,21,163,KY,Meade County,11725,11222,503,4.3
CN2116500000000,2022-08-01,21,165,KY,Menifee County,2394,2280,114,4.8
CN2116700000000,2022-08-01,21,167,KY,Mercer County,10136,9766,370,3.7
CN2116900000000,2022-08-01,21,169,KY,Metcalfe County,3911,3736,175,4.5
CN2117100000000,2022-08-01,21,171,KY,Monroe County,4585,4435,150,3.3
CN2117300000000,2022-08-01,21,173,KY,Montgomery County,12066,11540,526,4.4
CN2117500000000,2022-08-01,21,175,KY,Morgan County,4130,3931,199,4.8
CN2117700000000,2022-08-01,21,177,KY,Muhlenberg County,9768,9191,577,5.9
CN2117900000000,2022-08-01,21,179,KY,Nelson County,23931,23124,807,3.4
CN2118100000000,2022-08-01,21,181,KY,Nicholas County,3266,3122,144,4.4
CN2118300000000,2022-08-01,21,183,KY,Ohio County,9292,8827,465,5
CN2118500000000,2022-08-01,21,185,KY,Oldham County,33464,32500,964,2.9
CN2118700000000,2022-08-01,21,187,KY,Owen County,5346,5175,171,3.2
CN2118900000000,2022-08-01,21,189,KY,Owsley County,1097,1019,78,7.1
CN2119100000000,2022-08-01,21,191,KY,Pendleton County,6984,6749,235,3.4
CN2119300000000,2022-08-01,21,193,KY,Perry County,7964,7537,427,5.4
CN2119500000000,2022-08-01,21,195,KY,Pike County,18667,17693,974,5.2
CN2119700000000,2022-08-01,21,197,KY,Powell County,5331,5122,209,3.9
CN2119900000000,2022-08-01,21,199,KY,Pulaski County,25634,24442,1192,4.7
CN2120100000000,2022-08-01,21,201,KY,Robertson County,831,787,44,5.3
CN2120300000000,2022-08-01,21,203,KY,Rockcastle County,6473,6156,317,4.9
CN2120500000000,2022-08-01,21,205,KY,Rowan County,10109,9657,452,4.5
CN2120700000000,2022-08-01,21,207,KY,Russell County,6320,6011,309,4.9
CN2120900000000,2022-08-01,21,209,KY,Scott County,30521,29602,919,3
CN2121100000000,2022-08-01,21,211,KY,Shelby County,26085,25280,805,3.1
CN2121300000000,2022-08-01,21,213,KY,Simpson County,8956,8637,319,3.6
CN2121500000000,2022-08-01,21,215,KY,Spencer County,10606,10259,347,3.3
CN2121700000000,2022-08-01,21,217,KY,Taylor County,11921,11458,463,3.9
CN2121900000000,2022-08-01,21,219,KY,Todd County,5799,5609,190,3.3
CN2122100000000,2022-08-01,21,221,KY,Trigg County,6085,5810,275,4.5
CN2122300000000,2022-08-01,21,223,KY,Trimble County,3853,3709,144,3.7
CN2122500000000,2022-08-01,21,225,KY,Union County,5915,5659,256,4.3
CN2122700000000,2022-08-01,21,227,KY,Warren County,65859,63523,2336,3.5
CN2122900000000,2022-08-01,21,229,KY,Washington County,6172,5969,203,3.3
CN2123100000000,2022-08-01,21,231,KY,Wayne County,7215,6862,353,4.9
CN2123300000000,2022-08-01,21,233,KY,Webster County,5226,5015,211,4
CN2123500000000,2022-08-01,21,235,KY,Whitley County,13914,13267,647,4.6
CN2123700000000,2022-08-01,21,237,KY,Wolfe County,2276,2153,123,5.4
CN2123900000000,2022-08-01,21,239,KY,Woodford County,15244,14777,467,3.1
CN2200100000000,2022-08-01,22,001,LA,Acadia Parish,23950,23013,937,3.9
CN2200300000000,2022-08-01,22,003,LA,Allen Parish,8002,7640,362,4.5
CN2200500000000,2022-08-01,22,005,LA,Ascension Parish,67414,65301,2113,3.1
CN2200700000000,2022-08-01,22,007,LA,Assumption Parish,8779,8344,435,5
CN2200900000000,2022-08-01,22,009,LA,Avoyelles Parish,14384,13684,700,4.9
CN2201100000000,2022-08-01,22,011,LA,Beauregard Parish,14894,14376,518,3.5
CN2201300000000,2022-08-01,22,013,LA,Bienville Parish,5208,4978,230,4.4
CN2201500000000,2022-08-01,22,015,LA,Bossier Parish,58157,56271,1886,3.2
CN2201700000000,2022-08-01,22,017,LA,Caddo Parish,102098,97580,4518,4.4
CN2201900000000,2022-08-01,22,019,LA,Calcasieu Parish,92242,88806,3436,3.7
CN2202100000000,2022-08-01,22,021,LA,Caldwell Parish,3674,3523,151,4.1
CN2202300000000,2022-08-01,22,023,LA,Cameron Parish,3415,3318,97,2.8
CN2202500000000,2022-08-01,22,025,LA,Catahoula Parish,3449,3300,149,4.3
CN2202700000000,2022-08-01,22,027,LA,Claiborne Parish,5479,5234,245,4.5
CN2202900000000,2022-08-01,22,029,LA,Concordia Parish,7024,6663,361,5.1
CN2203100000000,2022-08-01,22,031,LA,De Soto Parish,10949,10485,464,4.2
CN2203300000000,2022-08-01,22,033,LA,East Baton Rouge Parish,235822,226735,9087,3.9
CN2203500000000,2022-08-01,22,035,LA,East Carroll Parish,1663,1510,153,9.2
CN2203700000000,2022-08-01,22,037,LA,East Feliciana Parish,7936,7668,268,3.4
CN2203900000000,2022-08-01,22,039,LA,Evangeline Parish,11854,11313,541,4.6
CN2204100000000,2022-08-01,22,041,LA,Franklin Parish,7368,6994,374,5.1
CN2204300000000,2022-08-01,22,043,LA,Grant Parish,8379,8057,322,3.8
CN2204500000000,2022-08-01,22,045,LA,Iberia Parish,27667,26447,1220,4.4
CN2204700000000,2022-08-01,22,047,LA,Iberville Parish,14019,13352,667,4.8
CN2204900000000,2022-08-01,22,049,LA,Jackson Parish,6861,6608,253,3.7
CN2205100000000,2022-08-01,22,051,LA,Jefferson Parish,210469,202619,7850,3.7
CN2205300000000,2022-08-01,22,053,LA,Jefferson Davis Parish,12344,11891,453,3.7
CN2205500000000,2022-08-01,22,055,LA,Lafayette Parish,117088,113123,3965,3.4
CN2205700000000,2022-08-01,22,057,LA,Lafourche Parish,40748,39326,1422,3.5
CN2205900000000,2022-08-01,22,059,LA,LaSalle Parish,6771,6585,186,2.7
CN2206100000000,2022-08-01,22,061,LA,Lincoln Parish,20540,19676,864,4.2
CN2206300000000,2022-08-01,22,063,LA,Livingston Parish,72201,69999,2202,3
CN2206500000000,2022-08-01,22,065,LA,Madison Parish,3558,3352,206,5.8
CN2206700000000,2022-08-01,22,067,LA,Morehouse Parish,9930,9374,556,5.6
CN2206900000000,2022-08-01,22,069,LA,Natchitoches Parish,16839,16070,769,4.6
CN2207100000000,2022-08-01,22,071,LA,Orleans Parish,176704,168323,8381,4.7
CN2207300000000,2022-08-01,22,073,LA,Ouachita Parish,70763,67941,2822,4
CN2207500000000,2022-08-01,22,075,LA,Plaquemines Parish,9759,9426,333,3.4
CN2207700000000,2022-08-01,22,077,LA,Pointe Coupee Parish,9868,9430,438,4.4
CN2207900000000,2022-08-01,22,079,LA,Rapides Parish,56522,54528,1994,3.5
CN2208100000000,2022-08-01,22,081,LA,Red River Parish,4023,3887,136,3.4
CN2208300000000,2022-08-01,22,083,LA,Richland Parish,8333,7959,374,4.5
CN2208500000000,2022-08-01,22,085,LA,Sabine Parish,9125,8811,314,3.4
CN2208700000000,2022-08-01,22,087,LA,St. Bernard Parish,19958,19123,835,4.2
CN2208900000000,2022-08-01,22,089,LA,St. Charles Parish,24811,23939,872,3.5
CN2209100000000,2022-08-01,22,091,LA,St. Helena Parish,4310,4063,247,5.7
CN2209300000000,2022-08-01,22,093,LA,St. James Parish,8925,8490,435,4.9
CN2209500000000,2022-08-01,22,095,LA,St. John the Baptist Parish,19104,18139,965,5.1
CN2209700000000,2022-08-01,22,097,LA,St. Landry Parish,31805,30253,1552,4.9
CN2209900000000,2022-08-01,22,099,LA,St. Martin Parish,22200,21328,872,3.9
CN2210100000000,2022-08-01,22,101,LA,St. Mary Parish,19468,18573,895,4.6
CN2210300000000,2022-08-01,22,103,LA,St. Tammany Parish,119661,115910,3751,3.1
CN2210500000000,2022-08-01,22,105,LA,Tangipahoa Parish,56668,54018,2650,4.7
CN2210700000000,2022-08-01,22,107,LA,Tensas Parish,1328,1260,68,5.1
CN2210900000000,2022-08-01,22,109,LA,Terrebonne Parish,44821,43030,1791,4
CN2211100000000,2022-08-01,22,111,LA,Union Parish,9184,8810,374,4.1
CN2211300000000,2022-08-01,22,113,LA,Vermilion Parish,24112,23223,889,3.7
CN2211500000000,2022-08-01,22,115,LA,Vernon Parish,16372,15736,636,3.9
CN2211700000000,2022-08-01,22,117,LA,Washington Parish,17132,16365,767,4.5
CN2211900000000,2022-08-01,22,119,LA,Webster Parish,14260,13576,684,4.8
CN2212100000000,2022-08-01,22,121,LA,West Baton Rouge Parish,14144,13632,512,3.6
CN2212300000000,2022-08-01,22,123,LA,West Carroll Parish,3467,3268,199,5.7
CN2212500000000,2022-08-01,22,125,LA,West Feliciana Parish,5470,5316,154,2.8
CN2212700000000,2022-08-01,22,127,LA,Winn Parish,4694,4489,205,4.4
CN2300100000000,2022-08-01,23,001,ME,Androscoggin County,52259,50978,1281,2.5
CN2300300000000,2022-08-01,23,003,ME,Aroostook County,28190,27382,808,2.9
CN2300500000000,2022-08-01,23,005,ME,Cumberland County,164613,161404,3209,1.9
CN2300700000000,2022-08-01,23,007,ME,Franklin County,13508,13140,368,2.7
CN2300900000000,2022-08-01,23,009,ME,Hancock County,31041,30418,623,2
CN2301100000000,2022-08-01,23,011,ME,Kennebec County,61381,59998,1383,2.3
CN2301300000000,2022-08-01,23,013,ME,Knox County,20604,20178,426,2.1
CN2301500000000,2022-08-01,23,015,ME,Lincoln County,17581,17229,352,2
CN2301700000000,2022-08-01,23,017,ME,Oxford County,26248,25562,686,2.6
CN2301900000000,2022-08-01,23,019,ME,Penobscot County,74031,72195,1836,2.5
CN2302100000000,2022-08-01,23,021,ME,Piscataquis County,7377,7164,213,2.9
CN2302300000000,2022-08-01,23,023,ME,Sagadahoc County,19115,18749,366,1.9
CN2302500000000,2022-08-01,23,025,ME,Somerset County,21987,21320,667,3
CN2302700000000,2022-08-01,23,027,ME,Waldo County,20745,20258,487,2.3
CN2302900000000,2022-08-01,23,029,ME,Washington County,13539,13134,405,3
CN2303100000000,2022-08-01,23,031,ME,York County,113743,111548,2195,1.9
CN2400100000000,2022-08-01,24,001,MD,Allegany County,30739,29388,1351,4.4
CN2400300000000,2022-08-01,24,003,MD,Anne Arundel County,315647,305873,9774,3.1
CN2400500000000,2022-08-01,24,005,MD,Baltimore County,446703,431103,15600,3.5
CN2400900000000,2022-08-01,24,009,MD,Calvert County,49347,47673,1674,3.4
CN2401100000000,2022-08-01,24,011,MD,Caroline County,17116,16567,549,3.2
CN2401300000000,2022-08-01,24,013,MD,Carroll County,95388,92524,2864,3
CN2401500000000,2022-08-01,24,015,MD,Cecil County,53757,51814,1943,3.6
CN2401700000000,2022-08-01,24,017,MD,Charles County,86472,83295,3177,3.7
CN2401900000000,2022-08-01,24,019,MD,Dorchester County,16731,16130,601,3.6
CN2402100000000,2022-08-01,24,021,MD,Frederick County,137023,132641,4382,3.2
CN2402300000000,2022-08-01,24,023,MD,Garrett County,14792,14275,517,3.5
CN2402500000000,2022-08-01,24,025,MD,Harford County,141008,136345,4663,3.3
CN2402700000000,2022-08-01,24,027,MD,Howard County,188701,183267,5434,2.9
CN2402900000000,2022-08-01,24,029,MD,Kent County,9903,9548,355,3.6
CN2403100000000,2022-08-01,24,031,MD,Montgomery County,550107,533085,17022,3.1
CN2403300000000,2022-08-01,24,033,MD,Prince George's County,494913,476907,18006,3.6
CN2403500000000,2022-08-01,24,035,MD,Queen Anne's County,28216,27380,836,3
CN2403700000000,2022-08-01,24,037,MD,St. Mary's County,57638,55527,2111,3.7
CN2403900000000,2022-08-01,24,039,MD,Somerset County,9451,8978,473,5
CN2404100000000,2022-08-01,24,041,MD,Talbot County,17840,17242,598,3.4
CN2404300000000,2022-08-01,24,043,MD,Washington County,72163,69574,2589,3.6
CN2404500000000,2022-08-01,24,045,MD,Wicomico County,53392,51333,2059,3.9
CN2404700000000,2022-08-01,24,047,MD,Worcester County,25942,24978,964,3.7
CN2451000000000,2022-08-01,24,510,MD,Baltimore city,275841,263287,12554,4.6
CN2500100000000,2022-08-01,25,001,MA,Barnstable County,121924,117741,4183,3.4
CN2500300000000,2022-08-01,25,003,MA,Berkshire County,63200,60647,2553,4
CN2500500000000,2022-08-01,25,005,MA,Bristol County,300209,286272,13937,4.6
CN2500700000000,2022-08-01,25,007,MA,Dukes County,11757,11410,347,3
CN2500900000000,2022-08-01,25,009,MA,Essex County,424425,407430,16995,4
CN2501100000000,2022-08-01,25,011,MA,Franklin County,40200,38843,1357,3.4
CN2501300000000,2022-08-01,25,013,MA,Hampden County,223474,211722,11752,5.3
CN2501500000000,2022-08-01,25,015,MA,Hampshire County,89195,85922,3273,3.7
CN2501700000000,2022-08-01,25,017,MA,Middlesex County,916035,886232,29803,3.3
CN2501900000000,2022-08-01,25,019,MA,Nantucket County/town,9949,9698,251,2.5
CN2502100000000,2022-08-01,25,021,MA,Norfolk County,395262,381444,13818,3.5
CN2502300000000,2022-08-01,25,023,MA,Plymouth County,286223,274951,11272,3.9
CN2502500000000,2022-08-01,25,025,MA,Suffolk County,457112,438985,18127,4
CN2502700000000,2022-08-01,25,027,MA,Worcester County,444741,426489,18252,4.1
CN2600100000000,2022-08-01,26,001,MI,Alcona County,4060,3793,267,6.6
CN2600300000000,2022-08-01,26,003,MI,Alger County,3525,3314,211,6
CN2600500000000,2022-08-01,26,005,MI,Allegan County,62983,60637,2346,3.7
CN2600700000000,2022-08-01,26,007,MI,Alpena County,13080,12398,682,5.2
CN2600900000000,2022-08-01,26,009,MI,Antrim County,10991,10423,568,5.2
CN2601100000000,2022-08-01,26,011,MI,Arenac County,5965,5577,388,6.5
CN2601300000000,2022-08-01,26,013,MI,Baraga County,3105,2889,216,7
CN2601500000000,2022-08-01,26,015,MI,Barry County,32116,30825,1291,4
CN2601700000000,2022-08-01,26,017,MI,Bay County,49467,46877,2590,5.2
CN2601900000000,2022-08-01,26,019,MI,Benzie County,9177,8751,426,4.6
CN2602100000000,2022-08-01,26,021,MI,Berrien County,72975,69552,3423,4.7
CN2602300000000,2022-08-01,26,023,MI,Branch County,19991,19120,871,4.4
CN2602500000000,2022-08-01,26,025,MI,Calhoun County,60234,57089,3145,5.2
CN2602700000000,2022-08-01,26,027,MI,Cass County,23728,22563,1165,4.9
CN2602900000000,2022-08-01,26,029,MI,Charlevoix County,13893,13338,555,4
CN2603100000000,2022-08-01,26,031,MI,Cheboygan County,11110,10585,525,4.7
CN2603300000000,2022-08-01,26,033,MI,Chippewa County,16188,15238,950,5.9
CN2603500000000,2022-08-01,26,035,MI,Clare County,11220,10452,768,6.8
CN2603700000000,2022-08-01,26,037,MI,Clinton County,39964,38211,1753,4.4
CN2603900000000,2022-08-01,26,039,MI,Crawford County,5670,5315,355,6.3
CN2604100000000,2022-08-01,26,041,MI,Delta County,16886,16001,885,5.2
CN2604300000000,2022-08-01,26,043,MI,Dickinson County,12408,11869,539,4.3
CN2604500000000,2022-08-01,26,045,MI,Eaton County,55420,52699,2721,4.9
CN2604700000000,2022-08-01,26,047,MI,Emmet County,18125,17330,795,4.4
CN2604900000000,2022-08-01,26,049,MI,Genesee County,180478,169950,10528,5.8
CN2605100000000,2022-08-01,26,051,MI,Gladwin County,10205,9612,593,5.8
CN2605300000000,2022-08-01,26,053,MI,Gogebic County,5669,5368,301,5.3
CN2605500000000,2022-08-01,26,055,MI,Grand Traverse County,52036,50189,1847,3.5
CN2605700000000,2022-08-01,26,057,MI,Gratiot County,17209,16322,887,5.2
CN2605900000000,2022-08-01,26,059,MI,Hillsdale County,20413,19486,927,4.5
CN2606100000000,2022-08-01,26,061,MI,Houghton County,16045,15271,774,4.8
CN2606300000000,2022-08-01,26,063,MI,Huron County,15396,14671,725,4.7
CN2606500000000,2022-08-01,26,065,MI,Ingham County,144854,137608,7246,5
CN2606700000000,2022-08-01,26,067,MI,Ionia County,30441,29177,1264,4.2
CN2606900000000,2022-08-01,26,069,MI,Iosco County,10718,10087,631,5.9
CN2607100000000,2022-08-01,26,071,MI,Iron County,4820,4555,265,5.5
CN2607300000000,2022-08-01,26,073,MI,Isabella County,31060,29444,1616,5.2
CN2607500000000,2022-08-01,26,075,MI,Jackson County,73193,69761,3432,4.7
CN2607700000000,2022-08-01,26,077,MI,Kalamazoo County,131378,125705,5673,4.3
CN2607900000000,2022-08-01,26,079,MI,Kalkaska County,8234,7801,433,5.3
CN2608100000000,2022-08-01,26,081,MI,Kent County,362201,348596,13605,3.8
CN2608300000000,2022-08-01,26,083,MI,Keweenaw County,889,846,43,4.8
CN2608500000000,2022-08-01,26,085,MI,Lake County,4007,3736,271,6.8
CN2608700000000,2022-08-01,26,087,MI,Lapeer County,40457,38946,1511,3.7
CN2608900000000,2022-08-01,26,089,MI,Leelanau County,10872,10454,418,3.8
CN2609100000000,2022-08-01,26,091,MI,Lenawee County,44705,42595,2110,4.7
CN2609300000000,2022-08-01,26,093,MI,Livingston County,103830,100969,2861,2.8
CN2609500000000,2022-08-01,26,095,MI,Luce County,2219,2096,123,5.5
CN2609700000000,2022-08-01,26,097,MI,Mackinac County,6131,5920,211,3.4
CN2609900000000,2022-08-01,26,099,MI,Macomb County,443799,427857,15942,3.6
CN2610100000000,2022-08-01,26,101,MI,Manistee County,10178,9632,546,5.4
CN2610300000000,2022-08-01,26,103,MI,Marquette County,31962,30398,1564,4.9
CN2610500000000,2022-08-01,26,105,MI,Mason County,13869,13218,651,4.7
CN2610700000000,2022-08-01,26,107,MI,Mecosta County,17957,16927,1030,5.7
CN2610900000000,2022-08-01,26,109,MI,Menominee County,10784,10308,476,4.4
CN2611100000000,2022-08-01,26,111,MI,Midland County,40652,38834,1818,4.5
CN2611300000000,2022-08-01,26,113,MI,Missaukee County,6985,6646,339,4.9
CN2611500000000,2022-08-01,26,115,MI,Monroe County,73909,70309,3600,4.9
CN2611700000000,2022-08-01,26,117,MI,Montcalm County,28188,26844,1344,4.8
CN2611900000000,2022-08-01,26,119,MI,Montmorency County,3119,2881,238,7.6
CN2612100000000,2022-08-01,26,121,MI,Muskegon County,78402,74189,4213,5.4
CN2612300000000,2022-08-01,26,123,MI,Newaygo County,23520,22377,1143,4.9
CN2612500000000,2022-08-01,26,125,MI,Oakland County,671453,651341,20112,3
CN2612700000000,2022-08-01,26,127,MI,Oceana County,12287,11585,702,5.7
CN2612900000000,2022-08-01,26,129,MI,Ogemaw County,8490,7944,546,6.4
CN2613100000000,2022-08-01,26,131,MI,Ontonagon County,2042,1889,153,7.5
CN2613300000000,2022-08-01,26,133,MI,Osceola County,11425,10900,525,4.6
CN2613500000000,2022-08-01,26,135,MI,Oscoda County,2982,2755,227,7.6
CN2613700000000,2022-08-01,26,137,MI,Otsego County,11784,11174,610,5.2
CN2613900000000,2022-08-01,26,139,MI,Ottawa County,162985,157297,5688,3.5
CN2614100000000,2022-08-01,26,141,MI,Presque Isle County,5115,4787,328,6.4
CN2614300000000,2022-08-01,26,143,MI,Roscommon County,8362,7745,617,7.4
CN2614500000000,2022-08-01,26,145,MI,Saginaw County,82871,78097,4774,5.8
CN2614700000000,2022-08-01,26,147,MI,St. Clair County,74981,72246,2735,3.6
CN2614900000000,2022-08-01,26,149,MI,St. Joseph County,29063,27719,1344,4.6
CN2615100000000,2022-08-01,26,151,MI,Sanilac County,19355,18311,1044,5.4
CN2615300000000,2022-08-01,26,153,MI,Schoolcraft County,3188,2970,218,6.8
CN2615500000000,2022-08-01,26,155,MI,Shiawassee County,32230,30657,1573,4.9
CN2615700000000,2022-08-01,26,157,MI,Tuscola County,23142,21853,1289,5.6
CN2615900000000,2022-08-01,26,159,MI,Van Buren County,34260,32518,1742,5.1
CN2616100000000,2022-08-01,26,161,MI,Washtenaw County,194013,186405,7608,3.9
CN2616300000000,2022-08-01,26,163,MI,Wayne County,793794,757237,36557,4.6
CN2616500000000,2022-08-01,26,165,MI,Wexford County,15044,14299,745,5
CN2700100000000,2022-08-01,27,001,MN,Aitkin County,7526,7275,251,3.3
CN2700300000000,2022-08-01,27,003,MN,Anoka County,199935,194518,5417,2.7
CN2700500000000,2022-08-01,27,005,MN,Becker County,20016,19543,473,2.4
CN2700700000000,2022-08-01,27,007,MN,Beltrami County,25475,24720,755,3
CN2700900000000,2022-08-01,27,009,MN,Benton County,21472,20850,622,2.9
CN2701100000000,2022-08-01,27,011,MN,Big Stone County,2444,2380,64,2.6
CN2701300000000,2022-08-01,27,013,MN,Blue Earth County,39388,38471,917,2.3
CN2701500000000,2022-08-01,27,015,MN,Brown County,13758,13421,337,2.4
CN2701700000000,2022-08-01,27,017,MN,Carlton County,17377,16860,517,3
CN2701900000000,2022-08-01,27,019,MN,Carver County,59721,58404,1317,2.2
CN2702100000000,2022-08-01,27,021,MN,Cass County,15540,15032,508,3.3
CN2702300000000,2022-08-01,27,023,MN,Chippewa County,6358,6205,153,2.4
CN2702500000000,2022-08-01,27,025,MN,Chisago County,30067,29261,806,2.7
CN2702700000000,2022-08-01,27,027,MN,Clay County,37616,36822,794,2.1
CN2702900000000,2022-08-01,27,029,MN,Clearwater County,4529,4323,206,4.5
CN2703100000000,2022-08-01,27,031,MN,Cook County,3113,3037,76,2.4
CN2703300000000,2022-08-01,27,033,MN,Cottonwood County,6593,6398,195,3
CN2703500000000,2022-08-01,27,035,MN,Crow Wing County,34232,33390,842,2.5
CN2703700000000,2022-08-01,27,037,MN,Dakota County,243823,237703,6120,2.5
CN2703900000000,2022-08-01,27,039,MN,Dodge County,12021,11739,282,2.3
CN2704100000000,2022-08-01,27,041,MN,Douglas County,22105,21652,453,2
CN2704300000000,2022-08-01,27,043,MN,Faribault County,7183,6988,195,2.7
CN2704500000000,2022-08-01,27,045,MN,Fillmore County,11549,11272,277,2.4
CN2704700000000,2022-08-01,27,047,MN,Freeborn County,15592,15151,441,2.8
CN2704900000000,2022-08-01,27,049,MN,Goodhue County,27001,26316,685,2.5
CN2705100000000,2022-08-01,27,051,MN,Grant County,3246,3174,72,2.2
CN2705300000000,2022-08-01,27,053,MN,Hennepin County,711389,691935,19454,2.7
CN2705500000000,2022-08-01,27,055,MN,Houston County,10385,10190,195,1.9
CN2705700000000,2022-08-01,27,057,MN,Hubbard County,10729,10388,341,3.2
CN2705900000000,2022-08-01,27,059,MN,Isanti County,21718,21130,588,2.7
CN2706100000000,2022-08-01,27,061,MN,Itasca County,22150,21304,846,3.8
CN2706300000000,2022-08-01,27,063,MN,Jackson County,5429,5306,123,2.3
CN2706500000000,2022-08-01,27,065,MN,Kanabec County,9148,8863,285,3.1
CN2706700000000,2022-08-01,27,067,MN,Kandiyohi County,23294,22705,589,2.5
CN2706900000000,2022-08-01,27,069,MN,Kittson County,2198,2138,60,2.7
CN2707100000000,2022-08-01,27,071,MN,Koochiching County,5922,5702,220,3.7
CN2707300000000,2022-08-01,27,073,MN,Lac qui Parle County,3205,3127,78,2.4
CN2707500000000,2022-08-01,27,075,MN,Lake County,5620,5249,371,6.6
CN2707700000000,2022-08-01,27,077,MN,Lake of the Woods County,2453,2353,100,4.1
CN2707900000000,2022-08-01,27,079,MN,Le Sueur County,15867,15455,412,2.6
CN2708100000000,2022-08-01,27,081,MN,Lincoln County,2973,2903,70,2.4
CN2708300000000,2022-08-01,27,083,MN,Lyon County,14016,13671,345,2.5
CN2708500000000,2022-08-01,27,085,MN,McLeod County,19312,18806,506,2.6
CN2708700000000,2022-08-01,27,087,MN,Mahnomen County,2218,2125,93,4.2
CN2708900000000,2022-08-01,27,089,MN,Marshall County,5224,5092,132,2.5
CN2709100000000,2022-08-01,27,091,MN,Martin County,9826,9563,263,2.7
CN2709300000000,2022-08-01,27,093,MN,Meeker County,13593,13282,311,2.3
CN2709500000000,2022-08-01,27,095,MN,Mille Lacs County,12607,12196,411,3.3
CN2709700000000,2022-08-01,27,097,MN,Morrison County,16966,16423,543,3.2
CN2709900000000,2022-08-01,27,099,MN,Mower County,20531,19997,534,2.6
CN2710100000000,2022-08-01,27,101,MN,Murray County,4601,4511,90,2
CN2710300000000,2022-08-01,27,103,MN,Nicollet County,20241,19833,408,2
CN2710500000000,2022-08-01,27,105,MN,Nobles County,10941,10695,246,2.2
CN2710700000000,2022-08-01,27,107,MN,Norman County,3182,3084,98,3.1
CN2710900000000,2022-08-01,27,109,MN,Olmsted County,92377,90330,2047,2.2
CN2711100000000,2022-08-01,27,111,MN,Otter Tail County,32189,31445,744,2.3
CN2711300000000,2022-08-01,27,113,MN,Pennington County,8809,8584,225,2.6
CN2711500000000,2022-08-01,27,115,MN,Pine County,14306,13848,458,3.2
CN2711700000000,2022-08-01,27,117,MN,Pipestone County,4745,4648,97,2
CN2711900000000,2022-08-01,27,119,MN,Polk County,15821,15357,464,2.9
CN2712100000000,2022-08-01,27,121,MN,Pope County,6569,6449,120,1.8
CN2712300000000,2022-08-01,27,123,MN,Ramsey County,288159,279575,8584,3
CN2712500000000,2022-08-01,27,125,MN,Red Lake County,2144,2068,76,3.5
CN2712700000000,2022-08-01,27,127,MN,Redwood County,7579,7383,196,2.6
CN2712900000000,2022-08-01,27,129,MN,Renville County,7975,7694,281,3.5
CN2713100000000,2022-08-01,27,131,MN,Rice County,37563,36626,937,2.5
CN2713300000000,2022-08-01,27,133,MN,Rock County,5943,5842,101,1.7
CN2713500000000,2022-08-01,27,135,MN,Roseau County,7846,7641,205,2.6
CN2713700000000,2022-08-01,27,137,MN,St. Louis County,99731,96380,3351,3.4
CN2713900000000,2022-08-01,27,139,MN,Scott County,84863,82909,1954,2.3
CN2714100000000,2022-08-01,27,141,MN,Sherburne County,53283,51890,1393,2.6
CN2714300000000,2022-08-01,27,143,MN,Sibley County,8064,7857,207,2.6
CN2714500000000,2022-08-01,27,145,MN,Stearns County,89078,86822,2256,2.5
CN2714700000000,2022-08-01,27,147,MN,Steele County,19310,18722,588,3
CN2714900000000,2022-08-01,27,149,MN,Stevens County,5267,5163,104,2
CN2715100000000,2022-08-01,27,151,MN,Swift County,4832,4696,136,2.8
CN2715300000000,2022-08-01,27,153,MN,Todd County,13400,13073,327,2.4
CN2715500000000,2022-08-01,27,155,MN,Traverse County,1624,1593,31,1.9
CN2715700000000,2022-08-01,27,157,MN,Wabasha County,12312,12015,297,2.4
CN2715900000000,2022-08-01,27,159,MN,Wadena County,6013,5812,201,3.3
CN2716100000000,2022-08-01,27,161,MN,Waseca County,8721,8440,281,3.2
CN2716300000000,2022-08-01,27,163,MN,Washington County,145757,142242,3515,2.4
CN2716500000000,2022-08-01,27,165,MN,Watonwan County,6466,6306,160,2.5
CN2716700000000,2022-08-01,27,167,MN,Wilkin County,3329,3246,83,2.5
CN2716900000000,2022-08-01,27,169,MN,Winona County,28142,27472,670,2.4
CN2717100000000,2022-08-01,27,171,MN,Wright County,76946,75148,1798,2.3
CN2717300000000,2022-08-01,27,173,MN,Yellow Medicine County,4960,4819,141,2.8
CN2800100000000,2022-08-01,28,001,MS,Adams County,10673,10113,560,5.2
CN2800300000000,2022-08-01,28,003,MS,Alcorn County,14894,14326,568,3.8
CN2800500000000,2022-08-01,28,005,MS,Amite County,4237,4002,235,5.5
CN2800700000000,2022-08-01,28,007,MS,Attala County,6853,6555,298,4.3
CN2800900000000,2022-08-01,28,009,MS,Benton County,3073,2922,151,4.9
CN2801100000000,2022-08-01,28,011,MS,Bolivar County,10877,10325,552,5.1
CN2801300000000,2022-08-01,28,013,MS,Calhoun County,5221,4983,238,4.6
CN2801500000000,2022-08-01,28,015,MS,Carroll County,3280,3128,152,4.6
CN2801700000000,2022-08-01,28,017,MS,Chickasaw County,6453,6120,333,5.2
CN2801900000000,2022-08-01,28,019,MS,Choctaw County,3531,3407,124,3.5
CN2802100000000,2022-08-01,28,021,MS,Claiborne County,2916,2646,270,9.3
CN2802300000000,2022-08-01,28,023,MS,Clarke County,5512,5247,265,4.8
CN2802500000000,2022-08-01,28,025,MS,Clay County,8795,8421,374,4.3
CN2802700000000,2022-08-01,28,027,MS,Coahoma County,7400,6967,433,5.9
CN2802900000000,2022-08-01,28,029,MS,Copiah County,10749,10261,488,4.5
CN2803100000000,2022-08-01,28,031,MS,Covington County,8239,7939,300,3.6
CN2803300000000,2022-08-01,28,033,MS,DeSoto County,94275,91126,3149,3.3
CN2803500000000,2022-08-01,28,035,MS,Forrest County,33293,32021,1272,3.8
CN2803700000000,2022-08-01,28,037,MS,Franklin County,2585,2445,140,5.4
CN2803900000000,2022-08-01,28,039,MS,George County,8642,8181,461,5.3
CN2804100000000,2022-08-01,28,041,MS,Greene County,4164,3898,266,6.4
CN2804300000000,2022-08-01,28,043,MS,Grenada County,8868,8524,344,3.9
CN2804500000000,2022-08-01,28,045,MS,Hancock County,18862,18069,793,4.2
CN2804700000000,2022-08-01,28,047,MS,Harrison County,87480,84107,3373,3.9
CN2804900000000,2022-08-01,28,049,MS,Hinds County,102095,97969,4126,4
CN2805100000000,2022-08-01,28,051,MS,Holmes County,4955,4619,336,6.8
CN2805300000000,2022-08-01,28,053,MS,Humphreys County,1892,1733,159,8.4
CN2805500000000,2022-08-01,28,055,MS,Issaquena County,298,277,21,7
CN2805700000000,2022-08-01,28,057,MS,Itawamba County,10193,9838,355,3.5
CN2805900000000,2022-08-01,28,059,MS,Jackson County,58859,56276,2583,4.4
CN2806100000000,2022-08-01,28,061,MS,Jasper County,5844,5549,295,5
CN2806300000000,2022-08-01,28,063,MS,Jefferson County,1904,1612,292,15.3
CN2806500000000,2022-08-01,28,065,MS,Jefferson Davis County,3884,3694,190,4.9
CN2806700000000,2022-08-01,28,067,MS,Jones County,24997,23920,1077,4.3
CN2806900000000,2022-08-01,28,069,MS,Kemper County,3181,2992,189,5.9
CN2807100000000,2022-08-01,28,071,MS,Lafayette County,27742,26800,942,3.4
CN2807300000000,2022-08-01,28,073,MS,Lamar County,31704,30726,978,3.1
CN2807500000000,2022-08-01,28,075,MS,Lauderdale County,28631,27447,1184,4.1
CN2807700000000,2022-08-01,28,077,MS,Lawrence County,4781,4548,233,4.9
CN2807900000000,2022-08-01,28,079,MS,Leake County,7877,7546,331,4.2
CN2808100000000,2022-08-01,28,081,MS,Lee County,40751,39305,1446,3.5
CN2808300000000,2022-08-01,28,083,MS,Leflore County,9320,8798,522,5.6
CN2808500000000,2022-08-01,28,085,MS,Lincoln County,14736,14156,580,3.9
CN2808700000000,2022-08-01,28,087,MS,Lowndes County,24518,23468,1050,4.3
CN2808900000000,2022-08-01,28,089,MS,Madison County,53416,51694,1722,3.2
CN2809100000000,2022-08-01,28,091,MS,Marion County,9902,9517,385,3.9
CN2809300000000,2022-08-01,28,093,MS,Marshall County,14247,13665,582,4.1
CN2809500000000,2022-08-01,28,095,MS,Monroe County,15391,14722,669,4.3
CN2809700000000,2022-08-01,28,097,MS,Montgomery County,3943,3769,174,4.4
CN2809900000000,2022-08-01,28,099,MS,Neshoba County,9754,9313,441,4.5
CN2810100000000,2022-08-01,28,101,MS,Newton County,7813,7477,336,4.3
CN2810300000000,2022-08-01,28,103,MS,Noxubee County,3294,3088,206,6.3
CN2810500000000,2022-08-01,28,105,MS,Oktibbeha County,21723,20775,948,4.4
CN2810700000000,2022-08-01,28,107,MS,Panola County,12339,11759,580,4.7
CN2810900000000,2022-08-01,28,109,MS,Pearl River County,23419,22499,920,3.9
CN2811100000000,2022-08-01,28,111,MS,Perry County,4235,4024,211,5
CN2811300000000,2022-08-01,28,113,MS,Pike County,13942,13228,714,5.1
CN2811500000000,2022-08-01,28,115,MS,Pontotoc County,14794,14234,560,3.8
CN2811700000000,2022-08-01,28,117,MS,Prentiss County,11200,10802,398,3.6
CN2811900000000,2022-08-01,28,119,MS,Quitman County,2226,2093,133,6
CN2812100000000,2022-08-01,28,121,MS,Rankin County,76814,74488,2326,3
CN2812300000000,2022-08-01,28,123,MS,Scott County,12180,11760,420,3.4
CN2812500000000,2022-08-01,28,125,MS,Sharkey County,1252,1173,79,6.3
CN2812700000000,2022-08-01,28,127,MS,Simpson County,10564,10152,412,3.9
CN2812900000000,2022-08-01,28,129,MS,Smith County,6556,6307,249,3.8
CN2813100000000,2022-08-01,28,131,MS,Stone County,6930,6638,292,4.2
CN2813300000000,2022-08-01,28,133,MS,Sunflower County,7038,6605,433,6.2
CN2813500000000,2022-08-01,28,135,MS,Tallahatchie County,4501,4309,192,4.3
CN2813700000000,2022-08-01,28,137,MS,Tate County,12121,11641,480,4
CN2813900000000,2022-08-01,28,139,MS,Tippah County,9743,9399,344,3.5
CN2814100000000,2022-08-01,28,141,MS,Tishomingo County,8474,8160,314,3.7
CN2814300000000,2022-08-01,28,143,MS,Tunica County,4152,3968,184,4.4
CN2814500000000,2022-08-01,28,145,MS,Union County,14742,14298,444,3
CN2814700000000,2022-08-01,28,147,MS,Walthall County,4889,4645,244,5
CN2814900000000,2022-08-01,28,149,MS,Warren County,19264,18433,831,4.3
CN2815100000000,2022-08-01,28,151,MS,Washington County,14600,13725,875,6
CN2815300000000,2022-08-01,28,153,MS,Wayne County,6918,6563,355,5.1
CN2815500000000,2022-08-01,28,155,MS,Webster County,3819,3665,154,4
CN2815700000000,2022-08-01,28,157,MS,Wilkinson County,2585,2417,168,6.5
CN2815900000000,2022-08-01,28,159,MS,Winston County,7130,6802,328,4.6
CN2816100000000,2022-08-01,28,161,MS,Yalobusha County,4737,4531,206,4.3
CN2816300000000,2022-08-01,28,163,MS,Yazoo County,8762,8350,412,4.7
CN2900100000000,2022-08-01,29,001,MO,Adair County,9489,9141,348,3.7
CN2900300000000,2022-08-01,29,003,MO,Andrew County,9390,9141,249,2.7
CN2900500000000,2022-08-01,29,005,MO,Atchison County,2409,2341,68,2.8
CN2900700000000,2022-08-01,29,007,MO,Audrain County,9529,9213,316,3.3
CN2900900000000,2022-08-01,29,009,MO,Barry County,13580,13153,427,3.1
CN2901100000000,2022-08-01,29,011,MO,Barton County,5065,4935,130,2.6
CN2901300000000,2022-08-01,29,013,MO,Bates County,7642,7415,227,3
CN2901500000000,2022-08-01,29,015,MO,Benton County,7113,6834,279,3.9
CN2901700000000,2022-08-01,29,017,MO,Bollinger County,5220,5060,160,3.1
CN2901900000000,2022-08-01,29,019,MO,Boone County,99986,97638,2348,2.3
CN2902100000000,2022-08-01,29,021,MO,Buchanan County,42187,41027,1160,2.7
CN2902300000000,2022-08-01,29,023,MO,Butler County,17837,17231,606,3.4
CN2902500000000,2022-08-01,29,025,MO,Caldwell County,4241,4112,129,3
CN2902700000000,2022-08-01,29,027,MO,Callaway County,21633,21019,614,2.8
CN2902900000000,2022-08-01,29,029,MO,Camden County,20109,19512,597,3
CN2903100000000,2022-08-01,29,031,MO,Cape Girardeau County,40193,39154,1039,2.6
CN2903300000000,2022-08-01,29,033,MO,Carroll County,4287,4176,111,2.6
CN2903500000000,2022-08-01,29,035,MO,Carter County,2548,2457,91,3.6
CN2903700000000,2022-08-01,29,037,MO,Cass County,55648,54127,1521,2.7
CN2903900000000,2022-08-01,29,039,MO,Cedar County,5527,5346,181,3.3
CN2904100000000,2022-08-01,29,041,MO,Chariton County,3482,3405,77,2.2
CN2904300000000,2022-08-01,29,043,MO,Christian County,47384,46238,1146,2.4
CN2904500000000,2022-08-01,29,045,MO,Clark County,3008,2890,118,3.9
CN2904700000000,2022-08-01,29,047,MO,Clay County,140497,136809,3688,2.6
CN2904900000000,2022-08-01,29,049,MO,Clinton County,10699,10369,330,3.1
CN2905100000000,2022-08-01,29,051,MO,Cole County,39329,38374,955,2.4
CN2905300000000,2022-08-01,29,053,MO,Cooper County,6877,6681,196,2.9
CN2905500000000,2022-08-01,29,055,MO,Crawford County,10809,10465,344,3.2
CN2905700000000,2022-08-01,29,057,MO,Dade County,3237,3156,81,2.5
CN2905900000000,2022-08-01,29,059,MO,Dallas County,7135,6929,206,2.9
CN2906100000000,2022-08-01,29,061,MO,Daviess County,3755,3643,112,3
CN2906300000000,2022-08-01,29,063,MO,DeKalb County,4001,3874,127,3.2
CN2906500000000,2022-08-01,29,065,MO,Dent County,5898,5683,215,3.6
CN2906700000000,2022-08-01,29,067,MO,Douglas County,4951,4796,155,3.1
CN2906900000000,2022-08-01,29,069,MO,Dunklin County,10471,9969,502,4.8
CN2907100000000,2022-08-01,29,071,MO,Franklin County,53261,51900,1361,2.6
CN2907300000000,2022-08-01,29,073,MO,Gasconade County,7540,7337,203,2.7
CN2907500000000,2022-08-01,29,075,MO,Gentry County,2999,2918,81,2.7
CN2907700000000,2022-08-01,29,077,MO,Greene County,154812,151172,3640,2.4
CN2907900000000,2022-08-01,29,079,MO,Grundy County,3699,3584,115,3.1
CN2908100000000,2022-08-01,29,081,MO,Harrison County,3491,3396,95,2.7
CN2908300000000,2022-08-01,29,083,MO,Henry County,9895,9574,321,3.2
CN2908500000000,2022-08-01,29,085,MO,Hickory County,3896,3781,115,3
CN2908700000000,2022-08-01,29,087,MO,Holt County,2305,2257,48,2.1
CN2908900000000,2022-08-01,29,089,MO,Howard County,4569,4432,137,3
CN2909100000000,2022-08-01,29,091,MO,Howell County,15725,15188,537,3.4
CN2909300000000,2022-08-01,29,093,MO,Iron County,3439,3289,150,4.4
CN2909500000000,2022-08-01,29,095,MO,Jackson County,365365,353877,11488,3.1
CN2909700000000,2022-08-01,29,097,MO,Jasper County,56954,55448,1506,2.6
CN2909900000000,2022-08-01,29,099,MO,Jefferson County,119181,115995,3186,2.7
CN2910100000000,2022-08-01,29,101,MO,Johnson County,22296,21595,701,3.1
CN2910300000000,2022-08-01,29,103,MO,Knox County,1581,1535,46,2.9
CN2910500000000,2022-08-01,29,105,MO,Laclede County,16016,15569,447,2.8
CN2910700000000,2022-08-01,29,107,MO,Lafayette County,16860,16361,499,3
CN2910900000000,2022-08-01,29,109,MO,Lawrence County,16442,15945,497,3
CN2911100000000,2022-08-01,29,111,MO,Lewis County,4534,4410,124,2.7
CN2911300000000,2022-08-01,29,113,MO,Lincoln County,29417,28588,829,2.8
CN2911500000000,2022-08-01,29,115,MO,Linn County,4896,4727,169,3.5
CN2911700000000,2022-08-01,29,117,MO,Livingston County,7019,6866,153,2.2
CN2911900000000,2022-08-01,29,119,MO,McDonald County,11100,10798,302,2.7
CN2912100000000,2022-08-01,29,121,MO,Macon County,6859,6650,209,3
CN2912300000000,2022-08-01,29,123,MO,Madison County,5338,5162,176,3.3
CN2912500000000,2022-08-01,29,125,MO,Maries County,3709,3592,117,3.2
CN2912700000000,2022-08-01,29,127,MO,Marion County,13578,13202,376,2.8
CN2912900000000,2022-08-01,29,129,MO,Mercer County,1473,1430,43,2.9
CN2913100000000,2022-08-01,29,131,MO,Miller County,12743,12407,336,2.6
CN2913300000000,2022-08-01,29,133,MO,Mississippi County,5034,4841,193,3.8
CN2913500000000,2022-08-01,29,135,MO,Moniteau County,7003,6822,181,2.6
CN2913700000000,2022-08-01,29,137,MO,Monroe County,3536,3430,106,3
CN2913900000000,2022-08-01,29,139,MO,Montgomery County,5799,5653,146,2.5
CN2914100000000,2022-08-01,29,141,MO,Morgan County,8454,8193,261,3.1
CN2914300000000,2022-08-01,29,143,MO,New Madrid County,7862,7563,299,3.8
CN2914500000000,2022-08-01,29,145,MO,Newton County,26916,26153,763,2.8
CN2914700000000,2022-08-01,29,147,MO,Nodaway County,10663,10367,296,2.8
CN2914900000000,2022-08-01,29,149,MO,Oregon County,3710,3583,127,3.4
CN2915100000000,2022-08-01,29,151,MO,Osage County,7003,6845,158,2.3
CN2915300000000,2022-08-01,29,153,MO,Ozark County,3159,3027,132,4.2
CN2915500000000,2022-08-01,29,155,MO,Pemiscot County,5706,5462,244,4.3
CN2915700000000,2022-08-01,29,157,MO,Perry County,9556,9337,219,2.3
CN2915900000000,2022-08-01,29,159,MO,Pettis County,20053,19388,665,3.3
CN2916100000000,2022-08-01,29,161,MO,Phelps County,20146,19574,572,2.8
CN2916300000000,2022-08-01,29,163,MO,Pike County,7011,6802,209,3
CN2916500000000,2022-08-01,29,165,MO,Platte County,60755,59299,1456,2.4
CN2916700000000,2022-08-01,29,167,MO,Polk County,14649,14209,440,3
CN2916900000000,2022-08-01,29,169,MO,Pulaski County,14630,14120,510,3.5
CN2917100000000,2022-08-01,29,171,MO,Putnam County,2106,2048,58,2.8
CN2917300000000,2022-08-01,29,173,MO,Ralls County,5317,5179,138,2.6
CN2917500000000,2022-08-01,29,175,MO,Randolph County,9908,9618,290,2.9
CN2917700000000,2022-08-01,29,177,MO,Ray County,10980,10619,361,3.3
CN2917900000000,2022-08-01,29,179,MO,Reynolds County,2655,2564,91,3.4
CN2918100000000,2022-08-01,29,181,MO,Ripley County,4998,4798,200,4
CN2918300000000,2022-08-01,29,183,MO,St. Charles County,230810,225615,5195,2.3
CN2918500000000,2022-08-01,29,185,MO,St. Clair County,3611,3497,114,3.2
CN2918600000000,2022-08-01,29,186,MO,Ste. Genevieve County,9252,9011,241,2.6
CN2918700000000,2022-08-01,29,187,MO,St. Francois County,25704,24742,962,3.7
CN2918900000000,2022-08-01,29,189,MO,St. Louis County,531389,516663,14726,2.8
CN2919500000000,2022-08-01,29,195,MO,Saline County,9782,9466,316,3.2
CN2919700000000,2022-08-01,29,197,MO,Schuyler County,1709,1651,58,3.4
CN2919900000000,2022-08-01,29,199,MO,Scotland County,2166,2114,52,2.4
CN2920100000000,2022-08-01,29,201,MO,Scott County,19762,19217,545,2.8
CN2920300000000,2022-08-01,29,203,MO,Shannon County,3186,3063,123,3.9
CN2920500000000,2022-08-01,29,205,MO,Shelby County,2753,2682,71,2.6
CN2920700000000,2022-08-01,29,207,MO,Stoddard County,12770,12326,444,3.5
CN2920900000000,2022-08-01,29,209,MO,Stone County,13910,13446,464,3.3
CN2921100000000,2022-08-01,29,211,MO,Sullivan County,2352,2284,68,2.9
CN2921300000000,2022-08-01,29,213,MO,Taney County,26738,25872,866,3.2
CN2921500000000,2022-08-01,29,215,MO,Texas County,8677,8393,284,3.3
CN2921700000000,2022-08-01,29,217,MO,Vernon County,8814,8544,270,3.1
CN2921900000000,2022-08-01,29,219,MO,Warren County,18872,18355,517,2.7
CN2922100000000,2022-08-01,29,221,MO,Washington County,10066,9742,324,3.2
CN2922300000000,2022-08-01,29,223,MO,Wayne County,4841,4645,196,4
CN2922500000000,2022-08-01,29,225,MO,Webster County,17512,17041,471,2.7
CN2922700000000,2022-08-01,29,227,MO,Worth County,1055,1030,25,2.4
CN2922900000000,2022-08-01,29,229,MO,Wright County,7214,6985,229,3.2
CN2951000000000,2022-08-01,29,510,MO,St. Louis city,150376,145041,5335,3.5
CN3000100000000,2022-08-01,30,001,MT,Beaverhead County,5543,5431,112,2
CN3000300000000,2022-08-01,30,003,MT,Big Horn County,4586,4384,202,4.4
CN3000500000000,2022-08-01,30,005,MT,Blaine County,2121,2052,69,3.3
CN3000700000000,2022-08-01,30,007,MT,Broadwater County,2877,2788,89,3.1
CN3000900000000,2022-08-01,30,009,MT,Carbon County,5820,5676,144,2.5
CN3001100000000,2022-08-01,30,011,MT,Carter County,615,600,15,2.4
CN3001300000000,2022-08-01,30,013,MT,Cascade County,39657,38660,997,2.5
CN3001500000000,2022-08-01,30,015,MT,Chouteau County,2411,2354,57,2.4
CN3001700000000,2022-08-01,30,017,MT,Custer County,6416,6263,153,2.4
CN3001900000000,2022-08-01,30,019,MT,Daniels County,864,847,17,2
CN3002100000000,2022-08-01,30,021,MT,Dawson County,4437,4325,112,2.5
CN3002300000000,2022-08-01,30,023,MT,Deer Lodge County,5530,5406,124,2.2
CN3002500000000,2022-08-01,30,025,MT,Fallon County,1682,1659,23,1.4
CN3002700000000,2022-08-01,30,027,MT,Fergus County,5873,5745,128,2.2
CN3002900000000,2022-08-01,30,029,MT,Flathead County,55064,53664,1400,2.5
CN3003100000000,2022-08-01,30,031,MT,Gallatin County,80383,79043,1340,1.7
CN3003300000000,2022-08-01,30,033,MT,Garfield County,689,672,17,2.5
CN3003500000000,2022-08-01,30,035,MT,Glacier County,6227,5923,304,4.9
CN3003700000000,2022-08-01,30,037,MT,Golden Valley County,369,358,11,3
CN3003900000000,2022-08-01,30,039,MT,Granite County,1659,1613,46,2.8
CN3004100000000,2022-08-01,30,041,MT,Hill County,7439,7223,216,2.9
CN3004300000000,2022-08-01,30,043,MT,Jefferson County,6231,6080,151,2.4
CN3004500000000,2022-08-01,30,045,MT,Judith Basin County,887,864,23,2.6
CN3004700000000,2022-08-01,30,047,MT,Lake County,14912,14453,459,3.1
CN3004900000000,2022-08-01,30,049,MT,Lewis and Clark County,39779,38840,939,2.4
CN3005100000000,2022-08-01,30,051,MT,Liberty County,922,894,28,3
CN3005300000000,2022-08-01,30,053,MT,Lincoln County,8930,8581,349,3.9
CN3005500000000,2022-08-01,30,055,MT,McCone County,917,899,18,2
CN3005700000000,2022-08-01,30,057,MT,Madison County,4999,4895,104,2.1
CN3005900000000,2022-08-01,30,059,MT,Meagher County,1032,1011,21,2
CN3006100000000,2022-08-01,30,061,MT,Mineral County,2020,1936,84,4.2
CN3006300000000,2022-08-01,30,063,MT,Missoula County,66764,65172,1592,2.4
CN3006500000000,2022-08-01,30,065,MT,Musselshell County,2306,2242,64,2.8
CN3006700000000,2022-08-01,30,067,MT,Park County,10736,10468,268,2.5
CN3006900000000,2022-08-01,30,069,MT,Petroleum County,252,244,8,3.2
CN3007100000000,2022-08-01,30,071,MT,Phillips County,1739,1676,63,3.6
CN3007300000000,2022-08-01,30,073,MT,Pondera County,2544,2478,66,2.6
CN3007500000000,2022-08-01,30,075,MT,Powder River County,948,930,18,1.9
CN3007700000000,2022-08-01,30,077,MT,Powell County,2974,2905,69,2.3
CN3007900000000,2022-08-01,30,079,MT,Prairie County,484,470,14,2.9
CN3008100000000,2022-08-01,30,081,MT,Ravalli County,22028,21479,549,2.5
CN3008300000000,2022-08-01,30,083,MT,Richland County,5729,5561,168,2.9
CN3008500000000,2022-08-01,30,085,MT,Roosevelt County,4332,4181,151,3.5
CN3008700000000,2022-08-01,30,087,MT,Rosebud County,3553,3412,141,4
CN3008900000000,2022-08-01,30,089,MT,Sanders County,5506,5306,200,3.6
CN3009100000000,2022-08-01,30,091,MT,Sheridan County,1734,1705,29,1.7
CN3009300000000,2022-08-01,30,093,MT,Silver Bow County,18162,17659,503,2.8
CN3009500000000,2022-08-01,30,095,MT,Stillwater County,5407,5291,116,2.1
CN3009700000000,2022-08-01,30,097,MT,Sweet Grass County,1851,1817,34,1.8
CN3009900000000,2022-08-01,30,099,MT,Teton County,2774,2707,67,2.4
CN3010100000000,2022-08-01,30,101,MT,Toole County,2115,2080,35,1.7
CN3010300000000,2022-08-01,30,103,MT,Treasure County,322,314,8,2.5
CN3010500000000,2022-08-01,30,105,MT,Valley County,3993,3904,89,2.2
CN3010700000000,2022-08-01,30,107,MT,Wheatland County,723,703,20,2.8
CN3010900000000,2022-08-01,30,109,MT,Wibaux County,458,449,9,2
CN3011100000000,2022-08-01,30,111,MT,Yellowstone County,88295,86153,2142,2.4
CN3100100000000,2022-08-01,31,001,NE,Adams County,17364,16974,390,2.2
CN3100300000000,2022-08-01,31,003,NE,Antelope County,3603,3529,74,2.1
CN3100500000000,2022-08-01,31,005,NE,Arthur County,229,223,6,2.6
CN3100700000000,2022-08-01,31,007,NE,Banner County,374,362,12,3.2
CN3100900000000,2022-08-01,31,009,NE,Blaine County,240,230,10,4.2
CN3101100000000,2022-08-01,31,011,NE,Boone County,3005,2947,58,1.9
CN3101300000000,2022-08-01,31,013,NE,Box Butte County,5363,5232,131,2.4
CN3101500000000,2022-08-01,31,015,NE,Boyd County,987,963,24,2.4
CN3101700000000,2022-08-01,31,017,NE,Brown County,1424,1388,36,2.5
CN3101900000000,2022-08-01,31,019,NE,Buffalo County,28259,27661,598,2.1
CN3102100000000,2022-08-01,31,021,NE,Burt County,3508,3426,82,2.3
CN3102300000000,2022-08-01,31,023,NE,Butler County,4723,4625,98,2.1
CN3102500000000,2022-08-01,31,025,NE,Cass County,13819,13470,349,2.5
CN3102700000000,2022-08-01,31,027,NE,Cedar County,4582,4496,86,1.9
CN3102900000000,2022-08-01,31,029,NE,Chase County,2242,2194,48,2.1
CN3103100000000,2022-08-01,31,031,NE,Cherry County,3386,3322,64,1.9
CN3103300000000,2022-08-01,31,033,NE,Cheyenne County,4283,4173,110,2.6
CN3103500000000,2022-08-01,31,035,NE,Clay County,3127,3055,72,2.3
CN3103700000000,2022-08-01,31,037,NE,Colfax County,5801,5683,118,2
CN3103900000000,2022-08-01,31,039,NE,Cuming County,4855,4751,104,2.1
CN3104100000000,2022-08-01,31,041,NE,Custer County,6299,6189,110,1.7
CN3104300000000,2022-08-01,31,043,NE,Dakota County,10983,10694,289,2.6
CN3104500000000,2022-08-01,31,045,NE,Dawes County,4786,4657,129,2.7
CN3104700000000,2022-08-01,31,047,NE,Dawson County,13689,13346,343,2.5
CN3104900000000,2022-08-01,31,049,NE,Deuel County,1048,1020,28,2.7
CN3105100000000,2022-08-01,31,051,NE,Dixon County,3008,2940,68,2.3
CN3105300000000,2022-08-01,31,053,NE,Dodge County,20783,20307,476,2.3
CN3105500000000,2022-08-01,31,055,NE,Douglas County,309865,301163,8702,2.8
CN3105700000000,2022-08-01,31,057,NE,Dundy County,1153,1133,20,1.7
CN3105900000000,2022-08-01,31,059,NE,Fillmore County,3333,3263,70,2.1
CN3106100000000,2022-08-01,31,061,NE,Franklin County,1540,1502,38,2.5
CN3106300000000,2022-08-01,31,063,NE,Frontier County,1458,1420,38,2.6
CN3106500000000,2022-08-01,31,065,NE,Furnas County,2480,2426,54,2.2
CN3106700000000,2022-08-01,31,067,NE,Gage County,10808,10533,275,2.5
CN3106900000000,2022-08-01,31,069,NE,Garden County,1162,1138,24,2.1
CN3107100000000,2022-08-01,31,071,NE,Garfield County,1176,1150,26,2.2
CN3107300000000,2022-08-01,31,073,NE,Gosper County,1276,1248,28,2.2
CN3107500000000,2022-08-01,31,075,NE,Grant County,408,402,6,1.5
CN3107700000000,2022-08-01,31,077,NE,Greeley County,1225,1199,26,2.1
CN3107900000000,2022-08-01,31,079,NE,Hall County,33062,32269,793,2.4
CN3108100000000,2022-08-01,31,081,NE,Hamilton County,4919,4819,100,2
CN3108300000000,2022-08-01,31,083,NE,Harlan County,1875,1839,36,1.9
CN3108500000000,2022-08-01,31,085,NE,Hayes County,566,554,12,2.1
CN3108700000000,2022-08-01,31,087,NE,Hitchcock County,1290,1258,32,2.5
CN3108900000000,2022-08-01,31,089,NE,Holt County,5684,5576,108,1.9
CN3109100000000,2022-08-01,31,091,NE,Hooker County,443,429,14,3.2
CN3109300000000,2022-08-01,31,093,NE,Howard County,3480,3412,68,2
CN3109500000000,2022-08-01,31,095,NE,Jefferson County,4215,4131,84,2
CN3109700000000,2022-08-01,31,097,NE,Johnson County,2015,1963,52,2.6
CN3109900000000,2022-08-01,31,099,NE,Kearney County,3696,3622,74,2
CN3110100000000,2022-08-01,31,101,NE,Keith County,4824,4730,94,1.9
CN3110300000000,2022-08-01,31,103,NE,Keya Paha County,525,511,14,2.7
CN3110500000000,2022-08-01,31,105,NE,Kimball County,1981,1943,38,1.9
CN3110700000000,2022-08-01,31,107,NE,Knox County,4620,4512,108,2.3
CN3110900000000,2022-08-01,31,109,NE,Lancaster County,180471,176268,4203,2.3
CN3111100000000,2022-08-01,31,111,NE,Lincoln County,18609,18181,428,2.3
CN3111300000000,2022-08-01,31,113,NE,Logan County,471,459,12,2.5
CN3111500000000,2022-08-01,31,115,NE,Loup County,395,381,14,3.5
CN3111700000000,2022-08-01,31,117,NE,McPherson County,430,422,8,1.9
CN3111900000000,2022-08-01,31,119,NE,Madison County,19897,19459,438,2.2
CN3112100000000,2022-08-01,31,121,NE,Merrick County,4188,4106,82,2
CN3112300000000,2022-08-01,31,123,NE,Morrill County,2654,2590,64,2.4
CN3112500000000,2022-08-01,31,125,NE,Nance County,1996,1958,38,1.9
CN3112700000000,2022-08-01,31,127,NE,Nemaha County,3517,3423,94,2.7
CN3112900000000,2022-08-01,31,129,NE,Nuckolls County,2468,2416,52,2.1
CN3113100000000,2022-08-01,31,131,NE,Otoe County,8622,8419,203,2.4
CN3113300000000,2022-08-01,31,133,NE,Pawnee County,1462,1428,34,2.3
CN3113500000000,2022-08-01,31,135,NE,Perkins County,1853,1817,36,1.9
CN3113700000000,2022-08-01,31,137,NE,Phelps County,5003,4889,114,2.3
CN3113900000000,2022-08-01,31,139,NE,Pierce County,4213,4129,84,2
CN3114100000000,2022-08-01,31,141,NE,Platte County,18739,18331,408,2.2
CN3114300000000,2022-08-01,31,143,NE,Polk County,2825,2763,62,2.2
CN3114500000000,2022-08-01,31,145,NE,Red Willow County,5978,5843,135,2.3
CN3114700000000,2022-08-01,31,147,NE,Richardson County,4227,4133,94,2.2
CN3114900000000,2022-08-01,31,149,NE,Rock County,883,869,14,1.6
CN3115100000000,2022-08-01,31,151,NE,Saline County,7144,6953,191,2.7
CN3115300000000,2022-08-01,31,153,NE,Sarpy County,100858,98462,2396,2.4
CN3115500000000,2022-08-01,31,155,NE,Saunders County,11708,11451,257,2.2
CN3115700000000,2022-08-01,31,157,NE,Scotts Bluff County,17982,17486,496,2.8
CN3115900000000,2022-08-01,31,159,NE,Seward County,8894,8685,209,2.3
CN3116100000000,2022-08-01,31,161,NE,Sheridan County,2781,2713,68,2.4
CN3116300000000,2022-08-01,31,163,NE,Sherman County,1662,1618,44,2.6
CN3116500000000,2022-08-01,31,165,NE,Sioux County,759,743,16,2.1
CN3116700000000,2022-08-01,31,167,NE,Stanton County,3554,3478,76,2.1
CN3116900000000,2022-08-01,31,169,NE,Thayer County,2694,2640,54,2
CN3117100000000,2022-08-01,31,171,NE,Thomas County,466,452,14,3
CN3117300000000,2022-08-01,31,173,NE,Thurston County,3252,3125,127,3.9
CN3117500000000,2022-08-01,31,175,NE,Valley County,2122,2078,44,2.1
CN3117700000000,2022-08-01,31,177,NE,Washington County,11590,11321,269,2.3
CN3117900000000,2022-08-01,31,179,NE,Wayne County,5417,5270,147,2.7
CN3118100000000,2022-08-01,31,181,NE,Webster County,1668,1620,48,2.9
CN3118300000000,2022-08-01,31,183,NE,Wheeler County,517,507,10,1.9
CN3118500000000,2022-08-01,31,185,NE,York County,7462,7277,185,2.5
CN3200100000000,2022-08-01,32,001,NV,Churchill County,10594,10144,450,4.2
CN3200300000000,2022-08-01,32,003,NV,Clark County,1164524,1092187,72337,6.2
CN3200500000000,2022-08-01,32,005,NV,Douglas County,22606,21643,963,4.3
CN3200700000000,2022-08-01,32,007,NV,Elko County,25765,24806,959,3.7
CN3200900000000,2022-08-01,32,009,NV,Esmeralda County,378,358,20,5.3
CN3201100000000,2022-08-01,32,011,NV,Eureka County,859,823,36,4.2
CN3201300000000,2022-08-01,32,013,NV,Humboldt County,7361,7064,297,4
CN3201500000000,2022-08-01,32,015,NV,Lander County,2983,2878,105,3.5
CN3201700000000,2022-08-01,32,017,NV,Lincoln County,1935,1847,88,4.5
CN3201900000000,2022-08-01,32,019,NV,Lyon County,23397,22124,1273,5.4
CN3202100000000,2022-08-01,32,021,NV,Mineral County,2003,1906,97,4.8
CN3202300000000,2022-08-01,32,023,NV,Nye County,17562,16442,1120,6.4
CN3202700000000,2022-08-01,32,027,NV,Pershing County,2263,2164,99,4.4
CN3202900000000,2022-08-01,32,029,NV,Storey County,2112,2018,94,4.5
CN3203100000000,2022-08-01,32,031,NV,Washoe County,258034,248310,9724,3.8
CN3203300000000,2022-08-01,32,033,NV,White Pine County,4506,4351,155,3.4
CN3251000000000,2022-08-01,32,510,NV,Carson City,25512,24440,1072,4.2
CN3300100000000,2022-08-01,33,001,NH,Belknap County,32800,31945,855,2.6
CN3300300000000,2022-08-01,33,003,NH,Carroll County,25281,24618,663,2.6
CN3300500000000,2022-08-01,33,005,NH,Cheshire County,39345,38221,1124,2.9
CN3300700000000,2022-08-01,33,007,NH,Coos County,14878,14264,614,4.1
CN3300900000000,2022-08-01,33,009,NH,Grafton County,50130,48911,1219,2.4
CN3301100000000,2022-08-01,33,011,NH,Hillsborough County,242540,235696,6844,2.8
CN3301300000000,2022-08-01,33,013,NH,Merrimack County,83067,81003,2064,2.5
CN3301500000000,2022-08-01,33,015,NH,Rockingham County,192917,187471,5446,2.8
CN3301700000000,2022-08-01,33,017,NH,Strafford County,74964,73094,1870,2.5
CN3301900000000,2022-08-01,33,019,NH,Sullivan County,23116,22497,619,2.7
CN3400100000000,2022-08-01,34,001,NJ,Atlantic County,125573,120430,5143,4.1
CN3400300000000,2022-08-01,34,003,NJ,Bergen County,506034,491270,14764,2.9
CN3400500000000,2022-08-01,34,005,NJ,Burlington County,249792,242355,7437,3
CN3400700000000,2022-08-01,34,007,NJ,Camden County,271866,262260,9606,3.5
CN3400900000000,2022-08-01,34,009,NJ,Cape May County,58188,56377,1811,3.1
CN3401100000000,2022-08-01,34,011,NJ,Cumberland County,69923,66849,3074,4.4
CN3401300000000,2022-08-01,34,013,NJ,Essex County,389080,373878,15202,3.9
CN3401500000000,2022-08-01,34,015,NJ,Gloucester County,162202,156985,5217,3.2
CN3401700000000,2022-08-01,34,017,NJ,Hudson County,378137,366297,11840,3.1
CN3401900000000,2022-08-01,34,019,NJ,Hunterdon County,68866,67177,1689,2.5
CN3402100000000,2022-08-01,34,021,NJ,Mercer County,217233,211147,6086,2.8
CN3402300000000,2022-08-01,34,023,NJ,Middlesex County,470210,456630,13580,2.9
CN3402500000000,2022-08-01,34,025,NJ,Monmouth County,353914,344073,9841,2.8
CN3402700000000,2022-08-01,34,027,NJ,Morris County,269954,263025,6929,2.6
CN3402900000000,2022-08-01,34,029,NJ,Ocean County,302555,293514,9041,3
CN3403100000000,2022-08-01,34,031,NJ,Passaic County,253324,243357,9967,3.9
CN3403300000000,2022-08-01,34,033,NJ,Salem County,31288,30037,1251,4
CN3403500000000,2022-08-01,34,035,NJ,Somerset County,180117,175368,4749,2.6
CN3403700000000,2022-08-01,34,037,NJ,Sussex County,78133,75748,2385,3.1
CN3403900000000,2022-08-01,34,039,NJ,Union County,290058,280568,9490,3.3
CN3404100000000,2022-08-01,34,041,NJ,Warren County,59634,57831,1803,3
CN3500100000000,2022-08-01,35,001,NM,Bernalillo County,335030,323841,11189,3.3
CN3500300000000,2022-08-01,35,003,NM,Catron County,1143,1085,58,5.1
CN3500500000000,2022-08-01,35,005,NM,Chaves County,27641,26562,1079,3.9
CN3500600000000,2022-08-01,35,006,NM,Cibola County,8031,7630,401,5
CN3500700000000,2022-08-01,35,007,NM,Colfax County,6007,5816,191,3.2
CN3500900000000,2022-08-01,35,009,NM,Curry County,22013,21351,662,3
CN3501100000000,2022-08-01,35,011,NM,De Baca County,759,739,20,2.6
CN3501300000000,2022-08-01,35,013,NM,Dona Ana County,99145,95349,3796,3.8
CN3501500000000,2022-08-01,35,015,NM,Eddy County,31133,30201,932,3
CN3501700000000,2022-08-01,35,017,NM,Grant County,11375,10951,424,3.7
CN3501900000000,2022-08-01,35,019,NM,Guadalupe County,1460,1388,72,4.9
CN3502100000000,2022-08-01,35,021,NM,Harding County,276,268,8,2.9
CN3502300000000,2022-08-01,35,023,NM,Hidalgo County,1857,1799,58,3.1
CN3502500000000,2022-08-01,35,025,NM,Lea County,29051,27912,1139,3.9
CN3502700000000,2022-08-01,35,027,NM,Lincoln County,9113,8808,305,3.3
CN3502800000000,2022-08-01,35,028,NM,Los Alamos County,10868,10649,219,2
CN3502900000000,2022-08-01,35,029,NM,Luna County,10065,9406,659,6.5
CN3503100000000,2022-08-01,35,031,NM,McKinley County,22519,21348,1171,5.2
CN3503300000000,2022-08-01,35,033,NM,Mora County,1928,1826,102,5.3
CN3503500000000,2022-08-01,35,035,NM,Otero County,24968,24000,968,3.9
CN3503700000000,2022-08-01,35,037,NM,Quay County,2925,2812,113,3.9
CN3503900000000,2022-08-01,35,039,NM,Rio Arriba County,16545,15905,640,3.9
CN3504100000000,2022-08-01,35,041,NM,Roosevelt County,7864,7579,285,3.6
CN3504300000000,2022-08-01,35,043,NM,Sandoval County,67741,65369,2372,3.5
CN3504500000000,2022-08-01,35,045,NM,San Juan County,49546,47494,2052,4.1
CN3504700000000,2022-08-01,35,047,NM,San Miguel County,10091,9588,503,5
CN3504900000000,2022-08-01,35,049,NM,Santa Fe County,72132,69764,2368,3.3
CN3505100000000,2022-08-01,35,051,NM,Sierra County,3880,3689,191,4.9
CN3505300000000,2022-08-01,35,053,NM,Socorro County,6140,5904,236,3.8
CN3505500000000,2022-08-01,35,055,NM,Taos County,14405,13782,623,4.3
CN3505700000000,2022-08-01,35,057,NM,Torrance County,5365,5098,267,5
CN3505900000000,2022-08-01,35,059,NM,Union County,1619,1578,41,2.5
CN3506100000000,2022-08-01,35,061,NM,Valencia County,30870,29646,1224,4
CN3600100000000,2022-08-01,36,001,NY,Albany County,160806,155393,5413,3.4
CN3600300000000,2022-08-01,36,003,NY,Allegany County,17992,17220,772,4.3
CN3600500000000,2022-08-01,36,005,NY,Bronx County,604252,561313,42939,7.1
CN3600700000000,2022-08-01,36,007,NY,Broome County,81903,78526,3377,4.1
CN3600900000000,2022-08-01,36,009,NY,Cattaraugus County,32029,30639,1390,4.3
CN3601100000000,2022-08-01,36,011,NY,Cayuga County,35314,33985,1329,3.8
CN3601300000000,2022-08-01,36,013,NY,Chautauqua County,53017,50838,2179,4.1
CN3601500000000,2022-08-01,36,015,NY,Chemung County,34848,33450,1398,4
CN3601700000000,2022-08-01,36,017,NY,Chenango County,21371,20662,709,3.3
CN3601900000000,2022-08-01,36,019,NY,Clinton County,34712,33375,1337,3.9
CN3602100000000,2022-08-01,36,021,NY,Columbia County,30948,30026,922,3
CN3602300000000,2022-08-01,36,023,NY,Cortland County,21595,20739,856,4
CN3602500000000,2022-08-01,36,025,NY,Delaware County,18145,17453,692,3.8
CN3602700000000,2022-08-01,36,027,NY,Dutchess County,146555,141698,4857,3.3
CN3602900000000,2022-08-01,36,029,NY,Erie County,446760,429178,17582,3.9
CN3603100000000,2022-08-01,36,031,NY,Essex County,17165,16605,560,3.3
CN3603300000000,2022-08-01,36,033,NY,Franklin County,18757,18057,700,3.7
CN3603500000000,2022-08-01,36,035,NY,Fulton County,22135,21232,903,4.1
CN3603700000000,2022-08-01,36,037,NY,Genesee County,29827,28907,920,3.1
CN3603900000000,2022-08-01,36,039,NY,Greene County,20192,19418,774,3.8
CN3604100000000,2022-08-01,36,041,NY,Hamilton County,2405,2335,70,2.9
CN3604300000000,2022-08-01,36,043,NY,Herkimer County,27517,26462,1055,3.8
CN3604500000000,2022-08-01,36,045,NY,Jefferson County,45438,43622,1816,4
CN3604700000000,2022-08-01,36,047,NY,Kings County,1211780,1146269,65511,5.4
CN3604900000000,2022-08-01,36,049,NY,Lewis County,11482,11056,426,3.7
CN3605100000000,2022-08-01,36,051,NY,Livingston County,30193,29185,1008,3.3
CN3605300000000,2022-08-01,36,053,NY,Madison County,33061,31957,1104,3.3
CN3605500000000,2022-08-01,36,055,NY,Monroe County,365723,351509,14214,3.9
CN3605700000000,2022-08-01,36,057,NY,Montgomery County,22066,21090,976,4.4
CN3605900000000,2022-08-01,36,059,NY,Nassau County,742930,718968,23962,3.2
CN3606100000000,2022-08-01,36,061,NY,New York County,922256,883202,39054,4.2
CN3606300000000,2022-08-01,36,063,NY,Niagara County,98527,94489,4038,4.1
CN3606500000000,2022-08-01,36,065,NY,Oneida County,101236,97349,3887,3.8
CN3606700000000,2022-08-01,36,067,NY,Onondaga County,226507,218372,8135,3.6
CN3606900000000,2022-08-01,36,069,NY,Ontario County,55681,53946,1735,3.1
CN3607100000000,2022-08-01,36,071,NY,Orange County,193351,186535,6816,3.5
CN3607300000000,2022-08-01,36,073,NY,Orleans County,17192,16465,727,4.2
CN3607500000000,2022-08-01,36,075,NY,Oswego County,53311,51083,2228,4.2
CN3607700000000,2022-08-01,36,077,NY,Otsego County,26798,25837,961,3.6
CN3607900000000,2022-08-01,36,079,NY,Putnam County,52054,50365,1689,3.2
CN3608100000000,2022-08-01,36,081,NY,Queens County,1142786,1089800,52986,4.6
CN3608300000000,2022-08-01,36,083,NY,Rensselaer County,82794,80083,2711,3.3
CN3608500000000,2022-08-01,36,085,NY,Richmond County,228689,216705,11984,5.2
CN3608700000000,2022-08-01,36,087,NY,Rockland County,161515,156323,5192,3.2
CN3608900000000,2022-08-01,36,089,NY,St. Lawrence County,40755,38812,1943,4.8
CN3609100000000,2022-08-01,36,091,NY,Saratoga County,122353,118889,3464,2.8
CN3609300000000,2022-08-01,36,093,NY,Schenectady County,78589,75729,2860,3.6
CN3609500000000,2022-08-01,36,095,NY,Schoharie County,14837,14277,560,3.8
CN3609700000000,2022-08-01,36,097,NY,Schuyler County,8158,7893,265,3.2
CN3609900000000,2022-08-01,36,099,NY,Seneca County,14862,14380,482,3.2
CN3610100000000,2022-08-01,36,101,NY,Steuben County,40696,39230,1466,3.6
CN3610300000000,2022-08-01,36,103,NY,Suffolk County,816250,787773,28477,3.5
CN3610500000000,2022-08-01,36,105,NY,Sullivan County,38550,37239,1311,3.4
CN3610700000000,2022-08-01,36,107,NY,Tioga County,22101,21376,725,3.3
CN3610900000000,2022-08-01,36,109,NY,Tompkins County,48535,47002,1533,3.2
CN3611100000000,2022-08-01,36,111,NY,Ulster County,87827,84751,3076,3.5
CN3611300000000,2022-08-01,36,113,NY,Warren County,32554,31539,1015,3.1
CN3611500000000,2022-08-01,36,115,NY,Washington County,28651,27758,893,3.1
CN3611700000000,2022-08-01,36,117,NY,Wayne County,43408,41939,1469,3.4
CN3611900000000,2022-08-01,36,119,NY,Westchester County,502730,485075,17655,3.5
CN3612100000000,2022-08-01,36,121,NY,Wyoming County,17348,16794,554,3.2
CN3612300000000,2022-08-01,36,123,NY,Yates County,11557,11222,335,2.9
CN3700100000000,2022-08-01,37,001,NC,Alamance County,83116,79512,3604,4.3
CN3700300000000,2022-08-01,37,003,NC,Alexander County,17995,17349,646,3.6
CN3700500000000,2022-08-01,37,005,NC,Alleghany County,4651,4469,182,3.9
CN3700700000000,2022-08-01,37,007,NC,Anson County,10192,9699,493,4.8
CN3700900000000,2022-08-01,37,009,NC,Ashe County,12956,12454,502,3.9
CN3701100000000,2022-08-01,37,011,NC,Avery County,7995,7718,277,3.5
CN3701300000000,2022-08-01,37,013,NC,Beaufort County,19758,18856,902,4.6
CN3701500000000,2022-08-01,37,015,NC,Bertie County,7082,6671,411,5.8
CN3701700000000,2022-08-01,37,017,NC,Bladen County,14596,13915,681,4.7
CN3701900000000,2022-08-01,37,019,NC,Brunswick County,58986,56030,2956,5
CN3702100000000,2022-08-01,37,021,NC,Buncombe County,142036,137334,4702,3.3
CN3702300000000,2022-08-01,37,023,NC,Burke County,40863,39269,1594,3.9
CN3702500000000,2022-08-01,37,025,NC,Cabarrus County,116297,111804,4493,3.9
CN3702700000000,2022-08-01,37,027,NC,Caldwell County,36388,34928,1460,4
CN3702900000000,2022-08-01,37,029,NC,Camden County,4669,4466,203,4.3
CN3703100000000,2022-08-01,37,031,NC,Carteret County,32572,31349,1223,3.8
CN3703300000000,2022-08-01,37,033,NC,Caswell County,9626,9171,455,4.7
CN3703500000000,2022-08-01,37,035,NC,Catawba County,79477,76364,3113,3.9
CN3703700000000,2022-08-01,37,037,NC,Chatham County,37629,36294,1335,3.5
CN3703900000000,2022-08-01,37,039,NC,Cherokee County,11050,10544,506,4.6
CN3704100000000,2022-08-01,37,041,NC,Chowan County,5745,5483,262,4.6
CN3704300000000,2022-08-01,37,043,NC,Clay County,4180,3987,193,4.6
CN3704500000000,2022-08-01,37,045,NC,Cleveland County,48512,46334,2178,4.5
CN3704700000000,2022-08-01,37,047,NC,Columbus County,23918,22830,1088,4.5
CN3704900000000,2022-08-01,37,049,NC,Craven County,42136,40371,1765,4.2
CN3705100000000,2022-08-01,37,051,NC,Cumberland County,126637,119194,7443,5.9
CN3705300000000,2022-08-01,37,053,NC,Currituck County,14782,14211,571,3.9
CN3705500000000,2022-08-01,37,055,NC,Dare County,22078,21301,777,3.5
CN3705700000000,2022-08-01,37,057,NC,Davidson County,81195,77957,3238,4
CN3705900000000,2022-08-01,37,059,NC,Davie County,20704,19900,804,3.9
CN3706100000000,2022-08-01,37,061,NC,Duplin County,24612,23573,1039,4.2
CN3706300000000,2022-08-01,37,063,NC,Durham County,179804,173366,6438,3.6
CN3706500000000,2022-08-01,37,065,NC,Edgecombe County,20217,18702,1515,7.5
CN3706700000000,2022-08-01,37,067,NC,Forsyth County,188279,180174,8105,4.3
CN3706900000000,2022-08-01,37,069,NC,Franklin County,34306,32905,1401,4.1
CN3707100000000,2022-08-01,37,071,NC,Gaston County,114882,110133,4749,4.1
CN3707300000000,2022-08-01,37,073,NC,Gates County,5168,4954,214,4.1
CN3707500000000,2022-08-01,37,075,NC,Graham County,2951,2792,159,5.4
CN3707700000000,2022-08-01,37,077,NC,Granville County,30313,29177,1136,3.7
CN3707900000000,2022-08-01,37,079,NC,Greene County,9474,9123,351,3.7
CN3708100000000,2022-08-01,37,081,NC,Guilford County,258434,246149,12285,4.8
CN3708300000000,2022-08-01,37,083,NC,Halifax County,19157,17902,1255,6.6
CN3708500000000,2022-08-01,37,085,NC,Harnett County,54842,52239,2603,4.7
CN3708700000000,2022-08-01,37,087,NC,Haywood County,30203,29136,1067,3.5
CN3708900000000,2022-08-01,37,089,NC,Henderson County,55572,53583,1989,3.6
CN3709100000000,2022-08-01,37,091,NC,Hertford County,8392,7891,501,6
CN3709300000000,2022-08-01,37,093,NC,Hoke County,20124,18977,1147,5.7
CN3709500000000,2022-08-01,37,095,NC,Hyde County,1864,1781,83,4.5
CN3709700000000,2022-08-01,37,097,NC,Iredell County,94783,91134,3649,3.8
CN3709900000000,2022-08-01,37,099,NC,Jackson County,19619,18747,872,4.4
CN3710100000000,2022-08-01,37,101,NC,Johnston County,109035,104915,4120,3.8
CN3710300000000,2022-08-01,37,103,NC,Jones County,4302,4147,155,3.6
CN3710500000000,2022-08-01,37,105,NC,Lee County,26069,24804,1265,4.9
CN3710700000000,2022-08-01,37,107,NC,Lenoir County,27495,26375,1120,4.1
CN3710900000000,2022-08-01,37,109,NC,Lincoln County,46481,44792,1689,3.6
CN3711100000000,2022-08-01,37,111,NC,McDowell County,20069,19263,806,4
CN3711300000000,2022-08-01,37,113,NC,Macon County,16193,15567,626,3.9
CN3711500000000,2022-08-01,37,115,NC,Madison County,10095,9703,392,3.9
CN3711700000000,2022-08-01,37,117,NC,Martin County,8519,8098,421,4.9
CN3711900000000,2022-08-01,37,119,NC,Mecklenburg County,653424,627519,25905,4
CN3712100000000,2022-08-01,37,121,NC,Mitchell County,5960,5689,271,4.5
CN3712300000000,2022-08-01,37,123,NC,Montgomery County,11190,10705,485,4.3
CN3712500000000,2022-08-01,37,125,NC,Moore County,42114,40355,1759,4.2
CN3712700000000,2022-08-01,37,127,NC,Nash County,42180,39727,2453,5.8
CN3712900000000,2022-08-01,37,129,NC,New Hanover County,130637,125829,4808,3.7
CN3713100000000,2022-08-01,37,131,NC,Northampton County,7205,6799,406,5.6
CN3713300000000,2022-08-01,37,133,NC,Onslow County,68483,65091,3392,5
CN3713500000000,2022-08-01,37,135,NC,Orange County,82044,79085,2959,3.6
CN3713700000000,2022-08-01,37,137,NC,Pamlico County,5501,5279,222,4
CN3713900000000,2022-08-01,37,139,NC,Pasquotank County,16739,15846,893,5.3
CN3714100000000,2022-08-01,37,141,NC,Pender County,31011,29798,1213,3.9
CN3714300000000,2022-08-01,37,143,NC,Perquimans County,4956,4708,248,5
CN3714500000000,2022-08-01,37,145,NC,Person County,18905,18113,792,4.2
CN3714700000000,2022-08-01,37,147,NC,Pitt County,87740,83497,4243,4.8
CN3714900000000,2022-08-01,37,149,NC,Polk County,9430,9038,392,4.2
CN3715100000000,2022-08-01,37,151,NC,Randolph County,64915,62113,2802,4.3
CN3715300000000,2022-08-01,37,153,NC,Richmond County,16848,15911,937,5.6
CN3715500000000,2022-08-01,37,155,NC,Robeson County,47643,44640,3003,6.3
CN3715700000000,2022-08-01,37,157,NC,Rockingham County,39207,37330,1877,4.8
CN3715900000000,2022-08-01,37,159,NC,Rowan County,67847,65087,2760,4.1
CN3716100000000,2022-08-01,37,161,NC,Rutherford County,24535,23217,1318,5.4
CN3716300000000,2022-08-01,37,163,NC,Sampson County,28707,27461,1246,4.3
CN3716500000000,2022-08-01,37,165,NC,Scotland County,11141,10352,789,7.1
CN3716700000000,2022-08-01,37,167,NC,Stanly County,30720,29558,1162,3.8
CN3716900000000,2022-08-01,37,169,NC,Stokes County,21593,20765,828,3.8
CN3717100000000,2022-08-01,37,171,NC,Surry County,32605,31310,1295,4
CN3717300000000,2022-08-01,37,173,NC,Swain County,7418,7168,250,3.4
CN3717500000000,2022-08-01,37,175,NC,Transylvania County,15100,14518,582,3.9
CN3717700000000,2022-08-01,37,177,NC,Tyrrell County,1438,1366,72,5
CN3717900000000,2022-08-01,37,179,NC,Union County,130599,125839,4760,3.6
CN3718100000000,2022-08-01,37,181,NC,Vance County,16828,15692,1136,6.8
CN3718300000000,2022-08-01,37,183,NC,Wake County,636850,614583,22267,3.5
CN3718500000000,2022-08-01,37,185,NC,Warren County,6462,6013,449,6.9
CN3718700000000,2022-08-01,37,187,NC,Washington County,4352,4107,245,5.6
CN3718900000000,2022-08-01,37,189,NC,Watauga County,29639,28507,1132,3.8
CN3719100000000,2022-08-01,37,191,NC,Wayne County,50400,48072,2328,4.6
CN3719300000000,2022-08-01,37,193,NC,Wilkes County,27041,25875,1166,4.3
CN3719500000000,2022-08-01,37,195,NC,Wilson County,33561,31513,2048,6.1
CN3719700000000,2022-08-01,37,197,NC,Yadkin County,17564,16904,660,3.8
CN3719900000000,2022-08-01,37,199,NC,Yancey County,8274,7940,334,4
CN3800100000000,2022-08-01,38,001,ND,Adams County,960,935,25,2.6
CN3800300000000,2022-08-01,38,003,ND,Barnes County,5166,5062,104,2
CN3800500000000,2022-08-01,38,005,ND,Benson County,2386,2321,65,2.7
CN3800700000000,2022-08-01,38,007,ND,Billings County,608,596,12,2
CN3800900000000,2022-08-01,38,009,ND,Bottineau County,3073,2986,87,2.8
CN3801100000000,2022-08-01,38,011,ND,Bowman County,1559,1531,28,1.8
CN3801300000000,2022-08-01,38,013,ND,Burke County,1034,1017,17,1.6
CN3801500000000,2022-08-01,38,015,ND,Burleigh County,53081,52091,990,1.9
CN3801700000000,2022-08-01,38,017,ND,Cass County,112112,110266,1846,1.6
CN3801900000000,2022-08-01,38,019,ND,Cavalier County,1848,1812,36,1.9
CN3802100000000,2022-08-01,38,021,ND,Dickey County,2280,2244,36,1.6
CN3802300000000,2022-08-01,38,023,ND,Divide County,1483,1464,19,1.3
CN3802500000000,2022-08-01,38,025,ND,Dunn County,3386,3347,39,1.2
CN3802700000000,2022-08-01,38,027,ND,Eddy County,1191,1160,31,2.6
CN3802900000000,2022-08-01,38,029,ND,Emmons County,1455,1406,49,3.4
CN3803100000000,2022-08-01,38,031,ND,Foster County,1549,1521,28,1.8
CN3803300000000,2022-08-01,38,033,ND,Golden Valley County,848,836,12,1.4
CN3803500000000,2022-08-01,38,035,ND,Grand Forks County,37685,36977,708,1.9
CN3803700000000,2022-08-01,38,037,ND,Grant County,1249,1224,25,2
CN3803900000000,2022-08-01,38,039,ND,Griggs County,1029,1010,19,1.8
CN3804100000000,2022-08-01,38,041,ND,Hettinger County,1432,1408,24,1.7
CN3804300000000,2022-08-01,38,043,ND,Kidder County,1376,1326,50,3.6
CN3804500000000,2022-08-01,38,045,ND,LaMoure County,2137,2098,39,1.8
CN3804700000000,2022-08-01,38,047,ND,Logan County,869,852,17,2
CN3804900000000,2022-08-01,38,049,ND,McHenry County,3092,3017,75,2.4
CN3805100000000,2022-08-01,38,051,ND,McIntosh County,1093,1071,22,2
CN3805300000000,2022-08-01,38,053,ND,McKenzie County,9608,9433,175,1.8
CN3805500000000,2022-08-01,38,055,ND,McLean County,4914,4778,136,2.8
CN3805700000000,2022-08-01,38,057,ND,Mercer County,3741,3606,135,3.6
CN3805900000000,2022-08-01,38,059,ND,Morton County,17469,17057,412,2.4
CN3806100000000,2022-08-01,38,061,ND,Mountrail County,6584,6491,93,1.4
CN3806300000000,2022-08-01,38,063,ND,Nelson County,1509,1466,43,2.8
CN3806500000000,2022-08-01,38,065,ND,Oliver County,910,881,29,3.2
CN3806700000000,2022-08-01,38,067,ND,Pembina County,3363,3255,108,3.2
CN3806900000000,2022-08-01,38,069,ND,Pierce County,1657,1615,42,2.5
CN3807100000000,2022-08-01,38,071,ND,Ramsey County,5747,5623,124,2.2
CN3807300000000,2022-08-01,38,073,ND,Ransom County,2679,2633,46,1.7
CN3807500000000,2022-08-01,38,075,ND,Renville County,1246,1222,24,1.9
CN3807700000000,2022-08-01,38,077,ND,Richland County,8881,8707,174,2
CN3807900000000,2022-08-01,38,079,ND,Rolette County,4844,4319,525,10.8
CN3808100000000,2022-08-01,38,081,ND,Sargent County,2330,2290,40,1.7
CN3808300000000,2022-08-01,38,083,ND,Sheridan County,675,664,11,1.6
CN3808500000000,2022-08-01,38,085,ND,Sioux County,1280,1229,51,4
CN3808700000000,2022-08-01,38,087,ND,Slope County,355,347,8,2.3
CN3808900000000,2022-08-01,38,089,ND,Stark County,18674,18330,344,1.8
CN3809100000000,2022-08-01,38,091,ND,Steele County,972,953,19,2
CN3809300000000,2022-08-01,38,093,ND,Stutsman County,10854,10646,208,1.9
CN3809500000000,2022-08-01,38,095,ND,Towner County,1157,1131,26,2.2
CN3809700000000,2022-08-01,38,097,ND,Traill County,4523,4430,93,2.1
CN3809900000000,2022-08-01,38,099,ND,Walsh County,5366,5184,182,3.4
CN3810100000000,2022-08-01,38,101,ND,Ward County,32560,31880,680,2.1
CN3810300000000,2022-08-01,38,103,ND,Wells County,1981,1932,49,2.5
CN3810500000000,2022-08-01,38,105,ND,Williams County,22711,22242,469,2.1
CN3900100000000,2022-08-01,39,001,OH,Adams County,10900,10320,580,5.3
CN3900300000000,2022-08-01,39,003,OH,Allen County,47078,45081,1997,4.2
CN3900500000000,2022-08-01,39,005,OH,Ashland County,25982,25007,975,3.8
CN3900700000000,2022-08-01,39,007,OH,Ashtabula County,43527,41618,1909,4.4
CN3900900000000,2022-08-01,39,009,OH,Athens County,24728,23436,1292,5.2
CN3901100000000,2022-08-01,39,011,OH,Auglaize County,24102,23303,799,3.3
CN3901300000000,2022-08-01,39,013,OH,Belmont County,26979,25572,1407,5.2
CN3901500000000,2022-08-01,39,015,OH,Brown County,19651,18742,909,4.6
CN3901700000000,2022-08-01,39,017,OH,Butler County,199951,192306,7645,3.8
CN3901900000000,2022-08-01,39,019,OH,Carroll County,12632,12081,551,4.4
CN3902100000000,2022-08-01,39,021,OH,Champaign County,19202,18449,753,3.9
CN3902300000000,2022-08-01,39,023,OH,Clark County,62793,60128,2665,4.2
CN3902500000000,2022-08-01,39,025,OH,Clermont County,109521,105338,4183,3.8
CN3902700000000,2022-08-01,39,027,OH,Clinton County,17879,17077,802,4.5
CN3902900000000,2022-08-01,39,029,OH,Columbiana County,44978,42738,2240,5
CN3903100000000,2022-08-01,39,031,OH,Coshocton County,13771,13066,705,5.1
CN3903300000000,2022-08-01,39,033,OH,Crawford County,17912,16951,961,5.4
CN3903500000000,2022-08-01,39,035,OH,Cuyahoga County,611379,582331,29048,4.8
CN3903700000000,2022-08-01,39,037,OH,Darke County,25348,24404,944,3.7
CN3903900000000,2022-08-01,39,039,OH,Defiance County,17387,16663,724,4.2
CN3904100000000,2022-08-01,39,041,OH,Delaware County,116700,112909,3791,3.2
CN3904300000000,2022-08-01,39,043,OH,Erie County,38468,36835,1633,4.2
CN3904500000000,2022-08-01,39,045,OH,Fairfield County,81020,78022,2998,3.7
CN3904700000000,2022-08-01,39,047,OH,Fayette County,13677,13145,532,3.9
CN3904900000000,2022-08-01,39,049,OH,Franklin County,716720,690232,26488,3.7
CN3905100000000,2022-08-01,39,051,OH,Fulton County,21429,20602,827,3.9
CN3905300000000,2022-08-01,39,053,OH,Gallia County,11618,11028,590,5.1
CN3905500000000,2022-08-01,39,055,OH,Geauga County,48956,47109,1847,3.8
CN3905700000000,2022-08-01,39,057,OH,Greene County,82478,79267,3211,3.9
CN3905900000000,2022-08-01,39,059,OH,Guernsey County,17872,17009,863,4.8
CN3906100000000,2022-08-01,39,061,OH,Hamilton County,423906,407091,16815,4
CN3906300000000,2022-08-01,39,063,OH,Hancock County,40074,38673,1401,3.5
CN3906500000000,2022-08-01,39,065,OH,Hardin County,12772,12172,600,4.7
CN3906700000000,2022-08-01,39,067,OH,Harrison County,6499,6189,310,4.8
CN3906900000000,2022-08-01,39,069,OH,Henry County,12711,12165,546,4.3
CN3907100000000,2022-08-01,39,071,OH,Highland County,17327,16503,824,4.8
CN3907300000000,2022-08-01,39,073,OH,Hocking County,13034,12517,517,4
CN3907500000000,2022-08-01,39,075,OH,Holmes County,21673,21051,622,2.9
CN3907700000000,2022-08-01,39,077,OH,Huron County,28120,26913,1207,4.3
CN3907900000000,2022-08-01,39,079,OH,Jackson County,12351,11720,631,5.1
CN3908100000000,2022-08-01,39,081,OH,Jefferson County,27190,25579,1611,5.9
CN3908300000000,2022-08-01,39,083,OH,Knox County,30640,29494,1146,3.7
CN3908500000000,2022-08-01,39,085,OH,Lake County,126841,121725,5116,4
CN3908700000000,2022-08-01,39,087,OH,Lawrence County,23340,22119,1221,5.2
CN3908900000000,2022-08-01,39,089,OH,Licking County,92842,89388,3454,3.7
CN3909100000000,2022-08-01,39,091,OH,Logan County,22722,21908,814,3.6
CN3909300000000,2022-08-01,39,093,OH,Lorain County,156353,149079,7274,4.7
CN3909500000000,2022-08-01,39,095,OH,Lucas County,202812,193235,9577,4.7
CN3909700000000,2022-08-01,39,097,OH,Madison County,21080,20376,704,3.3
CN3909900000000,2022-08-01,39,099,OH,Mahoning County,98095,93158,4937,5
CN3910100000000,2022-08-01,39,101,OH,Marion County,27728,25858,1870,6.7
CN3910300000000,2022-08-01,39,103,OH,Medina County,99383,95534,3849,3.9
CN3910500000000,2022-08-01,39,105,OH,Meigs County,8421,7923,498,5.9
CN3910700000000,2022-08-01,39,107,OH,Mercer County,22862,22219,643,2.8
CN3910900000000,2022-08-01,39,109,OH,Miami County,53561,51560,2001,3.7
CN3911100000000,2022-08-01,39,111,OH,Monroe County,5152,4838,314,6.1
CN3911300000000,2022-08-01,39,113,OH,Montgomery County,246919,236183,10736,4.3
CN3911500000000,2022-08-01,39,115,OH,Morgan County,6789,6472,317,4.7
CN3911700000000,2022-08-01,39,117,OH,Morrow County,17170,16443,727,4.2
CN3911900000000,2022-08-01,39,119,OH,Muskingum County,40708,39028,1680,4.1
CN3912100000000,2022-08-01,39,121,OH,Noble County,4627,4362,265,5.7
CN3912300000000,2022-08-01,39,123,OH,Ottawa County,21577,20627,950,4.4
CN3912500000000,2022-08-01,39,125,OH,Paulding County,8690,8378,312,3.6
CN3912700000000,2022-08-01,39,127,OH,Perry County,16031,15358,673,4.2
CN3912900000000,2022-08-01,39,129,OH,Pickaway County,26979,25958,1021,3.8
CN3913100000000,2022-08-01,39,131,OH,Pike County,11131,10566,565,5.1
CN3913300000000,2022-08-01,39,133,OH,Portage County,84902,81550,3352,3.9
CN3913500000000,2022-08-01,39,135,OH,Preble County,21880,21129,751,3.4
CN3913700000000,2022-08-01,39,137,OH,Putnam County,18987,18431,556,2.9
CN3913900000000,2022-08-01,39,139,OH,Richland County,50570,48257,2313,4.6
CN3914100000000,2022-08-01,39,141,OH,Ross County,35284,33914,1370,3.9
CN3914300000000,2022-08-01,39,143,OH,Sandusky County,29994,28668,1326,4.4
CN3914500000000,2022-08-01,39,145,OH,Scioto County,29183,27628,1555,5.3
CN3914700000000,2022-08-01,39,147,OH,Seneca County,26307,25230,1077,4.1
CN3914900000000,2022-08-01,39,149,OH,Shelby County,23566,22705,861,3.7
CN3915100000000,2022-08-01,39,151,OH,Stark County,182254,174690,7564,4.2
CN3915300000000,2022-08-01,39,153,OH,Summit County,264933,253464,11469,4.3
CN3915500000000,2022-08-01,39,155,OH,Trumbull County,82765,78555,4210,5.1
CN3915700000000,2022-08-01,39,157,OH,Tuscarawas County,45040,43363,1677,3.7
CN3915900000000,2022-08-01,39,159,OH,Union County,30393,29377,1016,3.3
CN3916100000000,2022-08-01,39,161,OH,Van Wert County,14335,13835,500,3.5
CN3916300000000,2022-08-01,39,163,OH,Vinton County,5401,5147,254,4.7
CN3916500000000,2022-08-01,39,165,OH,Warren County,124256,119859,4397,3.5
CN3916700000000,2022-08-01,39,167,OH,Washington County,26792,25522,1270,4.7
CN3916900000000,2022-08-01,39,169,OH,Wayne County,59575,57586,1989,3.3
CN3917100000000,2022-08-01,39,171,OH,Williams County,18243,17617,626,3.4
CN3917300000000,2022-08-01,39,173,OH,Wood County,69170,66537,2633,3.8
CN3917500000000,2022-08-01,39,175,OH,Wyandot County,13145,12731,414,3.1
CN4000100000000,2022-08-01,40,001,OK,Adair County,8652,8357,295,3.4
CN4000300000000,2022-08-01,40,003,OK,Alfalfa County,2609,2555,54,2.1
CN4000500000000,2022-08-01,40,005,OK,Atoka County,5167,4946,221,4.3
CN4000700000000,2022-08-01,40,007,OK,Beaver County,2656,2601,55,2.1
CN4000900000000,2022-08-01,40,009,OK,Beckham County,10465,10175,290,2.8
CN4001100000000,2022-08-01,40,011,OK,Blaine County,4441,4327,114,2.6
CN4001300000000,2022-08-01,40,013,OK,Bryan County,23271,22591,680,2.9
CN4001500000000,2022-08-01,40,015,OK,Caddo County,11766,11366,400,3.4
CN4001700000000,2022-08-01,40,017,OK,Canadian County,80679,78449,2230,2.8
CN4001900000000,2022-08-01,40,019,OK,Carter County,21074,20265,809,3.8
CN4002100000000,2022-08-01,40,021,OK,Cherokee County,20067,19268,799,4
CN4002300000000,2022-08-01,40,023,OK,Choctaw County,5979,5661,318,5.3
CN4002500000000,2022-08-01,40,025,OK,Cimarron County,1635,1612,23,1.4
CN4002700000000,2022-08-01,40,027,OK,Cleveland County,148733,144474,4259,2.9
CN4002900000000,2022-08-01,40,029,OK,Coal County,2362,2283,79,3.3
CN4003100000000,2022-08-01,40,031,OK,Comanche County,47833,45935,1898,4
CN4003300000000,2022-08-01,40,033,OK,Cotton County,2693,2603,90,3.3
CN4003500000000,2022-08-01,40,035,OK,Craig County,5852,5641,211,3.6
CN4003700000000,2022-08-01,40,037,OK,Creek County,31521,30315,1206,3.8
CN4003900000000,2022-08-01,40,039,OK,Custer County,14933,14504,429,2.9
CN4004100000000,2022-08-01,40,041,OK,Delaware County,20133,19508,625,3.1
CN4004300000000,2022-08-01,40,043,OK,Dewey County,2988,2923,65,2.2
CN4004500000000,2022-08-01,40,045,OK,Ellis County,2117,2067,50,2.4
CN4004700000000,2022-08-01,40,047,OK,Garfield County,26649,25820,829,3.1
CN4004900000000,2022-08-01,40,049,OK,Garvin County,12670,12280,390,3.1
CN4005100000000,2022-08-01,40,051,OK,Grady County,27413,26565,848,3.1
CN4005300000000,2022-08-01,40,053,OK,Grant County,2763,2704,59,2.1
CN4005500000000,2022-08-01,40,055,OK,Greer County,1848,1778,70,3.8
CN4005700000000,2022-08-01,40,057,OK,Harmon County,1229,1195,34,2.8
CN4005900000000,2022-08-01,40,059,OK,Harper County,1811,1774,37,2
CN4006100000000,2022-08-01,40,061,OK,Haskell County,4204,4008,196,4.7
CN4006300000000,2022-08-01,40,063,OK,Hughes County,5000,4784,216,4.3
CN4006500000000,2022-08-01,40,065,OK,Jackson County,10730,10410,320,3
CN4006700000000,2022-08-01,40,067,OK,Jefferson County,2401,2317,84,3.5
CN4006900000000,2022-08-01,40,069,OK,Johnston County,3898,3756,142,3.6
CN4007100000000,2022-08-01,40,071,OK,Kay County,18784,18053,731,3.9
CN4007300000000,2022-08-01,40,073,OK,Kingfisher County,8877,8684,193,2.2
CN4007500000000,2022-08-01,40,075,OK,Kiowa County,3720,3588,132,3.5
CN4007700000000,2022-08-01,40,077,OK,Latimer County,3089,2906,183,5.9
CN4007900000000,2022-08-01,40,079,OK,Le Flore County,19586,18829,757,3.9
CN4008100000000,2022-08-01,40,081,OK,Lincoln County,16223,15670,553,3.4
CN4008300000000,2022-08-01,40,083,OK,Logan County,23406,22717,689,2.9
CN4008500000000,2022-08-01,40,085,OK,Love County,5829,5682,147,2.5
CN4008700000000,2022-08-01,40,087,OK,McClain County,20954,20334,620,3
CN4008900000000,2022-08-01,40,089,OK,McCurtain County,15964,15260,704,4.4
CN4009100000000,2022-08-01,40,091,OK,McIntosh County,7280,6898,382,5.2
CN4009300000000,2022-08-01,40,093,OK,Major County,3788,3689,99,2.6
CN4009500000000,2022-08-01,40,095,OK,Marshall County,7406,7161,245,3.3
CN4009700000000,2022-08-01,40,097,OK,Mayes County,19670,18988,682,3.5
CN4009900000000,2022-08-01,40,099,OK,Murray County,6113,5897,216,3.5
CN4010100000000,2022-08-01,40,101,OK,Muskogee County,28827,27733,1094,3.8
CN4010300000000,2022-08-01,40,103,OK,Noble County,5814,5672,142,2.4
CN4010500000000,2022-08-01,40,105,OK,Nowata County,4751,4605,146,3.1
CN4010700000000,2022-08-01,40,107,OK,Okfuskee County,4379,4195,184,4.2
CN4010900000000,2022-08-01,40,109,OK,Oklahoma County,399041,386078,12963,3.2
CN4011100000000,2022-08-01,40,111,OK,Okmulgee County,15636,14939,697,4.5
CN4011300000000,2022-08-01,40,113,OK,Osage County,20624,19813,811,3.9
CN4011500000000,2022-08-01,40,115,OK,Ottawa County,15341,14862,479,3.1
CN4011700000000,2022-08-01,40,117,OK,Pawnee County,7390,7088,302,4.1
CN4011900000000,2022-08-01,40,119,OK,Payne County,39191,37856,1335,3.4
CN4012100000000,2022-08-01,40,121,OK,Pittsburg County,16362,15606,756,4.6
CN4012300000000,2022-08-01,40,123,OK,Pontotoc County,19250,18657,593,3.1
CN4012500000000,2022-08-01,40,125,OK,Pottawatomie County,33143,31819,1324,4
CN4012700000000,2022-08-01,40,127,OK,Pushmataha County,4600,4406,194,4.2
CN4012900000000,2022-08-01,40,129,OK,Roger Mills County,1815,1770,45,2.5
CN4013100000000,2022-08-01,40,131,OK,Rogers County,45715,44239,1476,3.2
CN4013300000000,2022-08-01,40,133,OK,Seminole County,9244,8778,466,5
CN4013500000000,2022-08-01,40,135,OK,Sequoyah County,16838,16210,628,3.7
CN4013700000000,2022-08-01,40,137,OK,Stephens County,19067,18407,660,3.5
CN4013900000000,2022-08-01,40,139,OK,Texas County,11985,11767,218,1.8
CN4014100000000,2022-08-01,40,141,OK,Tillman County,2929,2833,96,3.3
CN4014300000000,2022-08-01,40,143,OK,Tulsa County,327165,316254,10911,3.3
CN4014500000000,2022-08-01,40,145,OK,Wagoner County,39295,37981,1314,3.3
CN4014700000000,2022-08-01,40,147,OK,Washington County,22376,21567,809,3.6
CN4014900000000,2022-08-01,40,149,OK,Washita County,5418,5245,173,3.2
CN4015100000000,2022-08-01,40,151,OK,Woods County,4448,4361,87,2
CN4015300000000,2022-08-01,40,153,OK,Woodward County,8616,8350,266,3.1
CN4100100000000,2022-08-01,41,001,OR,Baker County,7406,7039,367,5
CN4100300000000,2022-08-01,41,003,OR,Benton County,47898,45858,2040,4.3
CN4100500000000,2022-08-01,41,005,OR,Clackamas County,229714,219890,9824,4.3
CN4100700000000,2022-08-01,41,007,OR,Clatsop County,20442,19501,941,4.6
CN4100900000000,2022-08-01,41,009,OR,Columbia County,25391,24053,1338,5.3
CN4101100000000,2022-08-01,41,011,OR,Coos County,26892,25274,1618,6
CN4101300000000,2022-08-01,41,013,OR,Crook County,11421,10780,641,5.6
CN4101500000000,2022-08-01,41,015,OR,Curry County,9499,8945,554,5.8
CN4101700000000,2022-08-01,41,017,OR,Deschutes County,104897,100314,4583,4.4
CN4101900000000,2022-08-01,41,019,OR,Douglas County,48168,45336,2832,5.9
CN4102100000000,2022-08-01,41,021,OR,Gilliam County,985,939,46,4.7
CN4102300000000,2022-08-01,41,023,OR,Grant County,3323,3159,164,4.9
CN4102500000000,2022-08-01,41,025,OR,Harney County,3866,3686,180,4.7
CN4102700000000,2022-08-01,41,027,OR,Hood River County,15149,14472,677,4.5
CN4102900000000,2022-08-01,41,029,OR,Jackson County,108115,102291,5824,5.4
CN4103100000000,2022-08-01,41,031,OR,Jefferson County,10260,9660,600,5.8
CN4103300000000,2022-08-01,41,033,OR,Josephine County,37040,34761,2279,6.2
CN4103500000000,2022-08-01,41,035,OR,Klamath County,30704,28794,1910,6.2
CN4103700000000,2022-08-01,41,037,OR,Lake County,3774,3566,208,5.5
CN4103900000000,2022-08-01,41,039,OR,Lane County,182970,173392,9578,5.2
CN4104100000000,2022-08-01,41,041,OR,Lincoln County,22084,20874,1210,5.5
CN4104300000000,2022-08-01,41,043,OR,Linn County,62066,58870,3196,5.1
CN4104500000000,2022-08-01,41,045,OR,Malheur County,12867,12200,667,5.2
CN4104700000000,2022-08-01,41,047,OR,Marion County,172837,164510,8327,4.8
CN4104900000000,2022-08-01,41,049,OR,Morrow County,6165,5888,277,4.5
CN4105100000000,2022-08-01,41,051,OR,Multnomah County,473957,453088,20869,4.4
CN4105300000000,2022-08-01,41,053,OR,Polk County,43227,41154,2073,4.8
CN4105500000000,2022-08-01,41,055,OR,Sherman County,1019,981,38,3.7
CN4105700000000,2022-08-01,41,057,OR,Tillamook County,12524,11917,607,4.8
CN4105900000000,2022-08-01,41,059,OR,Umatilla County,38891,37004,1887,4.9
CN4106100000000,2022-08-01,41,061,OR,Union County,12428,11828,600,4.8
CN4106300000000,2022-08-01,41,063,OR,Wallowa County,3853,3674,179,4.6
CN4106500000000,2022-08-01,41,065,OR,Wasco County,14457,13845,612,4.2
CN4106700000000,2022-08-01,41,067,OR,Washington County,338429,325129,13300,3.9
CN4106900000000,2022-08-01,41,069,OR,Wheeler County,743,713,30,4
CN4107100000000,2022-08-01,41,071,OR,Yamhill County,57259,54739,2520,4.4
CN4200100000000,2022-08-01,42,001,PA,Adams County,54884,52523,2361,4.3
CN4200300000000,2022-08-01,42,003,PA,Allegheny County,636607,604980,31627,5
CN4200500000000,2022-08-01,42,005,PA,Armstrong County,31464,29533,1931,6.1
CN4200700000000,2022-08-01,42,007,PA,Beaver County,82724,77490,5234,6.3
CN4200900000000,2022-08-01,42,009,PA,Bedford County,24594,23385,1209,4.9
CN4201100000000,2022-08-01,42,011,PA,Berks County,215546,204562,10984,5.1
CN4201300000000,2022-08-01,42,013,PA,Blair County,59862,56642,3220,5.4
CN4201500000000,2022-08-01,42,015,PA,Bradford County,28384,26987,1397,4.9
CN4201700000000,2022-08-01,42,017,PA,Bucks County,355261,339260,16001,4.5
CN4201900000000,2022-08-01,42,019,PA,Butler County,99528,94619,4909,4.9
CN4202100000000,2022-08-01,42,021,PA,Cambria County,55474,51797,3677,6.6
CN4202300000000,2022-08-01,42,023,PA,Cameron County,1977,1848,129,6.5
CN4202500000000,2022-08-01,42,025,PA,Carbon County,32830,30855,1975,6
CN4202700000000,2022-08-01,42,027,PA,Centre County,77498,74114,3384,4.4
CN4202900000000,2022-08-01,42,029,PA,Chester County,298903,286844,12059,4
CN4203100000000,2022-08-01,42,031,PA,Clarion County,16166,15188,978,6
CN4203300000000,2022-08-01,42,033,PA,Clearfield County,35384,33263,2121,6
CN4203500000000,2022-08-01,42,035,PA,Clinton County,17044,16044,1000,5.9
CN4203700000000,2022-08-01,42,037,PA,Columbia County,34037,32283,1754,5.2
CN4203900000000,2022-08-01,42,039,PA,Crawford County,38218,36045,2173,5.7
CN4204100000000,2022-08-01,42,041,PA,Cumberland County,137510,131731,5779,4.2
CN4204300000000,2022-08-01,42,043,PA,Dauphin County,148609,141637,6972,4.7
CN4204500000000,2022-08-01,42,045,PA,Delaware County,303121,288267,14854,4.9
CN4204700000000,2022-08-01,42,047,PA,Elk County,14998,14108,890,5.9
CN4204900000000,2022-08-01,42,049,PA,Erie County,126664,119576,7088,5.6
CN4205100000000,2022-08-01,42,051,PA,Fayette County,55757,51760,3997,7.2
CN4205300000000,2022-08-01,42,053,PA,Forest County,1718,1589,129,7.5
CN4205500000000,2022-08-01,42,055,PA,Franklin County,78554,75059,3495,4.4
CN4205700000000,2022-08-01,42,057,PA,Fulton County,7253,6927,326,4.5
CN4205900000000,2022-08-01,42,059,PA,Greene County,15444,14454,990,6.4
CN4206100000000,2022-08-01,42,061,PA,Huntingdon County,19526,18333,1193,6.1
CN4206300000000,2022-08-01,42,063,PA,Indiana County,36167,33794,2373,6.6
CN4206500000000,2022-08-01,42,065,PA,Jefferson County,19762,18687,1075,5.4
CN4206700000000,2022-08-01,42,067,PA,Juniata County,12510,11874,636,5.1
CN4206900000000,2022-08-01,42,069,PA,Lackawanna County,105970,99931,6039,5.7
CN4207100000000,2022-08-01,42,071,PA,Lancaster County,293574,280815,12759,4.3
CN4207300000000,2022-08-01,42,073,PA,Lawrence County,39624,37305,2319,5.9
CN4207500000000,2022-08-01,42,075,PA,Lebanon County,74112,70674,3438,4.6
CN4207700000000,2022-08-01,42,077,PA,Lehigh County,198550,188454,10096,5.1
CN4207900000000,2022-08-01,42,079,PA,Luzerne County,159269,149525,9744,6.1
CN4208100000000,2022-08-01,42,081,PA,Lycoming County,55351,52439,2912,5.3
CN4208300000000,2022-08-01,42,083,PA,McKean County,17004,15914,1090,6.4
CN4208500000000,2022-08-01,42,085,PA,Mercer County,48306,45451,2855,5.9
CN4208700000000,2022-08-01,42,087,PA,Mifflin County,21281,20126,1155,5.4
CN4208900000000,2022-08-01,42,089,PA,Monroe County,84550,78867,5683,6.7
CN4209100000000,2022-08-01,42,091,PA,Montgomery County,472529,452760,19769,4.2
CN4209300000000,2022-08-01,42,093,PA,Montour County,9269,8873,396,4.3
CN4209500000000,2022-08-01,42,095,PA,Northampton County,165420,157222,8198,5
CN4209700000000,2022-08-01,42,097,PA,Northumberland County,43203,40847,2356,5.5
CN4209900000000,2022-08-01,42,099,PA,Perry County,25137,24026,1111,4.4
CN4210100000000,2022-08-01,42,101,PA,Philadelphia County/city,738057,691676,46381,6.3
CN4210300000000,2022-08-01,42,103,PA,Pike County,26113,24439,1674,6.4
CN4210500000000,2022-08-01,42,105,PA,Potter County,6883,6441,442,6.4
CN4210700000000,2022-08-01,42,107,PA,Schuylkill County,66936,63022,3914,5.8
CN4210900000000,2022-08-01,42,109,PA,Snyder County,19752,18762,990,5
CN4211100000000,2022-08-01,42,111,PA,Somerset County,32650,30572,2078,6.4
CN4211300000000,2022-08-01,42,113,PA,Sullivan County,2680,2523,157,5.9
CN4211500000000,2022-08-01,42,115,PA,Susquehanna County,20423,19484,939,4.6
CN4211700000000,2022-08-01,42,117,PA,Tioga County,19040,17942,1098,5.8
CN4211900000000,2022-08-01,42,119,PA,Union County,19675,18773,902,4.6
CN4212100000000,2022-08-01,42,121,PA,Venango County,21688,20428,1260,5.8
CN4212300000000,2022-08-01,42,123,PA,Warren County,17776,16829,947,5.3
CN4212500000000,2022-08-01,42,125,PA,Washington County,105465,99935,5530,5.2
CN4212700000000,2022-08-01,42,127,PA,Wayne County,24169,22904,1265,5.2
CN4212900000000,2022-08-01,42,129,PA,Westmoreland County,177450,167816,9634,5.4
CN4213100000000,2022-08-01,42,131,PA,Wyoming County,13627,12855,772,5.7
CN4213300000000,2022-08-01,42,133,PA,York County,241252,230027,11225,4.7
CN4400100000000,2022-08-01,44,001,RI,Bristol County,26715,25795,920,3.4
CN4400300000000,2022-08-01,44,003,RI,Kent County,94238,90784,3454,3.7
CN4400500000000,2022-08-01,44,005,RI,Newport County,45301,43771,1530,3.4
CN4400700000000,2022-08-01,44,007,RI,Providence County,336853,322276,14577,4.3
CN4400900000000,2022-08-01,44,009,RI,Washington County,71420,68961,2459,3.4
CN4500100000000,2022-08-01,45,001,SC,Abbeville County,9431,9003,428,4.5
CN4500300000000,2022-08-01,45,003,SC,Aiken County,72951,70468,2483,3.4
CN4500500000000,2022-08-01,45,005,SC,Allendale County,2246,2118,128,5.7
CN4500700000000,2022-08-01,45,007,SC,Anderson County,91507,88380,3127,3.4
CN4500900000000,2022-08-01,45,009,SC,Bamberg County,4535,4269,266,5.9
CN4501100000000,2022-08-01,45,011,SC,Barnwell County,7518,7146,372,4.9
CN4501300000000,2022-08-01,45,013,SC,Beaufort County,77703,75025,2678,3.4
CN4501500000000,2022-08-01,45,015,SC,Berkeley County,110452,106879,3573,3.2
CN4501700000000,2022-08-01,45,017,SC,Calhoun County,6382,6135,247,3.9
CN4501900000000,2022-08-01,45,019,SC,Charleston County,216516,209989,6527,3
CN4502100000000,2022-08-01,45,021,SC,Cherokee County,23894,22828,1066,4.5
CN4502300000000,2022-08-01,45,023,SC,Chester County,13351,12728,623,4.7
CN4502500000000,2022-08-01,45,025,SC,Chesterfield County,21217,20376,841,4
CN4502700000000,2022-08-01,45,027,SC,Clarendon County,11945,11400,545,4.6
CN4502900000000,2022-08-01,45,029,SC,Colleton County,15715,15114,601,3.8
CN4503100000000,2022-08-01,45,031,SC,Darlington County,29851,28709,1142,3.8
CN4503300000000,2022-08-01,45,033,SC,Dillon County,12896,12277,619,4.8
CN4503500000000,2022-08-01,45,035,SC,Dorchester County,80065,77600,2465,3.1
CN4503700000000,2022-08-01,45,037,SC,Edgefield County,10221,9864,357,3.5
CN4503900000000,2022-08-01,45,039,SC,Fairfield County,9209,8722,487,5.3
CN4504100000000,2022-08-01,45,041,SC,Florence County,66139,63743,2396,3.6
CN4504300000000,2022-08-01,45,043,SC,Georgetown County,26598,25530,1068,4
CN4504500000000,2022-08-01,45,045,SC,Greenville County,259627,251724,7903,3
CN4504700000000,2022-08-01,45,047,SC,Greenwood County,29587,28389,1198,4
CN4504900000000,2022-08-01,45,049,SC,Hampton County,7959,7715,244,3.1
CN4505100000000,2022-08-01,45,051,SC,Horry County,154849,148711,6138,4
CN4505300000000,2022-08-01,45,053,SC,Jasper County,13316,12862,454,3.4
CN4505500000000,2022-08-01,45,055,SC,Kershaw County,29266,28187,1079,3.7
CN4505700000000,2022-08-01,45,057,SC,Lancaster County,43529,41820,1709,3.9
CN4505900000000,2022-08-01,45,059,SC,Laurens County,30032,28948,1084,3.6
CN4506100000000,2022-08-01,45,061,SC,Lee County,6396,6070,326,5.1
CN4506300000000,2022-08-01,45,063,SC,Lexington County,150332,145946,4386,2.9
CN4506500000000,2022-08-01,45,065,SC,McCormick County,3537,3381,156,4.4
CN4506700000000,2022-08-01,45,067,SC,Marion County,12759,12110,649,5.1
CN4506900000000,2022-08-01,45,069,SC,Marlboro County,8152,7603,549,6.7
CN4507100000000,2022-08-01,45,071,SC,Newberry County,18989,18444,545,2.9
CN4507300000000,2022-08-01,45,073,SC,Oconee County,34289,33084,1205,3.5
CN4507500000000,2022-08-01,45,075,SC,Orangeburg County,32697,30982,1715,5.2
CN4507700000000,2022-08-01,45,077,SC,Pickens County,57797,55920,1877,3.2
CN4507900000000,2022-08-01,45,079,SC,Richland County,196423,189292,7131,3.6
CN4508100000000,2022-08-01,45,081,SC,Saluda County,8379,8119,260,3.1
CN4508300000000,2022-08-01,45,083,SC,Spartanburg County,153286,147979,5307,3.5
CN4508500000000,2022-08-01,45,085,SC,Sumter County,41532,39793,1739,4.2
CN4508700000000,2022-08-01,45,087,SC,Union County,11166,10569,597,5.3
CN4508900000000,2022-08-01,45,089,SC,Williamsburg County,10864,10276,588,5.4
CN4509100000000,2022-08-01,45,091,SC,York County,147868,142758,5110,3.5
CN4600300000000,2022-08-01,46,003,SD,Aurora County,1465,1436,29,2
CN4600500000000,2022-08-01,46,005,SD,Beadle County,9322,9126,196,2.1
CN4600700000000,2022-08-01,46,007,SD,Bennett County,1087,1045,42,3.9
CN4600900000000,2022-08-01,46,009,SD,Bon Homme County,2840,2780,60,2.1
CN4601100000000,2022-08-01,46,011,SD,Brookings County,18721,18261,460,2.5
CN4601300000000,2022-08-01,46,013,SD,Brown County,19940,19467,473,2.4
CN4601500000000,2022-08-01,46,015,SD,Brule County,2634,2582,52,2
CN4601700000000,2022-08-01,46,017,SD,Buffalo County,733,691,42,5.7
CN4601900000000,2022-08-01,46,019,SD,Butte County,5132,5020,112,2.2
CN4602100000000,2022-08-01,46,021,SD,Campbell County,744,724,20,2.7
CN4602300000000,2022-08-01,46,023,SD,Charles Mix County,3851,3752,99,2.6
CN4602500000000,2022-08-01,46,025,SD,Clark County,1924,1882,42,2.2
CN4602700000000,2022-08-01,46,027,SD,Clay County,6894,6706,188,2.7
CN4602900000000,2022-08-01,46,029,SD,Codington County,15957,15617,340,2.1
CN4603100000000,2022-08-01,46,031,SD,Corson County,1229,1172,57,4.6
CN4603300000000,2022-08-01,46,033,SD,Custer County,4316,4199,117,2.7
CN4603500000000,2022-08-01,46,035,SD,Davison County,11112,10882,230,2.1
CN4603700000000,2022-08-01,46,037,SD,Day County,2687,2619,68,2.5
CN4603900000000,2022-08-01,46,039,SD,Deuel County,2316,2260,56,2.4
CN4604100000000,2022-08-01,46,041,SD,Dewey County,2343,2120,223,9.5
CN4604300000000,2022-08-01,46,043,SD,Douglas County,1500,1467,33,2.2
CN4604500000000,2022-08-01,46,045,SD,Edmunds County,1956,1912,44,2.2
CN4604700000000,2022-08-01,46,047,SD,Fall River County,3096,3016,80,2.6
CN4604900000000,2022-08-01,46,049,SD,Faulk County,1065,1039,26,2.4
CN4605100000000,2022-08-01,46,051,SD,Grant County,4360,4272,88,2
CN4605300000000,2022-08-01,46,053,SD,Gregory County,2076,2032,44,2.1
CN4605500000000,2022-08-01,46,055,SD,Haakon County,1069,1049,20,1.9
CN4605700000000,2022-08-01,46,057,SD,Hamlin County,3630,3561,69,1.9
CN4605900000000,2022-08-01,46,059,SD,Hand County,1690,1656,34,2
CN4606100000000,2022-08-01,46,061,SD,Hanson County,1766,1721,45,2.5
CN4606300000000,2022-08-01,46,063,SD,Harding County,731,715,16,2.2
CN4606500000000,2022-08-01,46,065,SD,Hughes County,10067,9885,182,1.8
CN4606700000000,2022-08-01,46,067,SD,Hutchinson County,3599,3521,78,2.2
CN4606900000000,2022-08-01,46,069,SD,Hyde County,643,625,18,2.8
CN4607100000000,2022-08-01,46,071,SD,Jackson County,1272,1234,38,3
CN4607300000000,2022-08-01,46,073,SD,Jerauld County,1289,1267,22,1.7
CN4607500000000,2022-08-01,46,075,SD,Jones County,542,530,12,2.2
CN4607700000000,2022-08-01,46,077,SD,Kingsbury County,2702,2648,54,2
CN4607900000000,2022-08-01,46,079,SD,Lake County,6740,6571,169,2.5
CN4608100000000,2022-08-01,46,081,SD,Lawrence County,14571,14257,314,2.2
CN4608300000000,2022-08-01,46,083,SD,Lincoln County,38000,37290,710,1.9
CN4608500000000,2022-08-01,46,085,SD,Lyman County,1701,1648,53,3.1
CN4608700000000,2022-08-01,46,087,SD,McCook County,3109,3052,57,1.8
CN4608900000000,2022-08-01,46,089,SD,McPherson County,938,907,31,3.3
CN4609100000000,2022-08-01,46,091,SD,Marshall County,2497,2436,61,2.4
CN4609300000000,2022-08-01,46,093,SD,Meade County,15099,14770,329,2.2
CN4609500000000,2022-08-01,46,095,SD,Mellette County,763,725,38,5
CN4609700000000,2022-08-01,46,097,SD,Miner County,1211,1185,26,2.1
CN4609900000000,2022-08-01,46,099,SD,Minnehaha County,117938,115670,2268,1.9
CN4610100000000,2022-08-01,46,101,SD,Moody County,4012,3899,113,2.8
CN4610200000000,2022-08-01,46,102,SD,Oglala Lakota County,4077,3787,290,7.1
CN4610300000000,2022-08-01,46,103,SD,Pennington County,62478,61105,1373,2.2
CN4610500000000,2022-08-01,46,105,SD,Perkins County,1401,1367,34,2.4
CN4610700000000,2022-08-01,46,107,SD,Potter County,1059,1035,24,2.3
CN4610900000000,2022-08-01,46,109,SD,Roberts County,4585,4439,146,3.2
CN4611100000000,2022-08-01,46,111,SD,Sanborn County,1194,1170,24,2
CN4611500000000,2022-08-01,46,115,SD,Spink County,3018,2945,73,2.4
CN4611700000000,2022-08-01,46,117,SD,Stanley County,1933,1896,37,1.9
CN4611900000000,2022-08-01,46,119,SD,Sully County,802,784,18,2.2
CN4612100000000,2022-08-01,46,121,SD,Todd County,3194,3057,137,4.3
CN4612300000000,2022-08-01,46,123,SD,Tripp County,3077,3016,61,2
CN4612500000000,2022-08-01,46,125,SD,Turner County,4752,4657,95,2
CN4612700000000,2022-08-01,46,127,SD,Union County,8629,8411,218,2.5
CN4612900000000,2022-08-01,46,129,SD,Walworth County,2098,2027,71,3.4
CN4613500000000,2022-08-01,46,135,SD,Yankton County,11876,11627,249,2.1
CN4613700000000,2022-08-01,46,137,SD,Ziebach County,940,894,46,4.9
CN4700100000000,2022-08-01,47,001,TN,Anderson County,35077,33848,1229,3.5
CN4700300000000,2022-08-01,47,003,TN,Bedford County,21569,20777,792,3.7
CN4700500000000,2022-08-01,47,005,TN,Benton County,6752,6451,301,4.5
CN4700700000000,2022-08-01,47,007,TN,Bledsoe County,4329,4084,245,5.7
CN4700900000000,2022-08-01,47,009,TN,Blount County,65110,63031,2079,3.2
CN4701100000000,2022-08-01,47,011,TN,Bradley County,49459,47609,1850,3.7
CN4701300000000,2022-08-01,47,013,TN,Campbell County,14897,14247,650,4.4
CN4701500000000,2022-08-01,47,015,TN,Cannon County,6864,6633,231,3.4
CN4701700000000,2022-08-01,47,017,TN,Carroll County,11680,11217,463,4
CN4701900000000,2022-08-01,47,019,TN,Carter County,23691,22757,934,3.9
CN4702100000000,2022-08-01,47,021,TN,Cheatham County,22625,22014,611,2.7
CN4702300000000,2022-08-01,47,023,TN,Chester County,8487,8216,271,3.2
CN4702500000000,2022-08-01,47,025,TN,Claiborne County,12744,12225,519,4.1
CN4702700000000,2022-08-01,47,027,TN,Clay County,2846,2722,124,4.4
CN4702900000000,2022-08-01,47,029,TN,Cocke County,14815,14107,708,4.8
CN4703100000000,2022-08-01,47,031,TN,Coffee County,25109,24219,890,3.5
CN4703300000000,2022-08-01,47,033,TN,Crockett County,6801,6578,223,3.3
CN4703500000000,2022-08-01,47,035,TN,Cumberland County,23661,22625,1036,4.4
CN4703700000000,2022-08-01,47,037,TN,Davidson County,412291,400263,12028,2.9
CN4703900000000,2022-08-01,47,039,TN,Decatur County,4440,4240,200,4.5
CN4704100000000,2022-08-01,47,041,TN,DeKalb County,8040,7731,309,3.8
CN4704300000000,2022-08-01,47,043,TN,Dickson County,27895,27009,886,3.2
CN4704500000000,2022-08-01,47,045,TN,Dyer County,16548,15921,627,3.8
CN4704700000000,2022-08-01,47,047,TN,Fayette County,19143,18437,706,3.7
CN4704900000000,2022-08-01,47,049,TN,Fentress County,7758,7457,301,3.9
CN4705100000000,2022-08-01,47,051,TN,Franklin County,19036,18324,712,3.7
CN4705300000000,2022-08-01,47,053,TN,Gibson County,21512,20732,780,3.6
CN4705500000000,2022-08-01,47,055,TN,Giles County,14780,14263,517,3.5
CN4705700000000,2022-08-01,47,057,TN,Grainger County,9679,9298,381,3.9
CN4705900000000,2022-08-01,47,059,TN,Greene County,28501,27342,1159,4.1
CN4706100000000,2022-08-01,47,061,TN,Grundy County,5037,4810,227,4.5
CN4706300000000,2022-08-01,47,063,TN,Hamblen County,27958,26928,1030,3.7
CN4706500000000,2022-08-01,47,065,TN,Hamilton County,182529,175982,6547,3.6
CN4706700000000,2022-08-01,47,067,TN,Hancock County,2267,2173,94,4.1
CN4706900000000,2022-08-01,47,069,TN,Hardeman County,8896,8507,389,4.4
CN4707100000000,2022-08-01,47,071,TN,Hardin County,10048,9633,415,4.1
CN4707300000000,2022-08-01,47,073,TN,Hawkins County,23138,22160,978,4.2
CN4707500000000,2022-08-01,47,075,TN,Haywood County,7521,7148,373,5
CN4707700000000,2022-08-01,47,077,TN,Henderson County,11736,11289,447,3.8
CN4707900000000,2022-08-01,47,079,TN,Henry County,13806,13235,571,4.1
CN4708100000000,2022-08-01,47,081,TN,Hickman County,11756,11397,359,3.1
CN4708300000000,2022-08-01,47,083,TN,Houston County,3252,3096,156,4.8
CN4708500000000,2022-08-01,47,085,TN,Humphreys County,8789,8456,333,3.8
CN4708700000000,2022-08-01,47,087,TN,Jackson County,4743,4547,196,4.1
CN4708900000000,2022-08-01,47,089,TN,Jefferson County,24847,23937,910,3.7
CN4709100000000,2022-08-01,47,091,TN,Johnson County,7498,7237,261,3.5
CN4709300000000,2022-08-01,47,093,TN,Knox County,249586,241844,7742,3.1
CN4709500000000,2022-08-01,47,095,TN,Lake County,1634,1548,86,5.3
CN4709700000000,2022-08-01,47,097,TN,Lauderdale County,9422,8941,481,5.1
CN4709900000000,2022-08-01,47,099,TN,Lawrence County,19302,18552,750,3.9
CN4710100000000,2022-08-01,47,101,TN,Lewis County,5623,5406,217,3.9
CN4710300000000,2022-08-01,47,103,TN,Lincoln County,16676,16119,557,3.3
CN4710500000000,2022-08-01,47,105,TN,Loudon County,24213,23383,830,3.4
CN4710700000000,2022-08-01,47,107,TN,McMinn County,21267,20331,936,4.4
CN4710900000000,2022-08-01,47,109,TN,McNairy County,8373,7962,411,4.9
CN4711100000000,2022-08-01,47,111,TN,Macon County,11631,11252,379,3.3
CN4711300000000,2022-08-01,47,113,TN,Madison County,48893,47093,1800,3.7
CN4711500000000,2022-08-01,47,115,TN,Marion County,12250,11751,499,4.1
CN4711700000000,2022-08-01,47,117,TN,Marshall County,15621,15064,557,3.6
CN4711900000000,2022-08-01,47,119,TN,Maury County,52940,51198,1742,3.3
CN4712100000000,2022-08-01,47,121,TN,Meigs County,5179,4922,257,5
CN4712300000000,2022-08-01,47,123,TN,Monroe County,20910,20098,812,3.9
CN4712500000000,2022-08-01,47,125,TN,Montgomery County,87173,83697,3476,4
CN4712700000000,2022-08-01,47,127,TN,Moore County,3634,3538,96,2.6
CN4712900000000,2022-08-01,47,129,TN,Morgan County,7781,7468,313,4
CN4713100000000,2022-08-01,47,131,TN,Obion County,12806,12293,513,4
CN4713300000000,2022-08-01,47,133,TN,Overton County,9866,9529,337,3.4
CN4713500000000,2022-08-01,47,135,TN,Perry County,2775,2633,142,5.1
CN4713700000000,2022-08-01,47,137,TN,Pickett County,2220,2136,84,3.8
CN4713900000000,2022-08-01,47,139,TN,Polk County,6946,6671,275,4
CN4714100000000,2022-08-01,47,141,TN,Putnam County,35046,33765,1281,3.7
CN4714300000000,2022-08-01,47,143,TN,Rhea County,13480,12790,690,5.1
CN4714500000000,2022-08-01,47,145,TN,Roane County,23603,22683,920,3.9
CN4714700000000,2022-08-01,47,147,TN,Robertson County,39132,37949,1183,3
CN4714900000000,2022-08-01,47,149,TN,Rutherford County,195151,189550,5601,2.9
CN4715100000000,2022-08-01,47,151,TN,Scott County,8083,7696,387,4.8
CN4715300000000,2022-08-01,47,153,TN,Sequatchie County,6166,5899,267,4.3
CN4715500000000,2022-08-01,47,155,TN,Sevier County,55660,54106,1554,2.8
CN4715700000000,2022-08-01,47,157,TN,Shelby County,437534,415831,21703,5
CN4715900000000,2022-08-01,47,159,TN,Smith County,9749,9442,307,3.1
CN4716100000000,2022-08-01,47,161,TN,Stewart County,5472,5247,225,4.1
CN4716300000000,2022-08-01,47,163,TN,Sullivan County,68689,66147,2542,3.7
CN4716500000000,2022-08-01,47,165,TN,Sumner County,108709,105584,3125,2.9
CN4716700000000,2022-08-01,47,167,TN,Tipton County,27520,26437,1083,3.9
CN4716900000000,2022-08-01,47,169,TN,Trousdale County,5705,5535,170,3
CN4717100000000,2022-08-01,47,171,TN,Unicoi County,6938,6609,329,4.7
CN4717300000000,2022-08-01,47,173,TN,Union County,7827,7528,299,3.8
CN4717500000000,2022-08-01,47,175,TN,Van Buren County,2061,1967,94,4.6
CN4717700000000,2022-08-01,47,177,TN,Warren County,16464,15730,734,4.5
CN4717900000000,2022-08-01,47,179,TN,Washington County,60194,58079,2115,3.5
CN4718100000000,2022-08-01,47,181,TN,Wayne County,6543,6224,319,4.9
CN4718300000000,2022-08-01,47,183,TN,Weakley County,15139,14590,549,3.6
CN4718500000000,2022-08-01,47,185,TN,White County,11935,11504,431,3.6
CN4718700000000,2022-08-01,47,187,TN,Williamson County,138150,134644,3506,2.5
CN4718900000000,2022-08-01,47,189,TN,Wilson County,81799,79506,2293,2.8
CN4800100000000,2022-08-01,48,001,TX,Anderson County,23103,22302,801,3.5
CN4800300000000,2022-08-01,48,003,TX,Andrews County,9451,9153,298,3.2
CN4800500000000,2022-08-01,48,005,TX,Angelina County,36157,34518,1639,4.5
CN4800700000000,2022-08-01,48,007,TX,Aransas County,9303,8813,490,5.3
CN4800900000000,2022-08-01,48,009,TX,Archer County,3994,3858,136,3.4
CN4801100000000,2022-08-01,48,011,TX,Armstrong County,937,910,27,2.9
CN4801300000000,2022-08-01,48,013,TX,Atascosa County,22509,21609,900,4
CN4801500000000,2022-08-01,48,015,TX,Austin County,14155,13586,569,4
CN4801700000000,2022-08-01,48,017,TX,Bailey County,2394,2296,98,4.1
CN4801900000000,2022-08-01,48,019,TX,Bandera County,10655,10251,404,3.8
CN4802100000000,2022-08-01,48,021,TX,Bastrop County,48478,46812,1666,3.4
CN4802300000000,2022-08-01,48,023,TX,Baylor County,1919,1869,50,2.6
CN4802500000000,2022-08-01,48,025,TX,Bee County,9162,8622,540,5.9
CN4802700000000,2022-08-01,48,027,TX,Bell County,148656,141905,6751,4.5
CN4802900000000,2022-08-01,48,029,TX,Bexar County,977043,940112,36931,3.8
CN4803100000000,2022-08-01,48,031,TX,Blanco County,7190,6993,197,2.7
CN4803300000000,2022-08-01,48,033,TX,Borden County,638,626,12,1.9
CN4803500000000,2022-08-01,48,035,TX,Bosque County,8783,8452,331,3.8
CN4803700000000,2022-08-01,48,037,TX,Bowie County,38336,36509,1827,4.8
CN4803900000000,2022-08-01,48,039,TX,Brazoria County,184443,175902,8541,4.6
CN4804100000000,2022-08-01,48,041,TX,Brazos County,124606,120523,4083,3.3
CN4804300000000,2022-08-01,48,043,TX,Brewster County,4207,4066,141,3.4
CN4804500000000,2022-08-01,48,045,TX,Briscoe County,587,567,20,3.4
CN4804700000000,2022-08-01,48,047,TX,Brooks County,2349,2221,128,5.4
CN4804900000000,2022-08-01,48,049,TX,Brown County,15151,14488,663,4.4
CN4805100000000,2022-08-01,48,051,TX,Burleson County,8619,8298,321,3.7
CN4805300000000,2022-08-01,48,053,TX,Burnet County,25731,24986,745,2.9
CN4805500000000,2022-08-01,48,055,TX,Caldwell County,21394,20654,740,3.5
CN4805700000000,2022-08-01,48,057,TX,Calhoun County,12159,11708,451,3.7
CN4805900000000,2022-08-01,48,059,TX,Callahan County,6307,6082,225,3.6
CN4806100000000,2022-08-01,48,061,TX,Cameron County,178050,168057,9993,5.6
CN4806300000000,2022-08-01,48,063,TX,Camp County,5124,4890,234,4.6
CN4806500000000,2022-08-01,48,065,TX,Carson County,3000,2913,87,2.9
CN4806700000000,2022-08-01,48,067,TX,Cass County,11932,11367,565,4.7
CN4806900000000,2022-08-01,48,069,TX,Castro County,3376,3268,108,3.2
CN4807100000000,2022-08-01,48,071,TX,Chambers County,21000,19883,1117,5.3
CN4807300000000,2022-08-01,48,073,TX,Cherokee County,20571,19646,925,4.5
CN4807500000000,2022-08-01,48,075,TX,Childress County,3236,3149,87,2.7
CN4807700000000,2022-08-01,48,077,TX,Clay County,4843,4656,187,3.9
CN4807900000000,2022-08-01,48,079,TX,Cochran County,1154,1098,56,4.9
CN4808100000000,2022-08-01,48,081,TX,Coke County,1577,1520,57,3.6
CN4808300000000,2022-08-01,48,083,TX,Coleman County,3069,2938,131,4.3
CN4808500000000,2022-08-01,48,085,TX,Collin County,627577,607369,20208,3.2
CN4808700000000,2022-08-01,48,087,TX,Collingsworth County,1092,1050,42,3.8
CN4808900000000,2022-08-01,48,089,TX,Colorado County,10369,10011,358,3.5
CN4809100000000,2022-08-01,48,091,TX,Comal County,82300,79373,2927,3.6
CN4809300000000,2022-08-01,48,093,TX,Comanche County,6265,6035,230,3.7
CN4809500000000,2022-08-01,48,095,TX,Concho County,1317,1275,42,3.2
CN4809700000000,2022-08-01,48,097,TX,Cooke County,20041,19382,659,3.3
CN4809900000000,2022-08-01,48,099,TX,Coryell County,24554,23445,1109,4.5
CN4810100000000,2022-08-01,48,101,TX,Cottle County,900,875,25,2.8
CN4810300000000,2022-08-01,48,103,TX,Crane County,1682,1603,79,4.7
CN4810500000000,2022-08-01,48,105,TX,Crockett County,1469,1413,56,3.8
CN4810700000000,2022-08-01,48,107,TX,Crosby County,2431,2323,108,4.4
CN4810900000000,2022-08-01,48,109,TX,Culberson County,1185,1155,30,2.5
CN4811100000000,2022-08-01,48,111,TX,Dallam County,3887,3789,98,2.5
CN4811300000000,2022-08-01,48,113,TX,Dallas County,1426924,1372759,54165,3.8
CN4811500000000,2022-08-01,48,115,TX,Dawson County,4399,4202,197,4.5
CN4811700000000,2022-08-01,48,117,TX,Deaf Smith County,9037,8766,271,3
CN4811900000000,2022-08-01,48,119,TX,Delta County,2508,2405,103,4.1
CN4812100000000,2022-08-01,48,121,TX,Denton County,553358,535280,18078,3.3
CN4812300000000,2022-08-01,48,123,TX,DeWitt County,9248,8920,328,3.5
CN4812500000000,2022-08-01,48,125,TX,Dickens County,712,673,39,5.5
CN4812700000000,2022-08-01,48,127,TX,Dimmit County,6315,6076,239,3.8
CN4812900000000,2022-08-01,48,129,TX,Donley County,1468,1414,54,3.7
CN4813100000000,2022-08-01,48,131,TX,Duval County,5045,4838,207,4.1
CN4813300000000,2022-08-01,48,133,TX,Eastland County,6521,6218,303,4.6
CN4813500000000,2022-08-01,48,135,TX,Ector County,83401,80290,3111,3.7
CN4813700000000,2022-08-01,48,137,TX,Edwards County,1169,1137,32,2.7
CN4813900000000,2022-08-01,48,139,TX,Ellis County,103805,100089,3716,3.6
CN4814100000000,2022-08-01,48,141,TX,El Paso County,369806,354034,15772,4.3
CN4814300000000,2022-08-01,48,143,TX,Erath County,20740,20006,734,3.5
CN4814500000000,2022-08-01,48,145,TX,Falls County,6848,6569,279,4.1
CN4814700000000,2022-08-01,48,147,TX,Fannin County,17349,16787,562,3.2
CN4814900000000,2022-08-01,48,149,TX,Fayette County,11848,11429,419,3.5
CN4815100000000,2022-08-01,48,151,TX,Fisher County,1633,1576,57,3.5
CN4815300000000,2022-08-01,48,153,TX,Floyd County,2423,2325,98,4
CN4815500000000,2022-08-01,48,155,TX,Foard County,556,537,19,3.4
CN4815700000000,2022-08-01,48,157,TX,Fort Bend County,418678,401952,16726,4
CN4815900000000,2022-08-01,48,159,TX,Franklin County,5328,5155,173,3.2
CN4816100000000,2022-08-01,48,161,TX,Freestone County,6381,6045,336,5.3
CN4816300000000,2022-08-01,48,163,TX,Frio County,9511,9195,316,3.3
CN4816500000000,2022-08-01,48,165,TX,Gaines County,10158,9860,298,2.9
CN4816700000000,2022-08-01,48,167,TX,Galveston County,169145,161553,7592,4.5
CN4816900000000,2022-08-01,48,169,TX,Garza County,2027,1906,121,6
CN4817100000000,2022-08-01,48,171,TX,Gillespie County,14610,14231,379,2.6
CN4817300000000,2022-08-01,48,173,TX,Glasscock County,865,843,22,2.5
CN4817500000000,2022-08-01,48,175,TX,Goliad County,3186,3043,143,4.5
CN4817700000000,2022-08-01,48,177,TX,Gonzales County,9482,9166,316,3.3
CN4817900000000,2022-08-01,48,179,TX,Gray County,7729,7382,347,4.5
CN4818100000000,2022-08-01,48,181,TX,Grayson County,65934,63459,2475,3.8
CN4818300000000,2022-08-01,48,183,TX,Gregg County,56641,54161,2480,4.4
CN4818500000000,2022-08-01,48,185,TX,Grimes County,11484,10966,518,4.5
CN4818700000000,2022-08-01,48,187,TX,Guadalupe County,85470,82494,2976,3.5
CN4818900000000,2022-08-01,48,189,TX,Hale County,11466,10859,607,5.3
CN4819100000000,2022-08-01,48,191,TX,Hall County,1108,1064,44,4
CN4819300000000,2022-08-01,48,193,TX,Hamilton County,3860,3714,146,3.8
CN4819500000000,2022-08-01,48,195,TX,Hansford County,3027,2958,69,2.3
CN4819700000000,2022-08-01,48,197,TX,Hardeman County,1818,1754,64,3.5
CN4819900000000,2022-08-01,48,199,TX,Hardin County,24738,23463,1275,5.2
CN4820100000000,2022-08-01,48,201,TX,Harris County,2341833,2240537,101296,4.3
CN4820300000000,2022-08-01,48,203,TX,Harrison County,28562,27299,1263,4.4
CN4820500000000,2022-08-01,48,205,TX,Hartley County,2599,2547,52,2
CN4820700000000,2022-08-01,48,207,TX,Haskell County,2734,2657,77,2.8
CN4820900000000,2022-08-01,48,209,TX,Hays County,139234,135050,4184,3
CN4821100000000,2022-08-01,48,211,TX,Hemphill County,1605,1556,49,3.1
CN4821300000000,2022-08-01,48,213,TX,Henderson County,38954,37490,1464,3.8
CN4821500000000,2022-08-01,48,215,TX,Hidalgo County,370747,346028,24719,6.7
CN4821700000000,2022-08-01,48,217,TX,Hill County,17885,17215,670,3.7
CN4821900000000,2022-08-01,48,219,TX,Hockley County,10628,10226,402,3.8
CN4822100000000,2022-08-01,48,221,TX,Hood County,30075,28923,1152,3.8
CN4822300000000,2022-08-01,48,223,TX,Hopkins County,18218,17619,599,3.3
CN4822500000000,2022-08-01,48,225,TX,Houston County,10647,10265,382,3.6
CN4822700000000,2022-08-01,48,227,TX,Howard County,12836,12165,671,5.2
CN4822900000000,2022-08-01,48,229,TX,Hudspeth County,1892,1818,74,3.9
CN4823100000000,2022-08-01,48,231,TX,Hunt County,47005,45165,1840,3.9
CN4823300000000,2022-08-01,48,233,TX,Hutchinson County,8372,8004,368,4.4
CN4823500000000,2022-08-01,48,235,TX,Irion County,792,770,22,2.8
CN4823700000000,2022-08-01,48,237,TX,Jack County,3425,3295,130,3.8
CN4823900000000,2022-08-01,48,239,TX,Jackson County,7048,6799,249,3.5
CN4824100000000,2022-08-01,48,241,TX,Jasper County,12734,11955,779,6.1
CN4824300000000,2022-08-01,48,243,TX,Jeff Davis County,1005,971,34,3.4
CN4824500000000,2022-08-01,48,245,TX,Jefferson County,100681,94258,6423,6.4
CN4824700000000,2022-08-01,48,247,TX,Jim Hogg County,1794,1708,86,4.8
CN4824900000000,2022-08-01,48,249,TX,Jim Wells County,15304,14451,853,5.6
CN4825100000000,2022-08-01,48,251,TX,Johnson County,89287,86106,3181,3.6
CN4825300000000,2022-08-01,48,253,TX,Jones County,5844,5590,254,4.3
CN4825500000000,2022-08-01,48,255,TX,Karnes County,6605,6383,222,3.4
CN4825700000000,2022-08-01,48,257,TX,Kaufman County,75386,72486,2900,3.8
CN4825900000000,2022-08-01,48,259,TX,Kendall County,23800,23053,747,3.1
CN4826100000000,2022-08-01,48,261,TX,Kenedy County,128,118,10,7.8
CN4826300000000,2022-08-01,48,263,TX,Kent County,720,708,12,1.7
CN4826500000000,2022-08-01,48,265,TX,Kerr County,22165,21361,804,3.6
CN4826700000000,2022-08-01,48,267,TX,Kimble County,1846,1785,61,3.3
CN4826900000000,2022-08-01,48,269,TX,King County,484,479,5,1
CN4827100000000,2022-08-01,48,271,TX,Kinney County,1244,1185,59,4.7
CN4827300000000,2022-08-01,48,273,TX,Kleberg County,12767,12148,619,4.8
CN4827500000000,2022-08-01,48,275,TX,Knox County,1476,1414,62,4.2
CN4827700000000,2022-08-01,48,277,TX,Lamar County,24454,23408,1046,4.3
CN4827900000000,2022-08-01,48,279,TX,Lamb County,5330,5118,212,4
CN4828100000000,2022-08-01,48,281,TX,Lampasas County,9399,9051,348,3.7
CN4828300000000,2022-08-01,48,283,TX,La Salle County,4147,4024,123,3
CN4828500000000,2022-08-01,48,285,TX,Lavaca County,9070,8760,310,3.4
CN4828700000000,2022-08-01,48,287,TX,Lee County,8987,8682,305,3.4
CN4828900000000,2022-08-01,48,289,TX,Leon County,6035,5717,318,5.3
CN4829100000000,2022-08-01,48,291,TX,Liberty County,35321,33230,2091,5.9
CN4829300000000,2022-08-01,48,293,TX,Limestone County,8460,8076,384,4.5
CN4829500000000,2022-08-01,48,295,TX,Lipscomb County,1439,1395,44,3.1
CN4829700000000,2022-08-01,48,297,TX,Live Oak County,4816,4609,207,4.3
CN4829900000000,2022-08-01,48,299,TX,Llano County,9526,9169,357,3.7
CN4830100000000,2022-08-01,48,301,TX,Loving County,1191,1186,5,0.4
CN4830300000000,2022-08-01,48,303,TX,Lubbock County,162697,157031,5666,3.5
CN4830500000000,2022-08-01,48,305,TX,Lynn County,2879,2770,109,3.8
CN4830700000000,2022-08-01,48,307,TX,McCulloch County,3163,3032,131,4.1
CN4830900000000,2022-08-01,48,309,TX,McLennan County,127120,122515,4605,3.6
CN4831100000000,2022-08-01,48,311,TX,McMullen County,909,889,20,2.2
CN4831300000000,2022-08-01,48,313,TX,Madison County,4716,4509,207,4.4
CN4831500000000,2022-08-01,48,315,TX,Marion County,4219,3997,222,5.3
CN4831700000000,2022-08-01,48,317,TX,Martin County,2833,2747,86,3
CN4831900000000,2022-08-01,48,319,TX,Mason County,1859,1795,64,3.4
CN4832100000000,2022-08-01,48,321,TX,Matagorda County,16956,15899,1057,6.2
CN4832300000000,2022-08-01,48,323,TX,Maverick County,22891,21431,1460,6.4
CN4832500000000,2022-08-01,48,325,TX,Medina County,22704,21811,893,3.9
CN4832700000000,2022-08-01,48,327,TX,Menard County,882,852,30,3.4
CN4832900000000,2022-08-01,48,329,TX,Midland County,107009,103984,3025,2.8
CN4833100000000,2022-08-01,48,331,TX,Milam County,10280,9839,441,4.3
CN4833300000000,2022-08-01,48,333,TX,Mills County,1876,1794,82,4.4
CN4833500000000,2022-08-01,48,335,TX,Mitchell County,2286,2192,94,4.1
CN4833700000000,2022-08-01,48,337,TX,Montague County,9306,8971,335,3.6
CN4833900000000,2022-08-01,48,339,TX,Montgomery County,302011,290142,11869,3.9
CN4834100000000,2022-08-01,48,341,TX,Moore County,11323,11032,291,2.6
CN4834300000000,2022-08-01,48,343,TX,Morris County,4486,4197,289,6.4
CN4834500000000,2022-08-01,48,345,TX,Motley County,524,502,22,4.2
CN4834700000000,2022-08-01,48,347,TX,Nacogdoches County,27823,26597,1226,4.4
CN4834900000000,2022-08-01,48,349,TX,Navarro County,23543,22618,925,3.9
CN4835100000000,2022-08-01,48,351,TX,Newton County,4845,4520,325,6.7
CN4835300000000,2022-08-01,48,353,TX,Nolan County,6761,6504,257,3.8
CN4835500000000,2022-08-01,48,355,TX,Nueces County,163772,156037,7735,4.7
CN4835700000000,2022-08-01,48,357,TX,Ochiltree County,3907,3774,133,3.4
CN4835900000000,2022-08-01,48,359,TX,Oldham County,934,907,27,2.9
CN4836100000000,2022-08-01,48,361,TX,Orange County,34679,32665,2014,5.8
CN4836300000000,2022-08-01,48,363,TX,Palo Pinto County,13180,12690,490,3.7
CN4836500000000,2022-08-01,48,365,TX,Panola County,9503,9079,424,4.5
CN4836700000000,2022-08-01,48,367,TX,Parker County,74854,72384,2470,3.3
CN4836900000000,2022-08-01,48,369,TX,Parmer County,5139,5011,128,2.5
CN4837100000000,2022-08-01,48,371,TX,Pecos County,6386,6144,242,3.8
CN4837300000000,2022-08-01,48,373,TX,Polk County,18514,17488,1026,5.5
CN4837500000000,2022-08-01,48,375,TX,Potter County,54696,52940,1756,3.2
CN4837700000000,2022-08-01,48,377,TX,Presidio County,3127,2917,210,6.7
CN4837900000000,2022-08-01,48,379,TX,Rains County,6481,6259,222,3.4
CN4838100000000,2022-08-01,48,381,TX,Randall County,75485,73306,2179,2.9
CN4838300000000,2022-08-01,48,383,TX,Reagan County,1632,1573,59,3.6
CN4838500000000,2022-08-01,48,385,TX,Real County,1235,1183,52,4.2
CN4838700000000,2022-08-01,48,387,TX,Red River County,5153,4865,288,5.6
CN4838900000000,2022-08-01,48,389,TX,Reeves County,8562,8268,294,3.4
CN4839100000000,2022-08-01,48,391,TX,Refugio County,3005,2864,141,4.7
CN4839300000000,2022-08-01,48,393,TX,Roberts County,403,388,15,3.7
CN4839500000000,2022-08-01,48,395,TX,Robertson County,7769,7451,318,4.1
CN4839700000000,2022-08-01,48,397,TX,Rockwall County,59476,57469,2007,3.4
CN4839900000000,2022-08-01,48,399,TX,Runnels County,4696,4533,163,3.5
CN4840100000000,2022-08-01,48,401,TX,Rusk County,22359,21382,977,4.4
CN4840300000000,2022-08-01,48,403,TX,Sabine County,3872,3589,283,7.3
CN4840500000000,2022-08-01,48,405,TX,San Augustine County,3079,2887,192,6.2
CN4840700000000,2022-08-01,48,407,TX,San Jacinto County,12032,11435,597,5
CN4840900000000,2022-08-01,48,409,TX,San Patricio County,29206,27451,1755,6
CN4841100000000,2022-08-01,48,411,TX,San Saba County,2209,2132,77,3.5
CN4841300000000,2022-08-01,48,413,TX,Schleicher County,1229,1187,42,3.4
CN4841500000000,2022-08-01,48,415,TX,Scurry County,6339,6068,271,4.3
CN4841700000000,2022-08-01,48,417,TX,Shackelford County,1829,1779,50,2.7
CN4841900000000,2022-08-01,48,419,TX,Shelby County,11073,10599,474,4.3
CN4842100000000,2022-08-01,48,421,TX,Sherman County,1362,1325,37,2.7
CN4842300000000,2022-08-01,48,423,TX,Smith County,112020,107782,4238,3.8
CN4842500000000,2022-08-01,48,425,TX,Somervell County,4600,4413,187,4.1
CN4842700000000,2022-08-01,48,427,TX,Starr County,24222,21692,2530,10.4
CN4842900000000,2022-08-01,48,429,TX,Stephens County,4044,3891,153,3.8
CN4843100000000,2022-08-01,48,431,TX,Sterling County,522,502,20,3.8
CN4843300000000,2022-08-01,48,433,TX,Stonewall County,835,813,22,2.6
CN4843500000000,2022-08-01,48,435,TX,Sutton County,1041,989,52,5
CN4843700000000,2022-08-01,48,437,TX,Swisher County,2633,2527,106,4
CN4843900000000,2022-08-01,48,439,TX,Tarrant County,1143855,1101541,42314,3.7
CN4844100000000,2022-08-01,48,441,TX,Taylor County,68964,66632,2332,3.4
CN4844300000000,2022-08-01,48,443,TX,Terrell County,402,389,13,3.2
CN4844500000000,2022-08-01,48,445,TX,Terry County,4703,4508,195,4.1
CN4844700000000,2022-08-01,48,447,TX,Throckmorton County,723,701,22,3
CN4844900000000,2022-08-01,48,449,TX,Titus County,13786,13170,616,4.5
CN4845100000000,2022-08-01,48,451,TX,Tom Green County,55342,53438,1904,3.4
CN4845300000000,2022-08-01,48,453,TX,Travis County,827455,803719,23736,2.9
CN4845500000000,2022-08-01,48,455,TX,Trinity County,5304,5025,279,5.3
CN4845700000000,2022-08-01,48,457,TX,Tyler County,7198,6784,414,5.8
CN4845900000000,2022-08-01,48,459,TX,Upshur County,17730,16980,750,4.2
CN4846100000000,2022-08-01,48,461,TX,Upton County,2269,2207,62,2.7
CN4846300000000,2022-08-01,48,463,TX,Uvalde County,11352,10817,535,4.7
CN4846500000000,2022-08-01,48,465,TX,Val Verde County,22069,21073,996,4.5
CN4846700000000,2022-08-01,48,467,TX,Van Zandt County,28171,27153,1018,3.6
CN4846900000000,2022-08-01,48,469,TX,Victoria County,41032,39338,1694,4.1
CN4847100000000,2022-08-01,48,471,TX,Walker County,23835,22703,1132,4.7
CN4847300000000,2022-08-01,48,473,TX,Waller County,25459,24360,1099,4.3
CN4847500000000,2022-08-01,48,475,TX,Ward County,6258,6038,220,3.5
CN4847700000000,2022-08-01,48,477,TX,Washington County,15175,14556,619,4.1
CN4847900000000,2022-08-01,48,479,TX,Webb County,116989,112467,4522,3.9
CN4848100000000,2022-08-01,48,481,TX,Wharton County,21472,20653,819,3.8
CN4848300000000,2022-08-01,48,483,TX,Wheeler County,1996,1920,76,3.8
CN4848500000000,2022-08-01,48,485,TX,Wichita County,55152,52931,2221,4
CN4848700000000,2022-08-01,48,487,TX,Wilbarger County,4737,4500,237,5
CN4848900000000,2022-08-01,48,489,TX,Willacy County,7175,6579,596,8.3
CN4849100000000,2022-08-01,48,491,TX,Williamson County,366220,355434,10786,2.9
CN4849300000000,2022-08-01,48,493,TX,Wilson County,25952,25114,838,3.2
CN4849500000000,2022-08-01,48,495,TX,Winkler County,3895,3752,143,3.7
CN4849700000000,2022-08-01,48,497,TX,Wise County,34414,33209,1205,3.5
CN4849900000000,2022-08-01,48,499,TX,Wood County,18220,17392,828,4.5
CN4850100000000,2022-08-01,48,501,TX,Yoakum County,3270,3146,124,3.8
CN4850300000000,2022-08-01,48,503,TX,Young County,8139,7865,274,3.4
CN4850500000000,2022-08-01,48,505,TX,Zapata County,4430,4129,301,6.8
CN4850700000000,2022-08-01,48,507,TX,Zavala County,3362,3084,278,8.3
CN4900100000000,2022-08-01,49,001,UT,Beaver County,2789,2711,78,2.8
CN4900300000000,2022-08-01,49,003,UT,Box Elder County,27889,27195,694,2.5
CN4900500000000,2022-08-01,49,005,UT,Cache County,68713,67149,1564,2.3
CN4900700000000,2022-08-01,49,007,UT,Carbon County,8532,8207,325,3.8
CN4900900000000,2022-08-01,49,009,UT,Daggett County,472,455,17,3.6
CN4901100000000,2022-08-01,49,011,UT,Davis County,186400,181918,4482,2.4
CN4901300000000,2022-08-01,49,013,UT,Duchesne County,8022,7757,265,3.3
CN4901500000000,2022-08-01,49,015,UT,Emery County,4530,4367,163,3.6
CN4901700000000,2022-08-01,49,017,UT,Garfield County,3323,3209,114,3.4
CN4901900000000,2022-08-01,49,019,UT,Grand County,7471,7311,160,2.1
CN4902100000000,2022-08-01,49,021,UT,Iron County,26924,26176,748,2.8
CN4902300000000,2022-08-01,49,023,UT,Juab County,6387,6244,143,2.2
CN4902500000000,2022-08-01,49,025,UT,Kane County,4401,4293,108,2.5
CN4902700000000,2022-08-01,49,027,UT,Millard County,6183,6020,163,2.6
CN4902900000000,2022-08-01,49,029,UT,Morgan County,6013,5881,132,2.2
CN4903100000000,2022-08-01,49,031,UT,Piute County,509,489,20,3.9
CN4903300000000,2022-08-01,49,033,UT,Rich County,1570,1542,28,1.8
CN4903500000000,2022-08-01,49,035,UT,Salt Lake County,685466,668311,17155,2.5
CN4903700000000,2022-08-01,49,037,UT,San Juan County,5699,5462,237,4.2
CN4903900000000,2022-08-01,49,039,UT,Sanpete County,13390,12976,414,3.1
CN4904100000000,2022-08-01,49,041,UT,Sevier County,10295,9987,308,3
CN4904300000000,2022-08-01,49,043,UT,Summit County,25817,25235,582,2.3
CN4904500000000,2022-08-01,49,045,UT,Tooele County,38622,37557,1065,2.8
CN4904700000000,2022-08-01,49,047,UT,Uintah County,14301,13755,546,3.8
CN4904900000000,2022-08-01,49,049,UT,Utah County,343947,335736,8211,2.4
CN4905100000000,2022-08-01,49,051,UT,Wasatch County,18109,17666,443,2.4
CN4905300000000,2022-08-01,49,053,UT,Washington County,87595,85097,2498,2.9
CN4905500000000,2022-08-01,49,055,UT,Wayne County,1645,1597,48,2.9
CN4905700000000,2022-08-01,49,057,UT,Weber County,136588,132959,3629,2.7
CN5000100000000,2022-08-01,50,001,VT,Addison County,21088,20544,544,2.6
CN5000300000000,2022-08-01,50,003,VT,Bennington County,17849,17242,607,3.4
CN5000500000000,2022-08-01,50,005,VT,Caledonia County,14996,14492,504,3.4
CN5000700000000,2022-08-01,50,007,VT,Chittenden County,98176,96011,2165,2.2
CN5000900000000,2022-08-01,50,009,VT,Essex County,2774,2633,141,5.1
CN5001100000000,2022-08-01,50,011,VT,Franklin County,28077,27250,827,2.9
CN5001300000000,2022-08-01,50,013,VT,Grand Isle County,4149,4028,121,2.9
CN5001500000000,2022-08-01,50,015,VT,Lamoille County,14247,13817,430,3
CN5001700000000,2022-08-01,50,017,VT,Orange County,16122,15724,398,2.5
CN5001900000000,2022-08-01,50,019,VT,Orleans County,13278,12731,547,4.1
CN5002100000000,2022-08-01,50,021,VT,Rutland County,30328,29238,1090,3.6
CN5002300000000,2022-08-01,50,023,VT,Washington County,34450,33583,867,2.5
CN5002500000000,2022-08-01,50,025,VT,Windham County,21501,20860,641,3
CN5002700000000,2022-08-01,50,027,VT,Windsor County,29448,28748,700,2.4
CN5100100000000,2022-08-01,51,001,VA,Accomack County,16199,15631,568,3.5
CN5100300000000,2022-08-01,51,003,VA,Albemarle County,57933,56110,1823,3.1
CN5100500000000,2022-08-01,51,005,VA,Alleghany County,6784,6534,250,3.7
CN5100700000000,2022-08-01,51,007,VA,Amelia County,6402,6169,233,3.6
CN5100900000000,2022-08-01,51,009,VA,Amherst County,14893,14336,557,3.7
CN5101100000000,2022-08-01,51,011,VA,Appomattox County,7177,6904,273,3.8
CN5101300000000,2022-08-01,51,013,VA,Arlington County,157953,154254,3699,2.3
CN5101500000000,2022-08-01,51,015,VA,Augusta County,38212,37000,1212,3.2
CN5101700000000,2022-08-01,51,017,VA,Bath County,2592,2520,72,2.8
CN5101900000000,2022-08-01,51,019,VA,Bedford County,38589,37266,1323,3.4
CN5102100000000,2022-08-01,51,021,VA,Bland County,2816,2726,90,3.2
CN5102300000000,2022-08-01,51,023,VA,Botetourt County,17746,17210,536,3
CN5102500000000,2022-08-01,51,025,VA,Brunswick County,5913,5619,294,5
CN5102700000000,2022-08-01,51,027,VA,Buchanan County,6295,5956,339,5.4
CN5102900000000,2022-08-01,51,029,VA,Buckingham County,6429,6152,277,4.3
CN5103100000000,2022-08-01,51,031,VA,Campbell County,25931,24932,999,3.9
CN5103300000000,2022-08-01,51,033,VA,Caroline County,15626,15001,625,4
CN5103500000000,2022-08-01,51,035,VA,Carroll County,13010,12481,529,4.1
CN5103600000000,2022-08-01,51,036,VA,Charles City County,3652,3532,120,3.3
CN5103700000000,2022-08-01,51,037,VA,Charlotte County,5649,5461,188,3.3
CN5104100000000,2022-08-01,51,041,VA,Chesterfield County,196314,189836,6478,3.3
CN5104300000000,2022-08-01,51,043,VA,Clarke County,7772,7537,235,3
CN5104500000000,2022-08-01,51,045,VA,Craig County,2327,2240,87,3.7
CN5104700000000,2022-08-01,51,047,VA,Culpeper County,25805,24955,850,3.3
CN5104900000000,2022-08-01,51,049,VA,Cumberland County,4873,4666,207,4.2
CN5105100000000,2022-08-01,51,051,VA,Dickenson County,4511,4289,222,4.9
CN5105300000000,2022-08-01,51,053,VA,Dinwiddie County,14025,13464,561,4
CN5105700000000,2022-08-01,51,057,VA,Essex County,5574,5359,215,3.9
CN5105900000000,2022-08-01,51,059,VA,Fairfax County,643496,625352,18144,2.8
CN5106100000000,2022-08-01,51,061,VA,Fauquier County,38216,37051,1165,3
CN5106300000000,2022-08-01,51,063,VA,Floyd County,8378,8126,252,3
CN5106500000000,2022-08-01,51,065,VA,Fluvanna County,14158,13729,429,3
CN5106700000000,2022-08-01,51,067,VA,Franklin County,26621,25707,914,3.4
CN5106900000000,2022-08-01,51,069,VA,Frederick County,51628,50187,1441,2.8
CN5107100000000,2022-08-01,51,071,VA,Giles County,7976,7681,295,3.7
CN5107300000000,2022-08-01,51,073,VA,Gloucester County,19701,19080,621,3.2
CN5107500000000,2022-08-01,51,075,VA,Goochland County,11984,11606,378,3.2
CN5107700000000,2022-08-01,51,077,VA,Grayson County,7920,7683,237,3
CN5107900000000,2022-08-01,51,079,VA,Greene County,10594,10302,292,2.8
CN5108100000000,2022-08-01,51,081,VA,Greensville County,4338,4137,201,4.6
CN5108300000000,2022-08-01,51,083,VA,Halifax County,15527,14836,691,4.5
CN5108500000000,2022-08-01,51,085,VA,Hanover County,60876,59130,1746,2.9
CN5108700000000,2022-08-01,51,087,VA,Henrico County,187834,181674,6160,3.3
CN5108900000000,2022-08-01,51,089,VA,Henry County,23923,23009,914,3.8
CN5109100000000,2022-08-01,51,091,VA,Highland County,1470,1434,36,2.4
CN5109300000000,2022-08-01,51,093,VA,Isle of Wight County,19900,19241,659,3.3
CN5109500000000,2022-08-01,51,095,VA,James City County,37278,36055,1223,3.3
CN5109700000000,2022-08-01,51,097,VA,King and Queen County,4014,3886,128,3.2
CN5109900000000,2022-08-01,51,099,VA,King George County,14503,14053,450,3.1
CN5110100000000,2022-08-01,51,101,VA,King William County,9702,9393,309,3.2
CN5110300000000,2022-08-01,51,103,VA,Lancaster County,5536,5348,188,3.4
CN5110500000000,2022-08-01,51,105,VA,Lee County,8162,7799,363,4.4
CN5110700000000,2022-08-01,51,107,VA,Loudoun County,234293,227798,6495,2.8
CN5110900000000,2022-08-01,51,109,VA,Louisa County,21161,20491,670,3.2
CN5111100000000,2022-08-01,51,111,VA,Lunenburg County,5274,5061,213,4
CN5111300000000,2022-08-01,51,113,VA,Madison County,7656,7458,198,2.6
CN5111500000000,2022-08-01,51,115,VA,Mathews County,4126,3992,134,3.2
CN5111700000000,2022-08-01,51,117,VA,Mecklenburg County,13158,12597,561,4.3
CN5111900000000,2022-08-01,51,119,VA,Middlesex County,5433,5258,175,3.2
CN5112100000000,2022-08-01,51,121,VA,Montgomery County,50951,49250,1701,3.3
CN5112500000000,2022-08-01,51,125,VA,Nelson County,7378,7132,246,3.3
CN5112700000000,2022-08-01,51,127,VA,New Kent County,13394,13031,363,2.7
CN5113100000000,2022-08-01,51,131,VA,Northampton County,5822,5621,201,3.5
CN5113300000000,2022-08-01,51,133,VA,Northumberland County,5664,5431,233,4.1
CN5113500000000,2022-08-01,51,135,VA,Nottoway County,7285,7012,273,3.7
CN5113700000000,2022-08-01,51,137,VA,Orange County,17683,17070,613,3.5
CN5113900000000,2022-08-01,51,139,VA,Page County,12315,11886,429,3.5
CN5114100000000,2022-08-01,51,141,VA,Patrick County,7207,6910,297,4.1
CN5114300000000,2022-08-01,51,143,VA,Pittsylvania County,30081,28950,1131,3.8
CN5114500000000,2022-08-01,51,145,VA,Powhatan County,14850,14412,438,2.9
CN5114700000000,2022-08-01,51,147,VA,Prince Edward County,10078,9596,482,4.8
CN5114900000000,2022-08-01,51,149,VA,Prince George County,15668,15008,660,4.2
CN5115300000000,2022-08-01,51,153,VA,Prince William County,253204,245134,8070,3.2
CN5115500000000,2022-08-01,51,155,VA,Pulaski County,16273,15718,555,3.4
CN5115700000000,2022-08-01,51,157,VA,Rappahannock County,3751,3636,115,3.1
CN5115900000000,2022-08-01,51,159,VA,Richmond County,4007,3881,126,3.1
CN5116100000000,2022-08-01,51,161,VA,Roanoke County,49970,48459,1511,3
CN5116300000000,2022-08-01,51,163,VA,Rockbridge County,10832,10459,373,3.4
CN5116500000000,2022-08-01,51,165,VA,Rockingham County,42351,41041,1310,3.1
CN5116700000000,2022-08-01,51,167,VA,Russell County,10779,10342,437,4.1
CN5116900000000,2022-08-01,51,169,VA,Scott County,9263,8926,337,3.6
CN5117100000000,2022-08-01,51,171,VA,Shenandoah County,22186,21460,726,3.3
CN5117300000000,2022-08-01,51,173,VA,Smyth County,13409,12927,482,3.6
CN5117500000000,2022-08-01,51,175,VA,Southampton County,8962,8674,288,3.2
CN5117700000000,2022-08-01,51,177,VA,Spotsylvania County,70088,67691,2397,3.4
CN5117900000000,2022-08-01,51,179,VA,Stafford County,76448,73846,2602,3.4
CN5118100000000,2022-08-01,51,181,VA,Surry County,3591,3469,122,3.4
CN5118300000000,2022-08-01,51,183,VA,Sussex County,3804,3605,199,5.2
CN5118500000000,2022-08-01,51,185,VA,Tazewell County,15174,14418,756,5
CN5118700000000,2022-08-01,51,187,VA,Warren County,20935,20243,692,3.3
CN5119100000000,2022-08-01,51,191,VA,Washington County,26549,25640,909,3.4
CN5119300000000,2022-08-01,51,193,VA,Westmoreland County,9583,9239,344,3.6
CN5119500000000,2022-08-01,51,195,VA,Wise County,12644,12017,627,5
CN5119700000000,2022-08-01,51,197,VA,Wythe County,14066,13581,485,3.4
CN5119900000000,2022-08-01,51,199,VA,York County,33482,32411,1071,3.2
CN5151000000000,2022-08-01,51,510,VA,Alexandria city,101508,98825,2683,2.6
CN5152000000000,2022-08-01,51,520,VA,Bristol city,7596,7304,292,3.8
CN5153000000000,2022-08-01,51,530,VA,Buena Vista city,3114,2999,115,3.7
CN5154000000000,2022-08-01,51,540,VA,Charlottesville city,25653,24842,811,3.2
CN5155000000000,2022-08-01,51,550,VA,Chesapeake city,125233,120885,4348,3.5
CN5157000000000,2022-08-01,51,570,VA,Colonial Heights city,8671,8330,341,3.9
CN5158000000000,2022-08-01,51,580,VA,Covington city,2324,2221,103,4.4
CN5159000000000,2022-08-01,51,590,VA,Danville city,18676,17660,1016,5.4
CN5159500000000,2022-08-01,51,595,VA,Emporia city,2340,2205,135,5.8
CN5160000000000,2022-08-01,51,600,VA,Fairfax city,12989,12641,348,2.7
CN5161000000000,2022-08-01,51,610,VA,Falls Church city,8617,8401,216,2.5
CN5162000000000,2022-08-01,51,620,VA,Franklin city,3490,3311,179,5.1
CN5163000000000,2022-08-01,51,630,VA,Fredericksburg city,14511,13950,561,3.9
CN5164000000000,2022-08-01,51,640,VA,Galax city,2844,2746,98,3.4
CN5165000000000,2022-08-01,51,650,VA,Hampton city,65165,62243,2922,4.5
CN5166000000000,2022-08-01,51,660,VA,Harrisonburg city,24577,23506,1071,4.4
CN5167000000000,2022-08-01,51,670,VA,Hopewell city,9802,9298,504,5.1
CN5167800000000,2022-08-01,51,678,VA,Lexington city,2139,2026,113,5.3
CN5168000000000,2022-08-01,51,680,VA,Lynchburg city,35985,34199,1786,5
CN5168300000000,2022-08-01,51,683,VA,Manassas city,21919,21260,659,3
CN5168500000000,2022-08-01,51,685,VA,Manassas Park city,9854,9581,273,2.8
CN5169000000000,2022-08-01,51,690,VA,Martinsville city,5580,5288,292,5.2
CN5170000000000,2022-08-01,51,700,VA,Newport News city,89473,85625,3848,4.3
CN5171000000000,2022-08-01,51,710,VA,Norfolk city,111313,106801,4512,4.1
CN5172000000000,2022-08-01,51,720,VA,Norton city,1583,1508,75,4.7
CN5173000000000,2022-08-01,51,730,VA,Petersburg city,12874,12016,858,6.7
CN5173500000000,2022-08-01,51,735,VA,Poquoson city,6443,6253,190,2.9
CN5174000000000,2022-08-01,51,740,VA,Portsmouth city,44568,42590,1978,4.4
CN5175000000000,2022-08-01,51,750,VA,Radford city,8839,8446,393,4.4
CN5176000000000,2022-08-01,51,760,VA,Richmond city,122459,117631,4828,3.9
CN5177000000000,2022-08-01,51,770,VA,Roanoke city,49197,47366,1831,3.7
CN5177500000000,2022-08-01,51,775,VA,Salem city,12935,12498,437,3.4
CN5179000000000,2022-08-01,51,790,VA,Staunton city,12411,11978,433,3.5
CN5180000000000,2022-08-01,51,800,VA,Suffolk city,46128,44425,1703,3.7
CN5181000000000,2022-08-01,51,810,VA,Virginia Beach city,233928,226402,7526,3.2
CN5182000000000,2022-08-01,51,820,VA,Waynesboro city,10780,10379,401,3.7
CN5183000000000,2022-08-01,51,830,VA,Williamsburg city,6900,6561,339,4.9
CN5184000000000,2022-08-01,51,840,VA,Winchester city,15182,14693,489,3.2
CN5300100000000,2022-08-01,53,001,WA,Adams County,10966,10495,471,4.3
CN5300300000000,2022-08-01,53,003,WA,Asotin County,10699,10254,445,4.2
CN5300500000000,2022-08-01,53,005,WA,Benton County,107498,101956,5542,5.2
CN5300700000000,2022-08-01,53,007,WA,Chelan County,47489,45179,2310,4.9
CN5300900000000,2022-08-01,53,009,WA,Clallam County,29210,27393,1817,6.2
CN5301100000000,2022-08-01,53,011,WA,Clark County,249482,236605,12877,5.2
CN5301300000000,2022-08-01,53,013,WA,Columbia County,1809,1717,92,5.1
CN5301500000000,2022-08-01,53,015,WA,Cowlitz County,49101,46140,2961,6
CN5301700000000,2022-08-01,53,017,WA,Douglas County,22648,21412,1236,5.5
CN5301900000000,2022-08-01,53,019,WA,Ferry County,2338,2119,219,9.4
CN5302100000000,2022-08-01,53,021,WA,Franklin County,46006,43284,2722,5.9
CN5302300000000,2022-08-01,53,023,WA,Garfield County,836,777,59,7.1
CN5302500000000,2022-08-01,53,025,WA,Grant County,51228,48426,2802,5.5
CN5302700000000,2022-08-01,53,027,WA,Grays Harbor County,29446,27471,1975,6.7
CN5302900000000,2022-08-01,53,029,WA,Island County,36333,34362,1971,5.4
CN5303100000000,2022-08-01,53,031,WA,Jefferson County,12558,11824,734,5.8
CN5303300000000,2022-08-01,53,033,WA,King County,1323465,1280421,43044,3.3
CN5303500000000,2022-08-01,53,035,WA,Kitsap County,128843,122504,6339,4.9
CN5303700000000,2022-08-01,53,037,WA,Kittitas County,21663,20286,1377,6.4
CN5303900000000,2022-08-01,53,039,WA,Klickitat County,10041,9429,612,6.1
CN5304100000000,2022-08-01,53,041,WA,Lewis County,35001,32835,2166,6.2
CN5304300000000,2022-08-01,53,043,WA,Lincoln County,4722,4476,246,5.2
CN5304500000000,2022-08-01,53,045,WA,Mason County,25397,23702,1695,6.7
CN5304700000000,2022-08-01,53,047,WA,Okanogan County,20719,19524,1195,5.8
CN5304900000000,2022-08-01,53,049,WA,Pacific County,8850,8260,590,6.7
CN5305100000000,2022-08-01,53,051,WA,Pend Oreille County,5115,4758,357,7
CN5305300000000,2022-08-01,53,053,WA,Pierce County,453378,428596,24782,5.5
CN5305500000000,2022-08-01,53,055,WA,San Juan County,9559,9213,346,3.6
CN5305700000000,2022-08-01,53,057,WA,Skagit County,62385,58990,3395,5.4
CN5305900000000,2022-08-01,53,059,WA,Skamania County,5547,5253,294,5.3
CN5306100000000,2022-08-01,53,061,WA,Snohomish County,451281,435153,16128,3.6
CN5306300000000,2022-08-01,53,063,WA,Spokane County,261871,248718,13153,5
CN5306500000000,2022-08-01,53,065,WA,Stevens County,18997,17783,1214,6.4
CN5306700000000,2022-08-01,53,067,WA,Thurston County,147627,140231,7396,5
CN5306900000000,2022-08-01,53,069,WA,Wahkiakum County,1380,1283,97,7
CN5307100000000,2022-08-01,53,071,WA,Walla Walla County,31099,29600,1499,4.8
CN5307300000000,2022-08-01,53,073,WA,Whatcom County,114943,108842,6101,5.3
CN5307500000000,2022-08-01,53,075,WA,Whitman County,24213,22918,1295,5.3
CN5307700000000,2022-08-01,53,077,WA,Yakima County,136641,128203,8438,6.2
CN5400100000000,2022-08-01,54,001,WV,Barbour County,7261,6895,366,5
CN5400300000000,2022-08-01,54,003,WV,Berkeley County,60921,58861,2060,3.4
CN5400500000000,2022-08-01,54,005,WV,Boone County,7143,6801,342,4.8
CN5400700000000,2022-08-01,54,007,WV,Braxton County,5217,4903,314,6
CN5400900000000,2022-08-01,54,009,WV,Brooke County,10021,9517,504,5
CN5401100000000,2022-08-01,54,011,WV,Cabell County,42085,40389,1696,4
CN5401300000000,2022-08-01,54,013,WV,Calhoun County,2403,2220,183,7.6
CN5401500000000,2022-08-01,54,015,WV,Clay County,2973,2794,179,6
CN5401700000000,2022-08-01,54,017,WV,Doddridge County,3874,3754,120,3.1
CN5401900000000,2022-08-01,54,019,WV,Fayette County,16126,15334,792,4.9
CN5402100000000,2022-08-01,54,021,WV,Gilmer County,2221,2092,129,5.8
CN5402300000000,2022-08-01,54,023,WV,Grant County,5852,5620,232,4
CN5402500000000,2022-08-01,54,025,WV,Greenbrier County,15472,14863,609,3.9
CN5402700000000,2022-08-01,54,027,WV,Hampshire County,11168,10834,334,3
CN5402900000000,2022-08-01,54,029,WV,Hancock County,13332,12564,768,5.8
CN5403100000000,2022-08-01,54,031,WV,Hardy County,5519,5276,243,4.4
CN5403300000000,2022-08-01,54,033,WV,Harrison County,33797,32484,1313,3.9
CN5403500000000,2022-08-01,54,035,WV,Jackson County,11680,11127,553,4.7
CN5403700000000,2022-08-01,54,037,WV,Jefferson County,31081,30205,876,2.8
CN5403900000000,2022-08-01,54,039,WV,Kanawha County,80735,77410,3325,4.1
CN5404100000000,2022-08-01,54,041,WV,Lewis County,6524,6195,329,5
CN5404300000000,2022-08-01,54,043,WV,Lincoln County,7158,6775,383,5.4
CN5404500000000,2022-08-01,54,045,WV,Logan County,11147,10635,512,4.6
CN5404700000000,2022-08-01,54,047,WV,McDowell County,4087,3783,304,7.4
CN5404900000000,2022-08-01,54,049,WV,Marion County,25278,24038,1240,4.9
CN5405100000000,2022-08-01,54,051,WV,Marshall County,13096,12455,641,4.9
CN5405300000000,2022-08-01,54,053,WV,Mason County,10278,9751,527,5.1
CN5405500000000,2022-08-01,54,055,WV,Mercer County,20415,19369,1046,5.1
CN5405700000000,2022-08-01,54,057,WV,Mineral County,12436,11919,517,4.2
CN5405900000000,2022-08-01,54,059,WV,Mingo County,6550,6120,430,6.6
CN5406100000000,2022-08-01,54,061,WV,Monongalia County,55574,53433,2141,3.9
CN5406300000000,2022-08-01,54,063,WV,Monroe County,5994,5789,205,3.4
CN5406500000000,2022-08-01,54,065,WV,Morgan County,8466,8199,267,3.2
CN5406700000000,2022-08-01,54,067,WV,Nicholas County,9106,8646,460,5.1
CN5406900000000,2022-08-01,54,069,WV,Ohio County,20045,19182,863,4.3
CN5407100000000,2022-08-01,54,071,WV,Pendleton County,3697,3598,99,2.7
CN5407300000000,2022-08-01,54,073,WV,Pleasants County,2702,2554,148,5.5
CN5407500000000,2022-08-01,54,075,WV,Pocahontas County,3746,3615,131,3.5
CN5407700000000,2022-08-01,54,077,WV,Preston County,15424,14725,699,4.5
CN5407900000000,2022-08-01,54,079,WV,Putnam County,27247,26292,955,3.5
CN5408100000000,2022-08-01,54,081,WV,Raleigh County,30422,29204,1218,4
CN5408300000000,2022-08-01,54,083,WV,Randolph County,11707,11145,562,4.8
CN5408500000000,2022-08-01,54,085,WV,Ritchie County,4164,3973,191,4.6
CN5408700000000,2022-08-01,54,087,WV,Roane County,4945,4641,304,6.1
CN5408900000000,2022-08-01,54,089,WV,Summers County,4674,4498,176,3.8
CN5409100000000,2022-08-01,54,091,WV,Taylor County,8040,7691,349,4.3
CN5409300000000,2022-08-01,54,093,WV,Tucker County,3534,3400,134,3.8
CN5409500000000,2022-08-01,54,095,WV,Tyler County,2856,2667,189,6.6
CN5409700000000,2022-08-01,54,097,WV,Upshur County,9481,9003,478,5
CN5409900000000,2022-08-01,54,099,WV,Wayne County,15812,15106,706,4.5
CN5410100000000,2022-08-01,54,101,WV,Webster County,2973,2822,151,5.1
CN5410300000000,2022-08-01,54,103,WV,Wetzel County,6313,5917,396,6.3
CN5410500000000,2022-08-01,54,105,WV,Wirt County,2255,2121,134,5.9
CN5410700000000,2022-08-01,54,107,WV,Wood County,36984,35376,1608,4.3
CN5410900000000,2022-08-01,54,109,WV,Wyoming County,7145,6792,353,4.9
CN5500100000000,2022-08-01,55,001,WI,Adams County,7795,7429,366,4.7
CN5500300000000,2022-08-01,55,003,WI,Ashland County,7720,7399,321,4.2
CN5500500000000,2022-08-01,55,005,WI,Barron County,23426,22669,757,3.2
CN5500700000000,2022-08-01,55,007,WI,Bayfield County,7529,7194,335,4.4
CN5500900000000,2022-08-01,55,009,WI,Brown County,142699,138546,4153,2.9
CN5501100000000,2022-08-01,55,011,WI,Buffalo County,5991,5762,229,3.8
CN5501300000000,2022-08-01,55,013,WI,Burnett County,7238,6950,288,4
CN5501500000000,2022-08-01,55,015,WI,Calumet County,27677,26962,715,2.6
CN5501700000000,2022-08-01,55,017,WI,Chippewa County,33509,32466,1043,3.1
CN5501900000000,2022-08-01,55,019,WI,Clark County,17153,16702,451,2.6
CN5502100000000,2022-08-01,55,021,WI,Columbia County,31768,30902,866,2.7
CN5502300000000,2022-08-01,55,023,WI,Crawford County,6906,6684,222,3.2
CN5502500000000,2022-08-01,55,025,WI,Dane County,331842,323970,7872,2.4
CN5502700000000,2022-08-01,55,027,WI,Dodge County,47915,46624,1291,2.7
CN5502900000000,2022-08-01,55,029,WI,Door County,16525,16091,434,2.6
CN5503100000000,2022-08-01,55,031,WI,Douglas County,22541,21611,930,4.1
CN5503300000000,2022-08-01,55,033,WI,Dunn County,22949,22189,760,3.3
CN5503500000000,2022-08-01,55,035,WI,Eau Claire County,60164,58460,1704,2.8
CN5503700000000,2022-08-01,55,037,WI,Florence County,2150,2079,71,3.3
CN5503900000000,2022-08-01,55,039,WI,Fond du Lac County,56895,55203,1692,3
CN5504100000000,2022-08-01,55,041,WI,Forest County,3822,3659,163,4.3
CN5504300000000,2022-08-01,55,043,WI,Grant County,25639,24889,750,2.9
CN5504500000000,2022-08-01,55,045,WI,Green County,20658,20146,512,2.5
CN5504700000000,2022-08-01,55,047,WI,Green Lake County,9246,8932,314,3.4
CN5504900000000,2022-08-01,55,049,WI,Iowa County,13383,13062,321,2.4
CN5505100000000,2022-08-01,55,051,WI,Iron County,2520,2400,120,4.8
CN5505300000000,2022-08-01,55,053,WI,Jackson County,9280,8961,319,3.4
CN5505500000000,2022-08-01,55,055,WI,Jefferson County,46201,44889,1312,2.8
CN5505700000000,2022-08-01,55,057,WI,Juneau County,13345,12904,441,3.3
CN5505900000000,2022-08-01,55,059,WI,Kenosha County,91514,88215,3299,3.6
CN5506100000000,2022-08-01,55,061,WI,Kewaunee County,10684,10432,252,2.4
CN5506300000000,2022-08-01,55,063,WI,La Crosse County,66147,64429,1718,2.6
CN5506500000000,2022-08-01,55,065,WI,Lafayette County,9561,9309,252,2.6
CN5506700000000,2022-08-01,55,067,WI,Langlade County,9161,8791,370,4
CN5506900000000,2022-08-01,55,069,WI,Lincoln County,14931,14414,517,3.5
CN5507100000000,2022-08-01,55,071,WI,Manitowoc County,40569,39420,1149,2.8
CN5507300000000,2022-08-01,55,073,WI,Marathon County,72896,70815,2081,2.9
CN5507500000000,2022-08-01,55,075,WI,Marinette County,18869,18093,776,4.1
CN5507700000000,2022-08-01,55,077,WI,Marquette County,7597,7347,250,3.3
CN5507800000000,2022-08-01,55,078,WI,Menominee County,1523,1400,123,8.1
CN5507900000000,2022-08-01,55,079,WI,Milwaukee County,466724,447301,19423,4.2
CN5508100000000,2022-08-01,55,081,WI,Monroe County,23075,22433,642,2.8
CN5508300000000,2022-08-01,55,083,WI,Oconto County,20604,19948,656,3.2
CN5508500000000,2022-08-01,55,085,WI,Oneida County,18446,17896,550,3
CN5508700000000,2022-08-01,55,087,WI,Outagamie County,105404,102372,3032,2.9
CN5508900000000,2022-08-01,55,089,WI,Ozaukee County,49383,48005,1378,2.8
CN5509100000000,2022-08-01,55,091,WI,Pepin County,3993,3882,111,2.8
CN5509300000000,2022-08-01,55,093,WI,Pierce County,24409,23623,786,3.2
CN5509500000000,2022-08-01,55,095,WI,Polk County,24233,23480,753,3.1
CN5509700000000,2022-08-01,55,097,WI,Portage County,37037,35900,1137,3.1
CN5509900000000,2022-08-01,55,099,WI,Price County,6106,5889,217,3.6
CN5510100000000,2022-08-01,55,101,WI,Racine County,99958,95961,3997,4
CN5510300000000,2022-08-01,55,103,WI,Richland County,8768,8525,243,2.8
CN5510500000000,2022-08-01,55,105,WI,Rock County,86335,83043,3292,3.8
CN5510700000000,2022-08-01,55,107,WI,Rusk County,6371,6154,217,3.4
CN5510900000000,2022-08-01,55,109,WI,St. Croix County,49717,48237,1480,3
CN5511100000000,2022-08-01,55,111,WI,Sauk County,34914,33937,977,2.8
CN5511300000000,2022-08-01,55,113,WI,Sawyer County,8204,7890,314,3.8
CN5511500000000,2022-08-01,55,115,WI,Shawano County,20200,19568,632,3.1
CN5511700000000,2022-08-01,55,117,WI,Sheboygan County,62243,60596,1647,2.6
CN5511900000000,2022-08-01,55,119,WI,Taylor County,10238,9952,286,2.8
CN5512100000000,2022-08-01,55,121,WI,Trempealeau County,14551,14140,411,2.8
CN5512300000000,2022-08-01,55,123,WI,Vernon County,14833,14444,389,2.6
CN5512500000000,2022-08-01,55,125,WI,Vilas County,10891,10518,373,3.4
CN5512700000000,2022-08-01,55,127,WI,Walworth County,57643,55809,1834,3.2
CN5512900000000,2022-08-01,55,129,WI,Washburn County,7785,7511,274,3.5
CN5513100000000,2022-08-01,55,131,WI,Washington County,77231,75183,2048,2.7
CN5513300000000,2022-08-01,55,133,WI,Waukesha County,226548,220104,6444,2.8
CN5513500000000,2022-08-01,55,135,WI,Waupaca County,25272,24456,816,3.2
CN5513700000000,2022-08-01,55,137,WI,Waushara County,10878,10508,370,3.4
CN5513900000000,2022-08-01,55,139,WI,Winnebago County,93153,90430,2723,2.9
CN5514100000000,2022-08-01,55,141,WI,Wood County,33268,32081,1187,3.6
CN5600100000000,2022-08-01,56,001,WY,Albany County,20373,19717,656,3.2
CN5600300000000,2022-08-01,56,003,WY,Big Horn County,5315,5106,209,3.9
CN5600500000000,2022-08-01,56,005,WY,Campbell County,22388,21607,781,3.5
CN5600700000000,2022-08-01,56,007,WY,Carbon County,7654,7382,272,3.6
CN5600900000000,2022-08-01,56,009,WY,Converse County,7681,7454,227,3
CN5601100000000,2022-08-01,56,011,WY,Crook County,4083,3918,165,4
CN5601300000000,2022-08-01,56,013,WY,Fremont County,19030,18273,757,4
CN5601500000000,2022-08-01,56,015,WY,Goshen County,6593,6412,181,2.7
CN5601700000000,2022-08-01,56,017,WY,Hot Springs County,2299,2229,70,3
CN5601900000000,2022-08-01,56,019,WY,Johnson County,4360,4223,137,3.1
CN5602100000000,2022-08-01,56,021,WY,Laramie County,49089,47362,1727,3.5
CN5602300000000,2022-08-01,56,023,WY,Lincoln County,9709,9415,294,3
CN5602500000000,2022-08-01,56,025,WY,Natrona County,39362,37830,1532,3.9
CN5602700000000,2022-08-01,56,027,WY,Niobrara County,1203,1165,38,3.2
CN5602900000000,2022-08-01,56,029,WY,Park County,16604,16091,513,3.1
CN5603100000000,2022-08-01,56,031,WY,Platte County,4452,4293,159,3.6
CN5603300000000,2022-08-01,56,033,WY,Sheridan County,16425,15908,517,3.1
CN5603500000000,2022-08-01,56,035,WY,Sublette County,4017,3866,151,3.8
CN5603700000000,2022-08-01,56,037,WY,Sweetwater County,19627,18850,777,4
CN5603900000000,2022-08-01,56,039,WY,Teton County,18593,18249,344,1.9
CN5604100000000,2022-08-01,56,041,WY,Uinta County,8951,8613,338,3.8
CN5604300000000,2022-08-01,56,043,WY,Washakie County,3894,3743,151,3.9
CN5604500000000,2022-08-01,56,045,WY,Weston County,3753,3662,91,2.4
CN7200100000000,2022-08-01,72,001,PR,Adjuntas Municipio,4337,4019,318,7.3
CN7200300000000,2022-08-01,72,003,PR,Aguada Municipio,13116,12268,848,6.5
CN7200500000000,2022-08-01,72,005,PR,Aguadilla Municipio,15937,14750,1187,7.4
CN7200700000000,2022-08-01,72,007,PR,Aguas Buenas Municipio,6970,6510,460,6.6
CN7200900000000,2022-08-01,72,009,PR,Aibonito Municipio,6813,6280,533,7.8
CN7201100000000,2022-08-01,72,011,PR,Anasco Municipio,9834,9287,547,5.6
CN7201300000000,2022-08-01,72,013,PR,Arecibo Municipio,25326,23631,1695,6.7
CN7201500000000,2022-08-01,72,015,PR,Arroyo Municipio,4821,4427,394,8.2
CN7201700000000,2022-08-01,72,017,PR,Barceloneta Municipio,6277,5769,508,8.1
CN7201900000000,2022-08-01,72,019,PR,Barranquitas Municipio,7778,7179,599,7.7
CN7202100000000,2022-08-01,72,021,PR,Bayamon Municipio,68761,65491,3270,4.8
CN7202300000000,2022-08-01,72,023,PR,Cabo Rojo Municipio,14761,13855,906,6.1
CN7202500000000,2022-08-01,72,025,PR,Caguas Municipio,50782,48245,2537,5
CN7202700000000,2022-08-01,72,027,PR,Camuy Municipio,10283,9538,745,7.2
CN7202900000000,2022-08-01,72,029,PR,Canovanas Municipio,17274,16485,789,4.6
CN7203100000000,2022-08-01,72,031,PR,Carolina Municipio,64968,62016,2952,4.5
CN7203300000000,2022-08-01,72,033,PR,Catano Municipio,8206,7805,401,4.9
CN7203500000000,2022-08-01,72,035,PR,Cayey Municipio,17252,16321,931,5.4
CN7203700000000,2022-08-01,72,037,PR,Ceiba Municipio,3775,3546,229,6.1
CN7203900000000,2022-08-01,72,039,PR,Ciales Municipio,3906,3530,376,9.6
CN7204100000000,2022-08-01,72,041,PR,Cidra Municipio,16441,15636,805,4.9
CN7204300000000,2022-08-01,72,043,PR,Coamo Municipio,10985,10188,797,7.3
CN7204500000000,2022-08-01,72,045,PR,Comerio Municipio,5224,4823,401,7.7
CN7204700000000,2022-08-01,72,047,PR,Corozal Municipio,9408,8683,725,7.7
CN7204900000000,2022-08-01,72,049,PR,Culebra Municipio,957,938,19,2
CN7205100000000,2022-08-01,72,051,PR,Dorado Municipio,14355,13746,609,4.2
CN7205300000000,2022-08-01,72,053,PR,Fajardo Municipio,11139,10441,698,6.3
CN7205400000000,2022-08-01,72,054,PR,Florida Municipio,3484,3191,293,8.4
CN7205500000000,2022-08-01,72,055,PR,Guanica Municipio,4002,3628,374,9.3
CN7205700000000,2022-08-01,72,057,PR,Guayama Municipio,11406,10582,824,7.2
CN7205900000000,2022-08-01,72,059,PR,Guayanilla Municipio,5074,4612,462,9.1
CN7206100000000,2022-08-01,72,061,PR,Guaynabo Municipio,40396,39143,1253,3.1
CN7206300000000,2022-08-01,72,063,PR,Gurabo Municipio,20090,19192,898,4.5
CN7206500000000,2022-08-01,72,065,PR,Hatillo Municipio,14666,13301,1365,9.3
CN7206700000000,2022-08-01,72,067,PR,Hormigueros Municipio,5850,5509,341,5.8
CN7206900000000,2022-08-01,72,069,PR,Humacao Municipio,18547,17426,1121,6
CN7207100000000,2022-08-01,72,071,PR,Isabela Municipio,13114,12228,886,6.8
CN7207300000000,2022-08-01,72,073,PR,Jayuya Municipio,4499,4150,349,7.8
CN7207500000000,2022-08-01,72,075,PR,Juana Diaz Municipio,16600,15442,1158,7
CN7207700000000,2022-08-01,72,077,PR,Juncos Municipio,13213,12391,822,6.2
CN7207900000000,2022-08-01,72,079,PR,Lajas Municipio,5564,5000,564,10.1
CN7208100000000,2022-08-01,72,081,PR,Lares Municipio,7938,6854,1084,13.7
CN7208300000000,2022-08-01,72,083,PR,Las Marias Municipio,2811,2316,495,17.6
CN7208500000000,2022-08-01,72,085,PR,Las Piedras Municipio,12218,11460,758,6.2
CN7208700000000,2022-08-01,72,087,PR,Loiza Municipio,8764,8295,469,5.4
CN7208900000000,2022-08-01,72,089,PR,Luquillo Municipio,6487,6101,386,6
CN7209100000000,2022-08-01,72,091,PR,Manati Municipio,11966,11219,747,6.2
CN7209300000000,2022-08-01,72,093,PR,Maricao Municipio,2053,1875,178,8.7
CN7209500000000,2022-08-01,72,095,PR,Maunabo Municipio,2952,2682,270,9.1
CN7209700000000,2022-08-01,72,097,PR,Mayaguez Municipio,23510,21844,1666,7.1
CN7209900000000,2022-08-01,72,099,PR,Moca Municipio,11641,10698,943,8.1
CN7210100000000,2022-08-01,72,101,PR,Morovis Municipio,8639,7974,665,7.7
CN7210300000000,2022-08-01,72,103,PR,Naguabo Municipio,8771,8240,531,6.1
CN7210500000000,2022-08-01,72,105,PR,Naranjito Municipio,7512,6983,529,7
CN7210700000000,2022-08-01,72,107,PR,Orocovis Municipio,5171,4711,460,8.9
CN7210900000000,2022-08-01,72,109,PR,Patillas Municipio,4308,3905,403,9.4
CN7211100000000,2022-08-01,72,111,PR,Penuelas Municipio,6014,5444,570,9.5
CN7211300000000,2022-08-01,72,113,PR,Ponce Municipio,47719,44406,3313,6.9
CN7211500000000,2022-08-01,72,115,PR,Quebradillas Municipio,6482,5927,555,8.6
CN7211700000000,2022-08-01,72,117,PR,Rincon Municipio,5033,4730,303,6
CN7211900000000,2022-08-01,72,119,PR,Rio Grande Municipio,18039,17054,985,5.5
CN7212100000000,2022-08-01,72,121,PR,Sabana Grande Municipio,6282,5764,518,8.2
CN7212300000000,2022-08-01,72,123,PR,Salinas Municipio,7362,6689,673,9.1
CN7212500000000,2022-08-01,72,125,PR,San German Municipio,10202,9436,766,7.5
CN7212700000000,2022-08-01,72,127,PR,San Juan Municipio,141607,135715,5892,4.2
CN7212900000000,2022-08-01,72,129,PR,San Lorenzo Municipio,12358,11522,836,6.8
CN7213100000000,2022-08-01,72,131,PR,San Sebastian Municipio,11187,10027,1160,10.4
CN7213300000000,2022-08-01,72,133,PR,Santa Isabel Municipio,8203,7536,667,8.1
CN7213500000000,2022-08-01,72,135,PR,Toa Alta Municipio,29624,28321,1303,4.4
CN7213700000000,2022-08-01,72,137,PR,Toa Baja Municipio,30751,29382,1369,4.5
CN7213900000000,2022-08-01,72,139,PR,Trujillo Alto Municipio,28869,27787,1082,3.7
CN7214100000000,2022-08-01,72,141,PR,Utuado Municipio,7252,6688,564,7.8
CN7214300000000,2022-08-01,72,143,PR,Vega Alta Municipio,10481,9723,758,7.2
CN7214500000000,2022-08-01,72,145,PR,Vega Baja Municipio,13867,12843,1024,7.4
CN7214700000000,2022-08-01,72,147,PR,Vieques Municipio,2671,2518,153,5.7
CN7214900000000,2022-08-01,72,149,PR,Villalba Municipio,7641,6823,818,10.7
CN7215100000000,2022-08-01,72,151,PR,Yabucoa Municipio,9022,8310,712,7.9
CN7215300000000,2022-08-01,72,153,PR,Yauco Municipio,10041,9100,941,9.4
CN0100100000000,2022-09-01,01,001,AL,Autauga County,26719,26133,586,2.2
CN0100300000000,2022-09-01,01,003,AL,Baldwin County,102370,100059,2311,2.3
CN0100500000000,2022-09-01,01,005,AL,Barbour County,8180,7880,300,3.7
CN0100700000000,2022-09-01,01,007,AL,Bibb County,8703,8489,214,2.5
CN0100900000000,2022-09-01,01,009,AL,Blount County,25722,25184,538,2.1
CN0101100000000,2022-09-01,01,011,AL,Bullock County,4603,4483,120,2.6
CN0101300000000,2022-09-01,01,013,AL,Butler County,8846,8569,277,3.1
CN0101500000000,2022-09-01,01,015,AL,Calhoun County,45876,44575,1301,2.8
CN0101700000000,2022-09-01,01,017,AL,Chambers County,15925,15545,380,2.4
CN0101900000000,2022-09-01,01,019,AL,Cherokee County,11680,11417,263,2.3
CN0102100000000,2022-09-01,01,021,AL,Chilton County,20240,19810,430,2.1
CN0102300000000,2022-09-01,01,023,AL,Choctaw County,4158,4004,154,3.7
CN0102500000000,2022-09-01,01,025,AL,Clarke County,7652,7274,378,4.9
CN0102700000000,2022-09-01,01,027,AL,Clay County,6284,6143,141,2.2
CN0102900000000,2022-09-01,01,029,AL,Cleburne County,6188,6039,149,2.4
CN0103100000000,2022-09-01,01,031,AL,Coffee County,21675,21141,534,2.5
CN0103300000000,2022-09-01,01,033,AL,Colbert County,23830,23149,681,2.9
CN0103500000000,2022-09-01,01,035,AL,Conecuh County,4262,4122,140,3.3
CN0103700000000,2022-09-01,01,037,AL,Coosa County,4502,4383,119,2.6
CN0103900000000,2022-09-01,01,039,AL,Covington County,15052,14666,386,2.6
CN0104100000000,2022-09-01,01,041,AL,Crenshaw County,6015,5865,150,2.5
CN0104300000000,2022-09-01,01,043,AL,Cullman County,39018,38237,781,2
CN0104500000000,2022-09-01,01,045,AL,Dale County,20950,20434,516,2.5
CN0104700000000,2022-09-01,01,047,AL,Dallas County,13614,12894,720,5.3
CN0104900000000,2022-09-01,01,049,AL,DeKalb County,31111,30421,690,2.2
CN0105100000000,2022-09-01,01,051,AL,Elmore County,38115,37294,821,2.2
CN0105300000000,2022-09-01,01,053,AL,Escambia County,14303,13856,447,3.1
CN0105500000000,2022-09-01,01,055,AL,Etowah County,38830,37704,1126,2.9
CN0105700000000,2022-09-01,01,057,AL,Fayette County,6553,6383,170,2.6
CN0105900000000,2022-09-01,01,059,AL,Franklin County,14600,14287,313,2.1
CN0106100000000,2022-09-01,01,061,AL,Geneva County,11350,11080,270,2.4
CN0106300000000,2022-09-01,01,063,AL,Greene County,2726,2605,121,4.4
CN0106500000000,2022-09-01,01,065,AL,Hale County,6080,5853,227,3.7
CN0106700000000,2022-09-01,01,067,AL,Henry County,7058,6881,177,2.5
CN0106900000000,2022-09-01,01,069,AL,Houston County,47966,46823,1143,2.4
CN0107100000000,2022-09-01,01,071,AL,Jackson County,23080,22537,543,2.4
CN0107300000000,2022-09-01,01,073,AL,Jefferson County,321712,313818,7894,2.5
CN0107500000000,2022-09-01,01,075,AL,Lamar County,5677,5554,123,2.2
CN0107700000000,2022-09-01,01,077,AL,Lauderdale County,42842,41794,1048,2.4
CN0107900000000,2022-09-01,01,079,AL,Lawrence County,14724,14398,326,2.2
CN0108100000000,2022-09-01,01,081,AL,Lee County,80176,78425,1751,2.2
CN0108300000000,2022-09-01,01,083,AL,Limestone County,48244,47277,967,2
CN0108500000000,2022-09-01,01,085,AL,Lowndes County,3516,3332,184,5.2
CN0108700000000,2022-09-01,01,087,AL,Macon County,7854,7587,267,3.4
CN0108900000000,2022-09-01,01,089,AL,Madison County,198636,194558,4078,2.1
CN0109100000000,2022-09-01,01,091,AL,Marengo County,7678,7415,263,3.4
CN0109300000000,2022-09-01,01,093,AL,Marion County,13677,13361,316,2.3
CN0109500000000,2022-09-01,01,095,AL,Marshall County,45459,44576,883,1.9
CN0109700000000,2022-09-01,01,097,AL,Mobile County,191489,185507,5982,3.1
CN0109900000000,2022-09-01,01,099,AL,Monroe County,7168,6884,284,4
CN0110100000000,2022-09-01,01,101,AL,Montgomery County,106836,103671,3165,3
CN0110300000000,2022-09-01,01,103,AL,Morgan County,60745,59542,1203,2
CN0110500000000,2022-09-01,01,105,AL,Perry County,3069,2925,144,4.7
CN0110700000000,2022-09-01,01,107,AL,Pickens County,7776,7545,231,3
CN0110900000000,2022-09-01,01,109,AL,Pike County,16170,15739,431,2.7
CN0111100000000,2022-09-01,01,111,AL,Randolph County,9634,9400,234,2.4
CN0111300000000,2022-09-01,01,113,AL,Russell County,23800,23196,604,2.5
CN0111500000000,2022-09-01,01,115,AL,St. Clair County,42046,41148,898,2.1
CN0111700000000,2022-09-01,01,117,AL,Shelby County,120809,118688,2121,1.8
CN0111900000000,2022-09-01,01,119,AL,Sumter County,4653,4500,153,3.3
CN0112100000000,2022-09-01,01,121,AL,Talladega County,36375,35324,1051,2.9
CN0112300000000,2022-09-01,01,123,AL,Tallapoosa County,17531,17054,477,2.7
CN0112500000000,2022-09-01,01,125,AL,Tuscaloosa County,104313,101916,2397,2.3
CN0112700000000,2022-09-01,01,127,AL,Walker County,25430,24769,661,2.6
CN0112900000000,2022-09-01,01,129,AL,Washington County,6561,6354,207,3.2
CN0113100000000,2022-09-01,01,131,AL,Wilcox County,2539,2353,186,7.3
CN0113300000000,2022-09-01,01,133,AL,Winston County,10243,10004,239,2.3
CN0201300000000,2022-09-01,02,013,AK,Aleutians East Borough,2358,2321,37,1.6
CN0201600000000,2022-09-01,02,016,AK,Aleutians West Census Area,2993,2894,99,3.3
CN0202000000000,2022-09-01,02,020,AK,Anchorage Borough/municipality,150533,146677,3856,2.6
CN0205000000000,2022-09-01,02,050,AK,Bethel Census Area,6537,6049,488,7.5
CN0206000000000,2022-09-01,02,060,AK,Bristol Bay Borough,368,357,11,3
CN0206300000000,2022-09-01,02,063,AK,Chugach Census Area,3539,3468,71,2
CN0206600000000,2022-09-01,02,066,AK,Copper River Census Area,1433,1343,90,6.3
CN0206800000000,2022-09-01,02,068,AK,Denali Borough,1377,1341,36,2.6
CN0207000000000,2022-09-01,02,070,AK,Dillingham Census Area,1735,1660,75,4.3
CN0209000000000,2022-09-01,02,090,AK,Fairbanks North Star Borough,44942,43759,1183,2.6
CN0210000000000,2022-09-01,02,100,AK,Haines Borough,1174,1131,43,3.7
CN0210500000000,2022-09-01,02,105,AK,Hoonah-Angoon Census Area,1462,1420,42,2.9
CN0211000000000,2022-09-01,02,110,AK,Juneau Borough/city,17848,17498,350,2
CN0212200000000,2022-09-01,02,122,AK,Kenai Peninsula Borough,28298,27387,911,3.2
CN0213000000000,2022-09-01,02,130,AK,Ketchikan Gateway Borough,7371,7189,182,2.5
CN0215000000000,2022-09-01,02,150,AK,Kodiak Island Borough,5972,5809,163,2.7
CN0215800000000,2022-09-01,02,158,AK,Kusilvak Census Area,2292,2059,233,10.2
CN0216400000000,2022-09-01,02,164,AK,Lake and Peninsula Borough,694,667,27,3.9
CN0217000000000,2022-09-01,02,170,AK,Matanuska-Susitna Borough,49436,47781,1655,3.3
CN0218000000000,2022-09-01,02,180,AK,Nome Census Area,4178,3940,238,5.7
CN0218500000000,2022-09-01,02,185,AK,North Slope Borough,2913,2785,128,4.4
CN0218800000000,2022-09-01,02,188,AK,Northwest Arctic Borough,2762,2541,221,8
CN0219500000000,2022-09-01,02,195,AK,Petersburg Borough,1457,1395,62,4.3
CN0219800000000,2022-09-01,02,198,AK,Prince of Wales-Hyder Census Area,2676,2557,119,4.4
CN0222000000000,2022-09-01,02,220,AK,Sitka Borough/city,4652,4568,84,1.8
CN0223000000000,2022-09-01,02,230,AK,Skagway Municipality,873,851,22,2.5
CN0224000000000,2022-09-01,02,240,AK,Southeast Fairbanks Census Area,3243,3127,116,3.6
CN0227500000000,2022-09-01,02,275,AK,Wrangell Borough/city,882,853,29,3.3
CN0228200000000,2022-09-01,02,282,AK,Yakutat Borough/city,326,314,12,3.7
CN0229000000000,2022-09-01,02,290,AK,Yukon-Koyukuk Census Area,2269,2132,137,6
CN0400100000000,2022-09-01,04,001,AZ,Apache County,19297,17850,1447,7.5
CN0400300000000,2022-09-01,04,003,AZ,Cochise County,49292,47029,2263,4.6
CN0400500000000,2022-09-01,04,005,AZ,Coconino County,76215,73020,3195,4.2
CN0400700000000,2022-09-01,04,007,AZ,Gila County,20971,20061,910,4.3
CN0400900000000,2022-09-01,04,009,AZ,Graham County,16472,15858,614,3.7
CN0401100000000,2022-09-01,04,011,AZ,Greenlee County,4962,4818,144,2.9
CN0401200000000,2022-09-01,04,012,AZ,La Paz County,9153,8709,444,4.9
CN0401300000000,2022-09-01,04,013,AZ,Maricopa County,2399368,2315175,84193,3.5
CN0401500000000,2022-09-01,04,015,AZ,Mohave County,90941,86728,4213,4.6
CN0401700000000,2022-09-01,04,017,AZ,Navajo County,40823,38768,2055,5
CN0401900000000,2022-09-01,04,019,AZ,Pima County,492791,473089,19702,4
CN0402100000000,2022-09-01,04,021,AZ,Pinal County,201599,193329,8270,4.1
CN0402300000000,2022-09-01,04,023,AZ,Santa Cruz County,18871,17138,1733,9.2
CN0402500000000,2022-09-01,04,025,AZ,Yavapai County,110136,106053,4083,3.7
CN0402700000000,2022-09-01,04,027,AZ,Yuma County,99666,86689,12977,13
CN0500100000000,2022-09-01,05,001,AR,Arkansas County,9399,9123,276,2.9
CN0500300000000,2022-09-01,05,003,AR,Ashley County,6818,6441,377,5.5
CN0500500000000,2022-09-01,05,005,AR,Baxter County,16630,16015,615,3.7
CN0500700000000,2022-09-01,05,007,AR,Benton County,153550,149905,3645,2.4
CN0500900000000,2022-09-01,05,009,AR,Boone County,16004,15516,488,3
CN0501100000000,2022-09-01,05,011,AR,Bradley County,4072,3848,224,5.5
CN0501300000000,2022-09-01,05,013,AR,Calhoun County,2382,2308,74,3.1
CN0501500000000,2022-09-01,05,015,AR,Carroll County,12836,12469,367,2.9
CN0501700000000,2022-09-01,05,017,AR,Chicot County,2962,2789,173,5.8
CN0501900000000,2022-09-01,05,019,AR,Clark County,8607,8252,355,4.1
CN0502100000000,2022-09-01,05,021,AR,Clay County,5456,5254,202,3.7
CN0502300000000,2022-09-01,05,023,AR,Cleburne County,9107,8747,360,4
CN0502500000000,2022-09-01,05,025,AR,Cleveland County,3103,2984,119,3.8
CN0502700000000,2022-09-01,05,027,AR,Columbia County,8950,8586,364,4.1
CN0502900000000,2022-09-01,05,029,AR,Conway County,8357,8053,304,3.6
CN0503100000000,2022-09-01,05,031,AR,Craighead County,57896,56308,1588,2.7
CN0503300000000,2022-09-01,05,033,AR,Crawford County,26377,25546,831,3.2
CN0503500000000,2022-09-01,05,035,AR,Crittenden County,20609,19777,832,4
CN0503700000000,2022-09-01,05,037,AR,Cross County,6895,6649,246,3.6
CN0503900000000,2022-09-01,05,039,AR,Dallas County,2716,2611,105,3.9
CN0504100000000,2022-09-01,05,041,AR,Desha County,4952,4715,237,4.8
CN0504300000000,2022-09-01,05,043,AR,Drew County,7549,7226,323,4.3
CN0504500000000,2022-09-01,05,045,AR,Faulkner County,63065,61230,1835,2.9
CN0504700000000,2022-09-01,05,047,AR,Franklin County,7496,7249,247,3.3
CN0504900000000,2022-09-01,05,049,AR,Fulton County,5065,4890,175,3.5
CN0505100000000,2022-09-01,05,051,AR,Garland County,42019,40449,1570,3.7
CN0505300000000,2022-09-01,05,053,AR,Grant County,8458,8191,267,3.2
CN0505500000000,2022-09-01,05,055,AR,Greene County,19875,19283,592,3
CN0505700000000,2022-09-01,05,057,AR,Hempstead County,9483,9192,291,3.1
CN0505900000000,2022-09-01,05,059,AR,Hot Spring County,13855,13364,491,3.5
CN0506100000000,2022-09-01,05,061,AR,Howard County,5343,5166,177,3.3
CN0506300000000,2022-09-01,05,063,AR,Independence County,16718,16183,535,3.2
CN0506500000000,2022-09-01,05,065,AR,Izard County,4607,4394,213,4.6
CN0506700000000,2022-09-01,05,067,AR,Jackson County,5523,5262,261,4.7
CN0506900000000,2022-09-01,05,069,AR,Jefferson County,25517,24275,1242,4.9
CN0507100000000,2022-09-01,05,071,AR,Johnson County,10089,9693,396,3.9
CN0507300000000,2022-09-01,05,073,AR,Lafayette County,2333,2232,101,4.3
CN0507500000000,2022-09-01,05,075,AR,Lawrence County,6968,6724,244,3.5
CN0507700000000,2022-09-01,05,077,AR,Lee County,2564,2451,113,4.4
CN0507900000000,2022-09-01,05,079,AR,Lincoln County,3720,3563,157,4.2
CN0508100000000,2022-09-01,05,081,AR,Little River County,5178,4976,202,3.9
CN0508300000000,2022-09-01,05,083,AR,Logan County,8351,8030,321,3.8
CN0508500000000,2022-09-01,05,085,AR,Lonoke County,34261,33295,966,2.8
CN0508700000000,2022-09-01,05,087,AR,Madison County,7933,7738,195,2.5
CN0508900000000,2022-09-01,05,089,AR,Marion County,6413,6173,240,3.7
CN0509100000000,2022-09-01,05,091,AR,Miller County,18681,17972,709,3.8
CN0509300000000,2022-09-01,05,093,AR,Mississippi County,16492,15729,763,4.6
CN0509500000000,2022-09-01,05,095,AR,Monroe County,2569,2468,101,3.9
CN0509700000000,2022-09-01,05,097,AR,Montgomery County,2922,2792,130,4.4
CN0509900000000,2022-09-01,05,099,AR,Nevada County,3483,3356,127,3.6
CN0510100000000,2022-09-01,05,101,AR,Newton County,3230,3137,93,2.9
CN0510300000000,2022-09-01,05,103,AR,Ouachita County,9655,9287,368,3.8
CN0510500000000,2022-09-01,05,105,AR,Perry County,4226,4084,142,3.4
CN0510700000000,2022-09-01,05,107,AR,Phillips County,5574,5229,345,6.2
CN0510900000000,2022-09-01,05,109,AR,Pike County,4053,3915,138,3.4
CN0511100000000,2022-09-01,05,111,AR,Poinsett County,10049,9726,323,3.2
CN0511300000000,2022-09-01,05,113,AR,Polk County,7942,7671,271,3.4
CN0511500000000,2022-09-01,05,115,AR,Pope County,27986,26948,1038,3.7
CN0511700000000,2022-09-01,05,117,AR,Prairie County,3627,3521,106,2.9
CN0511900000000,2022-09-01,05,119,AR,Pulaski County,189072,182664,6408,3.4
CN0512100000000,2022-09-01,05,121,AR,Randolph County,7220,6988,232,3.2
CN0512300000000,2022-09-01,05,123,AR,St. Francis County,7525,7155,370,4.9
CN0512500000000,2022-09-01,05,125,AR,Saline County,59950,58275,1675,2.8
CN0512700000000,2022-09-01,05,127,AR,Scott County,4322,4203,119,2.8
CN0512900000000,2022-09-01,05,129,AR,Searcy County,2917,2796,121,4.1
CN0513100000000,2022-09-01,05,131,AR,Sebastian County,55447,53728,1719,3.1
CN0513300000000,2022-09-01,05,133,AR,Sevier County,5529,5322,207,3.7
CN0513500000000,2022-09-01,05,135,AR,Sharp County,5962,5726,236,4
CN0513700000000,2022-09-01,05,137,AR,Stone County,4684,4503,181,3.9
CN0513900000000,2022-09-01,05,139,AR,Union County,14838,14157,681,4.6
CN0514100000000,2022-09-01,05,141,AR,Van Buren County,6049,5798,251,4.1
CN0514300000000,2022-09-01,05,143,AR,Washington County,135706,132598,3108,2.3
CN0514500000000,2022-09-01,05,145,AR,White County,34378,33224,1154,3.4
CN0514700000000,2022-09-01,05,147,AR,Woodruff County,2862,2771,91,3.2
CN0514900000000,2022-09-01,05,149,AR,Yell County,8045,7750,295,3.7
CN0600100000000,2022-09-01,06,001,CA,Alameda County,829021,804491,24530,3
CN0600300000000,2022-09-01,06,003,CA,Alpine County,452,431,21,4.6
CN0600500000000,2022-09-01,06,005,CA,Amador County,14413,13848,565,3.9
CN0600700000000,2022-09-01,06,007,CA,Butte County,92506,88955,3551,3.8
CN0600900000000,2022-09-01,06,009,CA,Calaveras County,22394,21687,707,3.2
CN0601100000000,2022-09-01,06,011,CA,Colusa County,10130,9395,735,7.3
CN0601300000000,2022-09-01,06,013,CA,Contra Costa County,553623,536233,17390,3.1
CN0601500000000,2022-09-01,06,015,CA,Del Norte County,9485,9066,419,4.4
CN0601700000000,2022-09-01,06,017,CA,El Dorado County,93883,91163,2720,2.9
CN0601900000000,2022-09-01,06,019,CA,Fresno County,456526,432733,23793,5.2
CN0602100000000,2022-09-01,06,021,CA,Glenn County,12997,12405,592,4.6
CN0602300000000,2022-09-01,06,023,CA,Humboldt County,60050,57967,2083,3.5
CN0602500000000,2022-09-01,06,025,CA,Imperial County,71655,59965,11690,16.3
CN0602700000000,2022-09-01,06,027,CA,Inyo County,8350,8103,247,3
CN0602900000000,2022-09-01,06,029,CA,Kern County,397796,374588,23208,5.8
CN0603100000000,2022-09-01,06,031,CA,Kings County,56820,53707,3113,5.5
CN0603300000000,2022-09-01,06,033,CA,Lake County,28482,27268,1214,4.3
CN0603500000000,2022-09-01,06,035,CA,Lassen County,9299,8975,324,3.5
CN0603700000000,2022-09-01,06,037,CA,Los Angeles County,4958064,4744505,213559,4.3
CN0603900000000,2022-09-01,06,039,CA,Madera County,63855,60683,3172,5
CN0604100000000,2022-09-01,06,041,CA,Marin County,132630,129468,3162,2.4
CN0604300000000,2022-09-01,06,043,CA,Mariposa County,7724,7458,266,3.4
CN0604500000000,2022-09-01,06,045,CA,Mendocino County,37625,36350,1275,3.4
CN0604700000000,2022-09-01,06,047,CA,Merced County,117801,110913,6888,5.8
CN0604900000000,2022-09-01,06,049,CA,Modoc County,3195,3069,126,3.9
CN0605100000000,2022-09-01,06,051,CA,Mono County,8543,8247,296,3.5
CN0605300000000,2022-09-01,06,053,CA,Monterey County,229067,220591,8476,3.7
CN0605500000000,2022-09-01,06,055,CA,Napa County,73217,71276,1941,2.7
CN0605700000000,2022-09-01,06,057,CA,Nevada County,48577,47141,1436,3
CN0605900000000,2022-09-01,06,059,CA,Orange County,1598729,1553276,45453,2.8
CN0606100000000,2022-09-01,06,061,CA,Placer County,195163,189773,5390,2.8
CN0606300000000,2022-09-01,06,063,CA,Plumas County,7737,7407,330,4.3
CN0606500000000,2022-09-01,06,065,CA,Riverside County,1152489,1107117,45372,3.9
CN0606700000000,2022-09-01,06,067,CA,Sacramento County,732316,706742,25574,3.5
CN0606900000000,2022-09-01,06,069,CA,San Benito County,32530,31244,1286,4
CN0607100000000,2022-09-01,06,071,CA,San Bernardino County,1007538,970015,37523,3.7
CN0607300000000,2022-09-01,06,073,CA,San Diego County,1599976,1550579,49397,3.1
CN0607500000000,2022-09-01,06,075,CA,San Francisco County/city,576715,563734,12981,2.3
CN0607700000000,2022-09-01,06,077,CA,San Joaquin County,346054,330333,15721,4.5
CN0607900000000,2022-09-01,06,079,CA,San Luis Obispo County,137122,133446,3676,2.7
CN0608100000000,2022-09-01,06,081,CA,San Mateo County,456775,446973,9802,2.1
CN0608300000000,2022-09-01,06,083,CA,Santa Barbara County,225769,219332,6437,2.9
CN0608500000000,2022-09-01,06,085,CA,Santa Clara County,1049882,1025126,24756,2.4
CN0608700000000,2022-09-01,06,087,CA,Santa Cruz County,135916,131200,4716,3.5
CN0608900000000,2022-09-01,06,089,CA,Shasta County,73445,70591,2854,3.9
CN0609100000000,2022-09-01,06,091,CA,Sierra County,1368,1331,37,2.7
CN0609300000000,2022-09-01,06,093,CA,Siskiyou County,17177,16443,734,4.3
CN0609500000000,2022-09-01,06,095,CA,Solano County,202668,195306,7362,3.6
CN0609700000000,2022-09-01,06,097,CA,Sonoma County,251465,244637,6828,2.7
CN0609900000000,2022-09-01,06,099,CA,Stanislaus County,244760,233688,11072,4.5
CN0610100000000,2022-09-01,06,101,CA,Sutter County,47088,44748,2340,5
CN0610300000000,2022-09-01,06,103,CA,Tehama County,26186,25090,1096,4.2
CN0610500000000,2022-09-01,06,105,CA,Trinity County,4691,4523,168,3.6
CN0610700000000,2022-09-01,06,107,CA,Tulare County,208565,193263,15302,7.3
CN0610900000000,2022-09-01,06,109,CA,Tuolumne County,19946,19194,752,3.8
CN0611100000000,2022-09-01,06,111,CA,Ventura County,413850,399698,14152,3.4
CN0611300000000,2022-09-01,06,113,CA,Yolo County,109372,105749,3623,3.3
CN0611500000000,2022-09-01,06,115,CA,Yuba County,32027,30533,1494,4.7
CN0800100000000,2022-09-01,08,001,CO,Adams County,282207,274258,7949,2.8
CN0800300000000,2022-09-01,08,003,CO,Alamosa County,8168,7922,246,3
CN0800500000000,2022-09-01,08,005,CO,Arapahoe County,376488,366741,9747,2.6
CN0800700000000,2022-09-01,08,007,CO,Archuleta County,7091,6920,171,2.4
CN0800900000000,2022-09-01,08,009,CO,Baca County,2024,1994,30,1.5
CN0801100000000,2022-09-01,08,011,CO,Bent County,1755,1700,55,3.1
CN0801300000000,2022-09-01,08,013,CO,Boulder County,204490,200289,4201,2.1
CN0801400000000,2022-09-01,08,014,CO,Broomfield County/city,42598,41635,963,2.3
CN0801500000000,2022-09-01,08,015,CO,Chaffee County,10066,9843,223,2.2
CN0801700000000,2022-09-01,08,017,CO,Cheyenne County,1018,1002,16,1.6
CN0801900000000,2022-09-01,08,019,CO,Clear Creek County,6187,6031,156,2.5
CN0802100000000,2022-09-01,08,021,CO,Conejos County,3945,3836,109,2.8
CN0802300000000,2022-09-01,08,023,CO,Costilla County,1812,1754,58,3.2
CN0802500000000,2022-09-01,08,025,CO,Crowley County,1363,1319,44,3.2
CN0802700000000,2022-09-01,08,027,CO,Custer County,2346,2287,59,2.5
CN0802900000000,2022-09-01,08,029,CO,Delta County,13339,12961,378,2.8
CN0803100000000,2022-09-01,08,031,CO,Denver County/city,437821,426235,11586,2.6
CN0803300000000,2022-09-01,08,033,CO,Dolores County,1145,1120,25,2.2
CN0803500000000,2022-09-01,08,035,CO,Douglas County,208474,204046,4428,2.1
CN0803700000000,2022-09-01,08,037,CO,Eagle County,34351,33652,699,2
CN0803900000000,2022-09-01,08,039,CO,Elbert County,16040,15703,337,2.1
CN0804100000000,2022-09-01,08,041,CO,El Paso County,361311,351265,10046,2.8
CN0804300000000,2022-09-01,08,043,CO,Fremont County,14614,14042,572,3.9
CN0804500000000,2022-09-01,08,045,CO,Garfield County,30959,30223,736,2.4
CN0804700000000,2022-09-01,08,047,CO,Gilpin County,3952,3864,88,2.2
CN0804900000000,2022-09-01,08,049,CO,Grand County,9066,8862,204,2.3
CN0805100000000,2022-09-01,08,051,CO,Gunnison County,11665,11462,203,1.7
CN0805300000000,2022-09-01,08,053,CO,Hinsdale County,504,494,10,2
CN0805500000000,2022-09-01,08,055,CO,Huerfano County,2506,2372,134,5.3
CN0805700000000,2022-09-01,08,057,CO,Jackson County,1010,994,16,1.6
CN0805900000000,2022-09-01,08,059,CO,Jefferson County,344451,336406,8045,2.3
CN0806100000000,2022-09-01,08,061,CO,Kiowa County,896,883,13,1.5
CN0806300000000,2022-09-01,08,063,CO,Kit Carson County,4015,3953,62,1.5
CN0806500000000,2022-09-01,08,065,CO,Lake County,4821,4715,106,2.2
CN0806700000000,2022-09-01,08,067,CO,La Plata County,31337,30614,723,2.3
CN0806900000000,2022-09-01,08,069,CO,Larimer County,213070,208341,4729,2.2
CN0807100000000,2022-09-01,08,071,CO,Las Animas County,5989,5758,231,3.9
CN0807300000000,2022-09-01,08,073,CO,Lincoln County,2156,2102,54,2.5
CN0807500000000,2022-09-01,08,075,CO,Logan County,10132,9909,223,2.2
CN0807700000000,2022-09-01,08,077,CO,Mesa County,77679,75562,2117,2.7
CN0807900000000,2022-09-01,08,079,CO,Mineral County,443,431,12,2.7
CN0808100000000,2022-09-01,08,081,CO,Moffat County,6821,6660,161,2.4
CN0808300000000,2022-09-01,08,083,CO,Montezuma County,12623,12266,357,2.8
CN0808500000000,2022-09-01,08,085,CO,Montrose County,21251,20689,562,2.6
CN0808700000000,2022-09-01,08,087,CO,Morgan County,15193,14775,418,2.8
CN0808900000000,2022-09-01,08,089,CO,Otero County,7796,7516,280,3.6
CN0809100000000,2022-09-01,08,091,CO,Ouray County,2624,2568,56,2.1
CN0809300000000,2022-09-01,08,093,CO,Park County,11745,11484,261,2.2
CN0809500000000,2022-09-01,08,095,CO,Phillips County,2373,2333,40,1.7
CN0809700000000,2022-09-01,08,097,CO,Pitkin County,10651,10386,265,2.5
CN0809900000000,2022-09-01,08,099,CO,Prowers County,6066,5936,130,2.1
CN0810100000000,2022-09-01,08,101,CO,Pueblo County,76758,73942,2816,3.7
CN0810300000000,2022-09-01,08,103,CO,Rio Blanco County,2854,2774,80,2.8
CN0810500000000,2022-09-01,08,105,CO,Rio Grande County,5179,5012,167,3.2
CN0810700000000,2022-09-01,08,107,CO,Routt County,15350,15039,311,2
CN0810900000000,2022-09-01,08,109,CO,Saguache County,3289,3203,86,2.6
CN0811100000000,2022-09-01,08,111,CO,San Juan County,660,650,10,1.5
CN0811300000000,2022-09-01,08,113,CO,San Miguel County,5804,5698,106,1.8
CN0811500000000,2022-09-01,08,115,CO,Sedgwick County,1053,1031,22,2.1
CN0811700000000,2022-09-01,08,117,CO,Summit County,20519,20120,399,1.9
CN0811900000000,2022-09-01,08,119,CO,Teller County,13564,13236,328,2.4
CN0812100000000,2022-09-01,08,121,CO,Washington County,2694,2641,53,2
CN0812300000000,2022-09-01,08,123,CO,Weld County,170077,165571,4506,2.6
CN0812500000000,2022-09-01,08,125,CO,Yuma County,5338,5246,92,1.7
CN0900100000000,2022-09-01,09,001,CT,Fairfield County,483721,466222,17499,3.6
CN0900300000000,2022-09-01,09,003,CT,Hartford County,480206,462479,17727,3.7
CN0900500000000,2022-09-01,09,005,CT,Litchfield County,105292,101938,3354,3.2
CN0900700000000,2022-09-01,09,007,CT,Middlesex County,94212,91290,2922,3.1
CN0900900000000,2022-09-01,09,009,CT,New Haven County,469415,451641,17774,3.8
CN0901100000000,2022-09-01,09,011,CT,New London County,134952,130078,4874,3.6
CN0901300000000,2022-09-01,09,013,CT,Tolland County,86624,83969,2655,3.1
CN0901500000000,2022-09-01,09,015,CT,Windham County,63880,61602,2278,3.6
CN1000100000000,2022-09-01,10,001,DE,Kent County,78539,74680,3859,4.9
CN1000300000000,2022-09-01,10,003,DE,New Castle County,301456,289127,12329,4.1
CN1000500000000,2022-09-01,10,005,DE,Sussex County,111746,107220,4526,4.1
CN1100100000000,2022-09-01,11,001,DC,District of Columbia,388623,372724,15899,4.1
CN1200100000000,2022-09-01,12,001,FL,Alachua County,144946,141210,3736,2.6
CN1200300000000,2022-09-01,12,003,FL,Baker County,12823,12486,337,2.6
CN1200500000000,2022-09-01,12,005,FL,Bay County,89396,87252,2144,2.4
CN1200700000000,2022-09-01,12,007,FL,Bradford County,11340,11008,332,2.9
CN1200900000000,2022-09-01,12,009,FL,Brevard County,300191,292200,7991,2.7
CN1201100000000,2022-09-01,12,011,FL,Broward County,1078321,1050101,28220,2.6
CN1201300000000,2022-09-01,12,013,FL,Calhoun County,4916,4763,153,3.1
CN1201500000000,2022-09-01,12,015,FL,Charlotte County,77213,74786,2427,3.1
CN1201700000000,2022-09-01,12,017,FL,Citrus County,49962,47968,1994,4
CN1201900000000,2022-09-01,12,019,FL,Clay County,114682,111877,2805,2.4
CN1202100000000,2022-09-01,12,021,FL,Collier County,189469,184273,5196,2.7
CN1202300000000,2022-09-01,12,023,FL,Columbia County,29678,28801,877,3
CN1202700000000,2022-09-01,12,027,FL,DeSoto County,14041,13603,438,3.1
CN1202900000000,2022-09-01,12,029,FL,Dixie County,6006,5824,182,3
CN1203100000000,2022-09-01,12,031,FL,Duval County,518920,504556,14364,2.8
CN1203300000000,2022-09-01,12,033,FL,Escambia County,151175,146985,4190,2.8
CN1203500000000,2022-09-01,12,035,FL,Flagler County,51229,49608,1621,3.2
CN1203700000000,2022-09-01,12,037,FL,Franklin County,4888,4769,119,2.4
CN1203900000000,2022-09-01,12,039,FL,Gadsden County,19436,18762,674,3.5
CN1204100000000,2022-09-01,12,041,FL,Gilchrist County,7580,7365,215,2.8
CN1204300000000,2022-09-01,12,043,FL,Glades County,5117,4957,160,3.1
CN1204500000000,2022-09-01,12,045,FL,Gulf County,5518,5383,135,2.4
CN1204700000000,2022-09-01,12,047,FL,Hamilton County,4231,4076,155,3.7
CN1204900000000,2022-09-01,12,049,FL,Hardee County,8834,8499,335,3.8
CN1205100000000,2022-09-01,12,051,FL,Hendry County,15387,14599,788,5.1
CN1205300000000,2022-09-01,12,053,FL,Hernando County,77713,75094,2619,3.4
CN1205500000000,2022-09-01,12,055,FL,Highlands County,36237,34785,1452,4
CN1205700000000,2022-09-01,12,057,FL,Hillsborough County,812229,791349,20880,2.6
CN1205900000000,2022-09-01,12,059,FL,Holmes County,7122,6922,200,2.8
CN1206100000000,2022-09-01,12,061,FL,Indian River County,68082,65865,2217,3.3
CN1206300000000,2022-09-01,12,063,FL,Jackson County,16662,16154,508,3
CN1206500000000,2022-09-01,12,065,FL,Jefferson County,5850,5681,169,2.9
CN1206700000000,2022-09-01,12,067,FL,Lafayette County,2837,2759,78,2.7
CN1206900000000,2022-09-01,12,069,FL,Lake County,174376,169496,4880,2.8
CN1207100000000,2022-09-01,12,071,FL,Lee County,377077,366913,10164,2.7
CN1207300000000,2022-09-01,12,073,FL,Leon County,163251,158862,4389,2.7
CN1207500000000,2022-09-01,12,075,FL,Levy County,17372,16812,560,3.2
CN1207700000000,2022-09-01,12,077,FL,Liberty County,2678,2597,81,3
CN1207900000000,2022-09-01,12,079,FL,Madison County,7924,7683,241,3
CN1208100000000,2022-09-01,12,081,FL,Manatee County,187259,182066,5193,2.8
CN1208300000000,2022-09-01,12,083,FL,Marion County,149827,144929,4898,3.3
CN1208500000000,2022-09-01,12,085,FL,Martin County,76887,74885,2002,2.6
CN1208600000000,2022-09-01,12,086,FL,Miami-Dade County,1368450,1332910,35540,2.6
CN1208700000000,2022-09-01,12,087,FL,Monroe County,48696,47837,859,1.8
CN1208900000000,2022-09-01,12,089,FL,Nassau County,45340,44236,1104,2.4
CN1209100000000,2022-09-01,12,091,FL,Okaloosa County,104258,101873,2385,2.3
CN1209300000000,2022-09-01,12,093,FL,Okeechobee County,17793,17279,514,2.9
CN1209500000000,2022-09-01,12,095,FL,Orange County,807456,786591,20865,2.6
CN1209700000000,2022-09-01,12,097,FL,Osceola County,200949,194946,6003,3
CN1209900000000,2022-09-01,12,099,FL,Palm Beach County,767870,746533,21337,2.8
CN1210100000000,2022-09-01,12,101,FL,Pasco County,261115,253559,7556,2.9
CN1210300000000,2022-09-01,12,103,FL,Pinellas County,516337,503446,12891,2.5
CN1210500000000,2022-09-01,12,105,FL,Polk County,343156,332102,11054,3.2
CN1210700000000,2022-09-01,12,107,FL,Putnam County,27603,26608,995,3.6
CN1210900000000,2022-09-01,12,109,FL,St. Johns County,151151,147809,3342,2.2
CN1211100000000,2022-09-01,12,111,FL,St. Lucie County,157184,152146,5038,3.2
CN1211300000000,2022-09-01,12,113,FL,Santa Rosa County,88848,86633,2215,2.5
CN1211500000000,2022-09-01,12,115,FL,Sarasota County,196780,191457,5323,2.7
CN1211700000000,2022-09-01,12,117,FL,Seminole County,269031,262403,6628,2.5
CN1211900000000,2022-09-01,12,119,FL,Sumter County,37962,36443,1519,4
CN1212100000000,2022-09-01,12,121,FL,Suwannee County,17852,17307,545,3.1
CN1212300000000,2022-09-01,12,123,FL,Taylor County,8187,7940,247,3
CN1212500000000,2022-09-01,12,125,FL,Union County,4637,4495,142,3.1
CN1212700000000,2022-09-01,12,127,FL,Volusia County,269897,262075,7822,2.9
CN1212900000000,2022-09-01,12,129,FL,Wakulla County,16371,15975,396,2.4
CN1213100000000,2022-09-01,12,131,FL,Walton County,35338,34480,858,2.4
CN1213300000000,2022-09-01,12,133,FL,Washington County,9943,9653,290,2.9
CN1300100000000,2022-09-01,13,001,GA,Appling County,9152,8818,334,3.6
CN1300300000000,2022-09-01,13,003,GA,Atkinson County,4352,4245,107,2.5
CN1300500000000,2022-09-01,13,005,GA,Bacon County,4915,4786,129,2.6
CN1300700000000,2022-09-01,13,007,GA,Baker County,1103,1064,39,3.5
CN1300900000000,2022-09-01,13,009,GA,Baldwin County,17993,17321,672,3.7
CN1301100000000,2022-09-01,13,011,GA,Banks County,10808,10595,213,2
CN1301300000000,2022-09-01,13,013,GA,Barrow County,42996,42001,995,2.3
CN1301500000000,2022-09-01,13,015,GA,Bartow County,52155,50800,1355,2.6
CN1301700000000,2022-09-01,13,017,GA,Ben Hill County,5622,5396,226,4
CN1301900000000,2022-09-01,13,019,GA,Berrien County,7730,7512,218,2.8
CN1302100000000,2022-09-01,13,021,GA,Bibb County,64751,62470,2281,3.5
CN1302300000000,2022-09-01,13,023,GA,Bleckley County,4483,4300,183,4.1
CN1302500000000,2022-09-01,13,025,GA,Brantley County,7456,7214,242,3.2
CN1302700000000,2022-09-01,13,027,GA,Brooks County,6666,6471,195,2.9
CN1302900000000,2022-09-01,13,029,GA,Bryan County,20015,19537,478,2.4
CN1303100000000,2022-09-01,13,031,GA,Bulloch County,38353,37221,1132,3
CN1303300000000,2022-09-01,13,033,GA,Burke County,8941,8502,439,4.9
CN1303500000000,2022-09-01,13,035,GA,Butts County,11302,11016,286,2.5
CN1303700000000,2022-09-01,13,037,GA,Calhoun County,2185,2122,63,2.9
CN1303900000000,2022-09-01,13,039,GA,Camden County,22026,21415,611,2.8
CN1304300000000,2022-09-01,13,043,GA,Candler County,6007,5873,134,2.2
CN1304500000000,2022-09-01,13,045,GA,Carroll County,57141,55572,1569,2.7
CN1304700000000,2022-09-01,13,047,GA,Catoosa County,33545,32745,800,2.4
CN1304900000000,2022-09-01,13,049,GA,Charlton County,5056,4904,152,3
CN1305100000000,2022-09-01,13,051,GA,Chatham County,143148,139148,4000,2.8
CN1305300000000,2022-09-01,13,053,GA,Chattahoochee County,1905,1823,82,4.3
CN1305500000000,2022-09-01,13,055,GA,Chattooga County,9222,8847,375,4.1
CN1305700000000,2022-09-01,13,057,GA,Cherokee County,142728,139599,3129,2.2
CN1305900000000,2022-09-01,13,059,GA,Clarke County,57987,56273,1714,3
CN1306100000000,2022-09-01,13,061,GA,Clay County,807,755,52,6.4
CN1306300000000,2022-09-01,13,063,GA,Clayton County,139760,134704,5056,3.6
CN1306500000000,2022-09-01,13,065,GA,Clinch County,2916,2845,71,2.4
CN1306700000000,2022-09-01,13,067,GA,Cobb County,431263,420834,10429,2.4
CN1306900000000,2022-09-01,13,069,GA,Coffee County,18915,18303,612,3.2
CN1307100000000,2022-09-01,13,071,GA,Colquitt County,21932,21354,578,2.6
CN1307300000000,2022-09-01,13,073,GA,Columbia County,75640,73584,2056,2.7
CN1307500000000,2022-09-01,13,075,GA,Cook County,8196,7967,229,2.8
CN1307700000000,2022-09-01,13,077,GA,Coweta County,77574,75687,1887,2.4
CN1307900000000,2022-09-01,13,079,GA,Crawford County,5309,5156,153,2.9
CN1308100000000,2022-09-01,13,081,GA,Crisp County,9773,9343,430,4.4
CN1308300000000,2022-09-01,13,083,GA,Dade County,8116,7924,192,2.4
CN1308500000000,2022-09-01,13,085,GA,Dawson County,13430,13128,302,2.2
CN1308700000000,2022-09-01,13,087,GA,Decatur County,11793,11412,381,3.2
CN1308900000000,2022-09-01,13,089,GA,DeKalb County,404727,392824,11903,2.9
CN1309100000000,2022-09-01,13,091,GA,Dodge County,6925,6697,228,3.3
CN1309300000000,2022-09-01,13,093,GA,Dooly County,4764,4585,179,3.8
CN1309500000000,2022-09-01,13,095,GA,Dougherty County,36242,34759,1483,4.1
CN1309700000000,2022-09-01,13,097,GA,Douglas County,75042,72753,2289,3.1
CN1309900000000,2022-09-01,13,099,GA,Early County,4463,4305,158,3.5
CN1310100000000,2022-09-01,13,101,GA,Echols County,1849,1810,39,2.1
CN1310300000000,2022-09-01,13,103,GA,Effingham County,33400,32623,777,2.3
CN1310500000000,2022-09-01,13,105,GA,Elbert County,7782,7527,255,3.3
CN1310700000000,2022-09-01,13,107,GA,Emanuel County,8758,8422,336,3.8
CN1310900000000,2022-09-01,13,109,GA,Evans County,5075,4939,136,2.7
CN1311100000000,2022-09-01,13,111,GA,Fannin County,11989,11692,297,2.5
CN1311300000000,2022-09-01,13,113,GA,Fayette County,59474,58036,1438,2.4
CN1311500000000,2022-09-01,13,115,GA,Floyd County,44065,42857,1208,2.7
CN1311700000000,2022-09-01,13,117,GA,Forsyth County,130085,127313,2772,2.1
CN1311900000000,2022-09-01,13,119,GA,Franklin County,9941,9653,288,2.9
CN1312100000000,2022-09-01,13,121,GA,Fulton County,574809,557763,17046,3
CN1312300000000,2022-09-01,13,123,GA,Gilmer County,12354,12002,352,2.8
CN1312500000000,2022-09-01,13,125,GA,Glascock County,1245,1206,39,3.1
CN1312700000000,2022-09-01,13,127,GA,Glynn County,39770,38718,1052,2.6
CN1312900000000,2022-09-01,13,129,GA,Gordon County,28822,28106,716,2.5
CN1313100000000,2022-09-01,13,131,GA,Grady County,10787,10483,304,2.8
CN1313300000000,2022-09-01,13,133,GA,Greene County,7404,7179,225,3
CN1313500000000,2022-09-01,13,135,GA,Gwinnett County,500862,488447,12415,2.5
CN1313700000000,2022-09-01,13,137,GA,Habersham County,18881,18353,528,2.8
CN1313900000000,2022-09-01,13,139,GA,Hall County,107584,105216,2368,2.2
CN1314100000000,2022-09-01,13,141,GA,Hancock County,2529,2413,116,4.6
CN1314300000000,2022-09-01,13,143,GA,Haralson County,13017,12652,365,2.8
CN1314500000000,2022-09-01,13,145,GA,Harris County,16842,16419,423,2.5
CN1314700000000,2022-09-01,13,147,GA,Hart County,12018,11680,338,2.8
CN1314900000000,2022-09-01,13,149,GA,Heard County,5317,5172,145,2.7
CN1315100000000,2022-09-01,13,151,GA,Henry County,120230,116766,3464,2.9
CN1315300000000,2022-09-01,13,153,GA,Houston County,70189,68103,2086,3
CN1315500000000,2022-09-01,13,155,GA,Irwin County,3519,3393,126,3.6
CN1315700000000,2022-09-01,13,157,GA,Jackson County,45672,44800,872,1.9
CN1315900000000,2022-09-01,13,159,GA,Jasper County,7188,7023,165,2.3
CN1316100000000,2022-09-01,13,161,GA,Jeff Davis County,6059,5852,207,3.4
CN1316300000000,2022-09-01,13,163,GA,Jefferson County,6601,6357,244,3.7
CN1316500000000,2022-09-01,13,165,GA,Jenkins County,3303,3171,132,4
CN1316700000000,2022-09-01,13,167,GA,Johnson County,3969,3862,107,2.7
CN1316900000000,2022-09-01,13,169,GA,Jones County,13194,12827,367,2.8
CN1317100000000,2022-09-01,13,171,GA,Lamar County,8367,8131,236,2.8
CN1317300000000,2022-09-01,13,173,GA,Lanier County,3762,3647,115,3.1
CN1317500000000,2022-09-01,13,175,GA,Laurens County,19010,18311,699,3.7
CN1317700000000,2022-09-01,13,177,GA,Lee County,14954,14563,391,2.6
CN1317900000000,2022-09-01,13,179,GA,Liberty County,26200,25383,817,3.1
CN1318100000000,2022-09-01,13,181,GA,Lincoln County,3493,3372,121,3.5
CN1318300000000,2022-09-01,13,183,GA,Long County,8471,8235,236,2.8
CN1318500000000,2022-09-01,13,185,GA,Lowndes County,50230,48739,1491,3
CN1318700000000,2022-09-01,13,187,GA,Lumpkin County,18709,18308,401,2.1
CN1318900000000,2022-09-01,13,189,GA,McDuffie County,8355,8004,351,4.2
CN1319100000000,2022-09-01,13,191,GA,McIntosh County,6214,6038,176,2.8
CN1319300000000,2022-09-01,13,193,GA,Macon County,4497,4319,178,4
CN1319500000000,2022-09-01,13,195,GA,Madison County,13421,13061,360,2.7
CN1319700000000,2022-09-01,13,197,GA,Marion County,3257,3146,111,3.4
CN1319900000000,2022-09-01,13,199,GA,Meriwether County,8974,8659,315,3.5
CN1320100000000,2022-09-01,13,201,GA,Miller County,2840,2771,69,2.4
CN1320500000000,2022-09-01,13,205,GA,Mitchell County,8195,7896,299,3.6
CN1320700000000,2022-09-01,13,207,GA,Monroe County,12695,12351,344,2.7
CN1320900000000,2022-09-01,13,209,GA,Montgomery County,3835,3701,134,3.5
CN1321100000000,2022-09-01,13,211,GA,Morgan County,9695,9459,236,2.4
CN1321300000000,2022-09-01,13,213,GA,Murray County,15236,14682,554,3.6
CN1321500000000,2022-09-01,13,215,GA,Muscogee County,75591,72646,2945,3.9
CN1321700000000,2022-09-01,13,217,GA,Newton County,54172,52460,1712,3.2
CN1321900000000,2022-09-01,13,219,GA,Oconee County,20070,19656,414,2.1
CN1322100000000,2022-09-01,13,221,GA,Oglethorpe County,6929,6746,183,2.6
CN1322300000000,2022-09-01,13,223,GA,Paulding County,91263,89037,2226,2.4
CN1322500000000,2022-09-01,13,225,GA,Peach County,11782,11344,438,3.7
CN1322700000000,2022-09-01,13,227,GA,Pickens County,15891,15518,373,2.3
CN1322900000000,2022-09-01,13,229,GA,Pierce County,8832,8607,225,2.5
CN1323100000000,2022-09-01,13,231,GA,Pike County,9212,8971,241,2.6
CN1323300000000,2022-09-01,13,233,GA,Polk County,18603,18080,523,2.8
CN1323500000000,2022-09-01,13,235,GA,Pulaski County,3975,3851,124,3.1
CN1323700000000,2022-09-01,13,237,GA,Putnam County,8744,8466,278,3.2
CN1323900000000,2022-09-01,13,239,GA,Quitman County,729,689,40,5.5
CN1324100000000,2022-09-01,13,241,GA,Rabun County,7720,7521,199,2.6
CN1324300000000,2022-09-01,13,243,GA,Randolph County,2378,2281,97,4.1
CN1324500000000,2022-09-01,13,245,GA,Richmond County,82223,78856,3367,4.1
CN1324700000000,2022-09-01,13,247,GA,Rockdale County,45186,43716,1470,3.3
CN1324900000000,2022-09-01,13,249,GA,Schley County,2175,2106,69,3.2
CN1325100000000,2022-09-01,13,251,GA,Screven County,4999,4805,194,3.9
CN1325300000000,2022-09-01,13,253,GA,Seminole County,3098,2991,107,3.5
CN1325500000000,2022-09-01,13,255,GA,Spalding County,29284,28387,897,3.1
CN1325700000000,2022-09-01,13,257,GA,Stephens County,10514,10183,331,3.1
CN1325900000000,2022-09-01,13,259,GA,Stewart County,2617,2518,99,3.8
CN1326100000000,2022-09-01,13,261,GA,Sumter County,12365,11893,472,3.8
CN1326300000000,2022-09-01,13,263,GA,Talbot County,2821,2727,94,3.3
CN1326500000000,2022-09-01,13,265,GA,Taliaferro County,546,522,24,4.4
CN1326700000000,2022-09-01,13,267,GA,Tattnall County,9344,9082,262,2.8
CN1326900000000,2022-09-01,13,269,GA,Taylor County,2624,2506,118,4.5
CN1327100000000,2022-09-01,13,271,GA,Telfair County,3507,3305,202,5.8
CN1327300000000,2022-09-01,13,273,GA,Terrell County,3463,3313,150,4.3
CN1327500000000,2022-09-01,13,275,GA,Thomas County,16891,16345,546,3.2
CN1327700000000,2022-09-01,13,277,GA,Tift County,21058,20518,540,2.6
CN1327900000000,2022-09-01,13,279,GA,Toombs County,12072,11649,423,3.5
CN1328100000000,2022-09-01,13,281,GA,Towns County,4275,4123,152,3.6
CN1328300000000,2022-09-01,13,283,GA,Treutlen County,2625,2523,102,3.9
CN1328500000000,2022-09-01,13,285,GA,Troup County,36370,35409,961,2.6
CN1328700000000,2022-09-01,13,287,GA,Turner County,3165,3047,118,3.7
CN1328900000000,2022-09-01,13,289,GA,Twiggs County,2696,2570,126,4.7
CN1329100000000,2022-09-01,13,291,GA,Union County,11467,11184,283,2.5
CN1329300000000,2022-09-01,13,293,GA,Upson County,11654,11284,370,3.2
CN1329500000000,2022-09-01,13,295,GA,Walker County,31374,30497,877,2.8
CN1329700000000,2022-09-01,13,297,GA,Walton County,47929,46692,1237,2.6
CN1329900000000,2022-09-01,13,299,GA,Ware County,15713,15287,426,2.7
CN1330100000000,2022-09-01,13,301,GA,Warren County,2671,2574,97,3.6
CN1330300000000,2022-09-01,13,303,GA,Washington County,6880,6628,252,3.7
CN1330500000000,2022-09-01,13,305,GA,Wayne County,11885,11552,333,2.8
CN1330700000000,2022-09-01,13,307,GA,Webster County,975,943,32,3.3
CN1330900000000,2022-09-01,13,309,GA,Wheeler County,1672,1590,82,4.9
CN1331100000000,2022-09-01,13,311,GA,White County,17148,16768,380,2.2
CN1331300000000,2022-09-01,13,313,GA,Whitfield County,42715,41303,1412,3.3
CN1331500000000,2022-09-01,13,315,GA,Wilcox County,2691,2584,107,4
CN1331700000000,2022-09-01,13,317,GA,Wilkes County,3724,3583,141,3.8
CN1331900000000,2022-09-01,13,319,GA,Wilkinson County,3991,3871,120,3
CN1332100000000,2022-09-01,13,321,GA,Worth County,8691,8445,246,2.8
CN1500100000000,2022-09-01,15,001,HI,Hawaii County,94540,90814,3726,3.9
CN1500300000000,2022-09-01,15,003,HI,Honolulu County/city,459637,442729,16908,3.7
CN1500700000000,2022-09-01,15,007,HI,Kauai County,36860,35499,1361,3.7
CN1500900000000,2022-09-01,15,009,HI,Maui County,87582,84522,3060,3.5
CN1600100000000,2022-09-01,16,001,ID,Ada County,274126,268154,5972,2.2
CN1600300000000,2022-09-01,16,003,ID,Adams County,1770,1705,65,3.7
CN1600500000000,2022-09-01,16,005,ID,Bannock County,43995,42911,1084,2.5
CN1600700000000,2022-09-01,16,007,ID,Bear Lake County,3332,3261,71,2.1
CN1600900000000,2022-09-01,16,009,ID,Benewah County,4097,3974,123,3
CN1601100000000,2022-09-01,16,011,ID,Bingham County,25875,25299,576,2.2
CN1601300000000,2022-09-01,16,013,ID,Blaine County,13107,12836,271,2.1
CN1601500000000,2022-09-01,16,015,ID,Boise County,3798,3685,113,3
CN1601700000000,2022-09-01,16,017,ID,Bonner County,21472,20849,623,2.9
CN1601900000000,2022-09-01,16,019,ID,Bonneville County,62097,60803,1294,2.1
CN1602100000000,2022-09-01,16,021,ID,Boundary County,5746,5581,165,2.9
CN1602300000000,2022-09-01,16,023,ID,Butte County,1491,1450,41,2.7
CN1602500000000,2022-09-01,16,025,ID,Camas County,746,732,14,1.9
CN1602700000000,2022-09-01,16,027,ID,Canyon County,115612,112616,2996,2.6
CN1602900000000,2022-09-01,16,029,ID,Caribou County,4186,4098,88,2.1
CN1603100000000,2022-09-01,16,031,ID,Cassia County,14890,14624,266,1.8
CN1603300000000,2022-09-01,16,033,ID,Clark County,392,381,11,2.8
CN1603500000000,2022-09-01,16,035,ID,Clearwater County,2984,2861,123,4.1
CN1603700000000,2022-09-01,16,037,ID,Custer County,2452,2402,50,2
CN1603900000000,2022-09-01,16,039,ID,Elmore County,12615,12305,310,2.5
CN1604100000000,2022-09-01,16,041,ID,Franklin County,7615,7477,138,1.8
CN1604300000000,2022-09-01,16,043,ID,Fremont County,8336,8179,157,1.9
CN1604500000000,2022-09-01,16,045,ID,Gem County,8941,8736,205,2.3
CN1604700000000,2022-09-01,16,047,ID,Gooding County,10238,10038,200,2
CN1604900000000,2022-09-01,16,049,ID,Idaho County,6746,6541,205,3
CN1605100000000,2022-09-01,16,051,ID,Jefferson County,15310,15016,294,1.9
CN1605300000000,2022-09-01,16,053,ID,Jerome County,15313,14998,315,2.1
CN1605500000000,2022-09-01,16,055,ID,Kootenai County,84389,82128,2261,2.7
CN1605700000000,2022-09-01,16,057,ID,Latah County,21224,20788,436,2.1
CN1605900000000,2022-09-01,16,059,ID,Lemhi County,3737,3635,102,2.7
CN1606100000000,2022-09-01,16,061,ID,Lewis County,1644,1594,50,3
CN1606300000000,2022-09-01,16,063,ID,Lincoln County,3097,3020,77,2.5
CN1606500000000,2022-09-01,16,065,ID,Madison County,23941,23557,384,1.6
CN1606700000000,2022-09-01,16,067,ID,Minidoka County,13522,13264,258,1.9
CN1606900000000,2022-09-01,16,069,ID,Nez Perce County,21122,20639,483,2.3
CN1607100000000,2022-09-01,16,071,ID,Oneida County,2698,2640,58,2.1
CN1607300000000,2022-09-01,16,073,ID,Owyhee County,6140,5984,156,2.5
CN1607500000000,2022-09-01,16,075,ID,Payette County,12336,12013,323,2.6
CN1607700000000,2022-09-01,16,077,ID,Power County,5210,5109,101,1.9
CN1607900000000,2022-09-01,16,079,ID,Shoshone County,5332,5146,186,3.5
CN1608100000000,2022-09-01,16,081,ID,Teton County,7982,7861,121,1.5
CN1608300000000,2022-09-01,16,083,ID,Twin Falls County,44801,43773,1028,2.3
CN1608500000000,2022-09-01,16,085,ID,Valley County,5741,5579,162,2.8
CN1608700000000,2022-09-01,16,087,ID,Washington County,5001,4867,134,2.7
CN1700100000000,2022-09-01,17,001,IL,Adams County,30701,29803,898,2.9
CN1700300000000,2022-09-01,17,003,IL,Alexander County,1810,1708,102,5.6
CN1700500000000,2022-09-01,17,005,IL,Bond County,7524,7280,244,3.2
CN1700700000000,2022-09-01,17,007,IL,Boone County,24772,23629,1143,4.6
CN1700900000000,2022-09-01,17,009,IL,Brown County,3127,3068,59,1.9
CN1701100000000,2022-09-01,17,011,IL,Bureau County,16208,15618,590,3.6
CN1701300000000,2022-09-01,17,013,IL,Calhoun County,2186,2112,74,3.4
CN1701500000000,2022-09-01,17,015,IL,Carroll County,7428,7178,250,3.4
CN1701700000000,2022-09-01,17,017,IL,Cass County,5728,5525,203,3.5
CN1701900000000,2022-09-01,17,019,IL,Champaign County,111471,107721,3750,3.4
CN1702100000000,2022-09-01,17,021,IL,Christian County,13418,12878,540,4
CN1702300000000,2022-09-01,17,023,IL,Clark County,7349,7094,255,3.5
CN1702500000000,2022-09-01,17,025,IL,Clay County,5760,5546,214,3.7
CN1702700000000,2022-09-01,17,027,IL,Clinton County,20029,19519,510,2.5
CN1702900000000,2022-09-01,17,029,IL,Coles County,23392,22495,897,3.8
CN1703100000000,2022-09-01,17,031,IL,Cook County,2671994,2539578,132416,5
CN1703300000000,2022-09-01,17,033,IL,Crawford County,8364,8076,288,3.4
CN1703500000000,2022-09-01,17,035,IL,Cumberland County,6054,5878,176,2.9
CN1703700000000,2022-09-01,17,037,IL,DeKalb County,54067,52099,1968,3.6
CN1703900000000,2022-09-01,17,039,IL,De Witt County,7425,7168,257,3.5
CN1704100000000,2022-09-01,17,041,IL,Douglas County,10180,9891,289,2.8
CN1704300000000,2022-09-01,17,043,IL,DuPage County,521202,502521,18681,3.6
CN1704500000000,2022-09-01,17,045,IL,Edgar County,9161,8890,271,3
CN1704700000000,2022-09-01,17,047,IL,Edwards County,2450,2348,102,4.2
CN1704900000000,2022-09-01,17,049,IL,Effingham County,19638,19148,490,2.5
CN1705100000000,2022-09-01,17,051,IL,Fayette County,9747,9413,334,3.4
CN1705300000000,2022-09-01,17,053,IL,Ford County,6467,6251,216,3.3
CN1705500000000,2022-09-01,17,055,IL,Franklin County,15823,15106,717,4.5
CN1705700000000,2022-09-01,17,057,IL,Fulton County,14619,14039,580,4
CN1705900000000,2022-09-01,17,059,IL,Gallatin County,2040,1946,94,4.6
CN1706100000000,2022-09-01,17,061,IL,Greene County,5945,5733,212,3.6
CN1706300000000,2022-09-01,17,063,IL,Grundy County,26305,25111,1194,4.5
CN1706500000000,2022-09-01,17,065,IL,Hamilton County,4387,4268,119,2.7
CN1706700000000,2022-09-01,17,067,IL,Hancock County,8067,7785,282,3.5
CN1706900000000,2022-09-01,17,069,IL,Hardin County,1465,1401,64,4.4
CN1707100000000,2022-09-01,17,071,IL,Henderson County,3536,3425,111,3.1
CN1707300000000,2022-09-01,17,073,IL,Henry County,23636,22802,834,3.5
CN1707500000000,2022-09-01,17,075,IL,Iroquois County,12575,12131,444,3.5
CN1707700000000,2022-09-01,17,077,IL,Jackson County,27199,26194,1005,3.7
CN1707900000000,2022-09-01,17,079,IL,Jasper County,4961,4807,154,3.1
CN1708100000000,2022-09-01,17,081,IL,Jefferson County,16375,15713,662,4
CN1708300000000,2022-09-01,17,083,IL,Jersey County,10604,10290,314,3
CN1708500000000,2022-09-01,17,085,IL,Jo Daviess County,10568,10263,305,2.9
CN1708700000000,2022-09-01,17,087,IL,Johnson County,4097,3904,193,4.7
CN1708900000000,2022-09-01,17,089,IL,Kane County,264294,254529,9765,3.7
CN1709100000000,2022-09-01,17,091,IL,Kankakee County,51817,49415,2402,4.6
CN1709300000000,2022-09-01,17,093,IL,Kendall County,72807,69968,2839,3.9
CN1709500000000,2022-09-01,17,095,IL,Knox County,20105,19216,889,4.4
CN1709700000000,2022-09-01,17,097,IL,Lake County,362458,350025,12433,3.4
CN1709900000000,2022-09-01,17,099,IL,LaSalle County,52104,49933,2171,4.2
CN1710100000000,2022-09-01,17,101,IL,Lawrence County,5107,4857,250,4.9
CN1710300000000,2022-09-01,17,103,IL,Lee County,16790,16241,549,3.3
CN1710500000000,2022-09-01,17,105,IL,Livingston County,15734,15207,527,3.3
CN1710700000000,2022-09-01,17,107,IL,Logan County,11503,11077,426,3.7
CN1710900000000,2022-09-01,17,109,IL,McDonough County,13251,12782,469,3.5
CN1711100000000,2022-09-01,17,111,IL,McHenry County,170142,163794,6348,3.7
CN1711300000000,2022-09-01,17,113,IL,McLean County,89386,86558,2828,3.2
CN1711500000000,2022-09-01,17,115,IL,Macon County,45688,43494,2194,4.8
CN1711700000000,2022-09-01,17,117,IL,Macoupin County,22191,21479,712,3.2
CN1711900000000,2022-09-01,17,119,IL,Madison County,131248,126832,4416,3.4
CN1712100000000,2022-09-01,17,121,IL,Marion County,16770,16099,671,4
CN1712300000000,2022-09-01,17,123,IL,Marshall County,5136,4942,194,3.8
CN1712500000000,2022-09-01,17,125,IL,Mason County,6002,5771,231,3.8
CN1712700000000,2022-09-01,17,127,IL,Massac County,5377,5142,235,4.4
CN1712900000000,2022-09-01,17,129,IL,Menard County,6162,5981,181,2.9
CN1713100000000,2022-09-01,17,131,IL,Mercer County,7541,7308,233,3.1
CN1713300000000,2022-09-01,17,133,IL,Monroe County,18754,18255,499,2.7
CN1713500000000,2022-09-01,17,135,IL,Montgomery County,11225,10766,459,4.1
CN1713700000000,2022-09-01,17,137,IL,Morgan County,15822,15292,530,3.3
CN1713900000000,2022-09-01,17,139,IL,Moultrie County,7482,7267,215,2.9
CN1714100000000,2022-09-01,17,141,IL,Ogle County,23819,22888,931,3.9
CN1714300000000,2022-09-01,17,143,IL,Peoria County,82003,78439,3564,4.3
CN1714500000000,2022-09-01,17,145,IL,Perry County,7831,7495,336,4.3
CN1714700000000,2022-09-01,17,147,IL,Piatt County,8794,8548,246,2.8
CN1714900000000,2022-09-01,17,149,IL,Pike County,6843,6604,239,3.5
CN1715100000000,2022-09-01,17,151,IL,Pope County,1804,1732,72,4
CN1715300000000,2022-09-01,17,153,IL,Pulaski County,1669,1566,103,6.2
CN1715500000000,2022-09-01,17,155,IL,Putnam County,2991,2878,113,3.8
CN1715700000000,2022-09-01,17,157,IL,Randolph County,13550,13112,438,3.2
CN1715900000000,2022-09-01,17,159,IL,Richland County,7229,6985,244,3.4
CN1716100000000,2022-09-01,17,161,IL,Rock Island County,66948,64434,2514,3.8
CN1716300000000,2022-09-01,17,163,IL,St. Clair County,123161,118402,4759,3.9
CN1716500000000,2022-09-01,17,165,IL,Saline County,9450,9038,412,4.4
CN1716700000000,2022-09-01,17,167,IL,Sangamon County,96956,93452,3504,3.6
CN1716900000000,2022-09-01,17,169,IL,Schuyler County,3106,3003,103,3.3
CN1717100000000,2022-09-01,17,171,IL,Scott County,2303,2227,76,3.3
CN1717300000000,2022-09-01,17,173,IL,Shelby County,9947,9606,341,3.4
CN1717500000000,2022-09-01,17,175,IL,Stark County,2398,2312,86,3.6
CN1717700000000,2022-09-01,17,177,IL,Stephenson County,20768,19966,802,3.9
CN1717900000000,2022-09-01,17,179,IL,Tazewell County,61823,59678,2145,3.5
CN1718100000000,2022-09-01,17,181,IL,Union County,7098,6810,288,4.1
CN1718300000000,2022-09-01,17,183,IL,Vermilion County,31786,30381,1405,4.4
CN1718500000000,2022-09-01,17,185,IL,Wabash County,5851,5687,164,2.8
CN1718700000000,2022-09-01,17,187,IL,Warren County,7952,7695,257,3.2
CN1718900000000,2022-09-01,17,189,IL,Washington County,9912,9705,207,2.1
CN1719100000000,2022-09-01,17,191,IL,Wayne County,7057,6818,239,3.4
CN1719300000000,2022-09-01,17,193,IL,White County,6128,5912,216,3.5
CN1719500000000,2022-09-01,17,195,IL,Whiteside County,27728,26780,948,3.4
CN1719700000000,2022-09-01,17,197,IL,Will County,369018,352820,16198,4.4
CN1719900000000,2022-09-01,17,199,IL,Williamson County,31065,29922,1143,3.7
CN1720100000000,2022-09-01,17,201,IL,Winnebago County,132514,126108,6406,4.8
CN1720300000000,2022-09-01,17,203,IL,Woodford County,18247,17722,525,2.9
CN1800100000000,2022-09-01,18,001,IN,Adams County,17170,16868,302,1.8
CN1800300000000,2022-09-01,18,003,IN,Allen County,188941,184580,4361,2.3
CN1800500000000,2022-09-01,18,005,IN,Bartholomew County,44540,43685,855,1.9
CN1800700000000,2022-09-01,18,007,IN,Benton County,4408,4322,86,2
CN1800900000000,2022-09-01,18,009,IN,Blackford County,4793,4655,138,2.9
CN1801100000000,2022-09-01,18,011,IN,Boone County,38570,37917,653,1.7
CN1801300000000,2022-09-01,18,013,IN,Brown County,8037,7814,223,2.8
CN1801500000000,2022-09-01,18,015,IN,Carroll County,10040,9804,236,2.4
CN1801700000000,2022-09-01,18,017,IN,Cass County,17443,16981,462,2.6
CN1801900000000,2022-09-01,18,019,IN,Clark County,62913,61485,1428,2.3
CN1802100000000,2022-09-01,18,021,IN,Clay County,11748,11411,337,2.9
CN1802300000000,2022-09-01,18,023,IN,Clinton County,17217,16852,365,2.1
CN1802500000000,2022-09-01,18,025,IN,Crawford County,4884,4763,121,2.5
CN1802700000000,2022-09-01,18,027,IN,Daviess County,16758,16461,297,1.8
CN1802900000000,2022-09-01,18,029,IN,Dearborn County,26031,25494,537,2.1
CN1803100000000,2022-09-01,18,031,IN,Decatur County,14428,14140,288,2
CN1803300000000,2022-09-01,18,033,IN,DeKalb County,22340,21841,499,2.2
CN1803500000000,2022-09-01,18,035,IN,Delaware County,51541,50128,1413,2.7
CN1803700000000,2022-09-01,18,037,IN,Dubois County,21876,21450,426,1.9
CN1803900000000,2022-09-01,18,039,IN,Elkhart County,116912,114176,2736,2.3
CN1804100000000,2022-09-01,18,041,IN,Fayette County,8346,8034,312,3.7
CN1804300000000,2022-09-01,18,043,IN,Floyd County,42362,41493,869,2.1
CN1804500000000,2022-09-01,18,045,IN,Fountain County,8061,7882,179,2.2
CN1804700000000,2022-09-01,18,047,IN,Franklin County,11442,11206,236,2.1
CN1804900000000,2022-09-01,18,049,IN,Fulton County,9643,9405,238,2.5
CN1805100000000,2022-09-01,18,051,IN,Gibson County,20025,19651,374,1.9
CN1805300000000,2022-09-01,18,053,IN,Grant County,31087,30259,828,2.7
CN1805500000000,2022-09-01,18,055,IN,Greene County,13857,13440,417,3
CN1805700000000,2022-09-01,18,057,IN,Hamilton County,196144,192632,3512,1.8
CN1805900000000,2022-09-01,18,059,IN,Hancock County,42975,42070,905,2.1
CN1806100000000,2022-09-01,18,061,IN,Harrison County,20566,20142,424,2.1
CN1806300000000,2022-09-01,18,063,IN,Hendricks County,95354,93415,1939,2
CN1806500000000,2022-09-01,18,065,IN,Henry County,22279,21686,593,2.7
CN1806700000000,2022-09-01,18,067,IN,Howard County,33038,31657,1381,4.2
CN1806900000000,2022-09-01,18,069,IN,Huntington County,18356,17930,426,2.3
CN1807100000000,2022-09-01,18,071,IN,Jackson County,23550,23022,528,2.2
CN1807300000000,2022-09-01,18,073,IN,Jasper County,15855,15443,412,2.6
CN1807500000000,2022-09-01,18,075,IN,Jay County,8911,8708,203,2.3
CN1807700000000,2022-09-01,18,077,IN,Jefferson County,15142,14793,349,2.3
CN1807900000000,2022-09-01,18,079,IN,Jennings County,13509,13160,349,2.6
CN1808100000000,2022-09-01,18,081,IN,Johnson County,87202,85468,1734,2
CN1808300000000,2022-09-01,18,083,IN,Knox County,18109,17704,405,2.2
CN1808500000000,2022-09-01,18,085,IN,Kosciusko County,41176,40298,878,2.1
CN1808700000000,2022-09-01,18,087,IN,LaGrange County,21674,21231,443,2
CN1808900000000,2022-09-01,18,089,IN,Lake County,226698,218308,8390,3.7
CN1809100000000,2022-09-01,18,091,IN,LaPorte County,47058,45648,1410,3
CN1809300000000,2022-09-01,18,093,IN,Lawrence County,20676,20105,571,2.8
CN1809500000000,2022-09-01,18,095,IN,Madison County,60378,58733,1645,2.7
CN1809700000000,2022-09-01,18,097,IN,Marion County,508920,495702,13218,2.6
CN1809900000000,2022-09-01,18,099,IN,Marshall County,23158,22652,506,2.2
CN1810100000000,2022-09-01,18,101,IN,Martin County,5458,5322,136,2.5
CN1810300000000,2022-09-01,18,103,IN,Miami County,14365,13912,453,3.2
CN1810500000000,2022-09-01,18,105,IN,Monroe County,71940,70379,1561,2.2
CN1810700000000,2022-09-01,18,107,IN,Montgomery County,18995,18610,385,2
CN1810900000000,2022-09-01,18,109,IN,Morgan County,37654,36828,826,2.2
CN1811100000000,2022-09-01,18,111,IN,Newton County,6797,6594,203,3
CN1811300000000,2022-09-01,18,113,IN,Noble County,21705,21191,514,2.4
CN1811500000000,2022-09-01,18,115,IN,Ohio County,3228,3166,62,1.9
CN1811700000000,2022-09-01,18,117,IN,Orange County,8219,7998,221,2.7
CN1811900000000,2022-09-01,18,119,IN,Owen County,9534,9288,246,2.6
CN1812100000000,2022-09-01,18,121,IN,Parke County,7175,6995,180,2.5
CN1812300000000,2022-09-01,18,123,IN,Perry County,8860,8605,255,2.9
CN1812500000000,2022-09-01,18,125,IN,Pike County,5865,5732,133,2.3
CN1812700000000,2022-09-01,18,127,IN,Porter County,85774,83485,2289,2.7
CN1812900000000,2022-09-01,18,129,IN,Posey County,13075,12829,246,1.9
CN1813100000000,2022-09-01,18,131,IN,Pulaski County,6616,6481,135,2
CN1813300000000,2022-09-01,18,133,IN,Putnam County,17027,16583,444,2.6
CN1813500000000,2022-09-01,18,135,IN,Randolph County,11751,11468,283,2.4
CN1813700000000,2022-09-01,18,137,IN,Ripley County,12789,12474,315,2.5
CN1813900000000,2022-09-01,18,139,IN,Rush County,8917,8738,179,2
CN1814100000000,2022-09-01,18,141,IN,St. Joseph County,132113,128337,3776,2.9
CN1814300000000,2022-09-01,18,143,IN,Scott County,10544,10267,277,2.6
CN1814500000000,2022-09-01,18,145,IN,Shelby County,23842,23345,497,2.1
CN1814700000000,2022-09-01,18,147,IN,Spencer County,10789,10569,220,2
CN1814900000000,2022-09-01,18,149,IN,Starke County,9659,9359,300,3.1
CN1815100000000,2022-09-01,18,151,IN,Steuben County,20969,20589,380,1.8
CN1815300000000,2022-09-01,18,153,IN,Sullivan County,7971,7739,232,2.9
CN1815500000000,2022-09-01,18,155,IN,Switzerland County,4811,4702,109,2.3
CN1815700000000,2022-09-01,18,157,IN,Tippecanoe County,97524,95378,2146,2.2
CN1815900000000,2022-09-01,18,159,IN,Tipton County,8924,8674,250,2.8
CN1816100000000,2022-09-01,18,161,IN,Union County,3590,3523,67,1.9
CN1816300000000,2022-09-01,18,163,IN,Vanderburgh County,92412,90096,2316,2.5
CN1816500000000,2022-09-01,18,165,IN,Vermillion County,6615,6424,191,2.9
CN1816700000000,2022-09-01,18,167,IN,Vigo County,46132,44821,1311,2.8
CN1816900000000,2022-09-01,18,169,IN,Wabash County,14644,14318,326,2.2
CN1817100000000,2022-09-01,18,171,IN,Warren County,4148,4060,88,2.1
CN1817300000000,2022-09-01,18,173,IN,Warrick County,32553,31860,693,2.1
CN1817500000000,2022-09-01,18,175,IN,Washington County,13881,13587,294,2.1
CN1817700000000,2022-09-01,18,177,IN,Wayne County,29697,28939,758,2.6
CN1817900000000,2022-09-01,18,179,IN,Wells County,14321,14065,256,1.8
CN1818100000000,2022-09-01,18,181,IN,White County,13369,13108,261,2
CN1818300000000,2022-09-01,18,183,IN,Whitley County,17802,17452,350,2
CN1900100000000,2022-09-01,19,001,IA,Adair County,4264,4187,77,1.8
CN1900300000000,2022-09-01,19,003,IA,Adams County,2108,2060,48,2.3
CN1900500000000,2022-09-01,19,005,IA,Allamakee County,7004,6802,202,2.9
CN1900700000000,2022-09-01,19,007,IA,Appanoose County,5957,5812,145,2.4
CN1900900000000,2022-09-01,19,009,IA,Audubon County,3010,2949,61,2
CN1901100000000,2022-09-01,19,011,IA,Benton County,13105,12746,359,2.7
CN1901300000000,2022-09-01,19,013,IA,Black Hawk County,68442,66617,1825,2.7
CN1901500000000,2022-09-01,19,015,IA,Boone County,14966,14675,291,1.9
CN1901700000000,2022-09-01,19,017,IA,Bremer County,14036,13747,289,2.1
CN1901900000000,2022-09-01,19,019,IA,Buchanan County,11276,10993,283,2.5
CN1902100000000,2022-09-01,19,021,IA,Buena Vista County,11895,11626,269,2.3
CN1902300000000,2022-09-01,19,023,IA,Butler County,8304,8124,180,2.2
CN1902500000000,2022-09-01,19,025,IA,Calhoun County,4154,4063,91,2.2
CN1902700000000,2022-09-01,19,027,IA,Carroll County,10739,10561,178,1.7
CN1902900000000,2022-09-01,19,029,IA,Cass County,6859,6718,141,2.1
CN1903100000000,2022-09-01,19,031,IA,Cedar County,10536,10296,240,2.3
CN1903300000000,2022-09-01,19,033,IA,Cerro Gordo County,22442,21905,537,2.4
CN1903500000000,2022-09-01,19,035,IA,Cherokee County,6059,5944,115,1.9
CN1903700000000,2022-09-01,19,037,IA,Chickasaw County,6560,6433,127,1.9
CN1903900000000,2022-09-01,19,039,IA,Clarke County,4949,4826,123,2.5
CN1904100000000,2022-09-01,19,041,IA,Clay County,8534,8326,208,2.4
CN1904300000000,2022-09-01,19,043,IA,Clayton County,9404,9172,232,2.5
CN1904500000000,2022-09-01,19,045,IA,Clinton County,22377,21650,727,3.2
CN1904700000000,2022-09-01,19,047,IA,Crawford County,7709,7479,230,3
CN1904900000000,2022-09-01,19,049,IA,Dallas County,54573,53582,991,1.8
CN1905100000000,2022-09-01,19,051,IA,Davis County,4316,4223,93,2.2
CN1905300000000,2022-09-01,19,053,IA,Decatur County,4250,4157,93,2.2
CN1905500000000,2022-09-01,19,055,IA,Delaware County,10407,10205,202,1.9
CN1905700000000,2022-09-01,19,057,IA,Des Moines County,18237,17512,725,4
CN1905900000000,2022-09-01,19,059,IA,Dickinson County,10791,10557,234,2.2
CN1906100000000,2022-09-01,19,061,IA,Dubuque County,56533,55003,1530,2.7
CN1906300000000,2022-09-01,19,063,IA,Emmet County,4881,4764,117,2.4
CN1906500000000,2022-09-01,19,065,IA,Fayette County,10344,10106,238,2.3
CN1906700000000,2022-09-01,19,067,IA,Floyd County,8302,8108,194,2.3
CN1906900000000,2022-09-01,19,069,IA,Franklin County,5606,5491,115,2.1
CN1907100000000,2022-09-01,19,071,IA,Fremont County,3709,3612,97,2.6
CN1907300000000,2022-09-01,19,073,IA,Greene County,5366,5269,97,1.8
CN1907500000000,2022-09-01,19,075,IA,Grundy County,6351,6214,137,2.2
CN1907700000000,2022-09-01,19,077,IA,Guthrie County,5605,5470,135,2.4
CN1907900000000,2022-09-01,19,079,IA,Hamilton County,6960,6782,178,2.6
CN1908100000000,2022-09-01,19,081,IA,Hancock County,5630,5513,117,2.1
CN1908300000000,2022-09-01,19,083,IA,Hardin County,7760,7566,194,2.5
CN1908500000000,2022-09-01,19,085,IA,Harrison County,7136,6968,168,2.4
CN1908700000000,2022-09-01,19,087,IA,Henry County,9505,9249,256,2.7
CN1908900000000,2022-09-01,19,089,IA,Howard County,5147,5040,107,2.1
CN1909100000000,2022-09-01,19,091,IA,Humboldt County,4907,4802,105,2.1
CN1909300000000,2022-09-01,19,093,IA,Ida County,3930,3855,75,1.9
CN1909500000000,2022-09-01,19,095,IA,Iowa County,9830,9642,188,1.9
CN1909700000000,2022-09-01,19,097,IA,Jackson County,10570,10281,289,2.7
CN1909900000000,2022-09-01,19,099,IA,Jasper County,18744,18255,489,2.6
CN1910100000000,2022-09-01,19,101,IA,Jefferson County,9909,9685,224,2.3
CN1910300000000,2022-09-01,19,103,IA,Johnson County,87962,86094,1868,2.1
CN1910500000000,2022-09-01,19,105,IA,Jones County,10312,10041,271,2.6
CN1910700000000,2022-09-01,19,107,IA,Keokuk County,5145,5008,137,2.7
CN1910900000000,2022-09-01,19,109,IA,Kossuth County,8167,8007,160,2
CN1911100000000,2022-09-01,19,111,IA,Lee County,14891,14122,769,5.2
CN1911300000000,2022-09-01,19,113,IA,Linn County,121913,118256,3657,3
CN1911500000000,2022-09-01,19,115,IA,Louisa County,5926,5775,151,2.5
CN1911700000000,2022-09-01,19,117,IA,Lucas County,4537,4454,83,1.8
CN1911900000000,2022-09-01,19,119,IA,Lyon County,7051,6938,113,1.6
CN1912100000000,2022-09-01,19,121,IA,Madison County,8793,8569,224,2.5
CN1912300000000,2022-09-01,19,123,IA,Mahaska County,12302,12031,271,2.2
CN1912500000000,2022-09-01,19,125,IA,Marion County,19623,19276,347,1.8
CN1912700000000,2022-09-01,19,127,IA,Marshall County,17097,16499,598,3.5
CN1912900000000,2022-09-01,19,129,IA,Mills County,7153,7004,149,2.1
CN1913100000000,2022-09-01,19,131,IA,Mitchell County,5803,5694,109,1.9
CN1913300000000,2022-09-01,19,133,IA,Monona County,4356,4249,107,2.5
CN1913500000000,2022-09-01,19,135,IA,Monroe County,4049,3952,97,2.4
CN1913700000000,2022-09-01,19,137,IA,Montgomery County,4943,4832,111,2.2
CN1913900000000,2022-09-01,19,139,IA,Muscatine County,21075,20516,559,2.7
CN1914100000000,2022-09-01,19,141,IA,O'Brien County,8148,7991,157,1.9
CN1914300000000,2022-09-01,19,143,IA,Osceola County,3639,3580,59,1.6
CN1914500000000,2022-09-01,19,145,IA,Page County,6403,6252,151,2.4
CN1914700000000,2022-09-01,19,147,IA,Palo Alto County,4475,4378,97,2.2
CN1914900000000,2022-09-01,19,149,IA,Plymouth County,14855,14568,287,1.9
CN1915100000000,2022-09-01,19,151,IA,Pocahontas County,4344,4265,79,1.8
CN1915300000000,2022-09-01,19,153,IA,Polk County,279945,273100,6845,2.4
CN1915500000000,2022-09-01,19,155,IA,Pottawattamie County,48288,47062,1226,2.5
CN1915700000000,2022-09-01,19,157,IA,Poweshiek County,10484,10238,246,2.3
CN1915900000000,2022-09-01,19,159,IA,Ringgold County,2334,2279,55,2.4
CN1916100000000,2022-09-01,19,161,IA,Sac County,5210,5101,109,2.1
CN1916300000000,2022-09-01,19,163,IA,Scott County,89639,86923,2716,3
CN1916500000000,2022-09-01,19,165,IA,Shelby County,6441,6306,135,2.1
CN1916700000000,2022-09-01,19,167,IA,Sioux County,22506,22165,341,1.5
CN1916900000000,2022-09-01,19,169,IA,Story County,61415,60240,1175,1.9
CN1917100000000,2022-09-01,19,171,IA,Tama County,9097,8887,210,2.3
CN1917300000000,2022-09-01,19,173,IA,Taylor County,3144,3087,57,1.8
CN1917500000000,2022-09-01,19,175,IA,Union County,6081,5934,147,2.4
CN1917700000000,2022-09-01,19,177,IA,Van Buren County,3641,3546,95,2.6
CN1917900000000,2022-09-01,19,179,IA,Wapello County,16876,16393,483,2.9
CN1918100000000,2022-09-01,19,181,IA,Warren County,29646,29010,636,2.1
CN1918300000000,2022-09-01,19,183,IA,Washington County,11748,11498,250,2.1
CN1918500000000,2022-09-01,19,185,IA,Wayne County,2903,2840,63,2.2
CN1918700000000,2022-09-01,19,187,IA,Webster County,18858,18331,527,2.8
CN1918900000000,2022-09-01,19,189,IA,Winnebago County,4988,4867,121,2.4
CN1919100000000,2022-09-01,19,191,IA,Winneshiek County,11647,11401,246,2.1
CN1919300000000,2022-09-01,19,193,IA,Woodbury County,56720,55377,1343,2.4
CN1919500000000,2022-09-01,19,195,IA,Worth County,3987,3902,85,2.1
CN1919700000000,2022-09-01,19,197,IA,Wright County,6554,6409,145,2.2
CN2000100000000,2022-09-01,20,001,KS,Allen County,6314,6136,178,2.8
CN2000300000000,2022-09-01,20,003,KS,Anderson County,4336,4241,95,2.2
CN2000500000000,2022-09-01,20,005,KS,Atchison County,6804,6589,215,3.2
CN2000700000000,2022-09-01,20,007,KS,Barber County,2222,2175,47,2.1
CN2000900000000,2022-09-01,20,009,KS,Barton County,12942,12611,331,2.6
CN2001100000000,2022-09-01,20,011,KS,Bourbon County,6271,6070,201,3.2
CN2001300000000,2022-09-01,20,013,KS,Brown County,5095,4985,110,2.2
CN2001500000000,2022-09-01,20,015,KS,Butler County,32787,31930,857,2.6
CN2001700000000,2022-09-01,20,017,KS,Chase County,1370,1341,29,2.1
CN2001900000000,2022-09-01,20,019,KS,Chautauqua County,1403,1366,37,2.6
CN2002100000000,2022-09-01,20,021,KS,Cherokee County,9831,9584,247,2.5
CN2002300000000,2022-09-01,20,023,KS,Cheyenne County,1215,1185,30,2.5
CN2002500000000,2022-09-01,20,025,KS,Clark County,1101,1079,22,2
CN2002700000000,2022-09-01,20,027,KS,Clay County,3760,3672,88,2.3
CN2002900000000,2022-09-01,20,029,KS,Cloud County,3798,3705,93,2.4
CN2003100000000,2022-09-01,20,031,KS,Coffey County,3754,3632,122,3.2
CN2003300000000,2022-09-01,20,033,KS,Comanche County,840,818,22,2.6
CN2003500000000,2022-09-01,20,035,KS,Cowley County,16374,15894,480,2.9
CN2003700000000,2022-09-01,20,037,KS,Crawford County,19067,18521,546,2.9
CN2003900000000,2022-09-01,20,039,KS,Decatur County,1141,1105,36,3.2
CN2004100000000,2022-09-01,20,041,KS,Dickinson County,8550,8325,225,2.6
CN2004300000000,2022-09-01,20,043,KS,Doniphan County,4002,3899,103,2.6
CN2004500000000,2022-09-01,20,045,KS,Douglas County,66788,65142,1646,2.5
CN2004700000000,2022-09-01,20,047,KS,Edwards County,1383,1351,32,2.3
CN2004900000000,2022-09-01,20,049,KS,Elk County,1183,1151,32,2.7
CN2005100000000,2022-09-01,20,051,KS,Ellis County,16880,16535,345,2
CN2005300000000,2022-09-01,20,053,KS,Ellsworth County,2626,2568,58,2.2
CN2005500000000,2022-09-01,20,055,KS,Finney County,20451,20042,409,2
CN2005700000000,2022-09-01,20,057,KS,Ford County,17947,17580,367,2
CN2005900000000,2022-09-01,20,059,KS,Franklin County,14961,14626,335,2.2
CN2006100000000,2022-09-01,20,061,KS,Geary County,11365,10937,428,3.8
CN2006300000000,2022-09-01,20,063,KS,Gove County,1344,1308,36,2.7
CN2006500000000,2022-09-01,20,065,KS,Graham County,1168,1134,34,2.9
CN2006700000000,2022-09-01,20,067,KS,Grant County,2789,2718,71,2.5
CN2006900000000,2022-09-01,20,069,KS,Gray County,3132,3068,64,2
CN2007100000000,2022-09-01,20,071,KS,Greeley County,786,772,14,1.8
CN2007300000000,2022-09-01,20,073,KS,Greenwood County,2975,2909,66,2.2
CN2007500000000,2022-09-01,20,075,KS,Hamilton County,1584,1557,27,1.7
CN2007700000000,2022-09-01,20,077,KS,Harper County,2776,2718,58,2.1
CN2007900000000,2022-09-01,20,079,KS,Harvey County,17122,16708,414,2.4
CN2008100000000,2022-09-01,20,081,KS,Haskell County,2167,2125,42,1.9
CN2008300000000,2022-09-01,20,083,KS,Hodgeman County,1003,983,20,2
CN2008500000000,2022-09-01,20,085,KS,Jackson County,7236,7085,151,2.1
CN2008700000000,2022-09-01,20,087,KS,Jefferson County,10284,10042,242,2.4
CN2008900000000,2022-09-01,20,089,KS,Jewell County,1141,1107,34,3
CN2009100000000,2022-09-01,20,091,KS,Johnson County,349458,341580,7878,2.3
CN2009300000000,2022-09-01,20,093,KS,Kearny County,1984,1945,39,2
CN2009500000000,2022-09-01,20,095,KS,Kingman County,3260,3181,79,2.4
CN2009700000000,2022-09-01,20,097,KS,Kiowa County,1226,1197,29,2.4
CN2009900000000,2022-09-01,20,099,KS,Labette County,9350,9074,276,3
CN2010100000000,2022-09-01,20,101,KS,Lane County,716,696,20,2.8
CN2010300000000,2022-09-01,20,103,KS,Leavenworth County,37464,36422,1042,2.8
CN2010500000000,2022-09-01,20,105,KS,Lincoln County,1675,1638,37,2.2
CN2010700000000,2022-09-01,20,107,KS,Linn County,4329,4180,149,3.4
CN2010900000000,2022-09-01,20,109,KS,Logan County,1622,1585,37,2.3
CN2011100000000,2022-09-01,20,111,KS,Lyon County,16952,16548,404,2.4
CN2011300000000,2022-09-01,20,113,KS,McPherson County,17385,17052,333,1.9
CN2011500000000,2022-09-01,20,115,KS,Marion County,5828,5684,144,2.5
CN2011700000000,2022-09-01,20,117,KS,Marshall County,5234,5127,107,2
CN2011900000000,2022-09-01,20,119,KS,Meade County,2125,2086,39,1.8
CN2012100000000,2022-09-01,20,121,KS,Miami County,18017,17587,430,2.4
CN2012300000000,2022-09-01,20,123,KS,Mitchell County,3287,3214,73,2.2
CN2012500000000,2022-09-01,20,125,KS,Montgomery County,14577,14149,428,2.9
CN2012700000000,2022-09-01,20,127,KS,Morris County,2998,2929,69,2.3
CN2012900000000,2022-09-01,20,129,KS,Morton County,1093,1066,27,2.5
CN2013100000000,2022-09-01,20,131,KS,Nemaha County,5574,5473,101,1.8
CN2013300000000,2022-09-01,20,133,KS,Neosho County,6020,5809,211,3.5
CN2013500000000,2022-09-01,20,135,KS,Ness County,1306,1274,32,2.5
CN2013700000000,2022-09-01,20,137,KS,Norton County,2577,2526,51,2
CN2013900000000,2022-09-01,20,139,KS,Osage County,7957,7739,218,2.7
CN2014100000000,2022-09-01,20,141,KS,Osborne County,1876,1839,37,2
CN2014300000000,2022-09-01,20,143,KS,Ottawa County,3013,2937,76,2.5
CN2014500000000,2022-09-01,20,145,KS,Pawnee County,2653,2589,64,2.4
CN2014700000000,2022-09-01,20,147,KS,Phillips County,2646,2583,63,2.4
CN2014900000000,2022-09-01,20,149,KS,Pottawatomie County,12773,12497,276,2.2
CN2015100000000,2022-09-01,20,151,KS,Pratt County,4901,4794,107,2.2
CN2015300000000,2022-09-01,20,153,KS,Rawlins County,1546,1516,30,1.9
CN2015500000000,2022-09-01,20,155,KS,Reno County,29580,28792,788,2.7
CN2015700000000,2022-09-01,20,157,KS,Republic County,2343,2296,47,2
CN2015900000000,2022-09-01,20,159,KS,Rice County,5370,5258,112,2.1
CN2016100000000,2022-09-01,20,161,KS,Riley County,35540,34618,922,2.6
CN2016300000000,2022-09-01,20,163,KS,Rooks County,2405,2337,68,2.8
CN2016500000000,2022-09-01,20,165,KS,Rush County,1588,1556,32,2
CN2016700000000,2022-09-01,20,167,KS,Russell County,3230,3147,83,2.6
CN2016900000000,2022-09-01,20,169,KS,Saline County,30097,29407,690,2.3
CN2017100000000,2022-09-01,20,171,KS,Scott County,2634,2575,59,2.2
CN2017300000000,2022-09-01,20,173,KS,Sedgwick County,255960,248520,7440,2.9
CN2017500000000,2022-09-01,20,175,KS,Seward County,9788,9550,238,2.4
CN2017700000000,2022-09-01,20,177,KS,Shawnee County,91459,89076,2383,2.6
CN2017900000000,2022-09-01,20,179,KS,Sheridan County,1426,1397,29,2
CN2018100000000,2022-09-01,20,181,KS,Sherman County,2725,2661,64,2.3
CN2018300000000,2022-09-01,20,183,KS,Smith County,1929,1888,41,2.1
CN2018500000000,2022-09-01,20,185,KS,Stafford County,1850,1806,44,2.4
CN2018700000000,2022-09-01,20,187,KS,Stanton County,1107,1087,20,1.8
CN2018900000000,2022-09-01,20,189,KS,Stevens County,2995,2943,52,1.7
CN2019100000000,2022-09-01,20,191,KS,Sumner County,10778,10475,303,2.8
CN2019300000000,2022-09-01,20,193,KS,Thomas County,4246,4145,101,2.4
CN2019500000000,2022-09-01,20,195,KS,Trego County,1334,1297,37,2.8
CN2019700000000,2022-09-01,20,197,KS,Wabaunsee County,3718,3627,91,2.4
CN2019900000000,2022-09-01,20,199,KS,Wallace County,845,826,19,2.2
CN2020100000000,2022-09-01,20,201,KS,Washington County,2960,2902,58,2
CN2020300000000,2022-09-01,20,203,KS,Wichita County,1120,1093,27,2.4
CN2020500000000,2022-09-01,20,205,KS,Wilson County,3678,3570,108,2.9
CN2020700000000,2022-09-01,20,207,KS,Woodson County,1527,1478,49,3.2
CN2020900000000,2022-09-01,20,209,KS,Wyandotte County,78194,75647,2547,3.3
CN2100100000000,2022-09-01,21,001,KY,Adair County,7239,6936,303,4.2
CN2100300000000,2022-09-01,21,003,KY,Allen County,9023,8704,319,3.5
CN2100500000000,2022-09-01,21,005,KY,Anderson County,11998,11663,335,2.8
CN2100700000000,2022-09-01,21,007,KY,Ballard County,3463,3316,147,4.2
CN2100900000000,2022-09-01,21,009,KY,Barren County,17954,17324,630,3.5
CN2101100000000,2022-09-01,21,011,KY,Bath County,4715,4513,202,4.3
CN2101300000000,2022-09-01,21,013,KY,Bell County,8135,7760,375,4.6
CN2101500000000,2022-09-01,21,015,KY,Boone County,72456,70351,2105,2.9
CN2101700000000,2022-09-01,21,017,KY,Bourbon County,9625,9324,301,3.1
CN2101900000000,2022-09-01,21,019,KY,Boyd County,17069,16295,774,4.5
CN2102100000000,2022-09-01,21,021,KY,Boyle County,12726,12273,453,3.6
CN2102300000000,2022-09-01,21,023,KY,Bracken County,3774,3645,129,3.4
CN2102500000000,2022-09-01,21,025,KY,Breathitt County,3140,2936,204,6.5
CN2102700000000,2022-09-01,21,027,KY,Breckinridge County,7955,7582,373,4.7
CN2102900000000,2022-09-01,21,029,KY,Bullitt County,42781,41473,1308,3.1
CN2103100000000,2022-09-01,21,031,KY,Butler County,5005,4821,184,3.7
CN2103300000000,2022-09-01,21,033,KY,Caldwell County,6140,5947,193,3.1
CN2103500000000,2022-09-01,21,035,KY,Calloway County,17538,16922,616,3.5
CN2103700000000,2022-09-01,21,037,KY,Campbell County,50828,49311,1517,3
CN2103900000000,2022-09-01,21,039,KY,Carlisle County,2260,2189,71,3.1
CN2104100000000,2022-09-01,21,041,KY,Carroll County,5821,5660,161,2.8
CN2104300000000,2022-09-01,21,043,KY,Carter County,9602,9048,554,5.8
CN2104500000000,2022-09-01,21,045,KY,Casey County,6590,6367,223,3.4
CN2104700000000,2022-09-01,21,047,KY,Christian County,24896,23781,1115,4.5
CN2104900000000,2022-09-01,21,049,KY,Clark County,17281,16697,584,3.4
CN2105100000000,2022-09-01,21,051,KY,Clay County,5062,4788,274,5.4
CN2105300000000,2022-09-01,21,053,KY,Clinton County,3627,3473,154,4.2
CN2105500000000,2022-09-01,21,055,KY,Crittenden County,3842,3697,145,3.8
CN2105700000000,2022-09-01,21,057,KY,Cumberland County,3418,3326,92,2.7
CN2105900000000,2022-09-01,21,059,KY,Daviess County,45814,44012,1802,3.9
CN2106100000000,2022-09-01,21,061,KY,Edmonson County,4768,4559,209,4.4
CN2106300000000,2022-09-01,21,063,KY,Elliott County,1885,1768,117,6.2
CN2106500000000,2022-09-01,21,065,KY,Estill County,5193,4974,219,4.2
CN2106700000000,2022-09-01,21,067,KY,Fayette County,175856,170852,5004,2.8
CN2106900000000,2022-09-01,21,069,KY,Fleming County,6090,5863,227,3.7
CN2107100000000,2022-09-01,21,071,KY,Floyd County,10986,10414,572,5.2
CN2107300000000,2022-09-01,21,073,KY,Franklin County,25151,24393,758,3
CN2107500000000,2022-09-01,21,075,KY,Fulton County,2117,2028,89,4.2
CN2107700000000,2022-09-01,21,077,KY,Gallatin County,4018,3889,129,3.2
CN2107900000000,2022-09-01,21,079,KY,Garrard County,7982,7716,266,3.3
CN2108100000000,2022-09-01,21,081,KY,Grant County,11685,11324,361,3.1
CN2108300000000,2022-09-01,21,083,KY,Graves County,15433,14840,593,3.8
CN2108500000000,2022-09-01,21,085,KY,Grayson County,10401,9990,411,4
CN2108700000000,2022-09-01,21,087,KY,Green County,5005,4844,161,3.2
CN2108900000000,2022-09-01,21,089,KY,Greenup County,12817,12185,632,4.9
CN2109100000000,2022-09-01,21,091,KY,Hancock County,3868,3657,211,5.5
CN2109300000000,2022-09-01,21,093,KY,Hardin County,46716,45001,1715,3.7
CN2109500000000,2022-09-01,21,095,KY,Harlan County,6344,5981,363,5.7
CN2109700000000,2022-09-01,21,097,KY,Harrison County,8871,8597,274,3.1
CN2109900000000,2022-09-01,21,099,KY,Hart County,7660,7387,273,3.6
CN2110100000000,2022-09-01,21,101,KY,Henderson County,20622,19903,719,3.5
CN2110300000000,2022-09-01,21,103,KY,Henry County,8120,7879,241,3
CN2110500000000,2022-09-01,21,105,KY,Hickman County,1666,1604,62,3.7
CN2110700000000,2022-09-01,21,107,KY,Hopkins County,18166,17462,704,3.9
CN2110900000000,2022-09-01,21,109,KY,Jackson County,4145,3931,214,5.2
CN2111100000000,2022-09-01,21,111,KY,Jefferson County,393519,381187,12332,3.1
CN2111300000000,2022-09-01,21,113,KY,Jessamine County,26606,25792,814,3.1
CN2111500000000,2022-09-01,21,115,KY,Johnson County,6652,6303,349,5.2
CN2111700000000,2022-09-01,21,117,KY,Kenton County,88070,85403,2667,3
CN2111900000000,2022-09-01,21,119,KY,Knott County,4306,4064,242,5.6
CN2112100000000,2022-09-01,21,121,KY,Knox County,9955,9461,494,5
CN2112300000000,2022-09-01,21,123,KY,Larue County,5706,5478,228,4
CN2112500000000,2022-09-01,21,125,KY,Laurel County,25204,24200,1004,4
CN2112700000000,2022-09-01,21,127,KY,Lawrence County,5510,5266,244,4.4
CN2112900000000,2022-09-01,21,129,KY,Lee County,2095,1998,97,4.6
CN2113100000000,2022-09-01,21,131,KY,Leslie County,2527,2380,147,5.8
CN2113300000000,2022-09-01,21,133,KY,Letcher County,5869,5513,356,6.1
CN2113500000000,2022-09-01,21,135,KY,Lewis County,4481,4196,285,6.4
CN2113700000000,2022-09-01,21,137,KY,Lincoln County,9351,8937,414,4.4
CN2113900000000,2022-09-01,21,139,KY,Livingston County,3623,3478,145,4
CN2114100000000,2022-09-01,21,141,KY,Logan County,12426,12022,404,3.3
CN2114300000000,2022-09-01,21,143,KY,Lyon County,3205,3079,126,3.9
CN2114500000000,2022-09-01,21,145,KY,McCracken County,29770,28699,1071,3.6
CN2114700000000,2022-09-01,21,147,KY,McCreary County,4729,4495,234,4.9
CN2114900000000,2022-09-01,21,149,KY,McLean County,3963,3800,163,4.1
CN2115100000000,2022-09-01,21,151,KY,Madison County,46983,45438,1545,3.3
CN2115300000000,2022-09-01,21,153,KY,Magoffin County,3133,2867,266,8.5
CN2115500000000,2022-09-01,21,155,KY,Marion County,9429,9160,269,2.9
CN2115700000000,2022-09-01,21,157,KY,Marshall County,14505,13988,517,3.6
CN2115900000000,2022-09-01,21,159,KY,Martin County,2207,2055,152,6.9
CN2116100000000,2022-09-01,21,161,KY,Mason County,6587,6298,289,4.4
CN2116300000000,2022-09-01,21,163,KY,Meade County,11541,11084,457,4
CN2116500000000,2022-09-01,21,165,KY,Menifee County,2374,2262,112,4.7
CN2116700000000,2022-09-01,21,167,KY,Mercer County,10103,9767,336,3.3
CN2116900000000,2022-09-01,21,169,KY,Metcalfe County,3922,3772,150,3.8
CN2117100000000,2022-09-01,21,171,KY,Monroe County,4641,4505,136,2.9
CN2117300000000,2022-09-01,21,173,KY,Montgomery County,11944,11475,469,3.9
CN2117500000000,2022-09-01,21,175,KY,Morgan County,4140,3967,173,4.2
CN2117700000000,2022-09-01,21,177,KY,Muhlenberg County,9801,9282,519,5.3
CN2117900000000,2022-09-01,21,179,KY,Nelson County,23706,22987,719,3
CN2118100000000,2022-09-01,21,181,KY,Nicholas County,3255,3136,119,3.7
CN2118300000000,2022-09-01,21,183,KY,Ohio County,9210,8743,467,5.1
CN2118500000000,2022-09-01,21,185,KY,Oldham County,33261,32353,908,2.7
CN2118700000000,2022-09-01,21,187,KY,Owen County,5255,5096,159,3
CN2118900000000,2022-09-01,21,189,KY,Owsley County,1084,1015,69,6.4
CN2119100000000,2022-09-01,21,191,KY,Pendleton County,6932,6716,216,3.1
CN2119300000000,2022-09-01,21,193,KY,Perry County,8052,7684,368,4.6
CN2119500000000,2022-09-01,21,195,KY,Pike County,18848,17961,887,4.7
CN2119700000000,2022-09-01,21,197,KY,Powell County,5291,5087,204,3.9
CN2119900000000,2022-09-01,21,199,KY,Pulaski County,25356,24200,1156,4.6
CN2120100000000,2022-09-01,21,201,KY,Robertson County,829,794,35,4.2
CN2120300000000,2022-09-01,21,203,KY,Rockcastle County,6495,6228,267,4.1
CN2120500000000,2022-09-01,21,205,KY,Rowan County,10358,9940,418,4
CN2120700000000,2022-09-01,21,207,KY,Russell County,6296,6007,289,4.6
CN2120900000000,2022-09-01,21,209,KY,Scott County,30393,29543,850,2.8
CN2121100000000,2022-09-01,21,211,KY,Shelby County,25837,25110,727,2.8
CN2121300000000,2022-09-01,21,213,KY,Simpson County,8750,8476,274,3.1
CN2121500000000,2022-09-01,21,215,KY,Spencer County,10538,10221,317,3
CN2121700000000,2022-09-01,21,217,KY,Taylor County,12145,11726,419,3.4
CN2121900000000,2022-09-01,21,219,KY,Todd County,5797,5625,172,3
CN2122100000000,2022-09-01,21,221,KY,Trigg County,6082,5834,248,4.1
CN2122300000000,2022-09-01,21,223,KY,Trimble County,3820,3685,135,3.5
CN2122500000000,2022-09-01,21,225,KY,Union County,5870,5640,230,3.9
CN2122700000000,2022-09-01,21,227,KY,Warren County,66159,64012,2147,3.2
CN2122900000000,2022-09-01,21,229,KY,Washington County,6145,5964,181,2.9
CN2123100000000,2022-09-01,21,231,KY,Wayne County,7065,6715,350,5
CN2123300000000,2022-09-01,21,233,KY,Webster County,5205,5017,188,3.6
CN2123500000000,2022-09-01,21,235,KY,Whitley County,13963,13395,568,4.1
CN2123700000000,2022-09-01,21,237,KY,Wolfe County,2265,2155,110,4.9
CN2123900000000,2022-09-01,21,239,KY,Woodford County,15044,14625,419,2.8
CN2200100000000,2022-09-01,22,001,LA,Acadia Parish,23926,23057,869,3.6
CN2200300000000,2022-09-01,22,003,LA,Allen Parish,8234,7919,315,3.8
CN2200500000000,2022-09-01,22,005,LA,Ascension Parish,67454,65487,1967,2.9
CN2200700000000,2022-09-01,22,007,LA,Assumption Parish,8842,8442,400,4.5
CN2200900000000,2022-09-01,22,009,LA,Avoyelles Parish,14361,13792,569,4
CN2201100000000,2022-09-01,22,011,LA,Beauregard Parish,14721,14239,482,3.3
CN2201300000000,2022-09-01,22,013,LA,Bienville Parish,5175,4966,209,4
CN2201500000000,2022-09-01,22,015,LA,Bossier Parish,58078,56333,1745,3
CN2201700000000,2022-09-01,22,017,LA,Caddo Parish,101688,97680,4008,3.9
CN2201900000000,2022-09-01,22,019,LA,Calcasieu Parish,92403,89289,3114,3.4
CN2202100000000,2022-09-01,22,021,LA,Caldwell Parish,3693,3553,140,3.8
CN2202300000000,2022-09-01,22,023,LA,Cameron Parish,3437,3338,99,2.9
CN2202500000000,2022-09-01,22,025,LA,Catahoula Parish,3455,3315,140,4.1
CN2202700000000,2022-09-01,22,027,LA,Claiborne Parish,5437,5241,196,3.6
CN2202900000000,2022-09-01,22,029,LA,Concordia Parish,6966,6657,309,4.4
CN2203100000000,2022-09-01,22,031,LA,De Soto Parish,10925,10500,425,3.9
CN2203300000000,2022-09-01,22,033,LA,East Baton Rouge Parish,235067,227373,7694,3.3
CN2203500000000,2022-09-01,22,035,LA,East Carroll Parish,1647,1524,123,7.5
CN2203700000000,2022-09-01,22,037,LA,East Feliciana Parish,7932,7700,232,2.9
CN2203900000000,2022-09-01,22,039,LA,Evangeline Parish,11928,11458,470,3.9
CN2204100000000,2022-09-01,22,041,LA,Franklin Parish,7485,7122,363,4.8
CN2204300000000,2022-09-01,22,043,LA,Grant Parish,8349,8066,283,3.4
CN2204500000000,2022-09-01,22,045,LA,Iberia Parish,27616,26505,1111,4
CN2204700000000,2022-09-01,22,047,LA,Iberville Parish,13994,13403,591,4.2
CN2204900000000,2022-09-01,22,049,LA,Jackson Parish,6936,6718,218,3.1
CN2205100000000,2022-09-01,22,051,LA,Jefferson Parish,209557,202474,7083,3.4
CN2205300000000,2022-09-01,22,053,LA,Jefferson Davis Parish,12396,11977,419,3.4
CN2205500000000,2022-09-01,22,055,LA,Lafayette Parish,116684,113101,3583,3.1
CN2205700000000,2022-09-01,22,057,LA,Lafourche Parish,40752,39417,1335,3.3
CN2205900000000,2022-09-01,22,059,LA,LaSalle Parish,6767,6588,179,2.6
CN2206100000000,2022-09-01,22,061,LA,Lincoln Parish,21588,20839,749,3.5
CN2206300000000,2022-09-01,22,063,LA,Livingston Parish,72305,70247,2058,2.8
CN2206500000000,2022-09-01,22,065,LA,Madison Parish,3522,3356,166,4.7
CN2206700000000,2022-09-01,22,067,LA,Morehouse Parish,9866,9384,482,4.9
CN2206900000000,2022-09-01,22,069,LA,Natchitoches Parish,16831,16183,648,3.9
CN2207100000000,2022-09-01,22,071,LA,Orleans Parish,175490,168256,7234,4.1
CN2207300000000,2022-09-01,22,073,LA,Ouachita Parish,70363,67869,2494,3.5
CN2207500000000,2022-09-01,22,075,LA,Plaquemines Parish,9766,9447,319,3.3
CN2207700000000,2022-09-01,22,077,LA,Pointe Coupee Parish,9847,9491,356,3.6
CN2207900000000,2022-09-01,22,079,LA,Rapides Parish,56352,54528,1824,3.2
CN2208100000000,2022-09-01,22,081,LA,Red River Parish,4035,3905,130,3.2
CN2208300000000,2022-09-01,22,083,LA,Richland Parish,8342,8008,334,4
CN2208500000000,2022-09-01,22,085,LA,Sabine Parish,9261,8953,308,3.3
CN2208700000000,2022-09-01,22,087,LA,St. Bernard Parish,19895,19143,752,3.8
CN2208900000000,2022-09-01,22,089,LA,St. Charles Parish,24699,23921,778,3.1
CN2209100000000,2022-09-01,22,091,LA,St. Helena Parish,4294,4080,214,5
CN2209300000000,2022-09-01,22,093,LA,St. James Parish,8864,8484,380,4.3
CN2209500000000,2022-09-01,22,095,LA,St. John the Baptist Parish,18959,18115,844,4.5
CN2209700000000,2022-09-01,22,097,LA,St. Landry Parish,31612,30240,1372,4.3
CN2209900000000,2022-09-01,22,099,LA,St. Martin Parish,22116,21324,792,3.6
CN2210100000000,2022-09-01,22,101,LA,St. Mary Parish,19523,18751,772,4
CN2210300000000,2022-09-01,22,103,LA,St. Tammany Parish,119457,115910,3547,3
CN2210500000000,2022-09-01,22,105,LA,Tangipahoa Parish,56759,54414,2345,4.1
CN2210700000000,2022-09-01,22,107,LA,Tensas Parish,1327,1262,65,4.9
CN2210900000000,2022-09-01,22,109,LA,Terrebonne Parish,44758,43140,1618,3.6
CN2211100000000,2022-09-01,22,111,LA,Union Parish,9182,8829,353,3.8
CN2211300000000,2022-09-01,22,113,LA,Vermilion Parish,24100,23274,826,3.4
CN2211500000000,2022-09-01,22,115,LA,Vernon Parish,16401,15792,609,3.7
CN2211700000000,2022-09-01,22,117,LA,Washington Parish,17222,16534,688,4
CN2211900000000,2022-09-01,22,119,LA,Webster Parish,14184,13591,593,4.2
CN2212100000000,2022-09-01,22,121,LA,West Baton Rouge Parish,14107,13667,440,3.1
CN2212300000000,2022-09-01,22,123,LA,West Carroll Parish,3460,3280,180,5.2
CN2212500000000,2022-09-01,22,125,LA,West Feliciana Parish,5484,5341,143,2.6
CN2212700000000,2022-09-01,22,127,LA,Winn Parish,4674,4497,177,3.8
CN2300100000000,2022-09-01,23,001,ME,Androscoggin County,52309,50967,1342,2.6
CN2300300000000,2022-09-01,23,003,ME,Aroostook County,27434,26598,836,3
CN2300500000000,2022-09-01,23,005,ME,Cumberland County,161590,158063,3527,2.2
CN2300700000000,2022-09-01,23,007,ME,Franklin County,13293,12911,382,2.9
CN2300900000000,2022-09-01,23,009,ME,Hancock County,29462,28817,645,2.2
CN2301100000000,2022-09-01,23,011,ME,Kennebec County,60182,58740,1442,2.4
CN2301300000000,2022-09-01,23,013,ME,Knox County,19627,19155,472,2.4
CN2301500000000,2022-09-01,23,015,ME,Lincoln County,16547,16187,360,2.2
CN2301700000000,2022-09-01,23,017,ME,Oxford County,25060,24350,710,2.8
CN2301900000000,2022-09-01,23,019,ME,Penobscot County,74786,72859,1927,2.6
CN2302100000000,2022-09-01,23,021,ME,Piscataquis County,7131,6909,222,3.1
CN2302300000000,2022-09-01,23,023,ME,Sagadahoc County,18754,18367,387,2.1
CN2302500000000,2022-09-01,23,025,ME,Somerset County,21482,20771,711,3.3
CN2302700000000,2022-09-01,23,027,ME,Waldo County,19998,19518,480,2.4
CN2302900000000,2022-09-01,23,029,ME,Washington County,12845,12443,402,3.1
CN2303100000000,2022-09-01,23,031,ME,York County,111328,108957,2371,2.1
CN2400100000000,2022-09-01,24,001,MD,Allegany County,31011,29938,1073,3.5
CN2400300000000,2022-09-01,24,003,MD,Anne Arundel County,312435,304261,8174,2.6
CN2400500000000,2022-09-01,24,005,MD,Baltimore County,442071,428714,13357,3
CN2400900000000,2022-09-01,24,009,MD,Calvert County,49167,47840,1327,2.7
CN2401100000000,2022-09-01,24,011,MD,Caroline County,17021,16561,460,2.7
CN2401300000000,2022-09-01,24,013,MD,Carroll County,94743,92439,2304,2.4
CN2401500000000,2022-09-01,24,015,MD,Cecil County,53796,52216,1580,2.9
CN2401700000000,2022-09-01,24,017,MD,Charles County,86150,83554,2596,3
CN2401900000000,2022-09-01,24,019,MD,Dorchester County,16815,16301,514,3.1
CN2402100000000,2022-09-01,24,021,MD,Frederick County,135876,132119,3757,2.8
CN2402300000000,2022-09-01,24,023,MD,Garrett County,14670,14252,418,2.8
CN2402500000000,2022-09-01,24,025,MD,Harford County,139491,135691,3800,2.7
CN2402700000000,2022-09-01,24,027,MD,Howard County,186797,182232,4565,2.4
CN2402900000000,2022-09-01,24,029,MD,Kent County,9978,9675,303,3
CN2403100000000,2022-09-01,24,031,MD,Montgomery County,544415,529728,14687,2.7
CN2403300000000,2022-09-01,24,033,MD,Prince George's County,494049,478514,15535,3.1
CN2403500000000,2022-09-01,24,035,MD,Queen Anne's County,28236,27532,704,2.5
CN2403700000000,2022-09-01,24,037,MD,St. Mary's County,56962,55347,1615,2.8
CN2403900000000,2022-09-01,24,039,MD,Somerset County,9319,8934,385,4.1
CN2404100000000,2022-09-01,24,041,MD,Talbot County,17683,17162,521,2.9
CN2404300000000,2022-09-01,24,043,MD,Washington County,72191,69998,2193,3
CN2404500000000,2022-09-01,24,045,MD,Wicomico County,51843,50129,1714,3.3
CN2404700000000,2022-09-01,24,047,MD,Worcester County,25324,24481,843,3.3
CN2451000000000,2022-09-01,24,510,MD,Baltimore city,272135,261648,10487,3.9
CN2500100000000,2022-09-01,25,001,MA,Barnstable County,112187,108180,4007,3.6
CN2500300000000,2022-09-01,25,003,MA,Berkshire County,60736,58384,2352,3.9
CN2500500000000,2022-09-01,25,005,MA,Bristol County,296012,283679,12333,4.2
CN2500700000000,2022-09-01,25,007,MA,Dukes County,10064,9737,327,3.2
CN2500900000000,2022-09-01,25,009,MA,Essex County,416798,401274,15524,3.7
CN2501100000000,2022-09-01,25,011,MA,Franklin County,39921,38710,1211,3
CN2501300000000,2022-09-01,25,013,MA,Hampden County,222503,212217,10286,4.6
CN2501500000000,2022-09-01,25,015,MA,Hampshire County,88949,86131,2818,3.2
CN2501700000000,2022-09-01,25,017,MA,Middlesex County,901189,874017,27172,3
CN2501900000000,2022-09-01,25,019,MA,Nantucket County/town,8468,8224,244,2.9
CN2502100000000,2022-09-01,25,021,MA,Norfolk County,389254,376406,12848,3.3
CN2502300000000,2022-09-01,25,023,MA,Plymouth County,280705,270545,10160,3.6
CN2502500000000,2022-09-01,25,025,MA,Suffolk County,448887,433089,15798,3.5
CN2502700000000,2022-09-01,25,027,MA,Worcester County,437256,421076,16180,3.7
CN2600100000000,2022-09-01,26,001,MI,Alcona County,3937,3716,221,5.6
CN2600300000000,2022-09-01,26,003,MI,Alger County,3378,3194,184,5.4
CN2600500000000,2022-09-01,26,005,MI,Allegan County,62013,59891,2122,3.4
CN2600700000000,2022-09-01,26,007,MI,Alpena County,13194,12624,570,4.3
CN2600900000000,2022-09-01,26,009,MI,Antrim County,10389,9890,499,4.8
CN2601100000000,2022-09-01,26,011,MI,Arenac County,5817,5483,334,5.7
CN2601300000000,2022-09-01,26,013,MI,Baraga County,3049,2874,175,5.7
CN2601500000000,2022-09-01,26,015,MI,Barry County,31701,30578,1123,3.5
CN2601700000000,2022-09-01,26,017,MI,Bay County,48890,46674,2216,4.5
CN2601900000000,2022-09-01,26,019,MI,Benzie County,8911,8541,370,4.2
CN2602100000000,2022-09-01,26,021,MI,Berrien County,71889,68896,2993,4.2
CN2602300000000,2022-09-01,26,023,MI,Branch County,19686,18909,777,3.9
CN2602500000000,2022-09-01,26,025,MI,Calhoun County,59756,57008,2748,4.6
CN2602700000000,2022-09-01,26,027,MI,Cass County,23476,22470,1006,4.3
CN2602900000000,2022-09-01,26,029,MI,Charlevoix County,13004,12510,494,3.8
CN2603100000000,2022-09-01,26,031,MI,Cheboygan County,10691,10224,467,4.4
CN2603300000000,2022-09-01,26,033,MI,Chippewa County,16217,15457,760,4.7
CN2603500000000,2022-09-01,26,035,MI,Clare County,11157,10496,661,5.9
CN2603700000000,2022-09-01,26,037,MI,Clinton County,40100,38669,1431,3.6
CN2603900000000,2022-09-01,26,039,MI,Crawford County,5508,5204,304,5.5
CN2604100000000,2022-09-01,26,041,MI,Delta County,16768,16017,751,4.5
CN2604300000000,2022-09-01,26,043,MI,Dickinson County,12211,11722,489,4
CN2604500000000,2022-09-01,26,045,MI,Eaton County,55474,53397,2077,3.7
CN2604700000000,2022-09-01,26,047,MI,Emmet County,16979,16292,687,4
CN2604900000000,2022-09-01,26,049,MI,Genesee County,177813,168588,9225,5.2
CN2605100000000,2022-09-01,26,051,MI,Gladwin County,10000,9480,520,5.2
CN2605300000000,2022-09-01,26,053,MI,Gogebic County,5576,5327,249,4.5
CN2605500000000,2022-09-01,26,055,MI,Grand Traverse County,50671,48998,1673,3.3
CN2605700000000,2022-09-01,26,057,MI,Gratiot County,17293,16591,702,4.1
CN2605900000000,2022-09-01,26,059,MI,Hillsdale County,20231,19379,852,4.2
CN2606100000000,2022-09-01,26,061,MI,Houghton County,16605,15915,690,4.2
CN2606300000000,2022-09-01,26,063,MI,Huron County,15194,14588,606,4
CN2606500000000,2022-09-01,26,065,MI,Ingham County,145343,139477,5866,4
CN2606700000000,2022-09-01,26,067,MI,Ionia County,30203,29132,1071,3.5
CN2606900000000,2022-09-01,26,069,MI,Iosco County,10459,9929,530,5.1
CN2607100000000,2022-09-01,26,071,MI,Iron County,4681,4445,236,5
CN2607300000000,2022-09-01,26,073,MI,Isabella County,31351,29928,1423,4.5
CN2607500000000,2022-09-01,26,075,MI,Jackson County,73327,70359,2968,4
CN2607700000000,2022-09-01,26,077,MI,Kalamazoo County,131393,126320,5073,3.9
CN2607900000000,2022-09-01,26,079,MI,Kalkaska County,8002,7620,382,4.8
CN2608100000000,2022-09-01,26,081,MI,Kent County,358308,346213,12095,3.4
CN2608300000000,2022-09-01,26,083,MI,Keweenaw County,924,878,46,5
CN2608500000000,2022-09-01,26,085,MI,Lake County,3940,3706,234,5.9
CN2608700000000,2022-09-01,26,087,MI,Lapeer County,40096,38739,1357,3.4
CN2608900000000,2022-09-01,26,089,MI,Leelanau County,10584,10198,386,3.6
CN2609100000000,2022-09-01,26,091,MI,Lenawee County,44623,42810,1813,4.1
CN2609300000000,2022-09-01,26,093,MI,Livingston County,102931,100412,2519,2.4
CN2609500000000,2022-09-01,26,095,MI,Luce County,2127,2021,106,5
CN2609700000000,2022-09-01,26,097,MI,Mackinac County,5674,5492,182,3.2
CN2609900000000,2022-09-01,26,099,MI,Macomb County,442294,425826,16468,3.7
CN2610100000000,2022-09-01,26,101,MI,Manistee County,9890,9391,499,5
CN2610300000000,2022-09-01,26,103,MI,Marquette County,32400,31016,1384,4.3
CN2610500000000,2022-09-01,26,105,MI,Mason County,13261,12669,592,4.5
CN2610700000000,2022-09-01,26,107,MI,Mecosta County,18538,17631,907,4.9
CN2610900000000,2022-09-01,26,109,MI,Menominee County,10681,10271,410,3.8
CN2611100000000,2022-09-01,26,111,MI,Midland County,39847,38255,1592,4
CN2611300000000,2022-09-01,26,113,MI,Missaukee County,6835,6548,287,4.2
CN2611500000000,2022-09-01,26,115,MI,Monroe County,73809,70563,3246,4.4
CN2611700000000,2022-09-01,26,117,MI,Montcalm County,27657,26522,1135,4.1
CN2611900000000,2022-09-01,26,119,MI,Montmorency County,3042,2851,191,6.3
CN2612100000000,2022-09-01,26,121,MI,Muskegon County,76339,72602,3737,4.9
CN2612300000000,2022-09-01,26,123,MI,Newaygo County,23150,22170,980,4.2
CN2612500000000,2022-09-01,26,125,MI,Oakland County,666266,647844,18422,2.8
CN2612700000000,2022-09-01,26,127,MI,Oceana County,11791,11190,601,5.1
CN2612900000000,2022-09-01,26,129,MI,Ogemaw County,8341,7865,476,5.7
CN2613100000000,2022-09-01,26,131,MI,Ontonagon County,2034,1905,129,6.3
CN2613300000000,2022-09-01,26,133,MI,Osceola County,11432,10973,459,4
CN2613500000000,2022-09-01,26,135,MI,Oscoda County,2882,2681,201,7
CN2613700000000,2022-09-01,26,137,MI,Otsego County,11473,10964,509,4.4
CN2613900000000,2022-09-01,26,139,MI,Ottawa County,161417,156218,5199,3.2
CN2614100000000,2022-09-01,26,141,MI,Presque Isle County,4957,4686,271,5.5
CN2614300000000,2022-09-01,26,143,MI,Roscommon County,8161,7608,553,6.8
CN2614500000000,2022-09-01,26,145,MI,Saginaw County,81873,77696,4177,5.1
CN2614700000000,2022-09-01,26,147,MI,St. Clair County,74343,71850,2493,3.4
CN2614900000000,2022-09-01,26,149,MI,St. Joseph County,28368,27142,1226,4.3
CN2615100000000,2022-09-01,26,151,MI,Sanilac County,19053,18161,892,4.7
CN2615300000000,2022-09-01,26,153,MI,Schoolcraft County,3095,2913,182,5.9
CN2615500000000,2022-09-01,26,155,MI,Shiawassee County,32090,30772,1318,4.1
CN2615700000000,2022-09-01,26,157,MI,Tuscola County,22774,21735,1039,4.6
CN2615900000000,2022-09-01,26,159,MI,Van Buren County,34194,32685,1509,4.4
CN2616100000000,2022-09-01,26,161,MI,Washtenaw County,194631,187664,6967,3.6
CN2616300000000,2022-09-01,26,163,MI,Wayne County,791234,759038,32196,4.1
CN2616500000000,2022-09-01,26,165,MI,Wexford County,14742,14086,656,4.4
CN2700100000000,2022-09-01,27,001,MN,Aitkin County,7439,7223,216,2.9
CN2700300000000,2022-09-01,27,003,MN,Anoka County,199400,194788,4612,2.3
CN2700500000000,2022-09-01,27,005,MN,Becker County,19470,19086,384,2
CN2700700000000,2022-09-01,27,007,MN,Beltrami County,25173,24611,562,2.2
CN2700900000000,2022-09-01,27,009,MN,Benton County,21708,21208,500,2.3
CN2701100000000,2022-09-01,27,011,MN,Big Stone County,2373,2322,51,2.1
CN2701300000000,2022-09-01,27,013,MN,Blue Earth County,40679,40014,665,1.6
CN2701500000000,2022-09-01,27,015,MN,Brown County,13607,13329,278,2
CN2701700000000,2022-09-01,27,017,MN,Carlton County,17675,17238,437,2.5
CN2701900000000,2022-09-01,27,019,MN,Carver County,59485,58405,1080,1.8
CN2702100000000,2022-09-01,27,021,MN,Cass County,15066,14681,385,2.6
CN2702300000000,2022-09-01,27,023,MN,Chippewa County,6403,6285,118,1.8
CN2702500000000,2022-09-01,27,025,MN,Chisago County,29931,29244,687,2.3
CN2702700000000,2022-09-01,27,027,MN,Clay County,38162,37559,603,1.6
CN2702900000000,2022-09-01,27,029,MN,Clearwater County,4470,4320,150,3.4
CN2703100000000,2022-09-01,27,031,MN,Cook County,3005,2940,65,2.2
CN2703300000000,2022-09-01,27,033,MN,Cottonwood County,6639,6495,144,2.2
CN2703500000000,2022-09-01,27,035,MN,Crow Wing County,34067,33330,737,2.2
CN2703700000000,2022-09-01,27,037,MN,Dakota County,243163,238074,5089,2.1
CN2703900000000,2022-09-01,27,039,MN,Dodge County,11841,11641,200,1.7
CN2704100000000,2022-09-01,27,041,MN,Douglas County,21566,21204,362,1.7
CN2704300000000,2022-09-01,27,043,MN,Faribault County,7149,6988,161,2.3
CN2704500000000,2022-09-01,27,045,MN,Fillmore County,11349,11139,210,1.9
CN2704700000000,2022-09-01,27,047,MN,Freeborn County,15832,15482,350,2.2
CN2704900000000,2022-09-01,27,049,MN,Goodhue County,26689,26139,550,2.1
CN2705100000000,2022-09-01,27,051,MN,Grant County,3234,3182,52,1.6
CN2705300000000,2022-09-01,27,053,MN,Hennepin County,708826,692350,16476,2.3
CN2705500000000,2022-09-01,27,055,MN,Houston County,10541,10364,177,1.7
CN2705700000000,2022-09-01,27,057,MN,Hubbard County,10391,10114,277,2.7
CN2705900000000,2022-09-01,27,059,MN,Isanti County,21656,21141,515,2.4
CN2706100000000,2022-09-01,27,061,MN,Itasca County,21695,21069,626,2.9
CN2706300000000,2022-09-01,27,063,MN,Jackson County,5365,5269,96,1.8
CN2706500000000,2022-09-01,27,065,MN,Kanabec County,9139,8907,232,2.5
CN2706700000000,2022-09-01,27,067,MN,Kandiyohi County,23153,22672,481,2.1
CN2706900000000,2022-09-01,27,069,MN,Kittson County,2180,2133,47,2.2
CN2707100000000,2022-09-01,27,071,MN,Koochiching County,5822,5652,170,2.9
CN2707300000000,2022-09-01,27,073,MN,Lac qui Parle County,3343,3287,56,1.7
CN2707500000000,2022-09-01,27,075,MN,Lake County,5472,5161,311,5.7
CN2707700000000,2022-09-01,27,077,MN,Lake of the Woods County,2381,2308,73,3.1
CN2707900000000,2022-09-01,27,079,MN,Le Sueur County,15740,15421,319,2
CN2708100000000,2022-09-01,27,081,MN,Lincoln County,2954,2903,51,1.7
CN2708300000000,2022-09-01,27,083,MN,Lyon County,14318,14058,260,1.8
CN2708500000000,2022-09-01,27,085,MN,McLeod County,19078,18671,407,2.1
CN2708700000000,2022-09-01,27,087,MN,Mahnomen County,2271,2199,72,3.2
CN2708900000000,2022-09-01,27,089,MN,Marshall County,5278,5182,96,1.8
CN2709100000000,2022-09-01,27,091,MN,Martin County,9511,9320,191,2
CN2709300000000,2022-09-01,27,093,MN,Meeker County,13531,13282,249,1.8
CN2709500000000,2022-09-01,27,095,MN,Mille Lacs County,12528,12186,342,2.7
CN2709700000000,2022-09-01,27,097,MN,Morrison County,17058,16657,401,2.4
CN2709900000000,2022-09-01,27,099,MN,Mower County,20767,20344,423,2
CN2710100000000,2022-09-01,27,101,MN,Murray County,4573,4499,74,1.6
CN2710300000000,2022-09-01,27,103,MN,Nicollet County,20881,20565,316,1.5
CN2710500000000,2022-09-01,27,105,MN,Nobles County,11056,10873,183,1.7
CN2710700000000,2022-09-01,27,107,MN,Norman County,3116,3041,75,2.4
CN2710900000000,2022-09-01,27,109,MN,Olmsted County,91541,89835,1706,1.9
CN2711100000000,2022-09-01,27,111,MN,Otter Tail County,31410,30837,573,1.8
CN2711300000000,2022-09-01,27,113,MN,Pennington County,8750,8561,189,2.2
CN2711500000000,2022-09-01,27,115,MN,Pine County,14166,13795,371,2.6
CN2711700000000,2022-09-01,27,117,MN,Pipestone County,4668,4583,85,1.8
CN2711900000000,2022-09-01,27,119,MN,Polk County,16010,15679,331,2.1
CN2712100000000,2022-09-01,27,121,MN,Pope County,6415,6310,105,1.6
CN2712300000000,2022-09-01,27,123,MN,Ramsey County,286934,279820,7114,2.5
CN2712500000000,2022-09-01,27,125,MN,Red Lake County,2147,2094,53,2.5
CN2712700000000,2022-09-01,27,127,MN,Redwood County,7506,7363,143,1.9
CN2712900000000,2022-09-01,27,129,MN,Renville County,8151,7932,219,2.7
CN2713100000000,2022-09-01,27,131,MN,Rice County,37419,36725,694,1.9
CN2713300000000,2022-09-01,27,133,MN,Rock County,5983,5909,74,1.2
CN2713500000000,2022-09-01,27,135,MN,Roseau County,7838,7690,148,1.9
CN2713700000000,2022-09-01,27,137,MN,St. Louis County,101335,98684,2651,2.6
CN2713900000000,2022-09-01,27,139,MN,Scott County,84635,83011,1624,1.9
CN2714100000000,2022-09-01,27,141,MN,Sherburne County,53118,51953,1165,2.2
CN2714300000000,2022-09-01,27,143,MN,Sibley County,7986,7803,183,2.3
CN2714500000000,2022-09-01,27,145,MN,Stearns County,90151,88324,1827,2
CN2714700000000,2022-09-01,27,147,MN,Steele County,19281,18841,440,2.3
CN2714900000000,2022-09-01,27,149,MN,Stevens County,5308,5233,75,1.4
CN2715100000000,2022-09-01,27,151,MN,Swift County,4719,4620,99,2.1
CN2715300000000,2022-09-01,27,153,MN,Todd County,13399,13119,280,2.1
CN2715500000000,2022-09-01,27,155,MN,Traverse County,1598,1577,21,1.3
CN2715700000000,2022-09-01,27,157,MN,Wabasha County,12097,11878,219,1.8
CN2715900000000,2022-09-01,27,159,MN,Wadena County,6066,5905,161,2.7
CN2716100000000,2022-09-01,27,161,MN,Waseca County,8655,8438,217,2.5
CN2716300000000,2022-09-01,27,163,MN,Washington County,145375,142463,2912,2
CN2716500000000,2022-09-01,27,165,MN,Watonwan County,6353,6248,105,1.7
CN2716700000000,2022-09-01,27,167,MN,Wilkin County,3382,3327,55,1.6
CN2716900000000,2022-09-01,27,169,MN,Winona County,28388,27904,484,1.7
CN2717100000000,2022-09-01,27,171,MN,Wright County,76594,75134,1460,1.9
CN2717300000000,2022-09-01,27,173,MN,Yellow Medicine County,4951,4853,98,2
CN2800100000000,2022-09-01,28,001,MS,Adams County,10554,10028,526,5
CN2800300000000,2022-09-01,28,003,MS,Alcorn County,14953,14422,531,3.6
CN2800500000000,2022-09-01,28,005,MS,Amite County,4199,3973,226,5.4
CN2800700000000,2022-09-01,28,007,MS,Attala County,6827,6541,286,4.2
CN2800900000000,2022-09-01,28,009,MS,Benton County,3050,2898,152,5
CN2801100000000,2022-09-01,28,011,MS,Bolivar County,10983,10476,507,4.6
CN2801300000000,2022-09-01,28,013,MS,Calhoun County,5204,4980,224,4.3
CN2801500000000,2022-09-01,28,015,MS,Carroll County,3269,3122,147,4.5
CN2801700000000,2022-09-01,28,017,MS,Chickasaw County,6462,6148,314,4.9
CN2801900000000,2022-09-01,28,019,MS,Choctaw County,3548,3425,123,3.5
CN2802100000000,2022-09-01,28,021,MS,Claiborne County,2890,2636,254,8.8
CN2802300000000,2022-09-01,28,023,MS,Clarke County,5533,5281,252,4.6
CN2802500000000,2022-09-01,28,025,MS,Clay County,8788,8420,368,4.2
CN2802700000000,2022-09-01,28,027,MS,Coahoma County,7454,7038,416,5.6
CN2802900000000,2022-09-01,28,029,MS,Copiah County,10714,10250,464,4.3
CN2803100000000,2022-09-01,28,031,MS,Covington County,8100,7838,262,3.2
CN2803300000000,2022-09-01,28,033,MS,DeSoto County,93618,90635,2983,3.2
CN2803500000000,2022-09-01,28,035,MS,Forrest County,33439,32236,1203,3.6
CN2803700000000,2022-09-01,28,037,MS,Franklin County,2618,2471,147,5.6
CN2803900000000,2022-09-01,28,039,MS,George County,8609,8204,405,4.7
CN2804100000000,2022-09-01,28,041,MS,Greene County,4118,3885,233,5.7
CN2804300000000,2022-09-01,28,043,MS,Grenada County,8700,8369,331,3.8
CN2804500000000,2022-09-01,28,045,MS,Hancock County,18947,18203,744,3.9
CN2804700000000,2022-09-01,28,047,MS,Harrison County,86948,83733,3215,3.7
CN2804900000000,2022-09-01,28,049,MS,Hinds County,101850,97940,3910,3.8
CN2805100000000,2022-09-01,28,051,MS,Holmes County,4974,4665,309,6.2
CN2805300000000,2022-09-01,28,053,MS,Humphreys County,1903,1760,143,7.5
CN2805500000000,2022-09-01,28,055,MS,Issaquena County,306,282,24,7.8
CN2805700000000,2022-09-01,28,057,MS,Itawamba County,10071,9736,335,3.3
CN2805900000000,2022-09-01,28,059,MS,Jackson County,58199,55776,2423,4.2
CN2806100000000,2022-09-01,28,061,MS,Jasper County,5796,5515,281,4.8
CN2806300000000,2022-09-01,28,063,MS,Jefferson County,1850,1586,264,14.3
CN2806500000000,2022-09-01,28,065,MS,Jefferson Davis County,3881,3696,185,4.8
CN2806700000000,2022-09-01,28,067,MS,Jones County,24845,23848,997,4
CN2806900000000,2022-09-01,28,069,MS,Kemper County,3186,2981,205,6.4
CN2807100000000,2022-09-01,28,071,MS,Lafayette County,28646,27775,871,3
CN2807300000000,2022-09-01,28,073,MS,Lamar County,31838,30913,925,2.9
CN2807500000000,2022-09-01,28,075,MS,Lauderdale County,28518,27383,1135,4
CN2807700000000,2022-09-01,28,077,MS,Lawrence County,4763,4549,214,4.5
CN2807900000000,2022-09-01,28,079,MS,Leake County,7852,7545,307,3.9
CN2808100000000,2022-09-01,28,081,MS,Lee County,40252,38901,1351,3.4
CN2808300000000,2022-09-01,28,083,MS,Leflore County,9201,8714,487,5.3
CN2808500000000,2022-09-01,28,085,MS,Lincoln County,14610,14080,530,3.6
CN2808700000000,2022-09-01,28,087,MS,Lowndes County,24668,23674,994,4
CN2808900000000,2022-09-01,28,089,MS,Madison County,53408,51795,1613,3
CN2809100000000,2022-09-01,28,091,MS,Marion County,9913,9509,404,4.1
CN2809300000000,2022-09-01,28,093,MS,Marshall County,14209,13650,559,3.9
CN2809500000000,2022-09-01,28,095,MS,Monroe County,15295,14701,594,3.9
CN2809700000000,2022-09-01,28,097,MS,Montgomery County,3880,3721,159,4.1
CN2809900000000,2022-09-01,28,099,MS,Neshoba County,9655,9248,407,4.2
CN2810100000000,2022-09-01,28,101,MS,Newton County,7834,7515,319,4.1
CN2810300000000,2022-09-01,28,103,MS,Noxubee County,3321,3110,211,6.4
CN2810500000000,2022-09-01,28,105,MS,Oktibbeha County,22764,21894,870,3.8
CN2810700000000,2022-09-01,28,107,MS,Panola County,12163,11613,550,4.5
CN2810900000000,2022-09-01,28,109,MS,Pearl River County,23427,22540,887,3.8
CN2811100000000,2022-09-01,28,111,MS,Perry County,4247,4055,192,4.5
CN2811300000000,2022-09-01,28,113,MS,Pike County,13827,13164,663,4.8
CN2811500000000,2022-09-01,28,115,MS,Pontotoc County,14707,14200,507,3.4
CN2811700000000,2022-09-01,28,117,MS,Prentiss County,11153,10792,361,3.2
CN2811900000000,2022-09-01,28,119,MS,Quitman County,2227,2101,126,5.7
CN2812100000000,2022-09-01,28,121,MS,Rankin County,76646,74439,2207,2.9
CN2812300000000,2022-09-01,28,123,MS,Scott County,12195,11800,395,3.2
CN2812500000000,2022-09-01,28,125,MS,Sharkey County,1260,1191,69,5.5
CN2812700000000,2022-09-01,28,127,MS,Simpson County,10547,10157,390,3.7
CN2812900000000,2022-09-01,28,129,MS,Smith County,6578,6345,233,3.5
CN2813100000000,2022-09-01,28,131,MS,Stone County,6994,6725,269,3.8
CN2813300000000,2022-09-01,28,133,MS,Sunflower County,7023,6609,414,5.9
CN2813500000000,2022-09-01,28,135,MS,Tallahatchie County,4546,4370,176,3.9
CN2813700000000,2022-09-01,28,137,MS,Tate County,12057,11596,461,3.8
CN2813900000000,2022-09-01,28,139,MS,Tippah County,9759,9440,319,3.3
CN2814100000000,2022-09-01,28,141,MS,Tishomingo County,8450,8155,295,3.5
CN2814300000000,2022-09-01,28,143,MS,Tunica County,4089,3916,173,4.2
CN2814500000000,2022-09-01,28,145,MS,Union County,14629,14206,423,2.9
CN2814700000000,2022-09-01,28,147,MS,Walthall County,4897,4650,247,5
CN2814900000000,2022-09-01,28,149,MS,Warren County,19081,18292,789,4.1
CN2815100000000,2022-09-01,28,151,MS,Washington County,14448,13623,825,5.7
CN2815300000000,2022-09-01,28,153,MS,Wayne County,6922,6582,340,4.9
CN2815500000000,2022-09-01,28,155,MS,Webster County,3874,3724,150,3.9
CN2815700000000,2022-09-01,28,157,MS,Wilkinson County,2556,2392,164,6.4
CN2815900000000,2022-09-01,28,159,MS,Winston County,7080,6769,311,4.4
CN2816100000000,2022-09-01,28,161,MS,Yalobusha County,4735,4543,192,4.1
CN2816300000000,2022-09-01,28,163,MS,Yazoo County,8790,8393,397,4.5
CN2900100000000,2022-09-01,29,001,MO,Adair County,9786,9561,225,2.3
CN2900300000000,2022-09-01,29,003,MO,Andrew County,9325,9180,145,1.6
CN2900500000000,2022-09-01,29,005,MO,Atchison County,2551,2507,44,1.7
CN2900700000000,2022-09-01,29,007,MO,Audrain County,9897,9648,249,2.5
CN2900900000000,2022-09-01,29,009,MO,Barry County,14151,13864,287,2
CN2901100000000,2022-09-01,29,011,MO,Barton County,5208,5112,96,1.8
CN2901300000000,2022-09-01,29,013,MO,Bates County,7618,7472,146,1.9
CN2901500000000,2022-09-01,29,015,MO,Benton County,7211,7015,196,2.7
CN2901700000000,2022-09-01,29,017,MO,Bollinger County,5298,5187,111,2.1
CN2901900000000,2022-09-01,29,019,MO,Boone County,100313,98745,1568,1.6
CN2902100000000,2022-09-01,29,021,MO,Buchanan County,41843,41056,787,1.9
CN2902300000000,2022-09-01,29,023,MO,Butler County,17798,17416,382,2.1
CN2902500000000,2022-09-01,29,025,MO,Caldwell County,4234,4154,80,1.9
CN2902700000000,2022-09-01,29,027,MO,Callaway County,21571,21197,374,1.7
CN2902900000000,2022-09-01,29,029,MO,Camden County,19152,18731,421,2.2
CN2903100000000,2022-09-01,29,031,MO,Cape Girardeau County,40536,39818,718,1.8
CN2903300000000,2022-09-01,29,033,MO,Carroll County,4445,4363,82,1.8
CN2903500000000,2022-09-01,29,035,MO,Carter County,2450,2396,54,2.2
CN2903700000000,2022-09-01,29,037,MO,Cass County,54935,53906,1029,1.9
CN2903900000000,2022-09-01,29,039,MO,Cedar County,5642,5522,120,2.1
CN2904100000000,2022-09-01,29,041,MO,Chariton County,3697,3642,55,1.5
CN2904300000000,2022-09-01,29,043,MO,Christian County,47461,46715,746,1.6
CN2904500000000,2022-09-01,29,045,MO,Clark County,3009,2927,82,2.7
CN2904700000000,2022-09-01,29,047,MO,Clay County,138650,136075,2575,1.9
CN2904900000000,2022-09-01,29,049,MO,Clinton County,10596,10398,198,1.9
CN2905100000000,2022-09-01,29,051,MO,Cole County,39163,38571,592,1.5
CN2905300000000,2022-09-01,29,053,MO,Cooper County,7101,6974,127,1.8
CN2905500000000,2022-09-01,29,055,MO,Crawford County,10755,10533,222,2.1
CN2905700000000,2022-09-01,29,057,MO,Dade County,3479,3421,58,1.7
CN2905900000000,2022-09-01,29,059,MO,Dallas County,7228,7079,149,2.1
CN2906100000000,2022-09-01,29,061,MO,Daviess County,4002,3929,73,1.8
CN2906300000000,2022-09-01,29,063,MO,DeKalb County,4019,3934,85,2.1
CN2906500000000,2022-09-01,29,065,MO,Dent County,6047,5896,151,2.5
CN2906700000000,2022-09-01,29,067,MO,Douglas County,5184,5081,103,2
CN2906900000000,2022-09-01,29,069,MO,Dunklin County,11060,10715,345,3.1
CN2907100000000,2022-09-01,29,071,MO,Franklin County,52872,51947,925,1.7
CN2907300000000,2022-09-01,29,073,MO,Gasconade County,7645,7514,131,1.7
CN2907500000000,2022-09-01,29,075,MO,Gentry County,3163,3115,48,1.5
CN2907700000000,2022-09-01,29,077,MO,Greene County,155558,152983,2575,1.7
CN2907900000000,2022-09-01,29,079,MO,Grundy County,4013,3926,87,2.2
CN2908100000000,2022-09-01,29,081,MO,Harrison County,3656,3590,66,1.8
CN2908300000000,2022-09-01,29,083,MO,Henry County,10246,10049,197,1.9
CN2908500000000,2022-09-01,29,085,MO,Hickory County,4084,4007,77,1.9
CN2908700000000,2022-09-01,29,087,MO,Holt County,2423,2390,33,1.4
CN2908900000000,2022-09-01,29,089,MO,Howard County,4687,4601,86,1.8
CN2909100000000,2022-09-01,29,091,MO,Howell County,15818,15430,388,2.5
CN2909300000000,2022-09-01,29,093,MO,Iron County,3458,3350,108,3.1
CN2909500000000,2022-09-01,29,095,MO,Jackson County,359735,351482,8253,2.3
CN2909700000000,2022-09-01,29,097,MO,Jasper County,56547,55453,1094,1.9
CN2909900000000,2022-09-01,29,099,MO,Jefferson County,117868,115732,2136,1.8
CN2910100000000,2022-09-01,29,101,MO,Johnson County,22758,22302,456,2
CN2910300000000,2022-09-01,29,103,MO,Knox County,1688,1655,33,2
CN2910500000000,2022-09-01,29,105,MO,Laclede County,16713,16385,328,2
CN2910700000000,2022-09-01,29,107,MO,Lafayette County,16767,16434,333,2
CN2910900000000,2022-09-01,29,109,MO,Lawrence County,17095,16778,317,1.9
CN2911100000000,2022-09-01,29,111,MO,Lewis County,4733,4644,89,1.9
CN2911300000000,2022-09-01,29,113,MO,Lincoln County,29216,28673,543,1.9
CN2911500000000,2022-09-01,29,115,MO,Linn County,5090,4976,114,2.2
CN2911700000000,2022-09-01,29,117,MO,Livingston County,7222,7118,104,1.4
CN2911900000000,2022-09-01,29,119,MO,McDonald County,11172,10965,207,1.9
CN2912100000000,2022-09-01,29,121,MO,Macon County,7059,6929,130,1.8
CN2912300000000,2022-09-01,29,123,MO,Madison County,5379,5259,120,2.2
CN2912500000000,2022-09-01,29,125,MO,Maries County,3807,3734,73,1.9
CN2912700000000,2022-09-01,29,127,MO,Marion County,13722,13467,255,1.9
CN2912900000000,2022-09-01,29,129,MO,Mercer County,1706,1673,33,1.9
CN2913100000000,2022-09-01,29,131,MO,Miller County,12840,12611,229,1.8
CN2913300000000,2022-09-01,29,133,MO,Mississippi County,5185,5050,135,2.6
CN2913500000000,2022-09-01,29,135,MO,Moniteau County,7082,6972,110,1.6
CN2913700000000,2022-09-01,29,137,MO,Monroe County,3769,3693,76,2
CN2913900000000,2022-09-01,29,139,MO,Montgomery County,5867,5762,105,1.8
CN2914100000000,2022-09-01,29,141,MO,Morgan County,8354,8170,184,2.2
CN2914300000000,2022-09-01,29,143,MO,New Madrid County,8117,7927,190,2.3
CN2914500000000,2022-09-01,29,145,MO,Newton County,26788,26263,525,2
CN2914700000000,2022-09-01,29,147,MO,Nodaway County,11161,10975,186,1.7
CN2914900000000,2022-09-01,29,149,MO,Oregon County,3756,3665,91,2.4
CN2915100000000,2022-09-01,29,151,MO,Osage County,7049,6947,102,1.4
CN2915300000000,2022-09-01,29,153,MO,Ozark County,3458,3360,98,2.8
CN2915500000000,2022-09-01,29,155,MO,Pemiscot County,5757,5590,167,2.9
CN2915700000000,2022-09-01,29,157,MO,Perry County,9439,9283,156,1.7
CN2915900000000,2022-09-01,29,159,MO,Pettis County,20087,19693,394,2
CN2916100000000,2022-09-01,29,161,MO,Phelps County,19979,19603,376,1.9
CN2916300000000,2022-09-01,29,163,MO,Pike County,7203,7078,125,1.7
CN2916500000000,2022-09-01,29,165,MO,Platte County,60055,59016,1039,1.7
CN2916700000000,2022-09-01,29,167,MO,Polk County,14734,14423,311,2.1
CN2916900000000,2022-09-01,29,169,MO,Pulaski County,14621,14283,338,2.3
CN2917100000000,2022-09-01,29,171,MO,Putnam County,2133,2094,39,1.8
CN2917300000000,2022-09-01,29,173,MO,Ralls County,5404,5308,96,1.8
CN2917500000000,2022-09-01,29,175,MO,Randolph County,10221,10013,208,2
CN2917700000000,2022-09-01,29,177,MO,Ray County,10818,10594,224,2.1
CN2917900000000,2022-09-01,29,179,MO,Reynolds County,2806,2737,69,2.5
CN2918100000000,2022-09-01,29,181,MO,Ripley County,5086,4965,121,2.4
CN2918300000000,2022-09-01,29,183,MO,St. Charles County,229467,225784,3683,1.6
CN2918500000000,2022-09-01,29,185,MO,St. Clair County,3815,3732,83,2.2
CN2918600000000,2022-09-01,29,186,MO,Ste. Genevieve County,9336,9176,160,1.7
CN2918700000000,2022-09-01,29,187,MO,St. Francois County,25515,24826,689,2.7
CN2918900000000,2022-09-01,29,189,MO,St. Louis County,526250,516011,10239,1.9
CN2919500000000,2022-09-01,29,195,MO,Saline County,10412,10212,200,1.9
CN2919700000000,2022-09-01,29,197,MO,Schuyler County,1785,1754,31,1.7
CN2919900000000,2022-09-01,29,199,MO,Scotland County,2246,2208,38,1.7
CN2920100000000,2022-09-01,29,201,MO,Scott County,20028,19659,369,1.8
CN2920300000000,2022-09-01,29,203,MO,Shannon County,3258,3176,82,2.5
CN2920500000000,2022-09-01,29,205,MO,Shelby County,2960,2916,44,1.5
CN2920700000000,2022-09-01,29,207,MO,Stoddard County,12958,12671,287,2.2
CN2920900000000,2022-09-01,29,209,MO,Stone County,13351,13019,332,2.5
CN2921100000000,2022-09-01,29,211,MO,Sullivan County,2550,2501,49,1.9
CN2921300000000,2022-09-01,29,213,MO,Taney County,25673,25046,627,2.4
CN2921500000000,2022-09-01,29,215,MO,Texas County,9020,8806,214,2.4
CN2921700000000,2022-09-01,29,217,MO,Vernon County,9248,9063,185,2
CN2921900000000,2022-09-01,29,219,MO,Warren County,18753,18398,355,1.9
CN2922100000000,2022-09-01,29,221,MO,Washington County,10010,9771,239,2.4
CN2922300000000,2022-09-01,29,223,MO,Wayne County,4713,4584,129,2.7
CN2922500000000,2022-09-01,29,225,MO,Webster County,17655,17353,302,1.7
CN2922700000000,2022-09-01,29,227,MO,Worth County,1150,1133,17,1.5
CN2922900000000,2022-09-01,29,229,MO,Wright County,7555,7388,167,2.2
CN2951000000000,2022-09-01,29,510,MO,St. Louis city,148554,144894,3660,2.5
CN3000100000000,2022-09-01,30,001,MT,Beaverhead County,5605,5516,89,1.6
CN3000300000000,2022-09-01,30,003,MT,Big Horn County,4658,4500,158,3.4
CN3000500000000,2022-09-01,30,005,MT,Blaine County,2161,2107,54,2.5
CN3000700000000,2022-09-01,30,007,MT,Broadwater County,2817,2741,76,2.7
CN3000900000000,2022-09-01,30,009,MT,Carbon County,5760,5642,118,2
CN3001100000000,2022-09-01,30,011,MT,Carter County,645,633,12,1.9
CN3001300000000,2022-09-01,30,013,MT,Cascade County,39482,38658,824,2.1
CN3001500000000,2022-09-01,30,015,MT,Chouteau County,2437,2386,51,2.1
CN3001700000000,2022-09-01,30,017,MT,Custer County,6359,6247,112,1.8
CN3001900000000,2022-09-01,30,019,MT,Daniels County,833,818,15,1.8
CN3002100000000,2022-09-01,30,021,MT,Dawson County,4484,4405,79,1.8
CN3002300000000,2022-09-01,30,023,MT,Deer Lodge County,5498,5405,93,1.7
CN3002500000000,2022-09-01,30,025,MT,Fallon County,1622,1601,21,1.3
CN3002700000000,2022-09-01,30,027,MT,Fergus County,5895,5789,106,1.8
CN3002900000000,2022-09-01,30,029,MT,Flathead County,53434,52297,1137,2.1
CN3003100000000,2022-09-01,30,031,MT,Gallatin County,78875,77683,1192,1.5
CN3003300000000,2022-09-01,30,033,MT,Garfield County,720,707,13,1.8
CN3003500000000,2022-09-01,30,035,MT,Glacier County,5886,5686,200,3.4
CN3003700000000,2022-09-01,30,037,MT,Golden Valley County,364,357,7,1.9
CN3003900000000,2022-09-01,30,039,MT,Granite County,1633,1593,40,2.4
CN3004100000000,2022-09-01,30,041,MT,Hill County,7609,7459,150,2
CN3004300000000,2022-09-01,30,043,MT,Jefferson County,6149,6029,120,2
CN3004500000000,2022-09-01,30,045,MT,Judith Basin County,967,945,22,2.3
CN3004700000000,2022-09-01,30,047,MT,Lake County,14559,14227,332,2.3
CN3004900000000,2022-09-01,30,049,MT,Lewis and Clark County,39151,38435,716,1.8
CN3005100000000,2022-09-01,30,051,MT,Liberty County,926,904,22,2.4
CN3005300000000,2022-09-01,30,053,MT,Lincoln County,8707,8442,265,3
CN3005500000000,2022-09-01,30,055,MT,McCone County,938,922,16,1.7
CN3005700000000,2022-09-01,30,057,MT,Madison County,4737,4648,89,1.9
CN3005900000000,2022-09-01,30,059,MT,Meagher County,959,942,17,1.8
CN3006100000000,2022-09-01,30,061,MT,Mineral County,1914,1850,64,3.3
CN3006300000000,2022-09-01,30,063,MT,Missoula County,67496,66190,1306,1.9
CN3006500000000,2022-09-01,30,065,MT,Musselshell County,2345,2289,56,2.4
CN3006700000000,2022-09-01,30,067,MT,Park County,10270,10061,209,2
CN3006900000000,2022-09-01,30,069,MT,Petroleum County,259,252,7,2.7
CN3007100000000,2022-09-01,30,071,MT,Phillips County,1772,1727,45,2.5
CN3007300000000,2022-09-01,30,073,MT,Pondera County,2557,2507,50,2
CN3007500000000,2022-09-01,30,075,MT,Powder River County,982,965,17,1.7
CN3007700000000,2022-09-01,30,077,MT,Powell County,2969,2910,59,2
CN3007900000000,2022-09-01,30,079,MT,Prairie County,474,465,9,1.9
CN3008100000000,2022-09-01,30,081,MT,Ravalli County,22090,21633,457,2.1
CN3008300000000,2022-09-01,30,083,MT,Richland County,5822,5693,129,2.2
CN3008500000000,2022-09-01,30,085,MT,Roosevelt County,4351,4237,114,2.6
CN3008700000000,2022-09-01,30,087,MT,Rosebud County,3544,3454,90,2.5
CN3008900000000,2022-09-01,30,089,MT,Sanders County,5479,5325,154,2.8
CN3009100000000,2022-09-01,30,091,MT,Sheridan County,1747,1718,29,1.7
CN3009300000000,2022-09-01,30,093,MT,Silver Bow County,17889,17502,387,2.2
CN3009500000000,2022-09-01,30,095,MT,Stillwater County,5407,5307,100,1.8
CN3009700000000,2022-09-01,30,097,MT,Sweet Grass County,1880,1847,33,1.8
CN3009900000000,2022-09-01,30,099,MT,Teton County,2765,2709,56,2
CN3010100000000,2022-09-01,30,101,MT,Toole County,2117,2082,35,1.7
CN3010300000000,2022-09-01,30,103,MT,Treasure County,346,340,6,1.7
CN3010500000000,2022-09-01,30,105,MT,Valley County,3981,3911,70,1.8
CN3010700000000,2022-09-01,30,107,MT,Wheatland County,713,693,20,2.8
CN3010900000000,2022-09-01,30,109,MT,Wibaux County,430,421,9,2.1
CN3011100000000,2022-09-01,30,111,MT,Yellowstone County,87088,85406,1682,1.9
CN3100100000000,2022-09-01,31,001,NE,Adams County,17278,16946,332,1.9
CN3100300000000,2022-09-01,31,003,NE,Antelope County,3615,3551,64,1.8
CN3100500000000,2022-09-01,31,005,NE,Arthur County,226,221,5,2.2
CN3100700000000,2022-09-01,31,007,NE,Banner County,373,359,14,3.8
CN3100900000000,2022-09-01,31,009,NE,Blaine County,231,222,9,3.9
CN3101100000000,2022-09-01,31,011,NE,Boone County,2948,2895,53,1.8
CN3101300000000,2022-09-01,31,013,NE,Box Butte County,5286,5171,115,2.2
CN3101500000000,2022-09-01,31,015,NE,Boyd County,1006,981,25,2.5
CN3101700000000,2022-09-01,31,017,NE,Brown County,1405,1373,32,2.3
CN3101900000000,2022-09-01,31,019,NE,Buffalo County,28541,27983,558,2
CN3102100000000,2022-09-01,31,021,NE,Burt County,3479,3405,74,2.1
CN3102300000000,2022-09-01,31,023,NE,Butler County,4646,4563,83,1.8
CN3102500000000,2022-09-01,31,025,NE,Cass County,13690,13379,311,2.3
CN3102700000000,2022-09-01,31,027,NE,Cedar County,4631,4550,81,1.7
CN3102900000000,2022-09-01,31,029,NE,Chase County,2215,2174,41,1.9
CN3103100000000,2022-09-01,31,031,NE,Cherry County,3338,3276,62,1.9
CN3103300000000,2022-09-01,31,033,NE,Cheyenne County,4225,4130,95,2.2
CN3103500000000,2022-09-01,31,035,NE,Clay County,3068,3004,64,2.1
CN3103700000000,2022-09-01,31,037,NE,Colfax County,5737,5635,102,1.8
CN3103900000000,2022-09-01,31,039,NE,Cuming County,4811,4721,90,1.9
CN3104100000000,2022-09-01,31,041,NE,Custer County,6192,6095,97,1.6
CN3104300000000,2022-09-01,31,043,NE,Dakota County,11003,10763,240,2.2
CN3104500000000,2022-09-01,31,045,NE,Dawes County,4954,4862,92,1.9
CN3104700000000,2022-09-01,31,047,NE,Dawson County,13589,13278,311,2.3
CN3104900000000,2022-09-01,31,049,NE,Deuel County,1028,1003,25,2.4
CN3105100000000,2022-09-01,31,051,NE,Dixon County,3009,2954,55,1.8
CN3105300000000,2022-09-01,31,053,NE,Dodge County,20710,20298,412,2
CN3105500000000,2022-09-01,31,055,NE,Douglas County,306810,299132,7678,2.5
CN3105700000000,2022-09-01,31,057,NE,Dundy County,1153,1134,19,1.6
CN3105900000000,2022-09-01,31,059,NE,Fillmore County,3307,3245,62,1.9
CN3106100000000,2022-09-01,31,061,NE,Franklin County,1538,1503,35,2.3
CN3106300000000,2022-09-01,31,063,NE,Frontier County,1500,1472,28,1.9
CN3106500000000,2022-09-01,31,065,NE,Furnas County,2482,2434,48,1.9
CN3106700000000,2022-09-01,31,067,NE,Gage County,10739,10495,244,2.3
CN3106900000000,2022-09-01,31,069,NE,Garden County,1099,1076,23,2.1
CN3107100000000,2022-09-01,31,071,NE,Garfield County,1134,1111,23,2
CN3107300000000,2022-09-01,31,073,NE,Gosper County,1235,1208,27,2.2
CN3107500000000,2022-09-01,31,075,NE,Grant County,409,402,7,1.7
CN3107700000000,2022-09-01,31,077,NE,Greeley County,1213,1188,25,2.1
CN3107900000000,2022-09-01,31,079,NE,Hall County,32841,32134,707,2.2
CN3108100000000,2022-09-01,31,081,NE,Hamilton County,4894,4799,95,1.9
CN3108300000000,2022-09-01,31,083,NE,Harlan County,1839,1805,34,1.8
CN3108500000000,2022-09-01,31,085,NE,Hayes County,580,571,9,1.6
CN3108700000000,2022-09-01,31,087,NE,Hitchcock County,1277,1249,28,2.2
CN3108900000000,2022-09-01,31,089,NE,Holt County,5540,5427,113,2
CN3109100000000,2022-09-01,31,091,NE,Hooker County,428,417,11,2.6
CN3109300000000,2022-09-01,31,093,NE,Howard County,3462,3397,65,1.9
CN3109500000000,2022-09-01,31,095,NE,Jefferson County,4146,4066,80,1.9
CN3109700000000,2022-09-01,31,097,NE,Johnson County,2031,1978,53,2.6
CN3109900000000,2022-09-01,31,099,NE,Kearney County,3715,3644,71,1.9
CN3110100000000,2022-09-01,31,101,NE,Keith County,4710,4632,78,1.7
CN3110300000000,2022-09-01,31,103,NE,Keya Paha County,511,499,12,2.3
CN3110500000000,2022-09-01,31,105,NE,Kimball County,1952,1915,37,1.9
CN3110700000000,2022-09-01,31,107,NE,Knox County,4574,4482,92,2
CN3110900000000,2022-09-01,31,109,NE,Lancaster County,180760,177007,3753,2.1
CN3111100000000,2022-09-01,31,111,NE,Lincoln County,18376,17989,387,2.1
CN3111300000000,2022-09-01,31,113,NE,Logan County,474,465,9,1.9
CN3111500000000,2022-09-01,31,115,NE,Loup County,394,383,11,2.8
CN3111700000000,2022-09-01,31,117,NE,McPherson County,424,417,7,1.7
CN3111900000000,2022-09-01,31,119,NE,Madison County,19957,19575,382,1.9
CN3112100000000,2022-09-01,31,121,NE,Merrick County,4172,4087,85,2
CN3112300000000,2022-09-01,31,123,NE,Morrill County,2593,2545,48,1.9
CN3112500000000,2022-09-01,31,125,NE,Nance County,1918,1879,39,2
CN3112700000000,2022-09-01,31,127,NE,Nemaha County,3639,3552,87,2.4
CN3112900000000,2022-09-01,31,129,NE,Nuckolls County,2465,2417,48,1.9
CN3113100000000,2022-09-01,31,131,NE,Otoe County,8607,8430,177,2.1
CN3113300000000,2022-09-01,31,133,NE,Pawnee County,1475,1443,32,2.2
CN3113500000000,2022-09-01,31,135,NE,Perkins County,1800,1770,30,1.7
CN3113700000000,2022-09-01,31,137,NE,Phelps County,4985,4891,94,1.9
CN3113900000000,2022-09-01,31,139,NE,Pierce County,4180,4106,74,1.8
CN3114100000000,2022-09-01,31,141,NE,Platte County,18542,18199,343,1.8
CN3114300000000,2022-09-01,31,143,NE,Polk County,2816,2759,57,2
CN3114500000000,2022-09-01,31,145,NE,Red Willow County,5913,5800,113,1.9
CN3114700000000,2022-09-01,31,147,NE,Richardson County,4149,4062,87,2.1
CN3114900000000,2022-09-01,31,149,NE,Rock County,875,863,12,1.4
CN3115100000000,2022-09-01,31,151,NE,Saline County,7158,7001,157,2.2
CN3115300000000,2022-09-01,31,153,NE,Sarpy County,99940,97804,2136,2.1
CN3115500000000,2022-09-01,31,155,NE,Saunders County,11597,11369,228,2
CN3115700000000,2022-09-01,31,157,NE,Scotts Bluff County,18019,17590,429,2.4
CN3115900000000,2022-09-01,31,159,NE,Seward County,8887,8709,178,2
CN3116100000000,2022-09-01,31,161,NE,Sheridan County,2753,2700,53,1.9
CN3116300000000,2022-09-01,31,163,NE,Sherman County,1635,1603,32,2
CN3116500000000,2022-09-01,31,165,NE,Sioux County,748,734,14,1.9
CN3116700000000,2022-09-01,31,167,NE,Stanton County,3541,3474,67,1.9
CN3116900000000,2022-09-01,31,169,NE,Thayer County,2652,2601,51,1.9
CN3117100000000,2022-09-01,31,171,NE,Thomas County,448,437,11,2.5
CN3117300000000,2022-09-01,31,173,NE,Thurston County,3203,3102,101,3.2
CN3117500000000,2022-09-01,31,175,NE,Valley County,2086,2045,41,2
CN3117700000000,2022-09-01,31,177,NE,Washington County,11470,11246,224,2
CN3117900000000,2022-09-01,31,179,NE,Wayne County,5718,5610,108,1.9
CN3118100000000,2022-09-01,31,181,NE,Webster County,1654,1612,42,2.5
CN3118300000000,2022-09-01,31,183,NE,Wheeler County,531,522,9,1.7
CN3118500000000,2022-09-01,31,185,NE,York County,7436,7291,145,1.9
CN3200100000000,2022-09-01,32,001,NV,Churchill County,10590,10179,411,3.9
CN3200300000000,2022-09-01,32,003,NV,Clark County,1162280,1094679,67601,5.8
CN3200500000000,2022-09-01,32,005,NV,Douglas County,22354,21486,868,3.9
CN3200700000000,2022-09-01,32,007,NV,Elko County,25515,24663,852,3.3
CN3200900000000,2022-09-01,32,009,NV,Esmeralda County,382,367,15,3.9
CN3201100000000,2022-09-01,32,011,NV,Eureka County,882,853,29,3.3
CN3201300000000,2022-09-01,32,013,NV,Humboldt County,7428,7163,265,3.6
CN3201500000000,2022-09-01,32,015,NV,Lander County,2946,2856,90,3.1
CN3201700000000,2022-09-01,32,017,NV,Lincoln County,1943,1860,83,4.3
CN3201900000000,2022-09-01,32,019,NV,Lyon County,23453,22297,1156,4.9
CN3202100000000,2022-09-01,32,021,NV,Mineral County,1971,1888,83,4.2
CN3202300000000,2022-09-01,32,023,NV,Nye County,17343,16311,1032,6
CN3202700000000,2022-09-01,32,027,NV,Pershing County,2284,2196,88,3.9
CN3202900000000,2022-09-01,32,029,NV,Storey County,2127,2042,85,4
CN3203100000000,2022-09-01,32,031,NV,Washoe County,260012,251175,8837,3.4
CN3203300000000,2022-09-01,32,033,NV,White Pine County,4469,4345,124,2.8
CN3251000000000,2022-09-01,32,510,NV,Carson City,25430,24465,965,3.8
CN3300100000000,2022-09-01,33,001,NH,Belknap County,31754,30941,813,2.6
CN3300300000000,2022-09-01,33,003,NH,Carroll County,23458,22827,631,2.7
CN3300500000000,2022-09-01,33,005,NH,Cheshire County,39126,38054,1072,2.7
CN3300700000000,2022-09-01,33,007,NH,Coos County,14570,14071,499,3.4
CN3300900000000,2022-09-01,33,009,NH,Grafton County,49157,47951,1206,2.5
CN3301100000000,2022-09-01,33,011,NH,Hillsborough County,240901,234585,6316,2.6
CN3301300000000,2022-09-01,33,013,NH,Merrimack County,82489,80494,1995,2.4
CN3301500000000,2022-09-01,33,015,NH,Rockingham County,188720,183811,4909,2.6
CN3301700000000,2022-09-01,33,017,NH,Strafford County,74470,72635,1835,2.5
CN3301900000000,2022-09-01,33,019,NH,Sullivan County,22854,22288,566,2.5
CN3400100000000,2022-09-01,34,001,NJ,Atlantic County,124241,119707,4534,3.6
CN3400300000000,2022-09-01,34,003,NJ,Bergen County,503910,491298,12612,2.5
CN3400500000000,2022-09-01,34,005,NJ,Burlington County,248329,241956,6373,2.6
CN3400700000000,2022-09-01,34,007,NJ,Camden County,270372,262009,8363,3.1
CN3400900000000,2022-09-01,34,009,NJ,Cape May County,49926,48298,1628,3.3
CN3401100000000,2022-09-01,34,011,NJ,Cumberland County,69907,67372,2535,3.6
CN3401300000000,2022-09-01,34,013,NJ,Essex County,387203,373661,13542,3.5
CN3401500000000,2022-09-01,34,015,NJ,Gloucester County,161239,156760,4479,2.8
CN3401700000000,2022-09-01,34,017,NJ,Hudson County,376733,366171,10562,2.8
CN3401900000000,2022-09-01,34,019,NJ,Hunterdon County,68457,66994,1463,2.1
CN3402100000000,2022-09-01,34,021,NJ,Mercer County,216372,211086,5286,2.4
CN3402300000000,2022-09-01,34,023,NJ,Middlesex County,461958,450321,11637,2.5
CN3402500000000,2022-09-01,34,025,NJ,Monmouth County,348203,339820,8383,2.4
CN3402700000000,2022-09-01,34,027,NJ,Morris County,268872,262832,6040,2.2
CN3402900000000,2022-09-01,34,029,NJ,Ocean County,297983,290029,7954,2.7
CN3403100000000,2022-09-01,34,031,NJ,Passaic County,251698,243141,8557,3.4
CN3403300000000,2022-09-01,34,033,NJ,Salem County,30838,29777,1061,3.4
CN3403500000000,2022-09-01,34,035,NJ,Somerset County,179305,175134,4171,2.3
CN3403700000000,2022-09-01,34,037,NJ,Sussex County,77658,75625,2033,2.6
CN3403900000000,2022-09-01,34,039,NJ,Union County,288649,280254,8395,2.9
CN3404100000000,2022-09-01,34,041,NJ,Warren County,59197,57750,1447,2.4
CN3500100000000,2022-09-01,35,001,NM,Bernalillo County,335379,325102,10277,3.1
CN3500300000000,2022-09-01,35,003,NM,Catron County,1202,1149,53,4.4
CN3500500000000,2022-09-01,35,005,NM,Chaves County,27611,26605,1006,3.6
CN3500600000000,2022-09-01,35,006,NM,Cibola County,8054,7683,371,4.6
CN3500700000000,2022-09-01,35,007,NM,Colfax County,5233,5061,172,3.3
CN3500900000000,2022-09-01,35,009,NM,Curry County,22106,21477,629,2.8
CN3501100000000,2022-09-01,35,011,NM,De Baca County,731,710,21,2.9
CN3501300000000,2022-09-01,35,013,NM,Dona Ana County,100135,96489,3646,3.6
CN3501500000000,2022-09-01,35,015,NM,Eddy County,31234,30384,850,2.7
CN3501700000000,2022-09-01,35,017,NM,Grant County,11658,11266,392,3.4
CN3501900000000,2022-09-01,35,019,NM,Guadalupe County,1435,1368,67,4.7
CN3502100000000,2022-09-01,35,021,NM,Harding County,286,278,8,2.8
CN3502300000000,2022-09-01,35,023,NM,Hidalgo County,1841,1790,51,2.8
CN3502500000000,2022-09-01,35,025,NM,Lea County,29136,28077,1059,3.6
CN3502700000000,2022-09-01,35,027,NM,Lincoln County,8973,8691,282,3.1
CN3502800000000,2022-09-01,35,028,NM,Los Alamos County,10829,10622,207,1.9
CN3502900000000,2022-09-01,35,029,NM,Luna County,9837,9184,653,6.6
CN3503100000000,2022-09-01,35,031,NM,McKinley County,22962,21891,1071,4.7
CN3503300000000,2022-09-01,35,033,NM,Mora County,1961,1872,89,4.5
CN3503500000000,2022-09-01,35,035,NM,Otero County,24962,24053,909,3.6
CN3503700000000,2022-09-01,35,037,NM,Quay County,2965,2857,108,3.6
CN3503900000000,2022-09-01,35,039,NM,Rio Arriba County,16561,15970,591,3.6
CN3504100000000,2022-09-01,35,041,NM,Roosevelt County,7878,7600,278,3.5
CN3504300000000,2022-09-01,35,043,NM,Sandoval County,67763,65572,2191,3.2
CN3504500000000,2022-09-01,35,045,NM,San Juan County,50033,48161,1872,3.7
CN3504700000000,2022-09-01,35,047,NM,San Miguel County,10329,9875,454,4.4
CN3504900000000,2022-09-01,35,049,NM,Santa Fe County,71741,69591,2150,3
CN3505100000000,2022-09-01,35,051,NM,Sierra County,3867,3686,181,4.7
CN3505300000000,2022-09-01,35,053,NM,Socorro County,6108,5879,229,3.7
CN3505500000000,2022-09-01,35,055,NM,Taos County,14568,13996,572,3.9
CN3505700000000,2022-09-01,35,057,NM,Torrance County,5412,5167,245,4.5
CN3505900000000,2022-09-01,35,059,NM,Union County,1563,1525,38,2.4
CN3506100000000,2022-09-01,35,061,NM,Valencia County,30909,29759,1150,3.7
CN3600100000000,2022-09-01,36,001,NY,Albany County,160237,155741,4496,2.8
CN3600300000000,2022-09-01,36,003,NY,Allegany County,19368,18733,635,3.3
CN3600500000000,2022-09-01,36,005,NY,Bronx County,596296,559808,36488,6.1
CN3600700000000,2022-09-01,36,007,NY,Broome County,82136,79447,2689,3.3
CN3600900000000,2022-09-01,36,009,NY,Cattaraugus County,32989,31874,1115,3.4
CN3601100000000,2022-09-01,36,011,NY,Cayuga County,36082,35050,1032,2.9
CN3601300000000,2022-09-01,36,013,NY,Chautauqua County,54245,52464,1781,3.3
CN3601500000000,2022-09-01,36,015,NY,Chemung County,34771,33604,1167,3.4
CN3601700000000,2022-09-01,36,017,NY,Chenango County,21982,21389,593,2.7
CN3601900000000,2022-09-01,36,019,NY,Clinton County,35891,34825,1066,3
CN3602100000000,2022-09-01,36,021,NY,Columbia County,31051,30314,737,2.4
CN3602300000000,2022-09-01,36,023,NY,Cortland County,22927,22236,691,3
CN3602500000000,2022-09-01,36,025,NY,Delaware County,18734,18142,592,3.2
CN3602700000000,2022-09-01,36,027,NY,Dutchess County,145052,140963,4089,2.8
CN3602900000000,2022-09-01,36,029,NY,Erie County,446546,432292,14254,3.2
CN3603100000000,2022-09-01,36,031,NY,Essex County,16796,16338,458,2.7
CN3603300000000,2022-09-01,36,033,NY,Franklin County,19276,18707,569,3
CN3603500000000,2022-09-01,36,035,NY,Fulton County,22642,21878,764,3.4
CN3603700000000,2022-09-01,36,037,NY,Genesee County,30170,29407,763,2.5
CN3603900000000,2022-09-01,36,039,NY,Greene County,20310,19677,633,3.1
CN3604100000000,2022-09-01,36,041,NY,Hamilton County,2287,2225,62,2.7
CN3604300000000,2022-09-01,36,043,NY,Herkimer County,27281,26429,852,3.1
CN3604500000000,2022-09-01,36,045,NY,Jefferson County,44344,42894,1450,3.3
CN3604700000000,2022-09-01,36,047,NY,Kings County,1199672,1142951,56721,4.7
CN3604900000000,2022-09-01,36,049,NY,Lewis County,11847,11513,334,2.8
CN3605100000000,2022-09-01,36,051,NY,Livingston County,30467,29614,853,2.8
CN3605300000000,2022-09-01,36,053,NY,Madison County,33136,32211,925,2.8
CN3605500000000,2022-09-01,36,055,NY,Monroe County,366258,354683,11575,3.2
CN3605700000000,2022-09-01,36,057,NY,Montgomery County,22581,21791,790,3.5
CN3605900000000,2022-09-01,36,059,NY,Nassau County,730924,711572,19352,2.6
CN3606100000000,2022-09-01,36,061,NY,New York County,914959,880627,34332,3.8
CN3606300000000,2022-09-01,36,063,NY,Niagara County,98433,95274,3159,3.2
CN3606500000000,2022-09-01,36,065,NY,Oneida County,100215,97013,3202,3.2
CN3606700000000,2022-09-01,36,067,NY,Onondaga County,225841,219087,6754,3
CN3606900000000,2022-09-01,36,069,NY,Ontario County,56017,54569,1448,2.6
CN3607100000000,2022-09-01,36,071,NY,Orange County,191008,185437,5571,2.9
CN3607300000000,2022-09-01,36,073,NY,Orleans County,17299,16759,540,3.1
CN3607500000000,2022-09-01,36,075,NY,Oswego County,53136,51312,1824,3.4
CN3607700000000,2022-09-01,36,077,NY,Otsego County,27069,26281,788,2.9
CN3607900000000,2022-09-01,36,079,NY,Putnam County,51433,50042,1391,2.7
CN3608100000000,2022-09-01,36,081,NY,Queens County,1132904,1086744,46160,4.1
CN3608300000000,2022-09-01,36,083,NY,Rensselaer County,82604,80292,2312,2.8
CN3608500000000,2022-09-01,36,085,NY,Richmond County,225894,216022,9872,4.4
CN3608700000000,2022-09-01,36,087,NY,Rockland County,159280,155140,4140,2.6
CN3608900000000,2022-09-01,36,089,NY,St. Lawrence County,43513,42053,1460,3.4
CN3609100000000,2022-09-01,36,091,NY,Saratoga County,122153,119232,2921,2.4
CN3609300000000,2022-09-01,36,093,NY,Schenectady County,78283,75903,2380,3
CN3609500000000,2022-09-01,36,095,NY,Schoharie County,14823,14395,428,2.9
CN3609700000000,2022-09-01,36,097,NY,Schuyler County,8249,8029,220,2.7
CN3609900000000,2022-09-01,36,099,NY,Seneca County,15002,14603,399,2.7
CN3610100000000,2022-09-01,36,101,NY,Steuben County,41506,40259,1247,3
CN3610300000000,2022-09-01,36,103,NY,Suffolk County,802358,780031,22327,2.8
CN3610500000000,2022-09-01,36,105,NY,Sullivan County,37730,36655,1075,2.8
CN3610700000000,2022-09-01,36,107,NY,Tioga County,22259,21662,597,2.7
CN3610900000000,2022-09-01,36,109,NY,Tompkins County,50468,49147,1321,2.6
CN3611100000000,2022-09-01,36,111,NY,Ulster County,87831,85390,2441,2.8
CN3611300000000,2022-09-01,36,113,NY,Warren County,31318,30482,836,2.7
CN3611500000000,2022-09-01,36,115,NY,Washington County,27746,27019,727,2.6
CN3611700000000,2022-09-01,36,117,NY,Wayne County,43768,42569,1199,2.7
CN3611900000000,2022-09-01,36,119,NY,Westchester County,495592,481351,14241,2.9
CN3612100000000,2022-09-01,36,121,NY,Wyoming County,17783,17325,458,2.6
CN3612300000000,2022-09-01,36,123,NY,Yates County,11774,11487,287,2.4
CN3700100000000,2022-09-01,37,001,NC,Alamance County,83095,80158,2937,3.5
CN3700300000000,2022-09-01,37,003,NC,Alexander County,18072,17539,533,2.9
CN3700500000000,2022-09-01,37,005,NC,Alleghany County,4677,4525,152,3.2
CN3700700000000,2022-09-01,37,007,NC,Anson County,10256,9838,418,4.1
CN3700900000000,2022-09-01,37,009,NC,Ashe County,12980,12550,430,3.3
CN3701100000000,2022-09-01,37,011,NC,Avery County,8045,7816,229,2.8
CN3701300000000,2022-09-01,37,013,NC,Beaufort County,19876,19125,751,3.8
CN3701500000000,2022-09-01,37,015,NC,Bertie County,7207,6883,324,4.5
CN3701700000000,2022-09-01,37,017,NC,Bladen County,14650,14056,594,4.1
CN3701900000000,2022-09-01,37,019,NC,Brunswick County,58186,55725,2461,4.2
CN3702100000000,2022-09-01,37,021,NC,Buncombe County,142809,138885,3924,2.7
CN3702300000000,2022-09-01,37,023,NC,Burke County,41071,39735,1336,3.3
CN3702500000000,2022-09-01,37,025,NC,Cabarrus County,116330,112544,3786,3.3
CN3702700000000,2022-09-01,37,027,NC,Caldwell County,36563,35347,1216,3.3
CN3702900000000,2022-09-01,37,029,NC,Camden County,4690,4521,169,3.6
CN3703100000000,2022-09-01,37,031,NC,Carteret County,32297,31268,1029,3.2
CN3703300000000,2022-09-01,37,033,NC,Caswell County,9660,9289,371,3.8
CN3703500000000,2022-09-01,37,035,NC,Catawba County,79839,77241,2598,3.3
CN3703700000000,2022-09-01,37,037,NC,Chatham County,37561,36439,1122,3
CN3703900000000,2022-09-01,37,039,NC,Cherokee County,11199,10791,408,3.6
CN3704100000000,2022-09-01,37,041,NC,Chowan County,5800,5577,223,3.8
CN3704300000000,2022-09-01,37,043,NC,Clay County,4270,4105,165,3.9
CN3704500000000,2022-09-01,37,045,NC,Cleveland County,48800,47007,1793,3.7
CN3704700000000,2022-09-01,37,047,NC,Columbus County,23845,22937,908,3.8
CN3704900000000,2022-09-01,37,049,NC,Craven County,41960,40467,1493,3.6
CN3705100000000,2022-09-01,37,051,NC,Cumberland County,126905,120763,6142,4.8
CN3705300000000,2022-09-01,37,053,NC,Currituck County,14762,14293,469,3.2
CN3705500000000,2022-09-01,37,055,NC,Dare County,20824,20190,634,3
CN3705700000000,2022-09-01,37,057,NC,Davidson County,81677,78986,2691,3.3
CN3705900000000,2022-09-01,37,059,NC,Davie County,20819,20154,665,3.2
CN3706100000000,2022-09-01,37,061,NC,Duplin County,24784,23930,854,3.4
CN3706300000000,2022-09-01,37,063,NC,Durham County,179018,173667,5351,3
CN3706500000000,2022-09-01,37,065,NC,Edgecombe County,20099,18844,1255,6.2
CN3706700000000,2022-09-01,37,067,NC,Forsyth County,189209,182525,6684,3.5
CN3706900000000,2022-09-01,37,069,NC,Franklin County,34063,32916,1147,3.4
CN3707100000000,2022-09-01,37,071,NC,Gaston County,114827,110871,3956,3.4
CN3707300000000,2022-09-01,37,073,NC,Gates County,5156,4974,182,3.5
CN3707500000000,2022-09-01,37,075,NC,Graham County,2924,2792,132,4.5
CN3707700000000,2022-09-01,37,077,NC,Granville County,30286,29373,913,3
CN3707900000000,2022-09-01,37,079,NC,Greene County,9525,9225,300,3.1
CN3708100000000,2022-09-01,37,081,NC,Guilford County,259686,249662,10024,3.9
CN3708300000000,2022-09-01,37,083,NC,Halifax County,19213,18165,1048,5.5
CN3708500000000,2022-09-01,37,085,NC,Harnett County,55274,53118,2156,3.9
CN3708700000000,2022-09-01,37,087,NC,Haywood County,30339,29453,886,2.9
CN3708900000000,2022-09-01,37,089,NC,Henderson County,55824,54166,1658,3
CN3709100000000,2022-09-01,37,091,NC,Hertford County,8493,8070,423,5
CN3709300000000,2022-09-01,37,093,NC,Hoke County,20213,19228,985,4.9
CN3709500000000,2022-09-01,37,095,NC,Hyde County,1791,1722,69,3.9
CN3709700000000,2022-09-01,37,097,NC,Iredell County,94790,91752,3038,3.2
CN3709900000000,2022-09-01,37,099,NC,Jackson County,19939,19237,702,3.5
CN3710100000000,2022-09-01,37,101,NC,Johnston County,108391,104953,3438,3.2
CN3710300000000,2022-09-01,37,103,NC,Jones County,4290,4150,140,3.3
CN3710500000000,2022-09-01,37,105,NC,Lee County,26121,25082,1039,4
CN3710700000000,2022-09-01,37,107,NC,Lenoir County,27763,26822,941,3.4
CN3710900000000,2022-09-01,37,109,NC,Lincoln County,46470,45125,1345,2.9
CN3711100000000,2022-09-01,37,111,NC,McDowell County,20380,19704,676,3.3
CN3711300000000,2022-09-01,37,113,NC,Macon County,16282,15764,518,3.2
CN3711500000000,2022-09-01,37,115,NC,Madison County,10133,9807,326,3.2
CN3711700000000,2022-09-01,37,117,NC,Martin County,8583,8219,364,4.2
CN3711900000000,2022-09-01,37,119,NC,Mecklenburg County,653562,631927,21635,3.3
CN3712100000000,2022-09-01,37,121,NC,Mitchell County,6071,5843,228,3.8
CN3712300000000,2022-09-01,37,123,NC,Montgomery County,11156,10756,400,3.6
CN3712500000000,2022-09-01,37,125,NC,Moore County,42191,40749,1442,3.4
CN3712700000000,2022-09-01,37,127,NC,Nash County,42085,40054,2031,4.8
CN3712900000000,2022-09-01,37,129,NC,New Hanover County,130359,126342,4017,3.1
CN3713100000000,2022-09-01,37,131,NC,Northampton County,7232,6895,337,4.7
CN3713300000000,2022-09-01,37,133,NC,Onslow County,68544,65754,2790,4.1
CN3713500000000,2022-09-01,37,135,NC,Orange County,81674,79314,2360,2.9
CN3713700000000,2022-09-01,37,137,NC,Pamlico County,5469,5285,184,3.4
CN3713900000000,2022-09-01,37,139,NC,Pasquotank County,16772,16053,719,4.3
CN3714100000000,2022-09-01,37,141,NC,Pender County,30926,29907,1019,3.3
CN3714300000000,2022-09-01,37,143,NC,Perquimans County,4970,4769,201,4
CN3714500000000,2022-09-01,37,145,NC,Person County,18786,18138,648,3.4
CN3714700000000,2022-09-01,37,147,NC,Pitt County,88857,85421,3436,3.9
CN3714900000000,2022-09-01,37,149,NC,Polk County,9444,9117,327,3.5
CN3715100000000,2022-09-01,37,151,NC,Randolph County,65281,62977,2304,3.5
CN3715300000000,2022-09-01,37,153,NC,Richmond County,17048,16247,801,4.7
CN3715500000000,2022-09-01,37,155,NC,Robeson County,47847,45379,2468,5.2
CN3715700000000,2022-09-01,37,157,NC,Rockingham County,39421,37862,1559,4
CN3715900000000,2022-09-01,37,159,NC,Rowan County,67865,65551,2314,3.4
CN3716100000000,2022-09-01,37,161,NC,Rutherford County,24757,23674,1083,4.4
CN3716300000000,2022-09-01,37,163,NC,Sampson County,28949,27964,985,3.4
CN3716500000000,2022-09-01,37,165,NC,Scotland County,11103,10450,653,5.9
CN3716700000000,2022-09-01,37,167,NC,Stanly County,30891,29911,980,3.2
CN3716900000000,2022-09-01,37,169,NC,Stokes County,21740,21050,690,3.2
CN3717100000000,2022-09-01,37,171,NC,Surry County,32674,31611,1063,3.3
CN3717300000000,2022-09-01,37,173,NC,Swain County,7290,7076,214,2.9
CN3717500000000,2022-09-01,37,175,NC,Transylvania County,14854,14370,484,3.3
CN3717700000000,2022-09-01,37,177,NC,Tyrrell County,1354,1295,59,4.4
CN3717900000000,2022-09-01,37,179,NC,Union County,130711,126747,3964,3
CN3718100000000,2022-09-01,37,181,NC,Vance County,16734,15784,950,5.7
CN3718300000000,2022-09-01,37,183,NC,Wake County,633360,614873,18487,2.9
CN3718500000000,2022-09-01,37,185,NC,Warren County,6525,6014,511,7.8
CN3718700000000,2022-09-01,37,187,NC,Washington County,4371,4170,201,4.6
CN3718900000000,2022-09-01,37,189,NC,Watauga County,29876,28955,921,3.1
CN3719100000000,2022-09-01,37,191,NC,Wayne County,50522,48614,1908,3.8
CN3719300000000,2022-09-01,37,193,NC,Wilkes County,27305,26327,978,3.6
CN3719500000000,2022-09-01,37,195,NC,Wilson County,33647,32024,1623,4.8
CN3719700000000,2022-09-01,37,197,NC,Yadkin County,17665,17110,555,3.1
CN3719900000000,2022-09-01,37,199,NC,Yancey County,8340,8033,307,3.7
CN3800100000000,2022-09-01,38,001,ND,Adams County,967,950,17,1.8
CN3800300000000,2022-09-01,38,003,ND,Barnes County,5214,5132,82,1.6
CN3800500000000,2022-09-01,38,005,ND,Benson County,2420,2365,55,2.3
CN3800700000000,2022-09-01,38,007,ND,Billings County,508,502,6,1.2
CN3800900000000,2022-09-01,38,009,ND,Bottineau County,2977,2918,59,2
CN3801100000000,2022-09-01,38,011,ND,Bowman County,1545,1525,20,1.3
CN3801300000000,2022-09-01,38,013,ND,Burke County,1035,1024,11,1.1
CN3801500000000,2022-09-01,38,015,ND,Burleigh County,52053,51306,747,1.4
CN3801700000000,2022-09-01,38,017,ND,Cass County,111172,109745,1427,1.3
CN3801900000000,2022-09-01,38,019,ND,Cavalier County,1842,1811,31,1.7
CN3802100000000,2022-09-01,38,021,ND,Dickey County,2201,2176,25,1.1
CN3802300000000,2022-09-01,38,023,ND,Divide County,1454,1441,13,0.9
CN3802500000000,2022-09-01,38,025,ND,Dunn County,3308,3277,31,0.9
CN3802700000000,2022-09-01,38,027,ND,Eddy County,1255,1230,25,2
CN3802900000000,2022-09-01,38,029,ND,Emmons County,1468,1424,44,3
CN3803100000000,2022-09-01,38,031,ND,Foster County,1542,1524,18,1.2
CN3803300000000,2022-09-01,38,033,ND,Golden Valley County,871,853,18,2.1
CN3803500000000,2022-09-01,38,035,ND,Grand Forks County,37642,37116,526,1.4
CN3803700000000,2022-09-01,38,037,ND,Grant County,1224,1209,15,1.2
CN3803900000000,2022-09-01,38,039,ND,Griggs County,1025,1012,13,1.3
CN3804100000000,2022-09-01,38,041,ND,Hettinger County,1408,1390,18,1.3
CN3804300000000,2022-09-01,38,043,ND,Kidder County,1323,1286,37,2.8
CN3804500000000,2022-09-01,38,045,ND,LaMoure County,2127,2102,25,1.2
CN3804700000000,2022-09-01,38,047,ND,Logan County,874,860,14,1.6
CN3804900000000,2022-09-01,38,049,ND,McHenry County,3171,3102,69,2.2
CN3805100000000,2022-09-01,38,051,ND,McIntosh County,1069,1054,15,1.4
CN3805300000000,2022-09-01,38,053,ND,McKenzie County,9561,9427,134,1.4
CN3805500000000,2022-09-01,38,055,ND,McLean County,4876,4772,104,2.1
CN3805700000000,2022-09-01,38,057,ND,Mercer County,3627,3536,91,2.5
CN3805900000000,2022-09-01,38,059,ND,Morton County,17088,16795,293,1.7
CN3806100000000,2022-09-01,38,061,ND,Mountrail County,6529,6454,75,1.1
CN3806300000000,2022-09-01,38,063,ND,Nelson County,1456,1425,31,2.1
CN3806500000000,2022-09-01,38,065,ND,Oliver County,881,866,15,1.7
CN3806700000000,2022-09-01,38,067,ND,Pembina County,3285,3206,79,2.4
CN3806900000000,2022-09-01,38,069,ND,Pierce County,1641,1607,34,2.1
CN3807100000000,2022-09-01,38,071,ND,Ramsey County,5664,5568,96,1.7
CN3807300000000,2022-09-01,38,073,ND,Ransom County,2673,2635,38,1.4
CN3807500000000,2022-09-01,38,075,ND,Renville County,1232,1214,18,1.5
CN3807700000000,2022-09-01,38,077,ND,Richland County,8981,8857,124,1.4
CN3807900000000,2022-09-01,38,079,ND,Rolette County,4738,4540,198,4.2
CN3808100000000,2022-09-01,38,081,ND,Sargent County,2290,2263,27,1.2
CN3808300000000,2022-09-01,38,083,ND,Sheridan County,666,655,11,1.7
CN3808500000000,2022-09-01,38,085,ND,Sioux County,1234,1207,27,2.2
CN3808700000000,2022-09-01,38,087,ND,Slope County,344,337,7,2
CN3808900000000,2022-09-01,38,089,ND,Stark County,18198,17931,267,1.5
CN3809100000000,2022-09-01,38,091,ND,Steele County,965,954,11,1.1
CN3809300000000,2022-09-01,38,093,ND,Stutsman County,10870,10717,153,1.4
CN3809500000000,2022-09-01,38,095,ND,Towner County,1144,1127,17,1.5
CN3809700000000,2022-09-01,38,097,ND,Traill County,4606,4541,65,1.4
CN3809900000000,2022-09-01,38,099,ND,Walsh County,5295,5184,111,2.1
CN3810100000000,2022-09-01,38,101,ND,Ward County,32281,31763,518,1.6
CN3810300000000,2022-09-01,38,103,ND,Wells County,1935,1898,37,1.9
CN3810500000000,2022-09-01,38,105,ND,Williams County,22546,22162,384,1.7
CN3900100000000,2022-09-01,39,001,OH,Adams County,10925,10436,489,4.5
CN3900300000000,2022-09-01,39,003,OH,Allen County,46443,44574,1869,4
CN3900500000000,2022-09-01,39,005,OH,Ashland County,25841,24903,938,3.6
CN3900700000000,2022-09-01,39,007,OH,Ashtabula County,42919,41261,1658,3.9
CN3900900000000,2022-09-01,39,009,OH,Athens County,27628,26518,1110,4
CN3901100000000,2022-09-01,39,011,OH,Auglaize County,23867,23108,759,3.2
CN3901300000000,2022-09-01,39,013,OH,Belmont County,26867,25591,1276,4.7
CN3901500000000,2022-09-01,39,015,OH,Brown County,19512,18747,765,3.9
CN3901700000000,2022-09-01,39,017,OH,Butler County,197838,191257,6581,3.3
CN3901900000000,2022-09-01,39,019,OH,Carroll County,12551,12050,501,4
CN3902100000000,2022-09-01,39,021,OH,Champaign County,18983,18331,652,3.4
CN3902300000000,2022-09-01,39,023,OH,Clark County,62005,59644,2361,3.8
CN3902500000000,2022-09-01,39,025,OH,Clermont County,108502,104906,3596,3.3
CN3902700000000,2022-09-01,39,027,OH,Clinton County,17793,17073,720,4
CN3902900000000,2022-09-01,39,029,OH,Columbiana County,44534,42623,1911,4.3
CN3903100000000,2022-09-01,39,031,OH,Coshocton County,13817,13196,621,4.5
CN3903300000000,2022-09-01,39,033,OH,Crawford County,17546,16817,729,4.2
CN3903500000000,2022-09-01,39,035,OH,Cuyahoga County,598096,572005,26091,4.4
CN3903700000000,2022-09-01,39,037,OH,Darke County,25235,24410,825,3.3
CN3903900000000,2022-09-01,39,039,OH,Defiance County,17284,16624,660,3.8
CN3904100000000,2022-09-01,39,041,OH,Delaware County,115577,112191,3386,2.9
CN3904300000000,2022-09-01,39,043,OH,Erie County,37009,35588,1421,3.8
CN3904500000000,2022-09-01,39,045,OH,Fairfield County,80180,77560,2620,3.3
CN3904700000000,2022-09-01,39,047,OH,Fayette County,13527,13049,478,3.5
CN3904900000000,2022-09-01,39,049,OH,Franklin County,708126,684787,23339,3.3
CN3905100000000,2022-09-01,39,051,OH,Fulton County,21428,20680,748,3.5
CN3905300000000,2022-09-01,39,053,OH,Gallia County,11729,11215,514,4.4
CN3905500000000,2022-09-01,39,055,OH,Geauga County,48249,46598,1651,3.4
CN3905700000000,2022-09-01,39,057,OH,Greene County,81576,78770,2806,3.4
CN3905900000000,2022-09-01,39,059,OH,Guernsey County,17588,16852,736,4.2
CN3906100000000,2022-09-01,39,061,OH,Hamilton County,419529,405025,14504,3.5
CN3906300000000,2022-09-01,39,063,OH,Hancock County,39807,38572,1235,3.1
CN3906500000000,2022-09-01,39,065,OH,Hardin County,12692,12159,533,4.2
CN3906700000000,2022-09-01,39,067,OH,Harrison County,6417,6137,280,4.4
CN3906900000000,2022-09-01,39,069,OH,Henry County,12659,12181,478,3.8
CN3907100000000,2022-09-01,39,071,OH,Highland County,17273,16542,731,4.2
CN3907300000000,2022-09-01,39,073,OH,Hocking County,12924,12438,486,3.8
CN3907500000000,2022-09-01,39,075,OH,Holmes County,21632,21068,564,2.6
CN3907700000000,2022-09-01,39,077,OH,Huron County,27723,26632,1091,3.9
CN3907900000000,2022-09-01,39,079,OH,Jackson County,12314,11756,558,4.5
CN3908100000000,2022-09-01,39,081,OH,Jefferson County,26924,25552,1372,5.1
CN3908300000000,2022-09-01,39,083,OH,Knox County,30723,29749,974,3.2
CN3908500000000,2022-09-01,39,085,OH,Lake County,124151,119633,4518,3.6
CN3908700000000,2022-09-01,39,087,OH,Lawrence County,23293,22275,1018,4.4
CN3908900000000,2022-09-01,39,089,OH,Licking County,92014,88952,3062,3.3
CN3909100000000,2022-09-01,39,091,OH,Logan County,22506,21764,742,3.3
CN3909300000000,2022-09-01,39,093,OH,Lorain County,152836,146573,6263,4.1
CN3909500000000,2022-09-01,39,095,OH,Lucas County,201632,192879,8753,4.3
CN3909700000000,2022-09-01,39,097,OH,Madison County,20969,20332,637,3
CN3909900000000,2022-09-01,39,099,OH,Mahoning County,97458,93189,4269,4.4
CN3910100000000,2022-09-01,39,101,OH,Marion County,27053,25862,1191,4.4
CN3910300000000,2022-09-01,39,103,OH,Medina County,97464,94011,3453,3.5
CN3910500000000,2022-09-01,39,105,OH,Meigs County,8605,8160,445,5.2
CN3910700000000,2022-09-01,39,107,OH,Mercer County,22606,21985,621,2.7
CN3910900000000,2022-09-01,39,109,OH,Miami County,53011,51200,1811,3.4
CN3911100000000,2022-09-01,39,111,OH,Monroe County,5163,4897,266,5.2
CN3911300000000,2022-09-01,39,113,OH,Montgomery County,243896,234313,9583,3.9
CN3911500000000,2022-09-01,39,115,OH,Morgan County,6806,6518,288,4.2
CN3911700000000,2022-09-01,39,117,OH,Morrow County,16990,16383,607,3.6
CN3911900000000,2022-09-01,39,119,OH,Muskingum County,40323,38770,1553,3.9
CN3912100000000,2022-09-01,39,121,OH,Noble County,4579,4340,239,5.2
CN3912300000000,2022-09-01,39,123,OH,Ottawa County,20959,20099,860,4.1
CN3912500000000,2022-09-01,39,125,OH,Paulding County,8669,8378,291,3.4
CN3912700000000,2022-09-01,39,127,OH,Perry County,15890,15275,615,3.9
CN3912900000000,2022-09-01,39,129,OH,Pickaway County,26787,25853,934,3.5
CN3913100000000,2022-09-01,39,131,OH,Pike County,10987,10511,476,4.3
CN3913300000000,2022-09-01,39,133,OH,Portage County,84057,81141,2916,3.5
CN3913500000000,2022-09-01,39,135,OH,Preble County,21683,21002,681,3.1
CN3913700000000,2022-09-01,39,137,OH,Putnam County,18811,18266,545,2.9
CN3913900000000,2022-09-01,39,139,OH,Richland County,49624,47552,2072,4.2
CN3914100000000,2022-09-01,39,141,OH,Ross County,35062,33864,1198,3.4
CN3914300000000,2022-09-01,39,143,OH,Sandusky County,29888,28480,1408,4.7
CN3914500000000,2022-09-01,39,145,OH,Scioto County,29241,27886,1355,4.6
CN3914700000000,2022-09-01,39,147,OH,Seneca County,26042,25044,998,3.8
CN3914900000000,2022-09-01,39,149,OH,Shelby County,23326,22535,791,3.4
CN3915100000000,2022-09-01,39,151,OH,Stark County,180077,173443,6634,3.7
CN3915300000000,2022-09-01,39,153,OH,Summit County,261816,251914,9902,3.8
CN3915500000000,2022-09-01,39,155,OH,Trumbull County,82305,78613,3692,4.5
CN3915700000000,2022-09-01,39,157,OH,Tuscarawas County,44426,42905,1521,3.4
CN3915900000000,2022-09-01,39,159,OH,Union County,30244,29350,894,3
CN3916100000000,2022-09-01,39,161,OH,Van Wert County,14313,13849,464,3.2
CN3916300000000,2022-09-01,39,163,OH,Vinton County,5356,5139,217,4.1
CN3916500000000,2022-09-01,39,165,OH,Warren County,123227,119299,3928,3.2
CN3916700000000,2022-09-01,39,167,OH,Washington County,26441,25355,1086,4.1
CN3916900000000,2022-09-01,39,169,OH,Wayne County,59238,57484,1754,3
CN3917100000000,2022-09-01,39,171,OH,Williams County,18050,17494,556,3.1
CN3917300000000,2022-09-01,39,173,OH,Wood County,68850,66474,2376,3.5
CN3917500000000,2022-09-01,39,175,OH,Wyandot County,13073,12727,346,2.6
CN4000100000000,2022-09-01,40,001,OK,Adair County,8517,8247,270,3.2
CN4000300000000,2022-09-01,40,003,OK,Alfalfa County,2590,2538,52,2
CN4000500000000,2022-09-01,40,005,OK,Atoka County,5148,4944,204,4
CN4000700000000,2022-09-01,40,007,OK,Beaver County,2537,2486,51,2
CN4000900000000,2022-09-01,40,009,OK,Beckham County,10337,10081,256,2.5
CN4001100000000,2022-09-01,40,011,OK,Blaine County,4367,4272,95,2.2
CN4001300000000,2022-09-01,40,013,OK,Bryan County,23140,22515,625,2.7
CN4001500000000,2022-09-01,40,015,OK,Caddo County,11620,11234,386,3.3
CN4001700000000,2022-09-01,40,017,OK,Canadian County,81133,79098,2035,2.5
CN4001900000000,2022-09-01,40,019,OK,Carter County,21455,20712,743,3.5
CN4002100000000,2022-09-01,40,021,OK,Cherokee County,19867,19188,679,3.4
CN4002300000000,2022-09-01,40,023,OK,Choctaw County,6037,5760,277,4.6
CN4002500000000,2022-09-01,40,025,OK,Cimarron County,1517,1493,24,1.6
CN4002700000000,2022-09-01,40,027,OK,Cleveland County,149978,146171,3807,2.5
CN4002900000000,2022-09-01,40,029,OK,Coal County,2335,2267,68,2.9
CN4003100000000,2022-09-01,40,031,OK,Comanche County,47321,45551,1770,3.7
CN4003300000000,2022-09-01,40,033,OK,Cotton County,2622,2528,94,3.6
CN4003500000000,2022-09-01,40,035,OK,Craig County,5857,5682,175,3
CN4003700000000,2022-09-01,40,037,OK,Creek County,31513,30421,1092,3.5
CN4003900000000,2022-09-01,40,039,OK,Custer County,14969,14583,386,2.6
CN4004100000000,2022-09-01,40,041,OK,Delaware County,19856,19285,571,2.9
CN4004300000000,2022-09-01,40,043,OK,Dewey County,2917,2858,59,2
CN4004500000000,2022-09-01,40,045,OK,Ellis County,2020,1971,49,2.4
CN4004700000000,2022-09-01,40,047,OK,Garfield County,25893,25127,766,3
CN4004900000000,2022-09-01,40,049,OK,Garvin County,12641,12285,356,2.8
CN4005100000000,2022-09-01,40,051,OK,Grady County,27373,26614,759,2.8
CN4005300000000,2022-09-01,40,053,OK,Grant County,2591,2539,52,2
CN4005500000000,2022-09-01,40,055,OK,Greer County,1745,1680,65,3.7
CN4005700000000,2022-09-01,40,057,OK,Harmon County,1181,1148,33,2.8
CN4005900000000,2022-09-01,40,059,OK,Harper County,1703,1671,32,1.9
CN4006100000000,2022-09-01,40,061,OK,Haskell County,4143,3968,175,4.2
CN4006300000000,2022-09-01,40,063,OK,Hughes County,5137,4957,180,3.5
CN4006500000000,2022-09-01,40,065,OK,Jackson County,10681,10385,296,2.8
CN4006700000000,2022-09-01,40,067,OK,Jefferson County,2420,2348,72,3
CN4006900000000,2022-09-01,40,069,OK,Johnston County,3947,3805,142,3.6
CN4007100000000,2022-09-01,40,071,OK,Kay County,18483,17845,638,3.5
CN4007300000000,2022-09-01,40,073,OK,Kingfisher County,8793,8620,173,2
CN4007500000000,2022-09-01,40,075,OK,Kiowa County,3547,3433,114,3.2
CN4007700000000,2022-09-01,40,077,OK,Latimer County,3130,2955,175,5.6
CN4007900000000,2022-09-01,40,079,OK,Le Flore County,19499,18775,724,3.7
CN4008100000000,2022-09-01,40,081,OK,Lincoln County,16195,15697,498,3.1
CN4008300000000,2022-09-01,40,083,OK,Logan County,23454,22829,625,2.7
CN4008500000000,2022-09-01,40,085,OK,Love County,5792,5658,134,2.3
CN4008700000000,2022-09-01,40,087,OK,McClain County,20878,20309,569,2.7
CN4008900000000,2022-09-01,40,089,OK,McCurtain County,15893,15294,599,3.8
CN4009100000000,2022-09-01,40,091,OK,McIntosh County,7296,6960,336,4.6
CN4009300000000,2022-09-01,40,093,OK,Major County,3666,3574,92,2.5
CN4009500000000,2022-09-01,40,095,OK,Marshall County,7270,7038,232,3.2
CN4009700000000,2022-09-01,40,097,OK,Mayes County,19906,19292,614,3.1
CN4009900000000,2022-09-01,40,099,OK,Murray County,6097,5901,196,3.2
CN4010100000000,2022-09-01,40,101,OK,Muskogee County,28973,27979,994,3.4
CN4010300000000,2022-09-01,40,103,OK,Noble County,5838,5709,129,2.2
CN4010500000000,2022-09-01,40,105,OK,Nowata County,4711,4582,129,2.7
CN4010700000000,2022-09-01,40,107,OK,Okfuskee County,4453,4284,169,3.8
CN4010900000000,2022-09-01,40,109,OK,Oklahoma County,401968,390283,11685,2.9
CN4011100000000,2022-09-01,40,111,OK,Okmulgee County,15570,14932,638,4.1
CN4011300000000,2022-09-01,40,113,OK,Osage County,20543,19827,716,3.5
CN4011500000000,2022-09-01,40,115,OK,Ottawa County,15246,14810,436,2.9
CN4011700000000,2022-09-01,40,117,OK,Pawnee County,7327,7063,264,3.6
CN4011900000000,2022-09-01,40,119,OK,Payne County,39328,38245,1083,2.8
CN4012100000000,2022-09-01,40,121,OK,Pittsburg County,16330,15649,681,4.2
CN4012300000000,2022-09-01,40,123,OK,Pontotoc County,19567,19061,506,2.6
CN4012500000000,2022-09-01,40,125,OK,Pottawatomie County,33448,32284,1164,3.5
CN4012700000000,2022-09-01,40,127,OK,Pushmataha County,4387,4217,170,3.9
CN4012900000000,2022-09-01,40,129,OK,Roger Mills County,1748,1707,41,2.3
CN4013100000000,2022-09-01,40,131,OK,Rogers County,45839,44494,1345,2.9
CN4013300000000,2022-09-01,40,133,OK,Seminole County,9258,8876,382,4.1
CN4013500000000,2022-09-01,40,135,OK,Sequoyah County,16731,16162,569,3.4
CN4013700000000,2022-09-01,40,137,OK,Stephens County,19372,18753,619,3.2
CN4013900000000,2022-09-01,40,139,OK,Texas County,11628,11434,194,1.7
CN4014100000000,2022-09-01,40,141,OK,Tillman County,2878,2795,83,2.9
CN4014300000000,2022-09-01,40,143,OK,Tulsa County,327923,318053,9870,3
CN4014500000000,2022-09-01,40,145,OK,Wagoner County,39330,38163,1167,3
CN4014700000000,2022-09-01,40,147,OK,Washington County,22413,21699,714,3.2
CN4014900000000,2022-09-01,40,149,OK,Washita County,5238,5087,151,2.9
CN4015100000000,2022-09-01,40,151,OK,Woods County,4585,4502,83,1.8
CN4015300000000,2022-09-01,40,153,OK,Woodward County,8457,8206,251,3
CN4100100000000,2022-09-01,41,001,OR,Baker County,7493,7158,335,4.5
CN4100300000000,2022-09-01,41,003,OR,Benton County,48936,47063,1873,3.8
CN4100500000000,2022-09-01,41,005,OR,Clackamas County,227767,218850,8917,3.9
CN4100700000000,2022-09-01,41,007,OR,Clatsop County,20071,19218,853,4.2
CN4100900000000,2022-09-01,41,009,OR,Columbia County,25206,23984,1222,4.8
CN4101100000000,2022-09-01,41,011,OR,Coos County,26720,25274,1446,5.4
CN4101300000000,2022-09-01,41,013,OR,Crook County,11431,10834,597,5.2
CN4101500000000,2022-09-01,41,015,OR,Curry County,9391,8892,499,5.3
CN4101700000000,2022-09-01,41,017,OR,Deschutes County,104106,99795,4311,4.1
CN4101900000000,2022-09-01,41,019,OR,Douglas County,47902,45351,2551,5.3
CN4102100000000,2022-09-01,41,021,OR,Gilliam County,1026,992,34,3.3
CN4102300000000,2022-09-01,41,023,OR,Grant County,3293,3140,153,4.6
CN4102500000000,2022-09-01,41,025,OR,Harney County,3870,3702,168,4.3
CN4102700000000,2022-09-01,41,027,OR,Hood River County,15284,14783,501,3.3
CN4102900000000,2022-09-01,41,029,OR,Jackson County,108129,103094,5035,4.7
CN4103100000000,2022-09-01,41,031,OR,Jefferson County,10313,9765,548,5.3
CN4103300000000,2022-09-01,41,033,OR,Josephine County,36895,34910,1985,5.4
CN4103500000000,2022-09-01,41,035,OR,Klamath County,30742,29080,1662,5.4
CN4103700000000,2022-09-01,41,037,OR,Lake County,3679,3505,174,4.7
CN4103900000000,2022-09-01,41,039,OR,Lane County,182823,174164,8659,4.7
CN4104100000000,2022-09-01,41,041,OR,Lincoln County,21553,20468,1085,5
CN4104300000000,2022-09-01,41,043,OR,Linn County,61607,58731,2876,4.7
CN4104500000000,2022-09-01,41,045,OR,Malheur County,12761,12236,525,4.1
CN4104700000000,2022-09-01,41,047,OR,Marion County,173435,166100,7335,4.2
CN4104900000000,2022-09-01,41,049,OR,Morrow County,6220,5973,247,4
CN4105100000000,2022-09-01,41,051,OR,Multnomah County,470091,451339,18752,4
CN4105300000000,2022-09-01,41,053,OR,Polk County,43454,41598,1856,4.3
CN4105500000000,2022-09-01,41,055,OR,Sherman County,980,950,30,3.1
CN4105700000000,2022-09-01,41,057,OR,Tillamook County,12221,11668,553,4.5
CN4105900000000,2022-09-01,41,059,OR,Umatilla County,39406,37412,1994,5.1
CN4106100000000,2022-09-01,41,061,OR,Union County,12179,11613,566,4.6
CN4106300000000,2022-09-01,41,063,OR,Wallowa County,3744,3580,164,4.4
CN4106500000000,2022-09-01,41,065,OR,Wasco County,13191,12649,542,4.1
CN4106700000000,2022-09-01,41,067,OR,Washington County,336303,323995,12308,3.7
CN4106900000000,2022-09-01,41,069,OR,Wheeler County,760,737,23,3
CN4107100000000,2022-09-01,41,071,OR,Yamhill County,56846,54612,2234,3.9
CN4200100000000,2022-09-01,42,001,PA,Adams County,54731,53137,1594,2.9
CN4200300000000,2022-09-01,42,003,PA,Allegheny County,634435,610583,23852,3.8
CN4200500000000,2022-09-01,42,005,PA,Armstrong County,31009,29735,1274,4.1
CN4200700000000,2022-09-01,42,007,PA,Beaver County,82228,78176,4052,4.9
CN4200900000000,2022-09-01,42,009,PA,Bedford County,24401,23509,892,3.7
CN4201100000000,2022-09-01,42,011,PA,Berks County,213891,205740,8151,3.8
CN4201300000000,2022-09-01,42,013,PA,Blair County,58666,56422,2244,3.8
CN4201500000000,2022-09-01,42,015,PA,Bradford County,28044,27037,1007,3.6
CN4201700000000,2022-09-01,42,017,PA,Bucks County,352440,340113,12327,3.5
CN4201900000000,2022-09-01,42,019,PA,Butler County,98853,95371,3482,3.5
CN4202100000000,2022-09-01,42,021,PA,Cambria County,55411,52933,2478,4.5
CN4202300000000,2022-09-01,42,023,PA,Cameron County,1925,1840,85,4.4
CN4202500000000,2022-09-01,42,025,PA,Carbon County,32546,31081,1465,4.5
CN4202700000000,2022-09-01,42,027,PA,Centre County,79422,76911,2511,3.2
CN4202900000000,2022-09-01,42,029,PA,Chester County,295127,286448,8679,2.9
CN4203100000000,2022-09-01,42,031,PA,Clarion County,16060,15369,691,4.3
CN4203300000000,2022-09-01,42,033,PA,Clearfield County,35103,33528,1575,4.5
CN4203500000000,2022-09-01,42,035,PA,Clinton County,16989,16244,745,4.4
CN4203700000000,2022-09-01,42,037,PA,Columbia County,34000,32690,1310,3.9
CN4203900000000,2022-09-01,42,039,PA,Crawford County,37701,36178,1523,4
CN4204100000000,2022-09-01,42,041,PA,Cumberland County,135548,131405,4143,3.1
CN4204300000000,2022-09-01,42,043,PA,Dauphin County,146764,141450,5314,3.6
CN4204500000000,2022-09-01,42,045,PA,Delaware County,303687,292026,11661,3.8
CN4204700000000,2022-09-01,42,047,PA,Elk County,14499,13909,590,4.1
CN4204900000000,2022-09-01,42,049,PA,Erie County,125861,120548,5313,4.2
CN4205100000000,2022-09-01,42,051,PA,Fayette County,54968,52170,2798,5.1
CN4205300000000,2022-09-01,42,053,PA,Forest County,1666,1578,88,5.3
CN4205500000000,2022-09-01,42,055,PA,Franklin County,77824,75264,2560,3.3
CN4205700000000,2022-09-01,42,057,PA,Fulton County,7169,6926,243,3.4
CN4205900000000,2022-09-01,42,059,PA,Greene County,15505,14815,690,4.5
CN4206100000000,2022-09-01,42,061,PA,Huntingdon County,19359,18469,890,4.6
CN4206300000000,2022-09-01,42,063,PA,Indiana County,36520,34924,1596,4.4
CN4206500000000,2022-09-01,42,065,PA,Jefferson County,19468,18712,756,3.9
CN4206700000000,2022-09-01,42,067,PA,Juniata County,12299,11844,455,3.7
CN4206900000000,2022-09-01,42,069,PA,Lackawanna County,105617,101149,4468,4.2
CN4207100000000,2022-09-01,42,071,PA,Lancaster County,290391,281285,9106,3.1
CN4207300000000,2022-09-01,42,073,PA,Lawrence County,39276,37518,1758,4.5
CN4207500000000,2022-09-01,42,075,PA,Lebanon County,73370,70957,2413,3.3
CN4207700000000,2022-09-01,42,077,PA,Lehigh County,197717,189926,7791,3.9
CN4207900000000,2022-09-01,42,079,PA,Luzerne County,158949,151325,7624,4.8
CN4208100000000,2022-09-01,42,081,PA,Lycoming County,55409,53146,2263,4.1
CN4208300000000,2022-09-01,42,083,PA,McKean County,16887,16115,772,4.6
CN4208500000000,2022-09-01,42,085,PA,Mercer County,47609,45518,2091,4.4
CN4208700000000,2022-09-01,42,087,PA,Mifflin County,21129,20250,879,4.2
CN4208900000000,2022-09-01,42,089,PA,Monroe County,82542,78086,4456,5.4
CN4209100000000,2022-09-01,42,091,PA,Montgomery County,469001,454103,14898,3.2
CN4209300000000,2022-09-01,42,093,PA,Montour County,9286,8985,301,3.2
CN4209500000000,2022-09-01,42,095,PA,Northampton County,164802,158451,6351,3.9
CN4209700000000,2022-09-01,42,097,PA,Northumberland County,42561,40792,1769,4.2
CN4209900000000,2022-09-01,42,099,PA,Perry County,24661,23881,780,3.2
CN4210100000000,2022-09-01,42,101,PA,Philadelphia County/city,738513,701377,37136,5
CN4210300000000,2022-09-01,42,103,PA,Pike County,25822,24463,1359,5.3
CN4210500000000,2022-09-01,42,105,PA,Potter County,6763,6438,325,4.8
CN4210700000000,2022-09-01,42,107,PA,Schuylkill County,66096,63162,2934,4.4
CN4210900000000,2022-09-01,42,109,PA,Snyder County,19772,19063,709,3.6
CN4211100000000,2022-09-01,42,111,PA,Somerset County,32075,30639,1436,4.5
CN4211300000000,2022-09-01,42,113,PA,Sullivan County,2561,2454,107,4.2
CN4211500000000,2022-09-01,42,115,PA,Susquehanna County,20153,19427,726,3.6
CN4211700000000,2022-09-01,42,117,PA,Tioga County,18982,18193,789,4.2
CN4211900000000,2022-09-01,42,119,PA,Union County,19763,19102,661,3.3
CN4212100000000,2022-09-01,42,121,PA,Venango County,21344,20430,914,4.3
CN4212300000000,2022-09-01,42,123,PA,Warren County,17539,16868,671,3.8
CN4212500000000,2022-09-01,42,125,PA,Washington County,104919,100769,4150,4
CN4212700000000,2022-09-01,42,127,PA,Wayne County,22509,21549,960,4.3
CN4212900000000,2022-09-01,42,129,PA,Westmoreland County,175919,169198,6721,3.8
CN4213100000000,2022-09-01,42,131,PA,Wyoming County,13538,12957,581,4.3
CN4213300000000,2022-09-01,42,133,PA,York County,238969,230847,8122,3.4
CN4400100000000,2022-09-01,44,001,RI,Bristol County,26633,25979,654,2.5
CN4400300000000,2022-09-01,44,003,RI,Kent County,93898,91433,2465,2.6
CN4400500000000,2022-09-01,44,005,RI,Newport County,45166,44083,1083,2.4
CN4400700000000,2022-09-01,44,007,RI,Providence County,335441,324580,10861,3.2
CN4400900000000,2022-09-01,44,009,RI,Washington County,70867,69116,1751,2.5
CN4500100000000,2022-09-01,45,001,SC,Abbeville County,9382,9045,337,3.6
CN4500300000000,2022-09-01,45,003,SC,Aiken County,72431,70284,2147,3
CN4500500000000,2022-09-01,45,005,SC,Allendale County,2262,2149,113,5
CN4500700000000,2022-09-01,45,007,SC,Anderson County,91097,88558,2539,2.8
CN4500900000000,2022-09-01,45,009,SC,Bamberg County,4517,4296,221,4.9
CN4501100000000,2022-09-01,45,011,SC,Barnwell County,7422,7118,304,4.1
CN4501300000000,2022-09-01,45,013,SC,Beaufort County,76022,73824,2198,2.9
CN4501500000000,2022-09-01,45,015,SC,Berkeley County,109800,106548,3252,3
CN4501700000000,2022-09-01,45,017,SC,Calhoun County,6371,6158,213,3.3
CN4501900000000,2022-09-01,45,019,SC,Charleston County,215356,209945,5411,2.5
CN4502100000000,2022-09-01,45,021,SC,Cherokee County,23918,23029,889,3.7
CN4502300000000,2022-09-01,45,023,SC,Chester County,13162,12659,503,3.8
CN4502500000000,2022-09-01,45,025,SC,Chesterfield County,20836,20142,694,3.3
CN4502700000000,2022-09-01,45,027,SC,Clarendon County,11852,11403,449,3.8
CN4502900000000,2022-09-01,45,029,SC,Colleton County,15825,15327,498,3.1
CN4503100000000,2022-09-01,45,031,SC,Darlington County,29546,28594,952,3.2
CN4503300000000,2022-09-01,45,033,SC,Dillon County,12668,12174,494,3.9
CN4503500000000,2022-09-01,45,035,SC,Dorchester County,79587,77389,2198,2.8
CN4503700000000,2022-09-01,45,037,SC,Edgefield County,10199,9854,345,3.4
CN4503900000000,2022-09-01,45,039,SC,Fairfield County,9139,8745,394,4.3
CN4504100000000,2022-09-01,45,041,SC,Florence County,65634,63654,1980,3
CN4504300000000,2022-09-01,45,043,SC,Georgetown County,25979,25139,840,3.2
CN4504500000000,2022-09-01,45,045,SC,Greenville County,258912,252211,6701,2.6
CN4504700000000,2022-09-01,45,047,SC,Greenwood County,29475,28447,1028,3.5
CN4504900000000,2022-09-01,45,049,SC,Hampton County,7821,7626,195,2.5
CN4505100000000,2022-09-01,45,051,SC,Horry County,151407,146372,5035,3.3
CN4505300000000,2022-09-01,45,053,SC,Jasper County,13138,12783,355,2.7
CN4505500000000,2022-09-01,45,055,SC,Kershaw County,29167,28264,903,3.1
CN4505700000000,2022-09-01,45,057,SC,Lancaster County,43083,41655,1428,3.3
CN4505900000000,2022-09-01,45,059,SC,Laurens County,29952,29032,920,3.1
CN4506100000000,2022-09-01,45,061,SC,Lee County,6324,6057,267,4.2
CN4506300000000,2022-09-01,45,063,SC,Lexington County,150130,146421,3709,2.5
CN4506500000000,2022-09-01,45,065,SC,McCormick County,3536,3417,119,3.4
CN4506700000000,2022-09-01,45,067,SC,Marion County,12500,11951,549,4.4
CN4506900000000,2022-09-01,45,069,SC,Marlboro County,7957,7517,440,5.5
CN4507100000000,2022-09-01,45,071,SC,Newberry County,19005,18528,477,2.5
CN4507300000000,2022-09-01,45,073,SC,Oconee County,34097,33136,961,2.8
CN4507500000000,2022-09-01,45,075,SC,Orangeburg County,32633,31141,1492,4.6
CN4507700000000,2022-09-01,45,077,SC,Pickens County,57719,56090,1629,2.8
CN4507900000000,2022-09-01,45,079,SC,Richland County,195583,189677,5906,3
CN4508100000000,2022-09-01,45,081,SC,Saluda County,8363,8133,230,2.8
CN4508300000000,2022-09-01,45,083,SC,Spartanburg County,153202,148834,4368,2.9
CN4508500000000,2022-09-01,45,085,SC,Sumter County,41335,39864,1471,3.6
CN4508700000000,2022-09-01,45,087,SC,Union County,11133,10638,495,4.4
CN4508900000000,2022-09-01,45,089,SC,Williamsburg County,10602,10148,454,4.3
CN4509100000000,2022-09-01,45,091,SC,York County,146523,142264,4259,2.9
CN4600300000000,2022-09-01,46,003,SD,Aurora County,1466,1443,23,1.6
CN4600500000000,2022-09-01,46,005,SD,Beadle County,9216,9075,141,1.5
CN4600700000000,2022-09-01,46,007,SD,Bennett County,1061,1034,27,2.5
CN4600900000000,2022-09-01,46,009,SD,Bon Homme County,2780,2734,46,1.7
CN4601100000000,2022-09-01,46,011,SD,Brookings County,19097,18797,300,1.6
CN4601300000000,2022-09-01,46,013,SD,Brown County,19913,19558,355,1.8
CN4601500000000,2022-09-01,46,015,SD,Brule County,2609,2571,38,1.5
CN4601700000000,2022-09-01,46,017,SD,Buffalo County,722,690,32,4.4
CN4601900000000,2022-09-01,46,019,SD,Butte County,5068,4982,86,1.7
CN4602100000000,2022-09-01,46,021,SD,Campbell County,732,717,15,2
CN4602300000000,2022-09-01,46,023,SD,Charles Mix County,3749,3677,72,1.9
CN4602500000000,2022-09-01,46,025,SD,Clark County,1892,1862,30,1.6
CN4602700000000,2022-09-01,46,027,SD,Clay County,7483,7359,124,1.7
CN4602900000000,2022-09-01,46,029,SD,Codington County,15932,15683,249,1.6
CN4603100000000,2022-09-01,46,031,SD,Corson County,1251,1221,30,2.4
CN4603300000000,2022-09-01,46,033,SD,Custer County,4181,4088,93,2.2
CN4603500000000,2022-09-01,46,035,SD,Davison County,11070,10898,172,1.6
CN4603700000000,2022-09-01,46,037,SD,Day County,2601,2552,49,1.9
CN4603900000000,2022-09-01,46,039,SD,Deuel County,2292,2248,44,1.9
CN4604100000000,2022-09-01,46,041,SD,Dewey County,2267,2159,108,4.8
CN4604300000000,2022-09-01,46,043,SD,Douglas County,1472,1447,25,1.7
CN4604500000000,2022-09-01,46,045,SD,Edmunds County,1950,1919,31,1.6
CN4604700000000,2022-09-01,46,047,SD,Fall River County,3024,2966,58,1.9
CN4604900000000,2022-09-01,46,049,SD,Faulk County,1037,1017,20,1.9
CN4605100000000,2022-09-01,46,051,SD,Grant County,4313,4247,66,1.5
CN4605300000000,2022-09-01,46,053,SD,Gregory County,2082,2048,34,1.6
CN4605500000000,2022-09-01,46,055,SD,Haakon County,1065,1047,18,1.7
CN4605700000000,2022-09-01,46,057,SD,Hamlin County,3569,3520,49,1.4
CN4605900000000,2022-09-01,46,059,SD,Hand County,1741,1716,25,1.4
CN4606100000000,2022-09-01,46,061,SD,Hanson County,1760,1726,34,1.9
CN4606300000000,2022-09-01,46,063,SD,Harding County,732,718,14,1.9
CN4606500000000,2022-09-01,46,065,SD,Hughes County,9899,9764,135,1.4
CN4606700000000,2022-09-01,46,067,SD,Hutchinson County,3509,3454,55,1.6
CN4606900000000,2022-09-01,46,069,SD,Hyde County,633,620,13,2.1
CN4607100000000,2022-09-01,46,071,SD,Jackson County,1208,1181,27,2.2
CN4607300000000,2022-09-01,46,073,SD,Jerauld County,1263,1246,17,1.3
CN4607500000000,2022-09-01,46,075,SD,Jones County,499,489,10,2
CN4607700000000,2022-09-01,46,077,SD,Kingsbury County,2669,2627,42,1.6
CN4607900000000,2022-09-01,46,079,SD,Lake County,6789,6674,115,1.7
CN4608100000000,2022-09-01,46,081,SD,Lawrence County,14318,14082,236,1.6
CN4608300000000,2022-09-01,46,083,SD,Lincoln County,37876,37358,518,1.4
CN4608500000000,2022-09-01,46,085,SD,Lyman County,1636,1604,32,2
CN4608700000000,2022-09-01,46,087,SD,McCook County,3099,3057,42,1.4
CN4608900000000,2022-09-01,46,089,SD,McPherson County,945,920,25,2.6
CN4609100000000,2022-09-01,46,091,SD,Marshall County,2450,2405,45,1.8
CN4609300000000,2022-09-01,46,093,SD,Meade County,14589,14329,260,1.8
CN4609500000000,2022-09-01,46,095,SD,Mellette County,714,696,18,2.5
CN4609700000000,2022-09-01,46,097,SD,Miner County,1200,1182,18,1.5
CN4609900000000,2022-09-01,46,099,SD,Minnehaha County,117567,115884,1683,1.4
CN4610100000000,2022-09-01,46,101,SD,Moody County,4000,3928,72,1.8
CN4610200000000,2022-09-01,46,102,SD,Oglala Lakota County,3762,3595,167,4.4
CN4610300000000,2022-09-01,46,103,SD,Pennington County,60267,59229,1038,1.7
CN4610500000000,2022-09-01,46,105,SD,Perkins County,1382,1354,28,2
CN4610700000000,2022-09-01,46,107,SD,Potter County,1012,994,18,1.8
CN4610900000000,2022-09-01,46,109,SD,Roberts County,4545,4452,93,2
CN4611100000000,2022-09-01,46,111,SD,Sanborn County,1164,1143,21,1.8
CN4611500000000,2022-09-01,46,115,SD,Spink County,2966,2907,59,2
CN4611700000000,2022-09-01,46,117,SD,Stanley County,1900,1875,25,1.3
CN4611900000000,2022-09-01,46,119,SD,Sully County,792,779,13,1.6
CN4612100000000,2022-09-01,46,121,SD,Todd County,2937,2855,82,2.8
CN4612300000000,2022-09-01,46,123,SD,Tripp County,3002,2958,44,1.5
CN4612500000000,2022-09-01,46,125,SD,Turner County,4735,4660,75,1.6
CN4612700000000,2022-09-01,46,127,SD,Union County,8699,8537,162,1.9
CN4612900000000,2022-09-01,46,129,SD,Walworth County,2054,2002,52,2.5
CN4613500000000,2022-09-01,46,135,SD,Yankton County,11762,11568,194,1.6
CN4613700000000,2022-09-01,46,137,SD,Ziebach County,938,911,27,2.9
CN4700100000000,2022-09-01,47,001,TN,Anderson County,35108,34004,1104,3.1
CN4700300000000,2022-09-01,47,003,TN,Bedford County,21264,20558,706,3.3
CN4700500000000,2022-09-01,47,005,TN,Benton County,6675,6415,260,3.9
CN4700700000000,2022-09-01,47,007,TN,Bledsoe County,4359,4138,221,5.1
CN4700900000000,2022-09-01,47,009,TN,Blount County,65160,63262,1898,2.9
CN4701100000000,2022-09-01,47,011,TN,Bradley County,49656,48008,1648,3.3
CN4701300000000,2022-09-01,47,013,TN,Campbell County,14896,14293,603,4
CN4701500000000,2022-09-01,47,015,TN,Cannon County,6824,6632,192,2.8
CN4701700000000,2022-09-01,47,017,TN,Carroll County,11622,11207,415,3.6
CN4701900000000,2022-09-01,47,019,TN,Carter County,24033,23189,844,3.5
CN4702100000000,2022-09-01,47,021,TN,Cheatham County,22558,21992,566,2.5
CN4702300000000,2022-09-01,47,023,TN,Chester County,8429,8185,244,2.9
CN4702500000000,2022-09-01,47,025,TN,Claiborne County,12626,12183,443,3.5
CN4702700000000,2022-09-01,47,027,TN,Clay County,2851,2740,111,3.9
CN4702900000000,2022-09-01,47,029,TN,Cocke County,14656,14037,619,4.2
CN4703100000000,2022-09-01,47,031,TN,Coffee County,24826,24016,810,3.3
CN4703300000000,2022-09-01,47,033,TN,Crockett County,6719,6520,199,3
CN4703500000000,2022-09-01,47,035,TN,Cumberland County,23468,22563,905,3.9
CN4703700000000,2022-09-01,47,037,TN,Davidson County,411826,400935,10891,2.6
CN4703900000000,2022-09-01,47,039,TN,Decatur County,4397,4208,189,4.3
CN4704100000000,2022-09-01,47,041,TN,DeKalb County,8021,7746,275,3.4
CN4704300000000,2022-09-01,47,043,TN,Dickson County,27839,27042,797,2.9
CN4704500000000,2022-09-01,47,045,TN,Dyer County,16443,15872,571,3.5
CN4704700000000,2022-09-01,47,047,TN,Fayette County,18946,18310,636,3.4
CN4704900000000,2022-09-01,47,049,TN,Fentress County,7673,7402,271,3.5
CN4705100000000,2022-09-01,47,051,TN,Franklin County,18799,18153,646,3.4
CN4705300000000,2022-09-01,47,053,TN,Gibson County,21357,20660,697,3.3
CN4705500000000,2022-09-01,47,055,TN,Giles County,14638,14193,445,3
CN4705700000000,2022-09-01,47,057,TN,Grainger County,9659,9304,355,3.7
CN4705900000000,2022-09-01,47,059,TN,Greene County,28321,27312,1009,3.6
CN4706100000000,2022-09-01,47,061,TN,Grundy County,4968,4760,208,4.2
CN4706300000000,2022-09-01,47,063,TN,Hamblen County,27914,26991,923,3.3
CN4706500000000,2022-09-01,47,065,TN,Hamilton County,182617,176847,5770,3.2
CN4706700000000,2022-09-01,47,067,TN,Hancock County,2253,2167,86,3.8
CN4706900000000,2022-09-01,47,069,TN,Hardeman County,8827,8486,341,3.9
CN4707100000000,2022-09-01,47,071,TN,Hardin County,10001,9628,373,3.7
CN4707300000000,2022-09-01,47,073,TN,Hawkins County,23128,22261,867,3.7
CN4707500000000,2022-09-01,47,075,TN,Haywood County,7415,7083,332,4.5
CN4707700000000,2022-09-01,47,077,TN,Henderson County,11641,11241,400,3.4
CN4707900000000,2022-09-01,47,079,TN,Henry County,13516,13008,508,3.8
CN4708100000000,2022-09-01,47,081,TN,Hickman County,11698,11380,318,2.7
CN4708300000000,2022-09-01,47,083,TN,Houston County,3189,3062,127,4
CN4708500000000,2022-09-01,47,085,TN,Humphreys County,8640,8355,285,3.3
CN4708700000000,2022-09-01,47,087,TN,Jackson County,4752,4578,174,3.7
CN4708900000000,2022-09-01,47,089,TN,Jefferson County,24818,23989,829,3.3
CN4709100000000,2022-09-01,47,091,TN,Johnson County,7463,7231,232,3.1
CN4709300000000,2022-09-01,47,093,TN,Knox County,249687,242981,6706,2.7
CN4709500000000,2022-09-01,47,095,TN,Lake County,1597,1520,77,4.8
CN4709700000000,2022-09-01,47,097,TN,Lauderdale County,9333,8895,438,4.7
CN4709900000000,2022-09-01,47,099,TN,Lawrence County,19063,18397,666,3.5
CN4710100000000,2022-09-01,47,101,TN,Lewis County,5479,5282,197,3.6
CN4710300000000,2022-09-01,47,103,TN,Lincoln County,16711,16212,499,3
CN4710500000000,2022-09-01,47,105,TN,Loudon County,24197,23429,768,3.2
CN4710700000000,2022-09-01,47,107,TN,McMinn County,21017,20168,849,4
CN4710900000000,2022-09-01,47,109,TN,McNairy County,8394,8024,370,4.4
CN4711100000000,2022-09-01,47,111,TN,Macon County,11535,11197,338,2.9
CN4711300000000,2022-09-01,47,113,TN,Madison County,48555,47000,1555,3.2
CN4711500000000,2022-09-01,47,115,TN,Marion County,12252,11800,452,3.7
CN4711700000000,2022-09-01,47,117,TN,Marshall County,15596,15097,499,3.2
CN4711900000000,2022-09-01,47,119,TN,Maury County,52756,51257,1499,2.8
CN4712100000000,2022-09-01,47,121,TN,Meigs County,5162,4938,224,4.3
CN4712300000000,2022-09-01,47,123,TN,Monroe County,20619,19883,736,3.6
CN4712500000000,2022-09-01,47,125,TN,Montgomery County,87837,84686,3151,3.6
CN4712700000000,2022-09-01,47,127,TN,Moore County,3697,3602,95,2.6
CN4712900000000,2022-09-01,47,129,TN,Morgan County,7784,7500,284,3.6
CN4713100000000,2022-09-01,47,131,TN,Obion County,12664,12212,452,3.6
CN4713300000000,2022-09-01,47,133,TN,Overton County,9858,9549,309,3.1
CN4713500000000,2022-09-01,47,135,TN,Perry County,2770,2644,126,4.5
CN4713700000000,2022-09-01,47,137,TN,Pickett County,2195,2121,74,3.4
CN4713900000000,2022-09-01,47,139,TN,Polk County,6956,6719,237,3.4
CN4714100000000,2022-09-01,47,141,TN,Putnam County,35233,34100,1133,3.2
CN4714300000000,2022-09-01,47,143,TN,Rhea County,13484,12892,592,4.4
CN4714500000000,2022-09-01,47,145,TN,Roane County,23615,22784,831,3.5
CN4714700000000,2022-09-01,47,147,TN,Robertson County,38995,37941,1054,2.7
CN4714900000000,2022-09-01,47,149,TN,Rutherford County,194938,189977,4961,2.5
CN4715100000000,2022-09-01,47,151,TN,Scott County,8089,7703,386,4.8
CN4715300000000,2022-09-01,47,153,TN,Sequatchie County,6154,5910,244,4
CN4715500000000,2022-09-01,47,155,TN,Sevier County,54654,53279,1375,2.5
CN4715700000000,2022-09-01,47,157,TN,Shelby County,433574,414747,18827,4.3
CN4715900000000,2022-09-01,47,159,TN,Smith County,9717,9433,284,2.9
CN4716100000000,2022-09-01,47,161,TN,Stewart County,5482,5283,199,3.6
CN4716300000000,2022-09-01,47,163,TN,Sullivan County,68723,66437,2286,3.3
CN4716500000000,2022-09-01,47,165,TN,Sumner County,108530,105688,2842,2.6
CN4716700000000,2022-09-01,47,167,TN,Tipton County,27272,26337,935,3.4
CN4716900000000,2022-09-01,47,169,TN,Trousdale County,5686,5535,151,2.7
CN4717100000000,2022-09-01,47,171,TN,Unicoi County,6999,6717,282,4
CN4717300000000,2022-09-01,47,173,TN,Union County,7814,7541,273,3.5
CN4717500000000,2022-09-01,47,175,TN,Van Buren County,2095,2011,84,4
CN4717700000000,2022-09-01,47,177,TN,Warren County,16282,15654,628,3.9
CN4717900000000,2022-09-01,47,179,TN,Washington County,61230,59318,1912,3.1
CN4718100000000,2022-09-01,47,181,TN,Wayne County,6468,6172,296,4.6
CN4718300000000,2022-09-01,47,183,TN,Weakley County,15338,14864,474,3.1
CN4718500000000,2022-09-01,47,185,TN,White County,11915,11509,406,3.4
CN4718700000000,2022-09-01,47,187,TN,Williamson County,137881,134674,3207,2.3
CN4718900000000,2022-09-01,47,189,TN,Wilson County,81671,79603,2068,2.5
CN4800100000000,2022-09-01,48,001,TX,Anderson County,22906,22163,743,3.2
CN4800300000000,2022-09-01,48,003,TX,Andrews County,9607,9332,275,2.9
CN4800500000000,2022-09-01,48,005,TX,Angelina County,36000,34479,1521,4.2
CN4800700000000,2022-09-01,48,007,TX,Aransas County,9270,8797,473,5.1
CN4800900000000,2022-09-01,48,009,TX,Archer County,3976,3853,123,3.1
CN4801100000000,2022-09-01,48,011,TX,Armstrong County,925,901,24,2.6
CN4801300000000,2022-09-01,48,013,TX,Atascosa County,22474,21624,850,3.8
CN4801500000000,2022-09-01,48,015,TX,Austin County,14134,13603,531,3.8
CN4801700000000,2022-09-01,48,017,TX,Bailey County,2352,2258,94,4
CN4801900000000,2022-09-01,48,019,TX,Bandera County,10653,10263,390,3.7
CN4802100000000,2022-09-01,48,021,TX,Bastrop County,48408,46874,1534,3.2
CN4802300000000,2022-09-01,48,023,TX,Baylor County,1937,1888,49,2.5
CN4802500000000,2022-09-01,48,025,TX,Bee County,9195,8701,494,5.4
CN4802700000000,2022-09-01,48,027,TX,Bell County,149299,142944,6355,4.3
CN4802900000000,2022-09-01,48,029,TX,Bexar County,978360,943600,34760,3.6
CN4803100000000,2022-09-01,48,031,TX,Blanco County,7174,6984,190,2.6
CN4803300000000,2022-09-01,48,033,TX,Borden County,646,635,11,1.7
CN4803500000000,2022-09-01,48,035,TX,Bosque County,8678,8376,302,3.5
CN4803700000000,2022-09-01,48,037,TX,Bowie County,38361,36657,1704,4.4
CN4803900000000,2022-09-01,48,039,TX,Brazoria County,184510,176684,7826,4.2
CN4804100000000,2022-09-01,48,041,TX,Brazos County,128679,124889,3790,2.9
CN4804300000000,2022-09-01,48,043,TX,Brewster County,4207,4075,132,3.1
CN4804500000000,2022-09-01,48,045,TX,Briscoe County,579,559,20,3.5
CN4804700000000,2022-09-01,48,047,TX,Brooks County,2347,2217,130,5.5
CN4804900000000,2022-09-01,48,049,TX,Brown County,15198,14577,621,4.1
CN4805100000000,2022-09-01,48,051,TX,Burleson County,8873,8562,311,3.5
CN4805300000000,2022-09-01,48,053,TX,Burnet County,25624,24903,721,2.8
CN4805500000000,2022-09-01,48,055,TX,Caldwell County,21360,20687,673,3.2
CN4805700000000,2022-09-01,48,057,TX,Calhoun County,12247,11832,415,3.4
CN4805900000000,2022-09-01,48,059,TX,Callahan County,6318,6104,214,3.4
CN4806100000000,2022-09-01,48,061,TX,Cameron County,177509,168306,9203,5.2
CN4806300000000,2022-09-01,48,063,TX,Camp County,5126,4904,222,4.3
CN4806500000000,2022-09-01,48,065,TX,Carson County,2973,2890,83,2.8
CN4806700000000,2022-09-01,48,067,TX,Cass County,11908,11391,517,4.3
CN4806900000000,2022-09-01,48,069,TX,Castro County,3279,3177,102,3.1
CN4807100000000,2022-09-01,48,071,TX,Chambers County,21025,19980,1045,5
CN4807300000000,2022-09-01,48,073,TX,Cherokee County,20436,19605,831,4.1
CN4807500000000,2022-09-01,48,075,TX,Childress County,3244,3156,88,2.7
CN4807700000000,2022-09-01,48,077,TX,Clay County,4814,4640,174,3.6
CN4807900000000,2022-09-01,48,079,TX,Cochran County,1089,1039,50,4.6
CN4808100000000,2022-09-01,48,081,TX,Coke County,1565,1513,52,3.3
CN4808300000000,2022-09-01,48,083,TX,Coleman County,3039,2915,124,4.1
CN4808500000000,2022-09-01,48,085,TX,Collin County,626965,607805,19160,3.1
CN4808700000000,2022-09-01,48,087,TX,Collingsworth County,1069,1030,39,3.6
CN4808900000000,2022-09-01,48,089,TX,Colorado County,10205,9864,341,3.3
CN4809100000000,2022-09-01,48,091,TX,Comal County,82416,79672,2744,3.3
CN4809300000000,2022-09-01,48,093,TX,Comanche County,6342,6131,211,3.3
CN4809500000000,2022-09-01,48,095,TX,Concho County,1271,1232,39,3.1
CN4809700000000,2022-09-01,48,097,TX,Cooke County,20005,19384,621,3.1
CN4809900000000,2022-09-01,48,099,TX,Coryell County,24667,23609,1058,4.3
CN4810100000000,2022-09-01,48,101,TX,Cottle County,904,880,24,2.7
CN4810300000000,2022-09-01,48,103,TX,Crane County,1694,1622,72,4.3
CN4810500000000,2022-09-01,48,105,TX,Crockett County,1463,1416,47,3.2
CN4810700000000,2022-09-01,48,107,TX,Crosby County,2386,2284,102,4.3
CN4810900000000,2022-09-01,48,109,TX,Culberson County,1173,1143,30,2.6
CN4811100000000,2022-09-01,48,111,TX,Dallam County,3777,3687,90,2.4
CN4811300000000,2022-09-01,48,113,TX,Dallas County,1425146,1374046,51100,3.6
CN4811500000000,2022-09-01,48,115,TX,Dawson County,4461,4274,187,4.2
CN4811700000000,2022-09-01,48,117,TX,Deaf Smith County,8870,8619,251,2.8
CN4811900000000,2022-09-01,48,119,TX,Delta County,2515,2413,102,4.1
CN4812100000000,2022-09-01,48,121,TX,Denton County,552775,535603,17172,3.1
CN4812300000000,2022-09-01,48,123,TX,DeWitt County,9165,8873,292,3.2
CN4812500000000,2022-09-01,48,125,TX,Dickens County,718,683,35,4.9
CN4812700000000,2022-09-01,48,127,TX,Dimmit County,6188,5970,218,3.5
CN4812900000000,2022-09-01,48,129,TX,Donley County,1446,1397,49,3.4
CN4813100000000,2022-09-01,48,131,TX,Duval County,5065,4875,190,3.8
CN4813300000000,2022-09-01,48,133,TX,Eastland County,6582,6298,284,4.3
CN4813500000000,2022-09-01,48,135,TX,Ector County,84593,81685,2908,3.4
CN4813700000000,2022-09-01,48,137,TX,Edwards County,1112,1081,31,2.8
CN4813900000000,2022-09-01,48,139,TX,Ellis County,103585,100130,3455,3.3
CN4814100000000,2022-09-01,48,141,TX,El Paso County,370522,355304,15218,4.1
CN4814300000000,2022-09-01,48,143,TX,Erath County,20888,20204,684,3.3
CN4814500000000,2022-09-01,48,145,TX,Falls County,6828,6570,258,3.8
CN4814700000000,2022-09-01,48,147,TX,Fannin County,17421,16739,682,3.9
CN4814900000000,2022-09-01,48,149,TX,Fayette County,11893,11484,409,3.4
CN4815100000000,2022-09-01,48,151,TX,Fisher County,1600,1545,55,3.4
CN4815300000000,2022-09-01,48,153,TX,Floyd County,2385,2288,97,4.1
CN4815500000000,2022-09-01,48,155,TX,Foard County,542,525,17,3.1
CN4815700000000,2022-09-01,48,157,TX,Fort Bend County,419656,403908,15748,3.8
CN4815900000000,2022-09-01,48,159,TX,Franklin County,5293,5109,184,3.5
CN4816100000000,2022-09-01,48,161,TX,Freestone County,6339,6020,319,5
CN4816300000000,2022-09-01,48,163,TX,Frio County,9487,9190,297,3.1
CN4816500000000,2022-09-01,48,165,TX,Gaines County,10059,9776,283,2.8
CN4816700000000,2022-09-01,48,167,TX,Galveston County,169416,162271,7145,4.2
CN4816900000000,2022-09-01,48,169,TX,Garza County,1983,1886,97,4.9
CN4817100000000,2022-09-01,48,171,TX,Gillespie County,14513,14150,363,2.5
CN4817300000000,2022-09-01,48,173,TX,Glasscock County,864,844,20,2.3
CN4817500000000,2022-09-01,48,175,TX,Goliad County,3205,3068,137,4.3
CN4817700000000,2022-09-01,48,177,TX,Gonzales County,9475,9173,302,3.2
CN4817900000000,2022-09-01,48,179,TX,Gray County,7616,7300,316,4.1
CN4818100000000,2022-09-01,48,181,TX,Grayson County,65840,63473,2367,3.6
CN4818300000000,2022-09-01,48,183,TX,Gregg County,57108,54808,2300,4
CN4818500000000,2022-09-01,48,185,TX,Grimes County,11450,10978,472,4.1
CN4818700000000,2022-09-01,48,187,TX,Guadalupe County,85508,82746,2762,3.2
CN4818900000000,2022-09-01,48,189,TX,Hale County,11467,10939,528,4.6
CN4819100000000,2022-09-01,48,191,TX,Hall County,1062,1018,44,4.1
CN4819300000000,2022-09-01,48,193,TX,Hamilton County,3841,3707,134,3.5
CN4819500000000,2022-09-01,48,195,TX,Hansford County,2869,2800,69,2.4
CN4819700000000,2022-09-01,48,197,TX,Hardeman County,1793,1735,58,3.2
CN4819900000000,2022-09-01,48,199,TX,Hardin County,24942,23744,1198,4.8
CN4820100000000,2022-09-01,48,201,TX,Harris County,2346081,2251730,94351,4
CN4820300000000,2022-09-01,48,203,TX,Harrison County,28907,27720,1187,4.1
CN4820500000000,2022-09-01,48,205,TX,Hartley County,2549,2499,50,2
CN4820700000000,2022-09-01,48,207,TX,Haskell County,2735,2663,72,2.6
CN4820900000000,2022-09-01,48,209,TX,Hays County,139352,135380,3972,2.9
CN4821100000000,2022-09-01,48,211,TX,Hemphill County,1598,1551,47,2.9
CN4821300000000,2022-09-01,48,213,TX,Henderson County,38833,37426,1407,3.6
CN4821500000000,2022-09-01,48,215,TX,Hidalgo County,370403,348283,22120,6
CN4821700000000,2022-09-01,48,217,TX,Hill County,17977,17339,638,3.5
CN4821900000000,2022-09-01,48,219,TX,Hockley County,10642,10276,366,3.4
CN4822100000000,2022-09-01,48,221,TX,Hood County,30053,28940,1113,3.7
CN4822300000000,2022-09-01,48,223,TX,Hopkins County,18231,17656,575,3.2
CN4822500000000,2022-09-01,48,225,TX,Houston County,10615,10261,354,3.3
CN4822700000000,2022-09-01,48,227,TX,Howard County,12837,12276,561,4.4
CN4822900000000,2022-09-01,48,229,TX,Hudspeth County,1867,1793,74,4
CN4823100000000,2022-09-01,48,231,TX,Hunt County,46964,45166,1798,3.8
CN4823300000000,2022-09-01,48,233,TX,Hutchinson County,8360,8003,357,4.3
CN4823500000000,2022-09-01,48,235,TX,Irion County,788,766,22,2.8
CN4823700000000,2022-09-01,48,237,TX,Jack County,3449,3325,124,3.6
CN4823900000000,2022-09-01,48,239,TX,Jackson County,7013,6779,234,3.3
CN4824100000000,2022-09-01,48,241,TX,Jasper County,12732,12004,728,5.7
CN4824300000000,2022-09-01,48,243,TX,Jeff Davis County,981,946,35,3.6
CN4824500000000,2022-09-01,48,245,TX,Jefferson County,101213,95375,5838,5.8
CN4824700000000,2022-09-01,48,247,TX,Jim Hogg County,1792,1710,82,4.6
CN4824900000000,2022-09-01,48,249,TX,Jim Wells County,15344,14544,800,5.2
CN4825100000000,2022-09-01,48,251,TX,Johnson County,89187,86223,2964,3.3
CN4825300000000,2022-09-01,48,253,TX,Jones County,5811,5578,233,4
CN4825500000000,2022-09-01,48,255,TX,Karnes County,6590,6394,196,3
CN4825700000000,2022-09-01,48,257,TX,Kaufman County,75284,72513,2771,3.7
CN4825900000000,2022-09-01,48,259,TX,Kendall County,23791,23065,726,3.1
CN4826100000000,2022-09-01,48,261,TX,Kenedy County,117,109,8,6.8
CN4826300000000,2022-09-01,48,263,TX,Kent County,777,763,14,1.8
CN4826500000000,2022-09-01,48,265,TX,Kerr County,22079,21306,773,3.5
CN4826700000000,2022-09-01,48,267,TX,Kimble County,1781,1724,57,3.2
CN4826900000000,2022-09-01,48,269,TX,King County,491,486,5,1
CN4827100000000,2022-09-01,48,271,TX,Kinney County,1243,1185,58,4.7
CN4827300000000,2022-09-01,48,273,TX,Kleberg County,12783,12211,572,4.5
CN4827500000000,2022-09-01,48,275,TX,Knox County,1464,1407,57,3.9
CN4827700000000,2022-09-01,48,277,TX,Lamar County,24322,23308,1014,4.2
CN4827900000000,2022-09-01,48,279,TX,Lamb County,5196,5001,195,3.8
CN4828100000000,2022-09-01,48,281,TX,Lampasas County,9431,9095,336,3.6
CN4828300000000,2022-09-01,48,283,TX,La Salle County,4125,4012,113,2.7
CN4828500000000,2022-09-01,48,285,TX,Lavaca County,9033,8745,288,3.2
CN4828700000000,2022-09-01,48,287,TX,Lee County,8874,8577,297,3.3
CN4828900000000,2022-09-01,48,289,TX,Leon County,6069,5769,300,4.9
CN4829100000000,2022-09-01,48,291,TX,Liberty County,35229,33343,1886,5.4
CN4829300000000,2022-09-01,48,293,TX,Limestone County,8430,8061,369,4.4
CN4829500000000,2022-09-01,48,295,TX,Lipscomb County,1454,1413,41,2.8
CN4829700000000,2022-09-01,48,297,TX,Live Oak County,4811,4621,190,3.9
CN4829900000000,2022-09-01,48,299,TX,Llano County,9346,9000,346,3.7
CN4830100000000,2022-09-01,48,301,TX,Loving County,1330,1325,5,0.4
CN4830300000000,2022-09-01,48,303,TX,Lubbock County,162993,157820,5173,3.2
CN4830500000000,2022-09-01,48,305,TX,Lynn County,2831,2732,99,3.5
CN4830700000000,2022-09-01,48,307,TX,McCulloch County,3161,3037,124,3.9
CN4830900000000,2022-09-01,48,309,TX,McLennan County,127592,123334,4258,3.3
CN4831100000000,2022-09-01,48,311,TX,McMullen County,903,887,16,1.8
CN4831300000000,2022-09-01,48,313,TX,Madison County,4672,4485,187,4
CN4831500000000,2022-09-01,48,315,TX,Marion County,4169,3976,193,4.6
CN4831700000000,2022-09-01,48,317,TX,Martin County,2814,2737,77,2.7
CN4831900000000,2022-09-01,48,319,TX,Mason County,1801,1740,61,3.4
CN4832100000000,2022-09-01,48,321,TX,Matagorda County,17047,16083,964,5.7
CN4832300000000,2022-09-01,48,323,TX,Maverick County,22837,21490,1347,5.9
CN4832500000000,2022-09-01,48,325,TX,Medina County,22640,21812,828,3.7
CN4832700000000,2022-09-01,48,327,TX,Menard County,858,827,31,3.6
CN4832900000000,2022-09-01,48,329,TX,Midland County,107563,104739,2824,2.6
CN4833100000000,2022-09-01,48,331,TX,Milam County,10293,9864,429,4.2
CN4833300000000,2022-09-01,48,333,TX,Mills County,1852,1777,75,4
CN4833500000000,2022-09-01,48,335,TX,Mitchell County,2282,2191,91,4
CN4833700000000,2022-09-01,48,337,TX,Montague County,9283,8954,329,3.5
CN4833900000000,2022-09-01,48,339,TX,Montgomery County,302794,291527,11267,3.7
CN4834100000000,2022-09-01,48,341,TX,Moore County,11189,10912,277,2.5
CN4834300000000,2022-09-01,48,343,TX,Morris County,4504,4242,262,5.8
CN4834500000000,2022-09-01,48,345,TX,Motley County,510,490,20,3.9
CN4834700000000,2022-09-01,48,347,TX,Nacogdoches County,27907,26771,1136,4.1
CN4834900000000,2022-09-01,48,349,TX,Navarro County,23797,22939,858,3.6
CN4835100000000,2022-09-01,48,351,TX,Newton County,4862,4563,299,6.1
CN4835300000000,2022-09-01,48,353,TX,Nolan County,6655,6416,239,3.6
CN4835500000000,2022-09-01,48,355,TX,Nueces County,163055,155965,7090,4.3
CN4835700000000,2022-09-01,48,357,TX,Ochiltree County,3872,3740,132,3.4
CN4835900000000,2022-09-01,48,359,TX,Oldham County,921,896,25,2.7
CN4836100000000,2022-09-01,48,361,TX,Orange County,34913,33071,1842,5.3
CN4836300000000,2022-09-01,48,363,TX,Palo Pinto County,13166,12702,464,3.5
CN4836500000000,2022-09-01,48,365,TX,Panola County,9620,9225,395,4.1
CN4836700000000,2022-09-01,48,367,TX,Parker County,74833,72445,2388,3.2
CN4836900000000,2022-09-01,48,369,TX,Parmer County,5026,4911,115,2.3
CN4837100000000,2022-09-01,48,371,TX,Pecos County,6367,6152,215,3.4
CN4837300000000,2022-09-01,48,373,TX,Polk County,18777,17820,957,5.1
CN4837500000000,2022-09-01,48,375,TX,Potter County,54682,53049,1633,3
CN4837700000000,2022-09-01,48,377,TX,Presidio County,2968,2800,168,5.7
CN4837900000000,2022-09-01,48,379,TX,Rains County,6507,6289,218,3.4
CN4838100000000,2022-09-01,48,381,TX,Randall County,75401,73351,2050,2.7
CN4838300000000,2022-09-01,48,383,TX,Reagan County,1612,1560,52,3.2
CN4838500000000,2022-09-01,48,385,TX,Real County,1095,1046,49,4.5
CN4838700000000,2022-09-01,48,387,TX,Red River County,5107,4856,251,4.9
CN4838900000000,2022-09-01,48,389,TX,Reeves County,8543,8252,291,3.4
CN4839100000000,2022-09-01,48,391,TX,Refugio County,2933,2809,124,4.2
CN4839300000000,2022-09-01,48,393,TX,Roberts County,391,377,14,3.6
CN4839500000000,2022-09-01,48,395,TX,Robertson County,7951,7668,283,3.6
CN4839700000000,2022-09-01,48,397,TX,Rockwall County,59449,57516,1933,3.3
CN4839900000000,2022-09-01,48,399,TX,Runnels County,4608,4462,146,3.2
CN4840100000000,2022-09-01,48,401,TX,Rusk County,22488,21598,890,4
CN4840300000000,2022-09-01,48,403,TX,Sabine County,3866,3611,255,6.6
CN4840500000000,2022-09-01,48,405,TX,San Augustine County,3150,2976,174,5.5
CN4840700000000,2022-09-01,48,407,TX,San Jacinto County,12053,11489,564,4.7
CN4840900000000,2022-09-01,48,409,TX,San Patricio County,29032,27385,1647,5.7
CN4841100000000,2022-09-01,48,411,TX,San Saba County,2198,2124,74,3.4
CN4841300000000,2022-09-01,48,413,TX,Schleicher County,1217,1176,41,3.4
CN4841500000000,2022-09-01,48,415,TX,Scurry County,6297,6055,242,3.8
CN4841700000000,2022-09-01,48,417,TX,Shackelford County,1805,1761,44,2.4
CN4841900000000,2022-09-01,48,419,TX,Shelby County,11173,10734,439,3.9
CN4842100000000,2022-09-01,48,421,TX,Sherman County,1384,1348,36,2.6
CN4842300000000,2022-09-01,48,423,TX,Smith County,111899,107900,3999,3.6
CN4842500000000,2022-09-01,48,425,TX,Somervell County,4594,4420,174,3.8
CN4842700000000,2022-09-01,48,427,TX,Starr County,23906,21643,2263,9.5
CN4842900000000,2022-09-01,48,429,TX,Stephens County,4001,3855,146,3.6
CN4843100000000,2022-09-01,48,431,TX,Sterling County,502,483,19,3.8
CN4843300000000,2022-09-01,48,433,TX,Stonewall County,814,794,20,2.5
CN4843500000000,2022-09-01,48,435,TX,Sutton County,1026,977,49,4.8
CN4843700000000,2022-09-01,48,437,TX,Swisher County,2590,2493,97,3.7
CN4843900000000,2022-09-01,48,439,TX,Tarrant County,1143737,1103823,39914,3.5
CN4844100000000,2022-09-01,48,441,TX,Taylor County,69104,66943,2161,3.1
CN4844300000000,2022-09-01,48,443,TX,Terrell County,405,392,13,3.2
CN4844500000000,2022-09-01,48,445,TX,Terry County,4566,4390,176,3.9
CN4844700000000,2022-09-01,48,447,TX,Throckmorton County,702,683,19,2.7
CN4844900000000,2022-09-01,48,449,TX,Titus County,13837,13238,599,4.3
CN4845100000000,2022-09-01,48,451,TX,Tom Green County,55443,53654,1789,3.2
CN4845300000000,2022-09-01,48,453,TX,Travis County,828779,806034,22745,2.7
CN4845500000000,2022-09-01,48,455,TX,Trinity County,5359,5097,262,4.9
CN4845700000000,2022-09-01,48,457,TX,Tyler County,7137,6739,398,5.6
CN4845900000000,2022-09-01,48,459,TX,Upshur County,17872,17151,721,4
CN4846100000000,2022-09-01,48,461,TX,Upton County,2337,2280,57,2.4
CN4846300000000,2022-09-01,48,463,TX,Uvalde County,11103,10616,487,4.4
CN4846500000000,2022-09-01,48,465,TX,Val Verde County,22036,21175,861,3.9
CN4846700000000,2022-09-01,48,467,TX,Van Zandt County,27775,26846,929,3.3
CN4846900000000,2022-09-01,48,469,TX,Victoria County,41408,39787,1621,3.9
CN4847100000000,2022-09-01,48,471,TX,Walker County,23998,22961,1037,4.3
CN4847300000000,2022-09-01,48,473,TX,Waller County,25431,24409,1022,4
CN4847500000000,2022-09-01,48,475,TX,Ward County,6308,6102,206,3.3
CN4847700000000,2022-09-01,48,477,TX,Washington County,15137,14571,566,3.7
CN4847900000000,2022-09-01,48,479,TX,Webb County,117224,112999,4225,3.6
CN4848100000000,2022-09-01,48,481,TX,Wharton County,21330,20541,789,3.7
CN4848300000000,2022-09-01,48,483,TX,Wheeler County,1964,1893,71,3.6
CN4848500000000,2022-09-01,48,485,TX,Wichita County,55161,53165,1996,3.6
CN4848700000000,2022-09-01,48,487,TX,Wilbarger County,4738,4513,225,4.7
CN4848900000000,2022-09-01,48,489,TX,Willacy County,7103,6583,520,7.3
CN4849100000000,2022-09-01,48,491,TX,Williamson County,366702,356342,10360,2.8
CN4849300000000,2022-09-01,48,493,TX,Wilson County,25970,25168,802,3.1
CN4849500000000,2022-09-01,48,495,TX,Winkler County,3911,3782,129,3.3
CN4849700000000,2022-09-01,48,497,TX,Wise County,34349,33208,1141,3.3
CN4849900000000,2022-09-01,48,499,TX,Wood County,18317,17548,769,4.2
CN4850100000000,2022-09-01,48,501,TX,Yoakum County,3287,3171,116,3.5
CN4850300000000,2022-09-01,48,503,TX,Young County,7988,7730,258,3.2
CN4850500000000,2022-09-01,48,505,TX,Zapata County,4454,4179,275,6.2
CN4850700000000,2022-09-01,48,507,TX,Zavala County,3354,3096,258,7.7
CN4900100000000,2022-09-01,49,001,UT,Beaver County,2731,2661,70,2.6
CN4900300000000,2022-09-01,49,003,UT,Box Elder County,27629,27060,569,2.1
CN4900500000000,2022-09-01,49,005,UT,Cache County,71592,70306,1286,1.8
CN4900700000000,2022-09-01,49,007,UT,Carbon County,8350,8091,259,3.1
CN4900900000000,2022-09-01,49,009,UT,Daggett County,460,444,16,3.5
CN4901100000000,2022-09-01,49,011,UT,Davis County,185269,181559,3710,2
CN4901300000000,2022-09-01,49,013,UT,Duchesne County,8085,7875,210,2.6
CN4901500000000,2022-09-01,49,015,UT,Emery County,4439,4309,130,2.9
CN4901700000000,2022-09-01,49,017,UT,Garfield County,3166,3078,88,2.8
CN4901900000000,2022-09-01,49,019,UT,Grand County,7282,7154,128,1.8
CN4902100000000,2022-09-01,49,021,UT,Iron County,27987,27391,596,2.1
CN4902300000000,2022-09-01,49,023,UT,Juab County,6474,6361,113,1.7
CN4902500000000,2022-09-01,49,025,UT,Kane County,4237,4154,83,2
CN4902700000000,2022-09-01,49,027,UT,Millard County,5995,5864,131,2.2
CN4902900000000,2022-09-01,49,029,UT,Morgan County,5969,5862,107,1.8
CN4903100000000,2022-09-01,49,031,UT,Piute County,518,500,18,3.5
CN4903300000000,2022-09-01,49,033,UT,Rich County,1283,1256,27,2.1
CN4903500000000,2022-09-01,49,035,UT,Salt Lake County,683594,669197,14397,2.1
CN4903700000000,2022-09-01,49,037,UT,San Juan County,5678,5495,183,3.2
CN4903900000000,2022-09-01,49,039,UT,Sanpete County,13730,13390,340,2.5
CN4904100000000,2022-09-01,49,041,UT,Sevier County,10250,10007,243,2.4
CN4904300000000,2022-09-01,49,043,UT,Summit County,25149,24662,487,1.9
CN4904500000000,2022-09-01,49,045,UT,Tooele County,38503,37617,886,2.3
CN4904700000000,2022-09-01,49,047,UT,Uintah County,14318,13890,428,3
CN4904900000000,2022-09-01,49,049,UT,Utah County,348761,341895,6866,2
CN4905100000000,2022-09-01,49,051,UT,Wasatch County,17665,17300,365,2.1
CN4905300000000,2022-09-01,49,053,UT,Washington County,87644,85654,1990,2.3
CN4905500000000,2022-09-01,49,055,UT,Wayne County,1583,1537,46,2.9
CN4905700000000,2022-09-01,49,057,UT,Weber County,135668,132678,2990,2.2
CN5000100000000,2022-09-01,50,001,VT,Addison County,20672,20183,489,2.4
CN5000300000000,2022-09-01,50,003,VT,Bennington County,17555,16979,576,3.3
CN5000500000000,2022-09-01,50,005,VT,Caledonia County,14712,14261,451,3.1
CN5000700000000,2022-09-01,50,007,VT,Chittenden County,97725,95360,2365,2.4
CN5000900000000,2022-09-01,50,009,VT,Essex County,2715,2601,114,4.2
CN5001100000000,2022-09-01,50,011,VT,Franklin County,27740,27068,672,2.4
CN5001300000000,2022-09-01,50,013,VT,Grand Isle County,4094,4000,94,2.3
CN5001500000000,2022-09-01,50,015,VT,Lamoille County,14033,13592,441,3.1
CN5001700000000,2022-09-01,50,017,VT,Orange County,15799,15420,379,2.4
CN5001900000000,2022-09-01,50,019,VT,Orleans County,13362,12840,522,3.9
CN5002100000000,2022-09-01,50,021,VT,Rutland County,29565,28509,1056,3.6
CN5002300000000,2022-09-01,50,023,VT,Washington County,33749,32899,850,2.5
CN5002500000000,2022-09-01,50,025,VT,Windham County,21266,20619,647,3
CN5002700000000,2022-09-01,50,027,VT,Windsor County,28720,28032,688,2.4
CN5100100000000,2022-09-01,51,001,VA,Accomack County,15869,15398,471,3
CN5100300000000,2022-09-01,51,003,VA,Albemarle County,58466,56873,1593,2.7
CN5100500000000,2022-09-01,51,005,VA,Alleghany County,6757,6541,216,3.2
CN5100700000000,2022-09-01,51,007,VA,Amelia County,6287,6096,191,3
CN5100900000000,2022-09-01,51,009,VA,Amherst County,14926,14423,503,3.4
CN5101100000000,2022-09-01,51,011,VA,Appomattox County,7169,6929,240,3.3
CN5101300000000,2022-09-01,51,013,VA,Arlington County,157004,153793,3211,2
CN5101500000000,2022-09-01,51,015,VA,Augusta County,38371,37353,1018,2.7
CN5101700000000,2022-09-01,51,017,VA,Bath County,2645,2583,62,2.3
CN5101900000000,2022-09-01,51,019,VA,Bedford County,38584,37479,1105,2.9
CN5102100000000,2022-09-01,51,021,VA,Bland County,2850,2769,81,2.8
CN5102300000000,2022-09-01,51,023,VA,Botetourt County,17747,17278,469,2.6
CN5102500000000,2022-09-01,51,025,VA,Brunswick County,5902,5620,282,4.8
CN5102700000000,2022-09-01,51,027,VA,Buchanan County,6304,6013,291,4.6
CN5102900000000,2022-09-01,51,029,VA,Buckingham County,6461,6215,246,3.8
CN5103100000000,2022-09-01,51,031,VA,Campbell County,25935,25110,825,3.2
CN5103300000000,2022-09-01,51,033,VA,Caroline County,15465,14928,537,3.5
CN5103500000000,2022-09-01,51,035,VA,Carroll County,12997,12545,452,3.5
CN5103600000000,2022-09-01,51,036,VA,Charles City County,3604,3498,106,2.9
CN5103700000000,2022-09-01,51,037,VA,Charlotte County,5590,5403,187,3.3
CN5104100000000,2022-09-01,51,041,VA,Chesterfield County,195124,189279,5845,3
CN5104300000000,2022-09-01,51,043,VA,Clarke County,7639,7442,197,2.6
CN5104500000000,2022-09-01,51,045,VA,Craig County,2319,2243,76,3.3
CN5104700000000,2022-09-01,51,047,VA,Culpeper County,25434,24715,719,2.8
CN5104900000000,2022-09-01,51,049,VA,Cumberland County,4821,4656,165,3.4
CN5105100000000,2022-09-01,51,051,VA,Dickenson County,4584,4380,204,4.5
CN5105300000000,2022-09-01,51,053,VA,Dinwiddie County,13827,13350,477,3.4
CN5105700000000,2022-09-01,51,057,VA,Essex County,5546,5345,201,3.6
CN5105900000000,2022-09-01,51,059,VA,Fairfax County,639072,622946,16126,2.5
CN5106100000000,2022-09-01,51,061,VA,Fauquier County,37678,36664,1014,2.7
CN5106300000000,2022-09-01,51,063,VA,Floyd County,8577,8369,208,2.4
CN5106500000000,2022-09-01,51,065,VA,Fluvanna County,14324,13949,375,2.6
CN5106700000000,2022-09-01,51,067,VA,Franklin County,26557,25723,834,3.1
CN5106900000000,2022-09-01,51,069,VA,Frederick County,51665,50392,1273,2.5
CN5107100000000,2022-09-01,51,071,VA,Giles County,8282,8025,257,3.1
CN5107300000000,2022-09-01,51,073,VA,Gloucester County,19514,18969,545,2.8
CN5107500000000,2022-09-01,51,075,VA,Goochland County,11851,11516,335,2.8
CN5107700000000,2022-09-01,51,077,VA,Grayson County,8105,7897,208,2.6
CN5107900000000,2022-09-01,51,079,VA,Greene County,10704,10439,265,2.5
CN5108100000000,2022-09-01,51,081,VA,Greensville County,4359,4179,180,4.1
CN5108300000000,2022-09-01,51,083,VA,Halifax County,15540,14940,600,3.9
CN5108500000000,2022-09-01,51,085,VA,Hanover County,60396,58882,1514,2.5
CN5108700000000,2022-09-01,51,087,VA,Henrico County,186887,181258,5629,3
CN5108900000000,2022-09-01,51,089,VA,Henry County,23875,23073,802,3.4
CN5109100000000,2022-09-01,51,091,VA,Highland County,1430,1400,30,2.1
CN5109300000000,2022-09-01,51,093,VA,Isle of Wight County,19673,19115,558,2.8
CN5109500000000,2022-09-01,51,095,VA,James City County,36996,35929,1067,2.9
CN5109700000000,2022-09-01,51,097,VA,King and Queen County,3962,3850,112,2.8
CN5109900000000,2022-09-01,51,099,VA,King George County,14390,14004,386,2.7
CN5110100000000,2022-09-01,51,101,VA,King William County,9589,9318,271,2.8
CN5110300000000,2022-09-01,51,103,VA,Lancaster County,5440,5279,161,3
CN5110500000000,2022-09-01,51,105,VA,Lee County,8250,7928,322,3.9
CN5110700000000,2022-09-01,51,107,VA,Loudoun County,232717,226980,5737,2.5
CN5110900000000,2022-09-01,51,109,VA,Louisa County,20917,20349,568,2.7
CN5111100000000,2022-09-01,51,111,VA,Lunenburg County,5220,5012,208,4
CN5111300000000,2022-09-01,51,113,VA,Madison County,7530,7360,170,2.3
CN5111500000000,2022-09-01,51,115,VA,Mathews County,4090,3971,119,2.9
CN5111700000000,2022-09-01,51,117,VA,Mecklenburg County,13176,12699,477,3.6
CN5111900000000,2022-09-01,51,119,VA,Middlesex County,5416,5265,151,2.8
CN5112100000000,2022-09-01,51,121,VA,Montgomery County,53281,51794,1487,2.8
CN5112500000000,2022-09-01,51,125,VA,Nelson County,7356,7152,204,2.8
CN5112700000000,2022-09-01,51,127,VA,New Kent County,13289,12964,325,2.4
CN5113100000000,2022-09-01,51,131,VA,Northampton County,5515,5333,182,3.3
CN5113300000000,2022-09-01,51,133,VA,Northumberland County,5555,5345,210,3.8
CN5113500000000,2022-09-01,51,135,VA,Nottoway County,7288,7042,246,3.4
CN5113700000000,2022-09-01,51,137,VA,Orange County,17452,16930,522,3
CN5113900000000,2022-09-01,51,139,VA,Page County,12248,11875,373,3
CN5114100000000,2022-09-01,51,141,VA,Patrick County,7158,6901,257,3.6
CN5114300000000,2022-09-01,51,143,VA,Pittsylvania County,30212,29238,974,3.2
CN5114500000000,2022-09-01,51,145,VA,Powhatan County,14725,14341,384,2.6
CN5114700000000,2022-09-01,51,147,VA,Prince Edward County,10023,9624,399,4
CN5114900000000,2022-09-01,51,149,VA,Prince George County,15538,14961,577,3.7
CN5115300000000,2022-09-01,51,153,VA,Prince William County,251469,244415,7054,2.8
CN5115500000000,2022-09-01,51,155,VA,Pulaski County,17009,16511,498,2.9
CN5115700000000,2022-09-01,51,157,VA,Rappahannock County,3662,3571,91,2.5
CN5115900000000,2022-09-01,51,159,VA,Richmond County,3972,3860,112,2.8
CN5116100000000,2022-09-01,51,161,VA,Roanoke County,50099,48761,1338,2.7
CN5116300000000,2022-09-01,51,163,VA,Rockbridge County,10932,10627,305,2.8
CN5116500000000,2022-09-01,51,165,VA,Rockingham County,42856,41730,1126,2.6
CN5116700000000,2022-09-01,51,167,VA,Russell County,10955,10563,392,3.6
CN5116900000000,2022-09-01,51,169,VA,Scott County,9292,8993,299,3.2
CN5117100000000,2022-09-01,51,171,VA,Shenandoah County,22126,21464,662,3
CN5117300000000,2022-09-01,51,173,VA,Smyth County,13491,13071,420,3.1
CN5117500000000,2022-09-01,51,175,VA,Southampton County,8834,8575,259,2.9
CN5117700000000,2022-09-01,51,177,VA,Spotsylvania County,69569,67416,2153,3.1
CN5117900000000,2022-09-01,51,179,VA,Stafford County,75967,73676,2291,3
CN5118100000000,2022-09-01,51,181,VA,Surry County,3650,3542,108,3
CN5118300000000,2022-09-01,51,183,VA,Sussex County,3681,3520,161,4.4
CN5118500000000,2022-09-01,51,185,VA,Tazewell County,15412,14750,662,4.3
CN5118700000000,2022-09-01,51,187,VA,Warren County,20746,20118,628,3
CN5119100000000,2022-09-01,51,191,VA,Washington County,26639,25875,764,2.9
CN5119300000000,2022-09-01,51,193,VA,Westmoreland County,9496,9157,339,3.6
CN5119500000000,2022-09-01,51,195,VA,Wise County,12839,12313,526,4.1
CN5119700000000,2022-09-01,51,197,VA,Wythe County,14206,13782,424,3
CN5119900000000,2022-09-01,51,199,VA,York County,33288,32359,929,2.8
CN5151000000000,2022-09-01,51,510,VA,Alexandria city,100922,98510,2412,2.4
CN5152000000000,2022-09-01,51,520,VA,Bristol city,7636,7373,263,3.4
CN5153000000000,2022-09-01,51,530,VA,Buena Vista city,3185,3087,98,3.1
CN5154000000000,2022-09-01,51,540,VA,Charlottesville city,25958,25298,660,2.5
CN5155000000000,2022-09-01,51,550,VA,Chesapeake city,124611,120706,3905,3.1
CN5157000000000,2022-09-01,51,570,VA,Colonial Heights city,8609,8306,303,3.5
CN5158000000000,2022-09-01,51,580,VA,Covington city,2324,2224,100,4.3
CN5159000000000,2022-09-01,51,590,VA,Danville city,18763,17823,940,5
CN5159500000000,2022-09-01,51,595,VA,Emporia city,2332,2224,108,4.6
CN5160000000000,2022-09-01,51,600,VA,Fairfax city,12912,12592,320,2.5
CN5161000000000,2022-09-01,51,610,VA,Falls Church city,8567,8370,197,2.3
CN5162000000000,2022-09-01,51,620,VA,Franklin city,3451,3305,146,4.2
CN5163000000000,2022-09-01,51,630,VA,Fredericksburg city,14430,13921,509,3.5
CN5164000000000,2022-09-01,51,640,VA,Galax city,2855,2774,81,2.8
CN5165000000000,2022-09-01,51,650,VA,Hampton city,64801,62169,2632,4.1
CN5166000000000,2022-09-01,51,660,VA,Harrisonburg city,25028,24120,908,3.6
CN5167000000000,2022-09-01,51,670,VA,Hopewell city,9719,9282,437,4.5
CN5167800000000,2022-09-01,51,678,VA,Lexington city,2304,2204,100,4.3
CN5168000000000,2022-09-01,51,680,VA,Lynchburg city,35992,34516,1476,4.1
CN5168300000000,2022-09-01,51,683,VA,Manassas city,21767,21192,575,2.6
CN5168500000000,2022-09-01,51,685,VA,Manassas Park city,9797,9538,259,2.6
CN5169000000000,2022-09-01,51,690,VA,Martinsville city,5589,5318,271,4.8
CN5170000000000,2022-09-01,51,700,VA,Newport News city,89068,85566,3502,3.9
CN5171000000000,2022-09-01,51,710,VA,Norfolk city,110854,106731,4123,3.7
CN5172000000000,2022-09-01,51,720,VA,Norton city,1589,1527,62,3.9
CN5173000000000,2022-09-01,51,730,VA,Petersburg city,12730,11988,742,5.8
CN5173500000000,2022-09-01,51,735,VA,Poquoson city,6384,6210,174,2.7
CN5174000000000,2022-09-01,51,740,VA,Portsmouth city,44351,42550,1801,4.1
CN5175000000000,2022-09-01,51,750,VA,Radford city,9250,8911,339,3.7
CN5176000000000,2022-09-01,51,760,VA,Richmond city,121593,117279,4314,3.5
CN5177000000000,2022-09-01,51,770,VA,Roanoke city,49267,47676,1591,3.2
CN5177500000000,2022-09-01,51,775,VA,Salem city,12990,12595,395,3
CN5179000000000,2022-09-01,51,790,VA,Staunton city,12511,12165,346,2.8
CN5180000000000,2022-09-01,51,800,VA,Suffolk city,45840,44357,1483,3.2
CN5181000000000,2022-09-01,51,810,VA,Virginia Beach city,232838,225983,6855,2.9
CN5182000000000,2022-09-01,51,820,VA,Waynesboro city,10898,10557,341,3.1
CN5183000000000,2022-09-01,51,830,VA,Williamsburg city,6848,6551,297,4.3
CN5184000000000,2022-09-01,51,840,VA,Winchester city,15149,14712,437,2.9
CN5300100000000,2022-09-01,53,001,WA,Adams County,10676,10289,387,3.6
CN5300300000000,2022-09-01,53,003,WA,Asotin County,10598,10231,367,3.5
CN5300500000000,2022-09-01,53,005,WA,Benton County,106534,101869,4665,4.4
CN5300700000000,2022-09-01,53,007,WA,Chelan County,45757,44055,1702,3.7
CN5300900000000,2022-09-01,53,009,WA,Clallam County,29122,27570,1552,5.3
CN5301100000000,2022-09-01,53,011,WA,Clark County,247321,236398,10923,4.4
CN5301300000000,2022-09-01,53,013,WA,Columbia County,1764,1683,81,4.6
CN5301500000000,2022-09-01,53,015,WA,Cowlitz County,48792,46181,2611,5.4
CN5301700000000,2022-09-01,53,017,WA,Douglas County,22373,21443,930,4.2
CN5301900000000,2022-09-01,53,019,WA,Ferry County,2273,2087,186,8.2
CN5302100000000,2022-09-01,53,021,WA,Franklin County,44866,42631,2235,5
CN5302300000000,2022-09-01,53,023,WA,Garfield County,805,762,43,5.3
CN5302500000000,2022-09-01,53,025,WA,Grant County,51648,49373,2275,4.4
CN5302700000000,2022-09-01,53,027,WA,Grays Harbor County,29224,27428,1796,6.1
CN5302900000000,2022-09-01,53,029,WA,Island County,37013,35324,1689,4.6
CN5303100000000,2022-09-01,53,031,WA,Jefferson County,12759,12101,658,5.2
CN5303300000000,2022-09-01,53,033,WA,King County,1332295,1289836,42459,3.2
CN5303500000000,2022-09-01,53,035,WA,Kitsap County,127876,122454,5422,4.2
CN5303700000000,2022-09-01,53,037,WA,Kittitas County,22735,21609,1126,5
CN5303900000000,2022-09-01,53,039,WA,Klickitat County,9855,9371,484,4.9
CN5304100000000,2022-09-01,53,041,WA,Lewis County,34766,32891,1875,5.4
CN5304300000000,2022-09-01,53,043,WA,Lincoln County,4684,4474,210,4.5
CN5304500000000,2022-09-01,53,045,WA,Mason County,25343,23844,1499,5.9
CN5304700000000,2022-09-01,53,047,WA,Okanogan County,20265,19250,1015,5
CN5304900000000,2022-09-01,53,049,WA,Pacific County,8862,8208,654,7.4
CN5305100000000,2022-09-01,53,051,WA,Pend Oreille County,5110,4812,298,5.8
CN5305300000000,2022-09-01,53,053,WA,Pierce County,450768,429320,21448,4.8
CN5305500000000,2022-09-01,53,055,WA,San Juan County,9042,8749,293,3.2
CN5305700000000,2022-09-01,53,057,WA,Skagit County,61766,58926,2840,4.6
CN5305900000000,2022-09-01,53,059,WA,Skamania County,5509,5261,248,4.5
CN5306100000000,2022-09-01,53,061,WA,Snohomish County,453848,438010,15838,3.5
CN5306300000000,2022-09-01,53,063,WA,Spokane County,262063,250707,11356,4.3
CN5306500000000,2022-09-01,53,065,WA,Stevens County,19009,17963,1046,5.5
CN5306700000000,2022-09-01,53,067,WA,Thurston County,148060,141701,6359,4.3
CN5306900000000,2022-09-01,53,069,WA,Wahkiakum County,1391,1304,87,6.3
CN5307100000000,2022-09-01,53,071,WA,Walla Walla County,30854,29589,1265,4.1
CN5307300000000,2022-09-01,53,073,WA,Whatcom County,113955,108822,5133,4.5
CN5307500000000,2022-09-01,53,075,WA,Whitman County,23762,22759,1003,4.2
CN5307700000000,2022-09-01,53,077,WA,Yakima County,138338,131706,6632,4.8
CN5400100000000,2022-09-01,54,001,WV,Barbour County,7395,7122,273,3.7
CN5400300000000,2022-09-01,54,003,WV,Berkeley County,60243,58671,1572,2.6
CN5400500000000,2022-09-01,54,005,WV,Boone County,7006,6740,266,3.8
CN5400700000000,2022-09-01,54,007,WV,Braxton County,5032,4791,241,4.8
CN5400900000000,2022-09-01,54,009,WV,Brooke County,9900,9511,389,3.9
CN5401100000000,2022-09-01,54,011,WV,Cabell County,41748,40465,1283,3.1
CN5401300000000,2022-09-01,54,013,WV,Calhoun County,2447,2315,132,5.4
CN5401500000000,2022-09-01,54,015,WV,Clay County,2935,2795,140,4.8
CN5401700000000,2022-09-01,54,017,WV,Doddridge County,3952,3852,100,2.5
CN5401900000000,2022-09-01,54,019,WV,Fayette County,15720,15117,603,3.8
CN5402100000000,2022-09-01,54,021,WV,Gilmer County,2320,2234,86,3.7
CN5402300000000,2022-09-01,54,023,WV,Grant County,6052,5879,173,2.9
CN5402500000000,2022-09-01,54,025,WV,Greenbrier County,15528,15043,485,3.1
CN5402700000000,2022-09-01,54,027,WV,Hampshire County,11436,11179,257,2.2
CN5402900000000,2022-09-01,54,029,WV,Hancock County,13074,12481,593,4.5
CN5403100000000,2022-09-01,54,031,WV,Hardy County,5799,5618,181,3.1
CN5403300000000,2022-09-01,54,033,WV,Harrison County,33605,32599,1006,3
CN5403500000000,2022-09-01,54,035,WV,Jackson County,11725,11319,406,3.5
CN5403700000000,2022-09-01,54,037,WV,Jefferson County,30891,30204,687,2.2
CN5403900000000,2022-09-01,54,039,WV,Kanawha County,79212,76641,2571,3.2
CN5404100000000,2022-09-01,54,041,WV,Lewis County,6450,6201,249,3.9
CN5404300000000,2022-09-01,54,043,WV,Lincoln County,7066,6776,290,4.1
CN5404500000000,2022-09-01,54,045,WV,Logan County,11037,10618,419,3.8
CN5404700000000,2022-09-01,54,047,WV,McDowell County,4088,3874,214,5.2
CN5404900000000,2022-09-01,54,049,WV,Marion County,25301,24371,930,3.7
CN5405100000000,2022-09-01,54,051,WV,Marshall County,12916,12402,514,4
CN5405300000000,2022-09-01,54,053,WV,Mason County,10493,10128,365,3.5
CN5405500000000,2022-09-01,54,055,WV,Mercer County,20777,20016,761,3.7
CN5405700000000,2022-09-01,54,057,WV,Mineral County,12628,12249,379,3
CN5405900000000,2022-09-01,54,059,WV,Mingo County,6505,6196,309,4.8
CN5406100000000,2022-09-01,54,061,WV,Monongalia County,55393,53845,1548,2.8
CN5406300000000,2022-09-01,54,063,WV,Monroe County,6350,6198,152,2.4
CN5406500000000,2022-09-01,54,065,WV,Morgan County,8563,8357,206,2.4
CN5406700000000,2022-09-01,54,067,WV,Nicholas County,8951,8612,339,3.8
CN5406900000000,2022-09-01,54,069,WV,Ohio County,19742,19087,655,3.3
CN5407100000000,2022-09-01,54,071,WV,Pendleton County,3850,3772,78,2
CN5407300000000,2022-09-01,54,073,WV,Pleasants County,2711,2595,116,4.3
CN5407500000000,2022-09-01,54,075,WV,Pocahontas County,3723,3620,103,2.8
CN5407700000000,2022-09-01,54,077,WV,Preston County,15631,15122,509,3.3
CN5407900000000,2022-09-01,54,079,WV,Putnam County,27148,26423,725,2.7
CN5408100000000,2022-09-01,54,081,WV,Raleigh County,29635,28737,898,3
CN5408300000000,2022-09-01,54,083,WV,Randolph County,11927,11481,446,3.7
CN5408500000000,2022-09-01,54,085,WV,Ritchie County,4241,4097,144,3.4
CN5408700000000,2022-09-01,54,087,WV,Roane County,4793,4571,222,4.6
CN5408900000000,2022-09-01,54,089,WV,Summers County,4691,4561,130,2.8
CN5409100000000,2022-09-01,54,091,WV,Taylor County,7913,7654,259,3.3
CN5409300000000,2022-09-01,54,093,WV,Tucker County,3437,3326,111,3.2
CN5409500000000,2022-09-01,54,095,WV,Tyler County,2918,2783,135,4.6
CN5409700000000,2022-09-01,54,097,WV,Upshur County,9713,9339,374,3.9
CN5409900000000,2022-09-01,54,099,WV,Wayne County,15630,15137,493,3.2
CN5410100000000,2022-09-01,54,101,WV,Webster County,3143,3016,127,4
CN5410300000000,2022-09-01,54,103,WV,Wetzel County,6375,6101,274,4.3
CN5410500000000,2022-09-01,54,105,WV,Wirt County,2249,2144,105,4.7
CN5410700000000,2022-09-01,54,107,WV,Wood County,36279,35058,1221,3.4
CN5410900000000,2022-09-01,54,109,WV,Wyoming County,7187,6930,257,3.6
CN5500100000000,2022-09-01,55,001,WI,Adams County,7643,7345,298,3.9
CN5500300000000,2022-09-01,55,003,WI,Ashland County,7494,7261,233,3.1
CN5500500000000,2022-09-01,55,005,WI,Barron County,23395,22745,650,2.8
CN5500700000000,2022-09-01,55,007,WI,Bayfield County,7282,7033,249,3.4
CN5500900000000,2022-09-01,55,009,WI,Brown County,142095,138479,3616,2.5
CN5501100000000,2022-09-01,55,011,WI,Buffalo County,5905,5714,191,3.2
CN5501300000000,2022-09-01,55,013,WI,Burnett County,7037,6792,245,3.5
CN5501500000000,2022-09-01,55,015,WI,Calumet County,27293,26659,634,2.3
CN5501700000000,2022-09-01,55,017,WI,Chippewa County,33226,32333,893,2.7
CN5501900000000,2022-09-01,55,019,WI,Clark County,16823,16420,403,2.4
CN5502100000000,2022-09-01,55,021,WI,Columbia County,31663,30891,772,2.4
CN5502300000000,2022-09-01,55,023,WI,Crawford County,6696,6481,215,3.2
CN5502500000000,2022-09-01,55,025,WI,Dane County,332304,324836,7468,2.2
CN5502700000000,2022-09-01,55,027,WI,Dodge County,47450,46270,1180,2.5
CN5502900000000,2022-09-01,55,029,WI,Door County,15678,15286,392,2.5
CN5503100000000,2022-09-01,55,031,WI,Douglas County,22755,21986,769,3.4
CN5503300000000,2022-09-01,55,033,WI,Dunn County,23929,23276,653,2.7
CN5503500000000,2022-09-01,55,035,WI,Eau Claire County,59859,58441,1418,2.4
CN5503700000000,2022-09-01,55,037,WI,Florence County,2111,2046,65,3.1
CN5503900000000,2022-09-01,55,039,WI,Fond du Lac County,55974,54601,1373,2.5
CN5504100000000,2022-09-01,55,041,WI,Forest County,3764,3613,151,4
CN5504300000000,2022-09-01,55,043,WI,Grant County,26479,25766,713,2.7
CN5504500000000,2022-09-01,55,045,WI,Green County,20561,20048,513,2.5
CN5504700000000,2022-09-01,55,047,WI,Green Lake County,9220,8950,270,2.9
CN5504900000000,2022-09-01,55,049,WI,Iowa County,13243,12940,303,2.3
CN5505100000000,2022-09-01,55,051,WI,Iron County,2466,2363,103,4.2
CN5505300000000,2022-09-01,55,053,WI,Jackson County,9193,8906,287,3.1
CN5505500000000,2022-09-01,55,055,WI,Jefferson County,45849,44669,1180,2.6
CN5505700000000,2022-09-01,55,057,WI,Juneau County,13271,12898,373,2.8
CN5505900000000,2022-09-01,55,059,WI,Kenosha County,90522,87738,2784,3.1
CN5506100000000,2022-09-01,55,061,WI,Kewaunee County,10568,10311,257,2.4
CN5506300000000,2022-09-01,55,063,WI,La Crosse County,67227,65621,1606,2.4
CN5506500000000,2022-09-01,55,065,WI,Lafayette County,9712,9481,231,2.4
CN5506700000000,2022-09-01,55,067,WI,Langlade County,9008,8717,291,3.2
CN5506900000000,2022-09-01,55,069,WI,Lincoln County,14647,14269,378,2.6
CN5507100000000,2022-09-01,55,071,WI,Manitowoc County,39979,38921,1058,2.6
CN5507300000000,2022-09-01,55,073,WI,Marathon County,72118,70346,1772,2.5
CN5507500000000,2022-09-01,55,075,WI,Marinette County,18703,18074,629,3.4
CN5507700000000,2022-09-01,55,077,WI,Marquette County,7562,7341,221,2.9
CN5507800000000,2022-09-01,55,078,WI,Menominee County,1452,1387,65,4.5
CN5507900000000,2022-09-01,55,079,WI,Milwaukee County,461564,445382,16182,3.5
CN5508100000000,2022-09-01,55,081,WI,Monroe County,22731,22164,567,2.5
CN5508300000000,2022-09-01,55,083,WI,Oconto County,20391,19813,578,2.8
CN5508500000000,2022-09-01,55,085,WI,Oneida County,17782,17311,471,2.6
CN5508700000000,2022-09-01,55,087,WI,Outagamie County,104076,101607,2469,2.4
CN5508900000000,2022-09-01,55,089,WI,Ozaukee County,48907,47641,1266,2.6
CN5509100000000,2022-09-01,55,091,WI,Pepin County,3925,3827,98,2.5
CN5509300000000,2022-09-01,55,093,WI,Pierce County,24072,23398,674,2.8
CN5509500000000,2022-09-01,55,095,WI,Polk County,23900,23210,690,2.9
CN5509700000000,2022-09-01,55,097,WI,Portage County,37925,36916,1009,2.7
CN5509900000000,2022-09-01,55,099,WI,Price County,6014,5821,193,3.2
CN5510100000000,2022-09-01,55,101,WI,Racine County,98245,95104,3141,3.2
CN5510300000000,2022-09-01,55,103,WI,Richland County,8581,8353,228,2.7
CN5510500000000,2022-09-01,55,105,WI,Rock County,85720,83006,2714,3.2
CN5510700000000,2022-09-01,55,107,WI,Rusk County,6230,6036,194,3.1
CN5510900000000,2022-09-01,55,109,WI,St. Croix County,49212,47881,1331,2.7
CN5511100000000,2022-09-01,55,111,WI,Sauk County,33977,33121,856,2.5
CN5511300000000,2022-09-01,55,113,WI,Sawyer County,7863,7628,235,3
CN5511500000000,2022-09-01,55,115,WI,Shawano County,19878,19339,539,2.7
CN5511700000000,2022-09-01,55,117,WI,Sheboygan County,61315,59793,1522,2.5
CN5511900000000,2022-09-01,55,119,WI,Taylor County,10114,9865,249,2.5
CN5512100000000,2022-09-01,55,121,WI,Trempealeau County,14390,14022,368,2.6
CN5512300000000,2022-09-01,55,123,WI,Vernon County,14870,14487,383,2.6
CN5512500000000,2022-09-01,55,125,WI,Vilas County,10145,9826,319,3.1
CN5512700000000,2022-09-01,55,127,WI,Walworth County,58018,56461,1557,2.7
CN5512900000000,2022-09-01,55,129,WI,Washburn County,7564,7340,224,3
CN5513100000000,2022-09-01,55,131,WI,Washington County,76604,74751,1853,2.4
CN5513300000000,2022-09-01,55,133,WI,Waukesha County,224678,219032,5646,2.5
CN5513500000000,2022-09-01,55,135,WI,Waupaca County,24755,24060,695,2.8
CN5513700000000,2022-09-01,55,137,WI,Waushara County,10736,10403,333,3.1
CN5513900000000,2022-09-01,55,139,WI,Winnebago County,92562,90221,2341,2.5
CN5514100000000,2022-09-01,55,141,WI,Wood County,32997,31987,1010,3.1
CN5600100000000,2022-09-01,56,001,WY,Albany County,21618,20973,645,3
CN5600300000000,2022-09-01,56,003,WY,Big Horn County,5216,5036,180,3.5
CN5600500000000,2022-09-01,56,005,WY,Campbell County,22808,22077,731,3.2
CN5600700000000,2022-09-01,56,007,WY,Carbon County,7531,7267,264,3.5
CN5600900000000,2022-09-01,56,009,WY,Converse County,7691,7481,210,2.7
CN5601100000000,2022-09-01,56,011,WY,Crook County,3949,3850,99,2.5
CN5601300000000,2022-09-01,56,013,WY,Fremont County,19090,18417,673,3.5
CN5601500000000,2022-09-01,56,015,WY,Goshen County,6511,6328,183,2.8
CN5601700000000,2022-09-01,56,017,WY,Hot Springs County,2292,2233,59,2.6
CN5601900000000,2022-09-01,56,019,WY,Johnson County,4335,4206,129,3
CN5602100000000,2022-09-01,56,021,WY,Laramie County,49051,47416,1635,3.3
CN5602300000000,2022-09-01,56,023,WY,Lincoln County,9827,9532,295,3
CN5602500000000,2022-09-01,56,025,WY,Natrona County,39530,38115,1415,3.6
CN5602700000000,2022-09-01,56,027,WY,Niobrara County,1222,1187,35,2.9
CN5602900000000,2022-09-01,56,029,WY,Park County,16139,15674,465,2.9
CN5603100000000,2022-09-01,56,031,WY,Platte County,4408,4274,134,3
CN5603300000000,2022-09-01,56,033,WY,Sheridan County,16274,15791,483,3
CN5603500000000,2022-09-01,56,035,WY,Sublette County,3967,3830,137,3.5
CN5603700000000,2022-09-01,56,037,WY,Sweetwater County,19795,19064,731,3.7
CN5603900000000,2022-09-01,56,039,WY,Teton County,17519,17179,340,1.9
CN5604100000000,2022-09-01,56,041,WY,Uinta County,9022,8705,317,3.5
CN5604300000000,2022-09-01,56,043,WY,Washakie County,3847,3708,139,3.6
CN5604500000000,2022-09-01,56,045,WY,Weston County,3810,3726,84,2.2
CN7200100000000,2022-09-01,72,001,PR,Adjuntas Municipio,4471,4146,325,7.3
CN7200300000000,2022-09-01,72,003,PR,Aguada Municipio,13236,12318,918,6.9
CN7200500000000,2022-09-01,72,005,PR,Aguadilla Municipio,16100,14811,1289,8
CN7200700000000,2022-09-01,72,007,PR,Aguas Buenas Municipio,6999,6549,450,6.4
CN7200900000000,2022-09-01,72,009,PR,Aibonito Municipio,6936,6431,505,7.3
CN7201100000000,2022-09-01,72,011,PR,Anasco Municipio,9939,9320,619,6.2
CN7201300000000,2022-09-01,72,013,PR,Arecibo Municipio,25883,24106,1777,6.9
CN7201500000000,2022-09-01,72,015,PR,Arroyo Municipio,4833,4431,402,8.3
CN7201700000000,2022-09-01,72,017,PR,Barceloneta Municipio,6307,5767,540,8.6
CN7201900000000,2022-09-01,72,019,PR,Barranquitas Municipio,7838,7250,588,7.5
CN7202100000000,2022-09-01,72,021,PR,Bayamon Municipio,69118,65614,3504,5.1
CN7202300000000,2022-09-01,72,023,PR,Cabo Rojo Municipio,15002,14014,988,6.6
CN7202500000000,2022-09-01,72,025,PR,Caguas Municipio,50896,48268,2628,5.2
CN7202700000000,2022-09-01,72,027,PR,Camuy Municipio,10529,9737,792,7.5
CN7202900000000,2022-09-01,72,029,PR,Canovanas Municipio,17381,16508,873,5
CN7203100000000,2022-09-01,72,031,PR,Carolina Municipio,65229,62012,3217,4.9
CN7203300000000,2022-09-01,72,033,PR,Catano Municipio,8253,7806,447,5.4
CN7203500000000,2022-09-01,72,035,PR,Cayey Municipio,17301,16335,966,5.6
CN7203700000000,2022-09-01,72,037,PR,Ceiba Municipio,3815,3547,268,7
CN7203900000000,2022-09-01,72,039,PR,Ciales Municipio,3905,3573,332,8.5
CN7204100000000,2022-09-01,72,041,PR,Cidra Municipio,16443,15649,794,4.8
CN7204300000000,2022-09-01,72,043,PR,Coamo Municipio,11176,10325,851,7.6
CN7204500000000,2022-09-01,72,045,PR,Comerio Municipio,5222,4858,364,7
CN7204700000000,2022-09-01,72,047,PR,Corozal Municipio,9457,8744,713,7.5
CN7204900000000,2022-09-01,72,049,PR,Culebra Municipio,952,930,22,2.3
CN7205100000000,2022-09-01,72,051,PR,Dorado Municipio,14476,13811,665,4.6
CN7205300000000,2022-09-01,72,053,PR,Fajardo Municipio,11213,10443,770,6.9
CN7205400000000,2022-09-01,72,054,PR,Florida Municipio,3475,3190,285,8.2
CN7205500000000,2022-09-01,72,055,PR,Guanica Municipio,4112,3734,378,9.2
CN7205700000000,2022-09-01,72,057,PR,Guayama Municipio,11442,10598,844,7.4
CN7205900000000,2022-09-01,72,059,PR,Guayanilla Municipio,5183,4635,548,10.6
CN7206100000000,2022-09-01,72,061,PR,Guaynabo Municipio,40567,39192,1375,3.4
CN7206300000000,2022-09-01,72,063,PR,Gurabo Municipio,20135,19205,930,4.6
CN7206500000000,2022-09-01,72,065,PR,Hatillo Municipio,15071,13653,1418,9.4
CN7206700000000,2022-09-01,72,067,PR,Hormigueros Municipio,5928,5588,340,5.7
CN7206900000000,2022-09-01,72,069,PR,Humacao Municipio,18896,17695,1201,6.4
CN7207100000000,2022-09-01,72,071,PR,Isabela Municipio,13240,12283,957,7.2
CN7207300000000,2022-09-01,72,073,PR,Jayuya Municipio,4581,4222,359,7.8
CN7207500000000,2022-09-01,72,075,PR,Juana Diaz Municipio,16908,15660,1248,7.4
CN7207700000000,2022-09-01,72,077,PR,Juncos Municipio,13318,12416,902,6.8
CN7207900000000,2022-09-01,72,079,PR,Lajas Municipio,5725,5158,567,9.9
CN7208100000000,2022-09-01,72,081,PR,Lares Municipio,8399,7292,1107,13.2
CN7208300000000,2022-09-01,72,083,PR,Las Marias Municipio,2819,2362,457,16.2
CN7208500000000,2022-09-01,72,085,PR,Las Piedras Municipio,12293,11513,780,6.3
CN7208700000000,2022-09-01,72,087,PR,Loiza Municipio,8824,8298,526,6
CN7208900000000,2022-09-01,72,089,PR,Luquillo Municipio,6527,6104,423,6.5
CN7209100000000,2022-09-01,72,091,PR,Manati Municipio,12094,11300,794,6.6
CN7209300000000,2022-09-01,72,093,PR,Maricao Municipio,2105,1921,184,8.7
CN7209500000000,2022-09-01,72,095,PR,Maunabo Municipio,2986,2682,304,10.2
CN7209700000000,2022-09-01,72,097,PR,Mayaguez Municipio,24078,22356,1722,7.2
CN7209900000000,2022-09-01,72,099,PR,Moca Municipio,11807,10786,1021,8.6
CN7210100000000,2022-09-01,72,101,PR,Morovis Municipio,8669,7999,670,7.7
CN7210300000000,2022-09-01,72,103,PR,Naguabo Municipio,8813,8277,536,6.1
CN7210500000000,2022-09-01,72,105,PR,Naranjito Municipio,7527,6991,536,7.1
CN7210700000000,2022-09-01,72,107,PR,Orocovis Municipio,5159,4738,421,8.2
CN7210900000000,2022-09-01,72,109,PR,Patillas Municipio,4315,3913,402,9.3
CN7211100000000,2022-09-01,72,111,PR,Penuelas Municipio,6150,5454,696,11.3
CN7211300000000,2022-09-01,72,113,PR,Ponce Municipio,48136,44503,3633,7.5
CN7211500000000,2022-09-01,72,115,PR,Quebradillas Municipio,6634,6027,607,9.1
CN7211700000000,2022-09-01,72,117,PR,Rincon Municipio,5103,4742,361,7.1
CN7211900000000,2022-09-01,72,119,PR,Rio Grande Municipio,18134,17077,1057,5.8
CN7212100000000,2022-09-01,72,121,PR,Sabana Grande Municipio,6391,5870,521,8.2
CN7212300000000,2022-09-01,72,123,PR,Salinas Municipio,7517,6814,703,9.4
CN7212500000000,2022-09-01,72,125,PR,San German Municipio,10332,9545,787,7.6
CN7212700000000,2022-09-01,72,127,PR,San Juan Municipio,142397,135873,6524,4.6
CN7212900000000,2022-09-01,72,129,PR,San Lorenzo Municipio,12388,11534,854,6.9
CN7213100000000,2022-09-01,72,131,PR,San Sebastian Municipio,11538,10314,1224,10.6
CN7213300000000,2022-09-01,72,133,PR,Santa Isabel Municipio,8688,7932,756,8.7
CN7213500000000,2022-09-01,72,135,PR,Toa Alta Municipio,29707,28325,1382,4.7
CN7213700000000,2022-09-01,72,137,PR,Toa Baja Municipio,30868,29395,1473,4.8
CN7213900000000,2022-09-01,72,139,PR,Trujillo Alto Municipio,28966,27820,1146,4
CN7214100000000,2022-09-01,72,141,PR,Utuado Municipio,7402,6802,600,8.1
CN7214300000000,2022-09-01,72,143,PR,Vega Alta Municipio,10532,9719,813,7.7
CN7214500000000,2022-09-01,72,145,PR,Vega Baja Municipio,13929,12877,1052,7.6
CN7214700000000,2022-09-01,72,147,PR,Vieques Municipio,2655,2461,194,7.3
CN7214900000000,2022-09-01,72,149,PR,Villalba Municipio,7670,6843,827,10.8
CN7215100000000,2022-09-01,72,151,PR,Yabucoa Municipio,9095,8344,751,8.3
CN7215300000000,2022-09-01,72,153,PR,Yauco Municipio,10300,9276,1024,9.9
CN0100100000000,2022-10-01,01,001,AL,Autauga County,26873,26292,581,2.2
CN0100300000000,2022-10-01,01,003,AL,Baldwin County,103176,100899,2277,2.2
CN0100500000000,2022-10-01,01,005,AL,Barbour County,8328,7944,384,4.6
CN0100700000000,2022-10-01,01,007,AL,Bibb County,8732,8520,212,2.4
CN0100900000000,2022-10-01,01,009,AL,Blount County,25990,25421,569,2.2
CN0101100000000,2022-10-01,01,011,AL,Bullock County,4783,4655,128,2.7
CN0101300000000,2022-10-01,01,013,AL,Butler County,8850,8560,290,3.3
CN0101500000000,2022-10-01,01,015,AL,Calhoun County,45985,44668,1317,2.9
CN0101700000000,2022-10-01,01,017,AL,Chambers County,15939,15545,394,2.5
CN0101900000000,2022-10-01,01,019,AL,Cherokee County,11706,11431,275,2.3
CN0102100000000,2022-10-01,01,021,AL,Chilton County,20434,20010,424,2.1
CN0102300000000,2022-10-01,01,023,AL,Choctaw County,4234,4076,158,3.7
CN0102500000000,2022-10-01,01,025,AL,Clarke County,7663,7276,387,5.1
CN0102700000000,2022-10-01,01,027,AL,Clay County,6125,5994,131,2.1
CN0102900000000,2022-10-01,01,029,AL,Cleburne County,6197,6067,130,2.1
CN0103100000000,2022-10-01,01,031,AL,Coffee County,21763,21238,525,2.4
CN0103300000000,2022-10-01,01,033,AL,Colbert County,23958,23305,653,2.7
CN0103500000000,2022-10-01,01,035,AL,Conecuh County,4264,4136,128,3
CN0103700000000,2022-10-01,01,037,AL,Coosa County,4548,4432,116,2.6
CN0103900000000,2022-10-01,01,039,AL,Covington County,15227,14858,369,2.4
CN0104100000000,2022-10-01,01,041,AL,Crenshaw County,6207,6060,147,2.4
CN0104300000000,2022-10-01,01,043,AL,Cullman County,39189,38431,758,1.9
CN0104500000000,2022-10-01,01,045,AL,Dale County,21080,20553,527,2.5
CN0104700000000,2022-10-01,01,047,AL,Dallas County,13675,12991,684,5
CN0104900000000,2022-10-01,01,049,AL,DeKalb County,31419,30727,692,2.2
CN0105100000000,2022-10-01,01,051,AL,Elmore County,38235,37430,805,2.1
CN0105300000000,2022-10-01,01,053,AL,Escambia County,14311,13848,463,3.2
CN0105500000000,2022-10-01,01,055,AL,Etowah County,38893,37771,1122,2.9
CN0105700000000,2022-10-01,01,057,AL,Fayette County,6524,6357,167,2.6
CN0105900000000,2022-10-01,01,059,AL,Franklin County,14603,14281,322,2.2
CN0106100000000,2022-10-01,01,061,AL,Geneva County,11631,11373,258,2.2
CN0106300000000,2022-10-01,01,063,AL,Greene County,2764,2639,125,4.5
CN0106500000000,2022-10-01,01,065,AL,Hale County,6273,6036,237,3.8
CN0106700000000,2022-10-01,01,067,AL,Henry County,7171,6981,190,2.6
CN0106900000000,2022-10-01,01,069,AL,Houston County,48229,47023,1206,2.5
CN0107100000000,2022-10-01,01,071,AL,Jackson County,23189,22669,520,2.2
CN0107300000000,2022-10-01,01,073,AL,Jefferson County,321754,313714,8040,2.5
CN0107500000000,2022-10-01,01,075,AL,Lamar County,5712,5587,125,2.2
CN0107700000000,2022-10-01,01,077,AL,Lauderdale County,43120,42108,1012,2.3
CN0107900000000,2022-10-01,01,079,AL,Lawrence County,14863,14526,337,2.3
CN0108100000000,2022-10-01,01,081,AL,Lee County,80366,78579,1787,2.2
CN0108300000000,2022-10-01,01,083,AL,Limestone County,48575,47632,943,1.9
CN0108500000000,2022-10-01,01,085,AL,Lowndes County,3560,3376,184,5.2
CN0108700000000,2022-10-01,01,087,AL,Macon County,7864,7605,259,3.3
CN0108900000000,2022-10-01,01,089,AL,Madison County,199390,195328,4062,2
CN0109100000000,2022-10-01,01,091,AL,Marengo County,7737,7449,288,3.7
CN0109300000000,2022-10-01,01,093,AL,Marion County,13872,13500,372,2.7
CN0109500000000,2022-10-01,01,095,AL,Marshall County,45626,44740,886,1.9
CN0109700000000,2022-10-01,01,097,AL,Mobile County,192644,186679,5965,3.1
CN0109900000000,2022-10-01,01,099,AL,Monroe County,7212,6934,278,3.9
CN0110100000000,2022-10-01,01,101,AL,Montgomery County,107198,103892,3306,3.1
CN0110300000000,2022-10-01,01,103,AL,Morgan County,60858,59676,1182,1.9
CN0110500000000,2022-10-01,01,105,AL,Perry County,3151,2988,163,5.2
CN0110700000000,2022-10-01,01,107,AL,Pickens County,7905,7654,251,3.2
CN0110900000000,2022-10-01,01,109,AL,Pike County,16306,15880,426,2.6
CN0111100000000,2022-10-01,01,111,AL,Randolph County,9842,9611,231,2.3
CN0111300000000,2022-10-01,01,113,AL,Russell County,23872,23234,638,2.7
CN0111500000000,2022-10-01,01,115,AL,St. Clair County,42122,41234,888,2.1
CN0111700000000,2022-10-01,01,117,AL,Shelby County,120783,118700,2083,1.7
CN0111900000000,2022-10-01,01,119,AL,Sumter County,4709,4557,152,3.2
CN0112100000000,2022-10-01,01,121,AL,Talladega County,37162,36069,1093,2.9
CN0112300000000,2022-10-01,01,123,AL,Tallapoosa County,17259,16798,461,2.7
CN0112500000000,2022-10-01,01,125,AL,Tuscaloosa County,104255,101826,2429,2.3
CN0112700000000,2022-10-01,01,127,AL,Walker County,25525,24861,664,2.6
CN0112900000000,2022-10-01,01,129,AL,Washington County,6652,6430,222,3.3
CN0113100000000,2022-10-01,01,131,AL,Wilcox County,2575,2373,202,7.8
CN0113300000000,2022-10-01,01,133,AL,Winston County,10298,10035,263,2.6
CN0201300000000,2022-10-01,02,013,AK,Aleutians East Borough,2327,2281,46,2
CN0201600000000,2022-10-01,02,016,AK,Aleutians West Census Area,2786,2681,105,3.8
CN0202000000000,2022-10-01,02,020,AK,Anchorage Borough/municipality,152844,148677,4167,2.7
CN0205000000000,2022-10-01,02,050,AK,Bethel Census Area,6689,6215,474,7.1
CN0206000000000,2022-10-01,02,060,AK,Bristol Bay Borough,303,292,11,3.6
CN0206300000000,2022-10-01,02,063,AK,Chugach Census Area,2993,2897,96,3.2
CN0206600000000,2022-10-01,02,066,AK,Copper River Census Area,1246,1130,116,9.3
CN0206800000000,2022-10-01,02,068,AK,Denali Borough,664,608,56,8.4
CN0207000000000,2022-10-01,02,070,AK,Dillingham Census Area,1516,1434,82,5.4
CN0209000000000,2022-10-01,02,090,AK,Fairbanks North Star Borough,45766,44386,1380,3
CN0210000000000,2022-10-01,02,100,AK,Haines Borough,1011,959,52,5.1
CN0210500000000,2022-10-01,02,105,AK,Hoonah-Angoon Census Area,1115,1072,43,3.9
CN0211000000000,2022-10-01,02,110,AK,Juneau Borough/city,17079,16691,388,2.3
CN0212200000000,2022-10-01,02,122,AK,Kenai Peninsula Borough,27721,26666,1055,3.8
CN0213000000000,2022-10-01,02,130,AK,Ketchikan Gateway Borough,6617,6421,196,3
CN0215000000000,2022-10-01,02,150,AK,Kodiak Island Borough,5976,5783,193,3.2
CN0215800000000,2022-10-01,02,158,AK,Kusilvak Census Area,2279,2062,217,9.5
CN0216400000000,2022-10-01,02,164,AK,Lake and Peninsula Borough,620,588,32,5.2
CN0217000000000,2022-10-01,02,170,AK,Matanuska-Susitna Borough,50243,48447,1796,3.6
CN0218000000000,2022-10-01,02,180,AK,Nome Census Area,4250,4038,212,5
CN0218500000000,2022-10-01,02,185,AK,North Slope Borough,2968,2837,131,4.4
CN0218800000000,2022-10-01,02,188,AK,Northwest Arctic Borough,2898,2681,217,7.5
CN0219500000000,2022-10-01,02,195,AK,Petersburg Borough,1546,1489,57,3.7
CN0219800000000,2022-10-01,02,198,AK,Prince of Wales-Hyder Census Area,2669,2556,113,4.2
CN0222000000000,2022-10-01,02,220,AK,Sitka Borough/city,4448,4344,104,2.3
CN0223000000000,2022-10-01,02,230,AK,Skagway Municipality,645,605,40,6.2
CN0224000000000,2022-10-01,02,240,AK,Southeast Fairbanks Census Area,3258,3137,121,3.7
CN0227500000000,2022-10-01,02,275,AK,Wrangell Borough/city,913,879,34,3.7
CN0228200000000,2022-10-01,02,282,AK,Yakutat Borough/city,288,276,12,4.2
CN0229000000000,2022-10-01,02,290,AK,Yukon-Koyukuk Census Area,2377,2235,142,6
CN0400100000000,2022-10-01,04,001,AZ,Apache County,19111,17657,1454,7.6
CN0400300000000,2022-10-01,04,003,AZ,Cochise County,48734,46499,2235,4.6
CN0400500000000,2022-10-01,04,005,AZ,Coconino County,75459,72228,3231,4.3
CN0400700000000,2022-10-01,04,007,AZ,Gila County,20593,19739,854,4.1
CN0400900000000,2022-10-01,04,009,AZ,Graham County,16556,15932,624,3.8
CN0401100000000,2022-10-01,04,011,AZ,Greenlee County,5002,4864,138,2.8
CN0401200000000,2022-10-01,04,012,AZ,La Paz County,9085,8665,420,4.6
CN0401300000000,2022-10-01,04,013,AZ,Maricopa County,2399447,2317530,81917,3.4
CN0401500000000,2022-10-01,04,015,AZ,Mohave County,90214,86127,4087,4.5
CN0401700000000,2022-10-01,04,017,AZ,Navajo County,40234,38178,2056,5.1
CN0401900000000,2022-10-01,04,019,AZ,Pima County,490809,471773,19036,3.9
CN0402100000000,2022-10-01,04,021,AZ,Pinal County,201505,193413,8092,4
CN0402300000000,2022-10-01,04,023,AZ,Santa Cruz County,19088,17282,1806,9.5
CN0402500000000,2022-10-01,04,025,AZ,Yavapai County,108821,105024,3797,3.5
CN0402700000000,2022-10-01,04,027,AZ,Yuma County,99775,86045,13730,13.8
CN0500100000000,2022-10-01,05,001,AR,Arkansas County,9388,9142,246,2.6
CN0500300000000,2022-10-01,05,003,AR,Ashley County,6751,6399,352,5.2
CN0500500000000,2022-10-01,05,005,AR,Baxter County,16384,15867,517,3.2
CN0500700000000,2022-10-01,05,007,AR,Benton County,154017,150968,3049,2
CN0500900000000,2022-10-01,05,009,AR,Boone County,15915,15516,399,2.5
CN0501100000000,2022-10-01,05,011,AR,Bradley County,4015,3806,209,5.2
CN0501300000000,2022-10-01,05,013,AR,Calhoun County,2359,2285,74,3.1
CN0501500000000,2022-10-01,05,015,AR,Carroll County,12697,12405,292,2.3
CN0501700000000,2022-10-01,05,017,AR,Chicot County,2905,2758,147,5.1
CN0501900000000,2022-10-01,05,019,AR,Clark County,8504,8178,326,3.8
CN0502100000000,2022-10-01,05,021,AR,Clay County,5385,5211,174,3.2
CN0502300000000,2022-10-01,05,023,AR,Cleburne County,8945,8631,314,3.5
CN0502500000000,2022-10-01,05,025,AR,Cleveland County,3085,2974,111,3.6
CN0502700000000,2022-10-01,05,027,AR,Columbia County,8906,8580,326,3.7
CN0502900000000,2022-10-01,05,029,AR,Conway County,8327,8070,257,3.1
CN0503100000000,2022-10-01,05,031,AR,Craighead County,57839,56479,1360,2.4
CN0503300000000,2022-10-01,05,033,AR,Crawford County,26256,25556,700,2.7
CN0503500000000,2022-10-01,05,035,AR,Crittenden County,20458,19696,762,3.7
CN0503700000000,2022-10-01,05,037,AR,Cross County,6857,6635,222,3.2
CN0503900000000,2022-10-01,05,039,AR,Dallas County,2689,2596,93,3.5
CN0504100000000,2022-10-01,05,041,AR,Desha County,4964,4742,222,4.5
CN0504300000000,2022-10-01,05,043,AR,Drew County,7469,7181,288,3.9
CN0504500000000,2022-10-01,05,045,AR,Faulkner County,63217,61631,1586,2.5
CN0504700000000,2022-10-01,05,047,AR,Franklin County,7491,7277,214,2.9
CN0504900000000,2022-10-01,05,049,AR,Fulton County,4996,4860,136,2.7
CN0505100000000,2022-10-01,05,051,AR,Garland County,41769,40351,1418,3.4
CN0505300000000,2022-10-01,05,053,AR,Grant County,8481,8243,238,2.8
CN0505500000000,2022-10-01,05,055,AR,Greene County,19717,19197,520,2.6
CN0505700000000,2022-10-01,05,057,AR,Hempstead County,9441,9168,273,2.9
CN0505900000000,2022-10-01,05,059,AR,Hot Spring County,13745,13317,428,3.1
CN0506100000000,2022-10-01,05,061,AR,Howard County,5300,5123,177,3.3
CN0506300000000,2022-10-01,05,063,AR,Independence County,16576,16126,450,2.7
CN0506500000000,2022-10-01,05,065,AR,Izard County,4583,4379,204,4.5
CN0506700000000,2022-10-01,05,067,AR,Jackson County,5452,5205,247,4.5
CN0506900000000,2022-10-01,05,069,AR,Jefferson County,25414,24227,1187,4.7
CN0507100000000,2022-10-01,05,071,AR,Johnson County,10017,9689,328,3.3
CN0507300000000,2022-10-01,05,073,AR,Lafayette County,2324,2221,103,4.4
CN0507500000000,2022-10-01,05,075,AR,Lawrence County,6921,6715,206,3
CN0507700000000,2022-10-01,05,077,AR,Lee County,2532,2431,101,4
CN0507900000000,2022-10-01,05,079,AR,Lincoln County,3692,3549,143,3.9
CN0508100000000,2022-10-01,05,081,AR,Little River County,5168,4995,173,3.3
CN0508300000000,2022-10-01,05,083,AR,Logan County,8201,7943,258,3.1
CN0508500000000,2022-10-01,05,085,AR,Lonoke County,34309,33495,814,2.4
CN0508700000000,2022-10-01,05,087,AR,Madison County,7926,7771,155,2
CN0508900000000,2022-10-01,05,089,AR,Marion County,6305,6099,206,3.3
CN0509100000000,2022-10-01,05,091,AR,Miller County,18672,18037,635,3.4
CN0509300000000,2022-10-01,05,093,AR,Mississippi County,16460,15758,702,4.3
CN0509500000000,2022-10-01,05,095,AR,Monroe County,2542,2442,100,3.9
CN0509700000000,2022-10-01,05,097,AR,Montgomery County,2792,2684,108,3.9
CN0509900000000,2022-10-01,05,099,AR,Nevada County,3467,3351,116,3.3
CN0510100000000,2022-10-01,05,101,AR,Newton County,3209,3133,76,2.4
CN0510300000000,2022-10-01,05,103,AR,Ouachita County,9544,9199,345,3.6
CN0510500000000,2022-10-01,05,105,AR,Perry County,4221,4104,117,2.8
CN0510700000000,2022-10-01,05,107,AR,Phillips County,5536,5202,334,6
CN0510900000000,2022-10-01,05,109,AR,Pike County,3976,3860,116,2.9
CN0511100000000,2022-10-01,05,111,AR,Poinsett County,10019,9742,277,2.8
CN0511300000000,2022-10-01,05,113,AR,Polk County,7863,7628,235,3
CN0511500000000,2022-10-01,05,115,AR,Pope County,27693,26852,841,3
CN0511700000000,2022-10-01,05,117,AR,Prairie County,3593,3503,90,2.5
CN0511900000000,2022-10-01,05,119,AR,Pulaski County,189707,183914,5793,3.1
CN0512100000000,2022-10-01,05,121,AR,Randolph County,7155,6957,198,2.8
CN0512300000000,2022-10-01,05,123,AR,St. Francis County,7452,7110,342,4.6
CN0512500000000,2022-10-01,05,125,AR,Saline County,60093,58672,1421,2.4
CN0512700000000,2022-10-01,05,127,AR,Scott County,4275,4186,89,2.1
CN0512900000000,2022-10-01,05,129,AR,Searcy County,2810,2696,114,4.1
CN0513100000000,2022-10-01,05,131,AR,Sebastian County,55205,53761,1444,2.6
CN0513300000000,2022-10-01,05,133,AR,Sevier County,5461,5287,174,3.2
CN0513500000000,2022-10-01,05,135,AR,Sharp County,5879,5689,190,3.2
CN0513700000000,2022-10-01,05,137,AR,Stone County,4613,4461,152,3.3
CN0513900000000,2022-10-01,05,139,AR,Union County,14731,14089,642,4.4
CN0514100000000,2022-10-01,05,141,AR,Van Buren County,5976,5765,211,3.5
CN0514300000000,2022-10-01,05,143,AR,Washington County,136074,133528,2546,1.9
CN0514500000000,2022-10-01,05,145,AR,White County,34150,33161,989,2.9
CN0514700000000,2022-10-01,05,147,AR,Woodruff County,2838,2764,74,2.6
CN0514900000000,2022-10-01,05,149,AR,Yell County,7947,7714,233,2.9
CN0600100000000,2022-10-01,06,001,CA,Alameda County,831013,805011,26002,3.1
CN0600300000000,2022-10-01,06,003,CA,Alpine County,443,418,25,5.6
CN0600500000000,2022-10-01,06,005,CA,Amador County,14375,13765,610,4.2
CN0600700000000,2022-10-01,06,007,CA,Butte County,92894,89105,3789,4.1
CN0600900000000,2022-10-01,06,009,CA,Calaveras County,22282,21517,765,3.4
CN0601100000000,2022-10-01,06,011,CA,Colusa County,10253,9428,825,8
CN0601300000000,2022-10-01,06,013,CA,Contra Costa County,555005,536515,18490,3.3
CN0601500000000,2022-10-01,06,015,CA,Del Norte County,9501,9061,440,4.6
CN0601700000000,2022-10-01,06,017,CA,El Dorado County,94086,91179,2907,3.1
CN0601900000000,2022-10-01,06,019,CA,Fresno County,454560,428422,26138,5.8
CN0602100000000,2022-10-01,06,021,CA,Glenn County,13111,12485,626,4.8
CN0602300000000,2022-10-01,06,023,CA,Humboldt County,60229,57988,2241,3.7
CN0602500000000,2022-10-01,06,025,CA,Imperial County,72062,59854,12208,16.9
CN0602700000000,2022-10-01,06,027,CA,Inyo County,8338,8075,263,3.2
CN0602900000000,2022-10-01,06,029,CA,Kern County,398887,374416,24471,6.1
CN0603100000000,2022-10-01,06,031,CA,Kings County,56960,53484,3476,6.1
CN0603300000000,2022-10-01,06,033,CA,Lake County,28223,26891,1332,4.7
CN0603500000000,2022-10-01,06,035,CA,Lassen County,9856,9511,345,3.5
CN0603700000000,2022-10-01,06,037,CA,Los Angeles County,4947566,4723562,224004,4.5
CN0603900000000,2022-10-01,06,039,CA,Madera County,62962,59487,3475,5.5
CN0604100000000,2022-10-01,06,041,CA,Marin County,132351,128985,3366,2.5
CN0604300000000,2022-10-01,06,043,CA,Mariposa County,7530,7250,280,3.7
CN0604500000000,2022-10-01,06,045,CA,Mendocino County,37443,36055,1388,3.7
CN0604700000000,2022-10-01,06,047,CA,Merced County,117225,109917,7308,6.2
CN0604900000000,2022-10-01,06,049,CA,Modoc County,3236,3105,131,4
CN0605100000000,2022-10-01,06,051,CA,Mono County,8190,7842,348,4.2
CN0605300000000,2022-10-01,06,053,CA,Monterey County,224906,215494,9412,4.2
CN0605500000000,2022-10-01,06,055,CA,Napa County,72278,70189,2089,2.9
CN0605700000000,2022-10-01,06,057,CA,Nevada County,48554,46990,1564,3.2
CN0605900000000,2022-10-01,06,059,CA,Orange County,1606752,1559064,47688,3
CN0606100000000,2022-10-01,06,061,CA,Placer County,195558,189845,5713,2.9
CN0606300000000,2022-10-01,06,063,CA,Plumas County,7559,7205,354,4.7
CN0606500000000,2022-10-01,06,065,CA,Riverside County,1159626,1112073,47553,4.1
CN0606700000000,2022-10-01,06,067,CA,Sacramento County,734382,707012,27370,3.7
CN0606900000000,2022-10-01,06,069,CA,San Benito County,32875,31443,1432,4.4
CN0607100000000,2022-10-01,06,071,CA,San Bernardino County,1013870,974048,39822,3.9
CN0607300000000,2022-10-01,06,073,CA,San Diego County,1600480,1548039,52441,3.3
CN0607500000000,2022-10-01,06,075,CA,San Francisco County/city,578192,564501,13691,2.4
CN0607700000000,2022-10-01,06,077,CA,San Joaquin County,347814,330997,16817,4.8
CN0607900000000,2022-10-01,06,079,CA,San Luis Obispo County,137716,133859,3857,2.8
CN0608100000000,2022-10-01,06,081,CA,San Mateo County,457861,447588,10273,2.2
CN0608300000000,2022-10-01,06,083,CA,Santa Barbara County,227103,220155,6948,3.1
CN0608500000000,2022-10-01,06,085,CA,Santa Clara County,1054919,1028809,26110,2.5
CN0608700000000,2022-10-01,06,087,CA,Santa Cruz County,135692,130532,5160,3.8
CN0608900000000,2022-10-01,06,089,CA,Shasta County,74247,71193,3054,4.1
CN0609100000000,2022-10-01,06,091,CA,Sierra County,1348,1309,39,2.9
CN0609300000000,2022-10-01,06,093,CA,Siskiyou County,17503,16732,771,4.4
CN0609500000000,2022-10-01,06,095,CA,Solano County,203671,195844,7827,3.8
CN0609700000000,2022-10-01,06,097,CA,Sonoma County,249860,242627,7233,2.9
CN0609900000000,2022-10-01,06,099,CA,Stanislaus County,243034,231115,11919,4.9
CN0610100000000,2022-10-01,06,101,CA,Sutter County,46745,44197,2548,5.5
CN0610300000000,2022-10-01,06,103,CA,Tehama County,26356,25213,1143,4.3
CN0610500000000,2022-10-01,06,105,CA,Trinity County,4610,4419,191,4.1
CN0610700000000,2022-10-01,06,107,CA,Tulare County,207355,190757,16598,8
CN0610900000000,2022-10-01,06,109,CA,Tuolumne County,20019,19212,807,4
CN0611100000000,2022-10-01,06,111,CA,Ventura County,416335,401397,14938,3.6
CN0611300000000,2022-10-01,06,113,CA,Yolo County,109557,105645,3912,3.6
CN0611500000000,2022-10-01,06,115,CA,Yuba County,31829,30245,1584,5
CN0800100000000,2022-10-01,08,001,CO,Adams County,282723,274314,8409,3
CN0800300000000,2022-10-01,08,003,CO,Alamosa County,8405,8143,262,3.1
CN0800500000000,2022-10-01,08,005,CO,Arapahoe County,376065,365773,10292,2.7
CN0800700000000,2022-10-01,08,007,CO,Archuleta County,6982,6802,180,2.6
CN0800900000000,2022-10-01,08,009,CO,Baca County,2162,2131,31,1.4
CN0801100000000,2022-10-01,08,011,CO,Bent County,1895,1843,52,2.7
CN0801300000000,2022-10-01,08,013,CO,Boulder County,203242,198742,4500,2.2
CN0801400000000,2022-10-01,08,014,CO,Broomfield County/city,42621,41590,1031,2.4
CN0801500000000,2022-10-01,08,015,CO,Chaffee County,9785,9539,246,2.5
CN0801700000000,2022-10-01,08,017,CO,Cheyenne County,1102,1084,18,1.6
CN0801900000000,2022-10-01,08,019,CO,Clear Creek County,6187,6019,168,2.7
CN0802100000000,2022-10-01,08,021,CO,Conejos County,4124,4013,111,2.7
CN0802300000000,2022-10-01,08,023,CO,Costilla County,1870,1808,62,3.3
CN0802500000000,2022-10-01,08,025,CO,Crowley County,1397,1348,49,3.5
CN0802700000000,2022-10-01,08,027,CO,Custer County,2341,2278,63,2.7
CN0802900000000,2022-10-01,08,029,CO,Delta County,13562,13162,400,2.9
CN0803100000000,2022-10-01,08,031,CO,Denver County/city,437303,425205,12098,2.8
CN0803300000000,2022-10-01,08,033,CO,Dolores County,1191,1163,28,2.4
CN0803500000000,2022-10-01,08,035,CO,Douglas County,208407,203656,4751,2.3
CN0803700000000,2022-10-01,08,037,CO,Eagle County,33787,32967,820,2.4
CN0803900000000,2022-10-01,08,039,CO,Elbert County,16211,15868,343,2.1
CN0804100000000,2022-10-01,08,041,CO,El Paso County,359910,349398,10512,2.9
CN0804300000000,2022-10-01,08,043,CO,Fremont County,14361,13753,608,4.2
CN0804500000000,2022-10-01,08,045,CO,Garfield County,30384,29597,787,2.6
CN0804700000000,2022-10-01,08,047,CO,Gilpin County,3944,3850,94,2.4
CN0804900000000,2022-10-01,08,049,CO,Grand County,8671,8446,225,2.6
CN0805100000000,2022-10-01,08,051,CO,Gunnison County,11671,11427,244,2.1
CN0805300000000,2022-10-01,08,053,CO,Hinsdale County,442,430,12,2.7
CN0805500000000,2022-10-01,08,055,CO,Huerfano County,2582,2437,145,5.6
CN0805700000000,2022-10-01,08,057,CO,Jackson County,1071,1054,17,1.6
CN0805900000000,2022-10-01,08,059,CO,Jefferson County,344073,335514,8559,2.5
CN0806100000000,2022-10-01,08,061,CO,Kiowa County,960,946,14,1.5
CN0806300000000,2022-10-01,08,063,CO,Kit Carson County,4330,4260,70,1.6
CN0806500000000,2022-10-01,08,065,CO,Lake County,4765,4656,109,2.3
CN0806700000000,2022-10-01,08,067,CO,La Plata County,31721,30937,784,2.5
CN0806900000000,2022-10-01,08,069,CO,Larimer County,212679,207686,4993,2.3
CN0807100000000,2022-10-01,08,071,CO,Las Animas County,6092,5828,264,4.3
CN0807300000000,2022-10-01,08,073,CO,Lincoln County,2239,2186,53,2.4
CN0807500000000,2022-10-01,08,075,CO,Logan County,10412,10159,253,2.4
CN0807700000000,2022-10-01,08,077,CO,Mesa County,77358,75108,2250,2.9
CN0807900000000,2022-10-01,08,079,CO,Mineral County,439,427,12,2.7
CN0808100000000,2022-10-01,08,081,CO,Moffat County,6777,6608,169,2.5
CN0808300000000,2022-10-01,08,083,CO,Montezuma County,12642,12259,383,3
CN0808500000000,2022-10-01,08,085,CO,Montrose County,21481,20894,587,2.7
CN0808700000000,2022-10-01,08,087,CO,Morgan County,15871,15440,431,2.7
CN0808900000000,2022-10-01,08,089,CO,Otero County,8065,7753,312,3.9
CN0809100000000,2022-10-01,08,091,CO,Ouray County,2592,2533,59,2.3
CN0809300000000,2022-10-01,08,093,CO,Park County,11722,11444,278,2.4
CN0809500000000,2022-10-01,08,095,CO,Phillips County,2600,2557,43,1.7
CN0809700000000,2022-10-01,08,097,CO,Pitkin County,10531,10108,423,4
CN0809900000000,2022-10-01,08,099,CO,Prowers County,6389,6247,142,2.2
CN0810100000000,2022-10-01,08,101,CO,Pueblo County,76368,73389,2979,3.9
CN0810300000000,2022-10-01,08,103,CO,Rio Blanco County,2913,2829,84,2.9
CN0810500000000,2022-10-01,08,105,CO,Rio Grande County,5463,5283,180,3.3
CN0810700000000,2022-10-01,08,107,CO,Routt County,15234,14885,349,2.3
CN0810900000000,2022-10-01,08,109,CO,Saguache County,3484,3397,87,2.5
CN0811100000000,2022-10-01,08,111,CO,San Juan County,569,557,12,2.1
CN0811300000000,2022-10-01,08,113,CO,San Miguel County,5423,5279,144,2.7
CN0811500000000,2022-10-01,08,115,CO,Sedgwick County,1109,1086,23,2.1
CN0811700000000,2022-10-01,08,117,CO,Summit County,19479,19030,449,2.3
CN0811900000000,2022-10-01,08,119,CO,Teller County,13438,13101,337,2.5
CN0812100000000,2022-10-01,08,121,CO,Washington County,2887,2834,53,1.8
CN0812300000000,2022-10-01,08,123,CO,Weld County,171607,166851,4756,2.8
CN0812500000000,2022-10-01,08,125,CO,Yuma County,5847,5751,96,1.6
CN0900100000000,2022-10-01,09,001,CT,Fairfield County,482823,464625,18198,3.8
CN0900300000000,2022-10-01,09,003,CT,Hartford County,479341,461079,18262,3.8
CN0900500000000,2022-10-01,09,005,CT,Litchfield County,104824,101357,3467,3.3
CN0900700000000,2022-10-01,09,007,CT,Middlesex County,94192,91182,3010,3.2
CN0900900000000,2022-10-01,09,009,CT,New Haven County,470067,451527,18540,3.9
CN0901100000000,2022-10-01,09,011,CT,New London County,133868,128806,5062,3.8
CN0901300000000,2022-10-01,09,013,CT,Tolland County,86464,83709,2755,3.2
CN0901500000000,2022-10-01,09,015,CT,Windham County,63843,61526,2317,3.6
CN1000100000000,2022-10-01,10,001,DE,Kent County,79518,75341,4177,5.3
CN1000300000000,2022-10-01,10,003,DE,New Castle County,305337,292161,13176,4.3
CN1000500000000,2022-10-01,10,005,DE,Sussex County,110953,105975,4978,4.5
CN1100100000000,2022-10-01,11,001,DC,District of Columbia,386974,370346,16628,4.3
CN1200100000000,2022-10-01,12,001,FL,Alachua County,144554,140713,3841,2.7
CN1200300000000,2022-10-01,12,003,FL,Baker County,12818,12490,328,2.6
CN1200500000000,2022-10-01,12,005,FL,Bay County,88775,86653,2122,2.4
CN1200700000000,2022-10-01,12,007,FL,Bradford County,11228,10900,328,2.9
CN1200900000000,2022-10-01,12,009,FL,Brevard County,298815,290785,8030,2.7
CN1201100000000,2022-10-01,12,011,FL,Broward County,1078465,1050351,28114,2.6
CN1201300000000,2022-10-01,12,013,FL,Calhoun County,4856,4711,145,3
CN1201500000000,2022-10-01,12,015,FL,Charlotte County,78046,74739,3307,4.2
CN1201700000000,2022-10-01,12,017,FL,Citrus County,49736,47810,1926,3.9
CN1201900000000,2022-10-01,12,019,FL,Clay County,114670,111839,2831,2.5
CN1202100000000,2022-10-01,12,021,FL,Collier County,190311,184582,5729,3
CN1202300000000,2022-10-01,12,023,FL,Columbia County,29774,28894,880,3
CN1202700000000,2022-10-01,12,027,FL,DeSoto County,13920,13429,491,3.5
CN1202900000000,2022-10-01,12,029,FL,Dixie County,5935,5759,176,3
CN1203100000000,2022-10-01,12,031,FL,Duval County,519045,504755,14290,2.8
CN1203300000000,2022-10-01,12,033,FL,Escambia County,150276,146073,4203,2.8
CN1203500000000,2022-10-01,12,035,FL,Flagler County,51161,49505,1656,3.2
CN1203700000000,2022-10-01,12,037,FL,Franklin County,4810,4687,123,2.6
CN1203900000000,2022-10-01,12,039,FL,Gadsden County,19555,18862,693,3.5
CN1204100000000,2022-10-01,12,041,FL,Gilchrist County,7526,7316,210,2.8
CN1204300000000,2022-10-01,12,043,FL,Glades County,5267,5113,154,2.9
CN1204500000000,2022-10-01,12,045,FL,Gulf County,5501,5358,143,2.6
CN1204700000000,2022-10-01,12,047,FL,Hamilton County,4214,4046,168,4
CN1204900000000,2022-10-01,12,049,FL,Hardee County,8844,8507,337,3.8
CN1205100000000,2022-10-01,12,051,FL,Hendry County,15540,14807,733,4.7
CN1205300000000,2022-10-01,12,053,FL,Hernando County,77826,75245,2581,3.3
CN1205500000000,2022-10-01,12,055,FL,Highlands County,36166,34703,1463,4
CN1205700000000,2022-10-01,12,057,FL,Hillsborough County,813630,792331,21299,2.6
CN1205900000000,2022-10-01,12,059,FL,Holmes County,7094,6897,197,2.8
CN1206100000000,2022-10-01,12,061,FL,Indian River County,68081,65943,2138,3.1
CN1206300000000,2022-10-01,12,063,FL,Jackson County,16602,16102,500,3
CN1206500000000,2022-10-01,12,065,FL,Jefferson County,5879,5707,172,2.9
CN1206700000000,2022-10-01,12,067,FL,Lafayette County,2833,2755,78,2.8
CN1206900000000,2022-10-01,12,069,FL,Lake County,173733,168882,4851,2.8
CN1207100000000,2022-10-01,12,071,FL,Lee County,382264,366575,15689,4.1
CN1207300000000,2022-10-01,12,073,FL,Leon County,163588,159046,4542,2.8
CN1207500000000,2022-10-01,12,075,FL,Levy County,17281,16738,543,3.1
CN1207700000000,2022-10-01,12,077,FL,Liberty County,2672,2594,78,2.9
CN1207900000000,2022-10-01,12,079,FL,Madison County,7874,7633,241,3.1
CN1208100000000,2022-10-01,12,081,FL,Manatee County,187288,182207,5081,2.7
CN1208300000000,2022-10-01,12,083,FL,Marion County,149788,144996,4792,3.2
CN1208500000000,2022-10-01,12,085,FL,Martin County,76918,74999,1919,2.5
CN1208600000000,2022-10-01,12,086,FL,Miami-Dade County,1386267,1353554,32713,2.4
CN1208700000000,2022-10-01,12,087,FL,Monroe County,49297,48435,862,1.7
CN1208900000000,2022-10-01,12,089,FL,Nassau County,45345,44268,1077,2.4
CN1209100000000,2022-10-01,12,091,FL,Okaloosa County,103565,101197,2368,2.3
CN1209300000000,2022-10-01,12,093,FL,Okeechobee County,17810,17327,483,2.7
CN1209500000000,2022-10-01,12,095,FL,Orange County,804213,782784,21429,2.7
CN1209700000000,2022-10-01,12,097,FL,Osceola County,200150,193894,6256,3.1
CN1209900000000,2022-10-01,12,099,FL,Palm Beach County,771021,749979,21042,2.7
CN1210100000000,2022-10-01,12,101,FL,Pasco County,261415,253872,7543,2.9
CN1210300000000,2022-10-01,12,103,FL,Pinellas County,516694,503921,12773,2.5
CN1210500000000,2022-10-01,12,105,FL,Polk County,341062,329755,11307,3.3
CN1210700000000,2022-10-01,12,107,FL,Putnam County,27519,26502,1017,3.7
CN1210900000000,2022-10-01,12,109,FL,St. Johns County,151430,148054,3376,2.2
CN1211100000000,2022-10-01,12,111,FL,St. Lucie County,157103,152100,5003,3.2
CN1211300000000,2022-10-01,12,113,FL,Santa Rosa County,88269,86035,2234,2.5
CN1211500000000,2022-10-01,12,115,FL,Sarasota County,197622,191896,5726,2.9
CN1211700000000,2022-10-01,12,117,FL,Seminole County,267998,261311,6687,2.5
CN1211900000000,2022-10-01,12,119,FL,Sumter County,37927,36513,1414,3.7
CN1212100000000,2022-10-01,12,121,FL,Suwannee County,17795,17254,541,3
CN1212300000000,2022-10-01,12,123,FL,Taylor County,8141,7913,228,2.8
CN1212500000000,2022-10-01,12,125,FL,Union County,4597,4452,145,3.2
CN1212700000000,2022-10-01,12,127,FL,Volusia County,269876,261761,8115,3
CN1212900000000,2022-10-01,12,129,FL,Wakulla County,16347,15958,389,2.4
CN1213100000000,2022-10-01,12,131,FL,Walton County,35158,34311,847,2.4
CN1213300000000,2022-10-01,12,133,FL,Washington County,9862,9571,291,3
CN1300100000000,2022-10-01,13,001,GA,Appling County,9363,9035,328,3.5
CN1300300000000,2022-10-01,13,003,GA,Atkinson County,4406,4278,128,2.9
CN1300500000000,2022-10-01,13,005,GA,Bacon County,4917,4765,152,3.1
CN1300700000000,2022-10-01,13,007,GA,Baker County,1121,1082,39,3.5
CN1300900000000,2022-10-01,13,009,GA,Baldwin County,18056,17295,761,4.2
CN1301100000000,2022-10-01,13,011,GA,Banks County,10849,10595,254,2.3
CN1301300000000,2022-10-01,13,013,GA,Barrow County,43203,42070,1133,2.6
CN1301500000000,2022-10-01,13,015,GA,Bartow County,52464,50899,1565,3
CN1301700000000,2022-10-01,13,017,GA,Ben Hill County,5665,5397,268,4.7
CN1301900000000,2022-10-01,13,019,GA,Berrien County,7832,7581,251,3.2
CN1302100000000,2022-10-01,13,021,GA,Bibb County,64690,62205,2485,3.8
CN1302300000000,2022-10-01,13,023,GA,Bleckley County,4520,4319,201,4.4
CN1302500000000,2022-10-01,13,025,GA,Brantley County,7468,7215,253,3.4
CN1302700000000,2022-10-01,13,027,GA,Brooks County,6740,6523,217,3.2
CN1302900000000,2022-10-01,13,029,GA,Bryan County,20172,19616,556,2.8
CN1303100000000,2022-10-01,13,031,GA,Bulloch County,38968,37627,1341,3.4
CN1303300000000,2022-10-01,13,033,GA,Burke County,8917,8474,443,5
CN1303500000000,2022-10-01,13,035,GA,Butts County,11362,11039,323,2.8
CN1303700000000,2022-10-01,13,037,GA,Calhoun County,2221,2151,70,3.2
CN1303900000000,2022-10-01,13,039,GA,Camden County,21842,21157,685,3.1
CN1304300000000,2022-10-01,13,043,GA,Candler County,6060,5913,147,2.4
CN1304500000000,2022-10-01,13,045,GA,Carroll County,57483,55689,1794,3.1
CN1304700000000,2022-10-01,13,047,GA,Catoosa County,33673,32756,917,2.7
CN1304900000000,2022-10-01,13,049,GA,Charlton County,5085,4926,159,3.1
CN1305100000000,2022-10-01,13,051,GA,Chatham County,143984,139654,4330,3
CN1305300000000,2022-10-01,13,053,GA,Chattahoochee County,1912,1829,83,4.3
CN1305500000000,2022-10-01,13,055,GA,Chattooga County,9131,8764,367,4
CN1305700000000,2022-10-01,13,057,GA,Cherokee County,143364,139800,3564,2.5
CN1305900000000,2022-10-01,13,059,GA,Clarke County,58544,56526,2018,3.4
CN1306100000000,2022-10-01,13,061,GA,Clay County,827,771,56,6.8
CN1306300000000,2022-10-01,13,063,GA,Clayton County,140198,134898,5300,3.8
CN1306500000000,2022-10-01,13,065,GA,Clinch County,2996,2910,86,2.9
CN1306700000000,2022-10-01,13,067,GA,Cobb County,432752,421411,11341,2.6
CN1306900000000,2022-10-01,13,069,GA,Coffee County,19189,18501,688,3.6
CN1307100000000,2022-10-01,13,071,GA,Colquitt County,22228,21590,638,2.9
CN1307300000000,2022-10-01,13,073,GA,Columbia County,75379,73109,2270,3
CN1307500000000,2022-10-01,13,075,GA,Cook County,8274,7993,281,3.4
CN1307700000000,2022-10-01,13,077,GA,Coweta County,77911,75808,2103,2.7
CN1307900000000,2022-10-01,13,079,GA,Crawford County,5319,5150,169,3.2
CN1308100000000,2022-10-01,13,081,GA,Crisp County,9806,9393,413,4.2
CN1308300000000,2022-10-01,13,083,GA,Dade County,8160,7936,224,2.7
CN1308500000000,2022-10-01,13,085,GA,Dawson County,13506,13163,343,2.5
CN1308700000000,2022-10-01,13,087,GA,Decatur County,11858,11475,383,3.2
CN1308900000000,2022-10-01,13,089,GA,DeKalb County,405759,393305,12454,3.1
CN1309100000000,2022-10-01,13,091,GA,Dodge County,6900,6646,254,3.7
CN1309300000000,2022-10-01,13,093,GA,Dooly County,4811,4634,177,3.7
CN1309500000000,2022-10-01,13,095,GA,Dougherty County,36215,34677,1538,4.2
CN1309700000000,2022-10-01,13,097,GA,Douglas County,75289,72847,2442,3.2
CN1309900000000,2022-10-01,13,099,GA,Early County,4468,4313,155,3.5
CN1310100000000,2022-10-01,13,101,GA,Echols County,1882,1833,49,2.6
CN1310300000000,2022-10-01,13,103,GA,Effingham County,33643,32748,895,2.7
CN1310500000000,2022-10-01,13,105,GA,Elbert County,7941,7659,282,3.6
CN1310700000000,2022-10-01,13,107,GA,Emanuel County,8823,8469,354,4
CN1310900000000,2022-10-01,13,109,GA,Evans County,5061,4918,143,2.8
CN1311100000000,2022-10-01,13,111,GA,Fannin County,12095,11762,333,2.8
CN1311300000000,2022-10-01,13,113,GA,Fayette County,59738,58113,1625,2.7
CN1311500000000,2022-10-01,13,115,GA,Floyd County,44254,42821,1433,3.2
CN1311700000000,2022-10-01,13,117,GA,Forsyth County,130736,127520,3216,2.5
CN1311900000000,2022-10-01,13,119,GA,Franklin County,9955,9628,327,3.3
CN1312100000000,2022-10-01,13,121,GA,Fulton County,576760,558564,18196,3.2
CN1312300000000,2022-10-01,13,123,GA,Gilmer County,12428,12025,403,3.2
CN1312500000000,2022-10-01,13,125,GA,Glascock County,1256,1213,43,3.4
CN1312700000000,2022-10-01,13,127,GA,Glynn County,39766,38523,1243,3.1
CN1312900000000,2022-10-01,13,129,GA,Gordon County,28821,27972,849,2.9
CN1313100000000,2022-10-01,13,131,GA,Grady County,10885,10557,328,3
CN1313300000000,2022-10-01,13,133,GA,Greene County,7419,7177,242,3.3
CN1313500000000,2022-10-01,13,135,GA,Gwinnett County,502928,489144,13784,2.7
CN1313700000000,2022-10-01,13,137,GA,Habersham County,18925,18320,605,3.2
CN1313900000000,2022-10-01,13,139,GA,Hall County,107781,105048,2733,2.5
CN1314100000000,2022-10-01,13,141,GA,Hancock County,2562,2431,131,5.1
CN1314300000000,2022-10-01,13,143,GA,Haralson County,13098,12673,425,3.2
CN1314500000000,2022-10-01,13,145,GA,Harris County,16934,16444,490,2.9
CN1314700000000,2022-10-01,13,147,GA,Hart County,12142,11773,369,3
CN1314900000000,2022-10-01,13,149,GA,Heard County,5341,5186,155,2.9
CN1315100000000,2022-10-01,13,151,GA,Henry County,120741,116909,3832,3.2
CN1315300000000,2022-10-01,13,153,GA,Houston County,70390,68103,2287,3.2
CN1315500000000,2022-10-01,13,155,GA,Irwin County,3533,3392,141,4
CN1315700000000,2022-10-01,13,157,GA,Jackson County,45739,44752,987,2.2
CN1315900000000,2022-10-01,13,159,GA,Jasper County,7233,7046,187,2.6
CN1316100000000,2022-10-01,13,161,GA,Jeff Davis County,6104,5878,226,3.7
CN1316300000000,2022-10-01,13,163,GA,Jefferson County,6751,6489,262,3.9
CN1316500000000,2022-10-01,13,165,GA,Jenkins County,3367,3218,149,4.4
CN1316700000000,2022-10-01,13,167,GA,Johnson County,3956,3839,117,3
CN1316900000000,2022-10-01,13,169,GA,Jones County,13214,12793,421,3.2
CN1317100000000,2022-10-01,13,171,GA,Lamar County,8426,8144,282,3.3
CN1317300000000,2022-10-01,13,173,GA,Lanier County,3781,3644,137,3.6
CN1317500000000,2022-10-01,13,175,GA,Laurens County,18909,18158,751,4
CN1317700000000,2022-10-01,13,177,GA,Lee County,14968,14534,434,2.9
CN1317900000000,2022-10-01,13,179,GA,Liberty County,26163,25283,880,3.4
CN1318100000000,2022-10-01,13,181,GA,Lincoln County,3489,3370,119,3.4
CN1318300000000,2022-10-01,13,183,GA,Long County,8499,8237,262,3.1
CN1318500000000,2022-10-01,13,185,GA,Lowndes County,50336,48612,1724,3.4
CN1318700000000,2022-10-01,13,187,GA,Lumpkin County,18723,18235,488,2.6
CN1318900000000,2022-10-01,13,189,GA,McDuffie County,8322,7953,369,4.4
CN1319100000000,2022-10-01,13,191,GA,McIntosh County,6239,6037,202,3.2
CN1319300000000,2022-10-01,13,193,GA,Macon County,4520,4324,196,4.3
CN1319500000000,2022-10-01,13,195,GA,Madison County,13540,13128,412,3
CN1319700000000,2022-10-01,13,197,GA,Marion County,3276,3153,123,3.8
CN1319900000000,2022-10-01,13,199,GA,Meriwether County,9025,8688,337,3.7
CN1320100000000,2022-10-01,13,201,GA,Miller County,2925,2851,74,2.5
CN1320500000000,2022-10-01,13,205,GA,Mitchell County,8220,7912,308,3.7
CN1320700000000,2022-10-01,13,207,GA,Monroe County,12700,12322,378,3
CN1320900000000,2022-10-01,13,209,GA,Montgomery County,3858,3721,137,3.6
CN1321100000000,2022-10-01,13,211,GA,Morgan County,9771,9506,265,2.7
CN1321300000000,2022-10-01,13,213,GA,Murray County,15217,14538,679,4.5
CN1321500000000,2022-10-01,13,215,GA,Muscogee County,75784,72651,3133,4.1
CN1321700000000,2022-10-01,13,217,GA,Newton County,54419,52555,1864,3.4
CN1321900000000,2022-10-01,13,219,GA,Oconee County,20247,19755,492,2.4
CN1322100000000,2022-10-01,13,221,GA,Oglethorpe County,6995,6799,196,2.8
CN1322300000000,2022-10-01,13,223,GA,Paulding County,91672,89176,2496,2.7
CN1322500000000,2022-10-01,13,225,GA,Peach County,11867,11382,485,4.1
CN1322700000000,2022-10-01,13,227,GA,Pickens County,15959,15540,419,2.6
CN1322900000000,2022-10-01,13,229,GA,Pierce County,8891,8634,257,2.9
CN1323100000000,2022-10-01,13,231,GA,Pike County,9257,8994,263,2.8
CN1323300000000,2022-10-01,13,233,GA,Polk County,18605,18013,592,3.2
CN1323500000000,2022-10-01,13,235,GA,Pulaski County,4002,3868,134,3.3
CN1323700000000,2022-10-01,13,237,GA,Putnam County,8693,8388,305,3.5
CN1323900000000,2022-10-01,13,239,GA,Quitman County,731,689,42,5.7
CN1324100000000,2022-10-01,13,241,GA,Rabun County,7636,7404,232,3
CN1324300000000,2022-10-01,13,243,GA,Randolph County,2512,2414,98,3.9
CN1324500000000,2022-10-01,13,245,GA,Richmond County,81803,78297,3506,4.3
CN1324700000000,2022-10-01,13,247,GA,Rockdale County,45318,43777,1541,3.4
CN1324900000000,2022-10-01,13,249,GA,Schley County,2177,2100,77,3.5
CN1325100000000,2022-10-01,13,251,GA,Screven County,5046,4845,201,4
CN1325300000000,2022-10-01,13,253,GA,Seminole County,3125,3016,109,3.5
CN1325500000000,2022-10-01,13,255,GA,Spalding County,29415,28438,977,3.3
CN1325700000000,2022-10-01,13,257,GA,Stephens County,10574,10131,443,4.2
CN1325900000000,2022-10-01,13,259,GA,Stewart County,2676,2579,97,3.6
CN1326100000000,2022-10-01,13,261,GA,Sumter County,12375,11871,504,4.1
CN1326300000000,2022-10-01,13,263,GA,Talbot County,2833,2733,100,3.5
CN1326500000000,2022-10-01,13,265,GA,Taliaferro County,552,524,28,5.1
CN1326700000000,2022-10-01,13,267,GA,Tattnall County,9322,9047,275,3
CN1326900000000,2022-10-01,13,269,GA,Taylor County,2653,2521,132,5
CN1327100000000,2022-10-01,13,271,GA,Telfair County,3538,3324,214,6
CN1327300000000,2022-10-01,13,273,GA,Terrell County,3462,3313,149,4.3
CN1327500000000,2022-10-01,13,275,GA,Thomas County,16819,16207,612,3.6
CN1327700000000,2022-10-01,13,277,GA,Tift County,21128,20535,593,2.8
CN1327900000000,2022-10-01,13,279,GA,Toombs County,12145,11712,433,3.6
CN1328100000000,2022-10-01,13,281,GA,Towns County,4274,4096,178,4.2
CN1328300000000,2022-10-01,13,283,GA,Treutlen County,2641,2540,101,3.8
CN1328500000000,2022-10-01,13,285,GA,Troup County,36160,35105,1055,2.9
CN1328700000000,2022-10-01,13,287,GA,Turner County,3137,3015,122,3.9
CN1328900000000,2022-10-01,13,289,GA,Twiggs County,2684,2559,125,4.7
CN1329100000000,2022-10-01,13,291,GA,Union County,11556,11239,317,2.7
CN1329300000000,2022-10-01,13,293,GA,Upson County,11649,11291,358,3.1
CN1329500000000,2022-10-01,13,295,GA,Walker County,31488,30526,962,3.1
CN1329700000000,2022-10-01,13,297,GA,Walton County,48159,46769,1390,2.9
CN1329900000000,2022-10-01,13,299,GA,Ware County,15848,15325,523,3.3
CN1330100000000,2022-10-01,13,301,GA,Warren County,2702,2586,116,4.3
CN1330300000000,2022-10-01,13,303,GA,Washington County,6972,6707,265,3.8
CN1330500000000,2022-10-01,13,305,GA,Wayne County,12213,11843,370,3
CN1330700000000,2022-10-01,13,307,GA,Webster County,972,935,37,3.8
CN1330900000000,2022-10-01,13,309,GA,Wheeler County,1696,1611,85,5
CN1331100000000,2022-10-01,13,311,GA,White County,17169,16742,427,2.5
CN1331300000000,2022-10-01,13,313,GA,Whitfield County,42857,40843,2014,4.7
CN1331500000000,2022-10-01,13,315,GA,Wilcox County,2710,2606,104,3.8
CN1331700000000,2022-10-01,13,317,GA,Wilkes County,3744,3597,147,3.9
CN1331900000000,2022-10-01,13,319,GA,Wilkinson County,3957,3820,137,3.5
CN1332100000000,2022-10-01,13,321,GA,Worth County,8726,8455,271,3.1
CN1500100000000,2022-10-01,15,001,HI,Hawaii County,94913,91140,3773,4
CN1500300000000,2022-10-01,15,003,HI,Honolulu County/city,460380,442995,17385,3.8
CN1500700000000,2022-10-01,15,007,HI,Kauai County,36929,35581,1348,3.7
CN1500900000000,2022-10-01,15,009,HI,Maui County,87186,84003,3183,3.7
CN1600100000000,2022-10-01,16,001,ID,Ada County,269074,263089,5985,2.2
CN1600300000000,2022-10-01,16,003,ID,Adams County,1691,1625,66,3.9
CN1600500000000,2022-10-01,16,005,ID,Bannock County,43412,42347,1065,2.5
CN1600700000000,2022-10-01,16,007,ID,Bear Lake County,3291,3226,65,2
CN1600900000000,2022-10-01,16,009,ID,Benewah County,4000,3866,134,3.4
CN1601100000000,2022-10-01,16,011,ID,Bingham County,26438,25899,539,2
CN1601300000000,2022-10-01,16,013,ID,Blaine County,12611,12343,268,2.1
CN1601500000000,2022-10-01,16,015,ID,Boise County,3726,3615,111,3
CN1601700000000,2022-10-01,16,017,ID,Bonner County,20876,20202,674,3.2
CN1601900000000,2022-10-01,16,019,ID,Bonneville County,61607,60295,1312,2.1
CN1602100000000,2022-10-01,16,021,ID,Boundary County,5550,5390,160,2.9
CN1602300000000,2022-10-01,16,023,ID,Butte County,1511,1471,40,2.6
CN1602500000000,2022-10-01,16,025,ID,Camas County,738,719,19,2.6
CN1602700000000,2022-10-01,16,027,ID,Canyon County,115244,112261,2983,2.6
CN1602900000000,2022-10-01,16,029,ID,Caribou County,4285,4197,88,2.1
CN1603100000000,2022-10-01,16,031,ID,Cassia County,17182,16889,293,1.7
CN1603300000000,2022-10-01,16,033,ID,Clark County,414,402,12,2.9
CN1603500000000,2022-10-01,16,035,ID,Clearwater County,2969,2842,127,4.3
CN1603700000000,2022-10-01,16,037,ID,Custer County,2283,2223,60,2.6
CN1603900000000,2022-10-01,16,039,ID,Elmore County,13040,12711,329,2.5
CN1604100000000,2022-10-01,16,041,ID,Franklin County,7713,7560,153,2
CN1604300000000,2022-10-01,16,043,ID,Fremont County,8941,8781,160,1.8
CN1604500000000,2022-10-01,16,045,ID,Gem County,8752,8542,210,2.4
CN1604700000000,2022-10-01,16,047,ID,Gooding County,11757,11566,191,1.6
CN1604900000000,2022-10-01,16,049,ID,Idaho County,6754,6561,193,2.9
CN1605100000000,2022-10-01,16,051,ID,Jefferson County,16073,15780,293,1.8
CN1605300000000,2022-10-01,16,053,ID,Jerome County,17262,16944,318,1.8
CN1605500000000,2022-10-01,16,055,ID,Kootenai County,82995,80696,2299,2.8
CN1605700000000,2022-10-01,16,057,ID,Latah County,20673,20259,414,2
CN1605900000000,2022-10-01,16,059,ID,Lemhi County,3587,3487,100,2.8
CN1606100000000,2022-10-01,16,061,ID,Lewis County,1694,1646,48,2.8
CN1606300000000,2022-10-01,16,063,ID,Lincoln County,3331,3251,80,2.4
CN1606500000000,2022-10-01,16,065,ID,Madison County,24623,24230,393,1.6
CN1606700000000,2022-10-01,16,067,ID,Minidoka County,14917,14664,253,1.7
CN1606900000000,2022-10-01,16,069,ID,Nez Perce County,20688,20197,491,2.4
CN1607100000000,2022-10-01,16,071,ID,Oneida County,2715,2642,73,2.7
CN1607300000000,2022-10-01,16,073,ID,Owyhee County,6470,6322,148,2.3
CN1607500000000,2022-10-01,16,075,ID,Payette County,12091,11781,310,2.6
CN1607700000000,2022-10-01,16,077,ID,Power County,6008,5912,96,1.6
CN1607900000000,2022-10-01,16,079,ID,Shoshone County,5173,4969,204,3.9
CN1608100000000,2022-10-01,16,081,ID,Teton County,7789,7638,151,1.9
CN1608300000000,2022-10-01,16,083,ID,Twin Falls County,46016,44982,1034,2.2
CN1608500000000,2022-10-01,16,085,ID,Valley County,5321,5154,167,3.1
CN1608700000000,2022-10-01,16,087,ID,Washington County,5134,5004,130,2.5
CN1700100000000,2022-10-01,17,001,IL,Adams County,30599,29659,940,3.1
CN1700300000000,2022-10-01,17,003,IL,Alexander County,1813,1708,105,5.8
CN1700500000000,2022-10-01,17,005,IL,Bond County,7564,7297,267,3.5
CN1700700000000,2022-10-01,17,007,IL,Boone County,24733,23550,1183,4.8
CN1700900000000,2022-10-01,17,009,IL,Brown County,3144,3084,60,1.9
CN1701100000000,2022-10-01,17,011,IL,Bureau County,16129,15511,618,3.8
CN1701300000000,2022-10-01,17,013,IL,Calhoun County,2201,2120,81,3.7
CN1701500000000,2022-10-01,17,015,IL,Carroll County,7416,7159,257,3.5
CN1701700000000,2022-10-01,17,017,IL,Cass County,5724,5503,221,3.9
CN1701900000000,2022-10-01,17,019,IL,Champaign County,112057,108139,3918,3.5
CN1702100000000,2022-10-01,17,021,IL,Christian County,13460,12911,549,4.1
CN1702300000000,2022-10-01,17,023,IL,Clark County,7441,7177,264,3.5
CN1702500000000,2022-10-01,17,025,IL,Clay County,5780,5550,230,4
CN1702700000000,2022-10-01,17,027,IL,Clinton County,20088,19526,562,2.8
CN1702900000000,2022-10-01,17,029,IL,Coles County,23323,22439,884,3.8
CN1703100000000,2022-10-01,17,031,IL,Cook County,2682375,2553508,128867,4.8
CN1703300000000,2022-10-01,17,033,IL,Crawford County,8307,8011,296,3.6
CN1703500000000,2022-10-01,17,035,IL,Cumberland County,6046,5873,173,2.9
CN1703700000000,2022-10-01,17,037,IL,DeKalb County,53895,51855,2040,3.8
CN1703900000000,2022-10-01,17,039,IL,De Witt County,7491,7229,262,3.5
CN1704100000000,2022-10-01,17,041,IL,Douglas County,10273,9972,301,2.9
CN1704300000000,2022-10-01,17,043,IL,DuPage County,523452,505172,18280,3.5
CN1704500000000,2022-10-01,17,045,IL,Edgar County,9302,9006,296,3.2
CN1704700000000,2022-10-01,17,047,IL,Edwards County,2455,2358,97,4
CN1704900000000,2022-10-01,17,049,IL,Effingham County,19559,19035,524,2.7
CN1705100000000,2022-10-01,17,051,IL,Fayette County,9803,9438,365,3.7
CN1705300000000,2022-10-01,17,053,IL,Ford County,6569,6353,216,3.3
CN1705500000000,2022-10-01,17,055,IL,Franklin County,15848,15065,783,4.9
CN1705700000000,2022-10-01,17,057,IL,Fulton County,14710,14067,643,4.4
CN1705900000000,2022-10-01,17,059,IL,Gallatin County,2044,1945,99,4.8
CN1706100000000,2022-10-01,17,061,IL,Greene County,6021,5798,223,3.7
CN1706300000000,2022-10-01,17,063,IL,Grundy County,26428,25271,1157,4.4
CN1706500000000,2022-10-01,17,065,IL,Hamilton County,4416,4285,131,3
CN1706700000000,2022-10-01,17,067,IL,Hancock County,8104,7825,279,3.4
CN1706900000000,2022-10-01,17,069,IL,Hardin County,1465,1401,64,4.4
CN1707100000000,2022-10-01,17,071,IL,Henderson County,3586,3476,110,3.1
CN1707300000000,2022-10-01,17,073,IL,Henry County,23853,22960,893,3.7
CN1707500000000,2022-10-01,17,075,IL,Iroquois County,12749,12272,477,3.7
CN1707700000000,2022-10-01,17,077,IL,Jackson County,27338,26309,1029,3.8
CN1707900000000,2022-10-01,17,079,IL,Jasper County,5041,4888,153,3
CN1708100000000,2022-10-01,17,081,IL,Jefferson County,16348,15657,691,4.2
CN1708300000000,2022-10-01,17,083,IL,Jersey County,10612,10287,325,3.1
CN1708500000000,2022-10-01,17,085,IL,Jo Daviess County,10549,10197,352,3.3
CN1708700000000,2022-10-01,17,087,IL,Johnson County,4076,3882,194,4.8
CN1708900000000,2022-10-01,17,089,IL,Kane County,263055,252797,10258,3.9
CN1709100000000,2022-10-01,17,091,IL,Kankakee County,51822,49312,2510,4.8
CN1709300000000,2022-10-01,17,093,IL,Kendall County,73005,70212,2793,3.8
CN1709500000000,2022-10-01,17,095,IL,Knox County,19867,18932,935,4.7
CN1709700000000,2022-10-01,17,097,IL,Lake County,360522,347545,12977,3.6
CN1709900000000,2022-10-01,17,099,IL,LaSalle County,51834,49622,2212,4.3
CN1710100000000,2022-10-01,17,101,IL,Lawrence County,5066,4826,240,4.7
CN1710300000000,2022-10-01,17,103,IL,Lee County,16798,16213,585,3.5
CN1710500000000,2022-10-01,17,105,IL,Livingston County,15752,15193,559,3.5
CN1710700000000,2022-10-01,17,107,IL,Logan County,11505,11051,454,3.9
CN1710900000000,2022-10-01,17,109,IL,McDonough County,13341,12847,494,3.7
CN1711100000000,2022-10-01,17,111,IL,McHenry County,171143,164808,6335,3.7
CN1711300000000,2022-10-01,17,113,IL,McLean County,89680,86725,2955,3.3
CN1711500000000,2022-10-01,17,115,IL,Macon County,45583,43351,2232,4.9
CN1711700000000,2022-10-01,17,117,IL,Macoupin County,22276,21500,776,3.5
CN1711900000000,2022-10-01,17,119,IL,Madison County,130973,126321,4652,3.6
CN1712100000000,2022-10-01,17,121,IL,Marion County,16878,16119,759,4.5
CN1712300000000,2022-10-01,17,123,IL,Marshall County,5179,4976,203,3.9
CN1712500000000,2022-10-01,17,125,IL,Mason County,5993,5755,238,4
CN1712700000000,2022-10-01,17,127,IL,Massac County,5339,5084,255,4.8
CN1712900000000,2022-10-01,17,129,IL,Menard County,6183,5985,198,3.2
CN1713100000000,2022-10-01,17,131,IL,Mercer County,7630,7385,245,3.2
CN1713300000000,2022-10-01,17,133,IL,Monroe County,18699,18191,508,2.7
CN1713500000000,2022-10-01,17,135,IL,Montgomery County,11180,10694,486,4.3
CN1713700000000,2022-10-01,17,137,IL,Morgan County,15828,15278,550,3.5
CN1713900000000,2022-10-01,17,139,IL,Moultrie County,7470,7250,220,2.9
CN1714100000000,2022-10-01,17,141,IL,Ogle County,23834,22872,962,4
CN1714300000000,2022-10-01,17,143,IL,Peoria County,81801,78109,3692,4.5
CN1714500000000,2022-10-01,17,145,IL,Perry County,7845,7490,355,4.5
CN1714700000000,2022-10-01,17,147,IL,Piatt County,8898,8634,264,3
CN1714900000000,2022-10-01,17,149,IL,Pike County,6834,6585,249,3.6
CN1715100000000,2022-10-01,17,151,IL,Pope County,1806,1733,73,4
CN1715300000000,2022-10-01,17,153,IL,Pulaski County,1675,1569,106,6.3
CN1715500000000,2022-10-01,17,155,IL,Putnam County,2997,2880,117,3.9
CN1715700000000,2022-10-01,17,157,IL,Randolph County,13506,13065,441,3.3
CN1715900000000,2022-10-01,17,159,IL,Richland County,7179,6928,251,3.5
CN1716100000000,2022-10-01,17,161,IL,Rock Island County,67213,64597,2616,3.9
CN1716300000000,2022-10-01,17,163,IL,St. Clair County,122854,117916,4938,4
CN1716500000000,2022-10-01,17,165,IL,Saline County,9495,9058,437,4.6
CN1716700000000,2022-10-01,17,167,IL,Sangamon County,96732,93123,3609,3.7
CN1716900000000,2022-10-01,17,169,IL,Schuyler County,3065,2958,107,3.5
CN1717100000000,2022-10-01,17,171,IL,Scott County,2340,2246,94,4
CN1717300000000,2022-10-01,17,173,IL,Shelby County,9947,9597,350,3.5
CN1717500000000,2022-10-01,17,175,IL,Stark County,2431,2335,96,3.9
CN1717700000000,2022-10-01,17,177,IL,Stephenson County,20885,20060,825,4
CN1717900000000,2022-10-01,17,179,IL,Tazewell County,61772,59505,2267,3.7
CN1718100000000,2022-10-01,17,181,IL,Union County,7154,6844,310,4.3
CN1718300000000,2022-10-01,17,183,IL,Vermilion County,31830,30363,1467,4.6
CN1718500000000,2022-10-01,17,185,IL,Wabash County,5788,5614,174,3
CN1718700000000,2022-10-01,17,187,IL,Warren County,7978,7708,270,3.4
CN1718900000000,2022-10-01,17,189,IL,Washington County,9868,9653,215,2.2
CN1719100000000,2022-10-01,17,191,IL,Wayne County,7124,6873,251,3.5
CN1719300000000,2022-10-01,17,193,IL,White County,6116,5890,226,3.7
CN1719500000000,2022-10-01,17,195,IL,Whiteside County,27783,26693,1090,3.9
CN1719700000000,2022-10-01,17,197,IL,Will County,369927,354088,15839,4.3
CN1719900000000,2022-10-01,17,199,IL,Williamson County,31223,30015,1208,3.9
CN1720100000000,2022-10-01,17,201,IL,Winnebago County,132058,125511,6547,5
CN1720300000000,2022-10-01,17,203,IL,Woodford County,18305,17711,594,3.2
CN1800100000000,2022-10-01,18,001,IN,Adams County,17127,16724,403,2.4
CN1800300000000,2022-10-01,18,003,IN,Allen County,190114,184716,5398,2.8
CN1800500000000,2022-10-01,18,005,IN,Bartholomew County,44698,43610,1088,2.4
CN1800700000000,2022-10-01,18,007,IN,Benton County,4477,4371,106,2.4
CN1800900000000,2022-10-01,18,009,IN,Blackford County,4813,4646,167,3.5
CN1801100000000,2022-10-01,18,011,IN,Boone County,38898,38036,862,2.2
CN1801300000000,2022-10-01,18,013,IN,Brown County,8026,7769,257,3.2
CN1801500000000,2022-10-01,18,015,IN,Carroll County,10107,9823,284,2.8
CN1801700000000,2022-10-01,18,017,IN,Cass County,17446,16893,553,3.2
CN1801900000000,2022-10-01,18,019,IN,Clark County,62833,61130,1703,2.7
CN1802100000000,2022-10-01,18,021,IN,Clay County,11785,11392,393,3.3
CN1802300000000,2022-10-01,18,023,IN,Clinton County,17326,16879,447,2.6
CN1802500000000,2022-10-01,18,025,IN,Crawford County,4825,4679,146,3
CN1802700000000,2022-10-01,18,027,IN,Daviess County,16758,16369,389,2.3
CN1802900000000,2022-10-01,18,029,IN,Dearborn County,26103,25429,674,2.6
CN1803100000000,2022-10-01,18,031,IN,Decatur County,14549,14197,352,2.4
CN1803300000000,2022-10-01,18,033,IN,DeKalb County,22441,21814,627,2.8
CN1803500000000,2022-10-01,18,035,IN,Delaware County,52017,50219,1798,3.5
CN1803700000000,2022-10-01,18,037,IN,Dubois County,21998,21465,533,2.4
CN1803900000000,2022-10-01,18,039,IN,Elkhart County,117110,113744,3366,2.9
CN1804100000000,2022-10-01,18,041,IN,Fayette County,8403,8034,369,4.4
CN1804300000000,2022-10-01,18,043,IN,Floyd County,42370,41278,1092,2.6
CN1804500000000,2022-10-01,18,045,IN,Fountain County,8067,7847,220,2.7
CN1804700000000,2022-10-01,18,047,IN,Franklin County,11399,11108,291,2.6
CN1804900000000,2022-10-01,18,049,IN,Fulton County,9608,9330,278,2.9
CN1805100000000,2022-10-01,18,051,IN,Gibson County,20237,19786,451,2.2
CN1805300000000,2022-10-01,18,053,IN,Grant County,32060,31036,1024,3.2
CN1805500000000,2022-10-01,18,055,IN,Greene County,13820,13338,482,3.5
CN1805700000000,2022-10-01,18,057,IN,Hamilton County,198166,193651,4515,2.3
CN1805900000000,2022-10-01,18,059,IN,Hancock County,43388,42276,1112,2.6
CN1806100000000,2022-10-01,18,061,IN,Harrison County,20560,20014,546,2.7
CN1806300000000,2022-10-01,18,063,IN,Hendricks County,96412,94029,2383,2.5
CN1806500000000,2022-10-01,18,065,IN,Henry County,22357,21665,692,3.1
CN1806700000000,2022-10-01,18,067,IN,Howard County,33197,31607,1590,4.8
CN1806900000000,2022-10-01,18,069,IN,Huntington County,18360,17852,508,2.8
CN1807100000000,2022-10-01,18,071,IN,Jackson County,23634,23000,634,2.7
CN1807300000000,2022-10-01,18,073,IN,Jasper County,16062,15558,504,3.1
CN1807500000000,2022-10-01,18,075,IN,Jay County,8888,8633,255,2.9
CN1807700000000,2022-10-01,18,077,IN,Jefferson County,15150,14723,427,2.8
CN1807900000000,2022-10-01,18,079,IN,Jennings County,13537,13133,404,3
CN1808100000000,2022-10-01,18,081,IN,Johnson County,88169,85988,2181,2.5
CN1808300000000,2022-10-01,18,083,IN,Knox County,18353,17830,523,2.8
CN1808500000000,2022-10-01,18,085,IN,Kosciusko County,41184,40059,1125,2.7
CN1808700000000,2022-10-01,18,087,IN,LaGrange County,21755,21100,655,3
CN1808900000000,2022-10-01,18,089,IN,Lake County,227765,218687,9078,4
CN1809100000000,2022-10-01,18,091,IN,LaPorte County,47201,45578,1623,3.4
CN1809300000000,2022-10-01,18,093,IN,Lawrence County,20655,19930,725,3.5
CN1809500000000,2022-10-01,18,095,IN,Madison County,60975,59069,1906,3.1
CN1809700000000,2022-10-01,18,097,IN,Marion County,513239,498062,15177,3
CN1809900000000,2022-10-01,18,099,IN,Marshall County,23247,22606,641,2.8
CN1810100000000,2022-10-01,18,101,IN,Martin County,5480,5327,153,2.8
CN1810300000000,2022-10-01,18,103,IN,Miami County,14354,13812,542,3.8
CN1810500000000,2022-10-01,18,105,IN,Monroe County,72669,70432,2237,3.1
CN1810700000000,2022-10-01,18,107,IN,Montgomery County,19116,18618,498,2.6
CN1810900000000,2022-10-01,18,109,IN,Morgan County,37945,36920,1025,2.7
CN1811100000000,2022-10-01,18,111,IN,Newton County,6838,6608,230,3.4
CN1811300000000,2022-10-01,18,113,IN,Noble County,21875,21109,766,3.5
CN1811500000000,2022-10-01,18,115,IN,Ohio County,3228,3154,74,2.3
CN1811700000000,2022-10-01,18,117,IN,Orange County,8206,7938,268,3.3
CN1811900000000,2022-10-01,18,119,IN,Owen County,9588,9287,301,3.1
CN1812100000000,2022-10-01,18,121,IN,Parke County,7176,6960,216,3
CN1812300000000,2022-10-01,18,123,IN,Perry County,8831,8549,282,3.2
CN1812500000000,2022-10-01,18,125,IN,Pike County,5904,5735,169,2.9
CN1812700000000,2022-10-01,18,127,IN,Porter County,86216,83586,2630,3.1
CN1812900000000,2022-10-01,18,129,IN,Posey County,13162,12850,312,2.4
CN1813100000000,2022-10-01,18,131,IN,Pulaski County,6640,6471,169,2.5
CN1813300000000,2022-10-01,18,133,IN,Putnam County,17213,16668,545,3.2
CN1813500000000,2022-10-01,18,135,IN,Randolph County,11726,11381,345,2.9
CN1813700000000,2022-10-01,18,137,IN,Ripley County,12763,12374,389,3
CN1813900000000,2022-10-01,18,139,IN,Rush County,9040,8813,227,2.5
CN1814100000000,2022-10-01,18,141,IN,St. Joseph County,132629,128116,4513,3.4
CN1814300000000,2022-10-01,18,143,IN,Scott County,10555,10223,332,3.1
CN1814500000000,2022-10-01,18,145,IN,Shelby County,24070,23464,606,2.5
CN1814700000000,2022-10-01,18,147,IN,Spencer County,10666,10399,267,2.5
CN1814900000000,2022-10-01,18,149,IN,Starke County,9644,9291,353,3.7
CN1815100000000,2022-10-01,18,151,IN,Steuben County,20778,20291,487,2.3
CN1815300000000,2022-10-01,18,153,IN,Sullivan County,8062,7775,287,3.6
CN1815500000000,2022-10-01,18,155,IN,Switzerland County,4791,4659,132,2.8
CN1815700000000,2022-10-01,18,157,IN,Tippecanoe County,98330,95427,2903,3
CN1815900000000,2022-10-01,18,159,IN,Tipton County,8966,8714,252,2.8
CN1816100000000,2022-10-01,18,161,IN,Union County,3622,3528,94,2.6
CN1816300000000,2022-10-01,18,163,IN,Vanderburgh County,92999,90247,2752,3
CN1816500000000,2022-10-01,18,165,IN,Vermillion County,6639,6422,217,3.3
CN1816700000000,2022-10-01,18,167,IN,Vigo County,46298,44701,1597,3.4
CN1816900000000,2022-10-01,18,169,IN,Wabash County,14762,14356,406,2.8
CN1817100000000,2022-10-01,18,171,IN,Warren County,4164,4052,112,2.7
CN1817300000000,2022-10-01,18,173,IN,Warrick County,32683,31818,865,2.6
CN1817500000000,2022-10-01,18,175,IN,Washington County,13902,13535,367,2.6
CN1817700000000,2022-10-01,18,177,IN,Wayne County,29706,28788,918,3.1
CN1817900000000,2022-10-01,18,179,IN,Wells County,14460,14117,343,2.4
CN1818100000000,2022-10-01,18,181,IN,White County,13422,13099,323,2.4
CN1818300000000,2022-10-01,18,183,IN,Whitley County,17956,17518,438,2.4
CN1900100000000,2022-10-01,19,001,IA,Adair County,4372,4286,86,2
CN1900300000000,2022-10-01,19,003,IA,Adams County,2130,2084,46,2.2
CN1900500000000,2022-10-01,19,005,IA,Allamakee County,7072,6871,201,2.8
CN1900700000000,2022-10-01,19,007,IA,Appanoose County,6081,5912,169,2.8
CN1900900000000,2022-10-01,19,009,IA,Audubon County,3047,2980,67,2.2
CN1901100000000,2022-10-01,19,011,IA,Benton County,13237,12864,373,2.8
CN1901300000000,2022-10-01,19,013,IA,Black Hawk County,68774,66874,1900,2.8
CN1901500000000,2022-10-01,19,015,IA,Boone County,15061,14734,327,2.2
CN1901700000000,2022-10-01,19,017,IA,Bremer County,14159,13854,305,2.2
CN1901900000000,2022-10-01,19,019,IA,Buchanan County,11329,11045,284,2.5
CN1902100000000,2022-10-01,19,021,IA,Buena Vista County,12053,11766,287,2.4
CN1902300000000,2022-10-01,19,023,IA,Butler County,8358,8163,195,2.3
CN1902500000000,2022-10-01,19,025,IA,Calhoun County,4219,4107,112,2.7
CN1902700000000,2022-10-01,19,027,IA,Carroll County,10848,10632,216,2
CN1902900000000,2022-10-01,19,029,IA,Cass County,6926,6770,156,2.3
CN1903100000000,2022-10-01,19,031,IA,Cedar County,10614,10364,250,2.4
CN1903300000000,2022-10-01,19,033,IA,Cerro Gordo County,22498,21914,584,2.6
CN1903500000000,2022-10-01,19,035,IA,Cherokee County,6130,5995,135,2.2
CN1903700000000,2022-10-01,19,037,IA,Chickasaw County,6633,6492,141,2.1
CN1903900000000,2022-10-01,19,039,IA,Clarke County,5016,4887,129,2.6
CN1904100000000,2022-10-01,19,041,IA,Clay County,8545,8329,216,2.5
CN1904300000000,2022-10-01,19,043,IA,Clayton County,9434,9189,245,2.6
CN1904500000000,2022-10-01,19,045,IA,Clinton County,22496,21757,739,3.3
CN1904700000000,2022-10-01,19,047,IA,Crawford County,7825,7583,242,3.1
CN1904900000000,2022-10-01,19,049,IA,Dallas County,55233,54087,1146,2.1
CN1905100000000,2022-10-01,19,051,IA,Davis County,4366,4266,100,2.3
CN1905300000000,2022-10-01,19,053,IA,Decatur County,4372,4272,100,2.3
CN1905500000000,2022-10-01,19,055,IA,Delaware County,10489,10282,207,2
CN1905700000000,2022-10-01,19,057,IA,Des Moines County,18223,17513,710,3.9
CN1905900000000,2022-10-01,19,059,IA,Dickinson County,10292,10034,258,2.5
CN1906100000000,2022-10-01,19,061,IA,Dubuque County,57183,55502,1681,2.9
CN1906300000000,2022-10-01,19,063,IA,Emmet County,4888,4761,127,2.6
CN1906500000000,2022-10-01,19,065,IA,Fayette County,10437,10179,258,2.5
CN1906700000000,2022-10-01,19,067,IA,Floyd County,8385,8166,219,2.6
CN1906900000000,2022-10-01,19,069,IA,Franklin County,5633,5501,132,2.3
CN1907100000000,2022-10-01,19,071,IA,Fremont County,3782,3679,103,2.7
CN1907300000000,2022-10-01,19,073,IA,Greene County,5432,5326,106,2
CN1907500000000,2022-10-01,19,075,IA,Grundy County,6446,6291,155,2.4
CN1907700000000,2022-10-01,19,077,IA,Guthrie County,5704,5557,147,2.6
CN1907900000000,2022-10-01,19,079,IA,Hamilton County,7012,6826,186,2.7
CN1908100000000,2022-10-01,19,081,IA,Hancock County,5702,5569,133,2.3
CN1908300000000,2022-10-01,19,083,IA,Hardin County,7820,7607,213,2.7
CN1908500000000,2022-10-01,19,085,IA,Harrison County,7198,7017,181,2.5
CN1908700000000,2022-10-01,19,087,IA,Henry County,9616,9328,288,3
CN1908900000000,2022-10-01,19,089,IA,Howard County,5215,5088,127,2.4
CN1909100000000,2022-10-01,19,091,IA,Humboldt County,4935,4821,114,2.3
CN1909300000000,2022-10-01,19,093,IA,Ida County,3973,3893,80,2
CN1909500000000,2022-10-01,19,095,IA,Iowa County,9950,9746,204,2.1
CN1909700000000,2022-10-01,19,097,IA,Jackson County,10666,10353,313,2.9
CN1909900000000,2022-10-01,19,099,IA,Jasper County,18955,18447,508,2.7
CN1910100000000,2022-10-01,19,101,IA,Jefferson County,9983,9724,259,2.6
CN1910300000000,2022-10-01,19,103,IA,Johnson County,88879,86860,2019,2.3
CN1910500000000,2022-10-01,19,105,IA,Jones County,10423,10147,276,2.6
CN1910700000000,2022-10-01,19,107,IA,Keokuk County,5206,5065,141,2.7
CN1910900000000,2022-10-01,19,109,IA,Kossuth County,8315,8132,183,2.2
CN1911100000000,2022-10-01,19,111,IA,Lee County,14768,14138,630,4.3
CN1911300000000,2022-10-01,19,113,IA,Linn County,122334,118745,3589,2.9
CN1911500000000,2022-10-01,19,115,IA,Louisa County,5958,5803,155,2.6
CN1911700000000,2022-10-01,19,117,IA,Lucas County,4597,4493,104,2.3
CN1911900000000,2022-10-01,19,119,IA,Lyon County,7113,6986,127,1.8
CN1912100000000,2022-10-01,19,121,IA,Madison County,8903,8665,238,2.7
CN1912300000000,2022-10-01,19,123,IA,Mahaska County,12400,12112,288,2.3
CN1912500000000,2022-10-01,19,125,IA,Marion County,19707,19320,387,2
CN1912700000000,2022-10-01,19,127,IA,Marshall County,17144,16557,587,3.4
CN1912900000000,2022-10-01,19,129,IA,Mills County,7213,7038,175,2.4
CN1913100000000,2022-10-01,19,131,IA,Mitchell County,5857,5740,117,2
CN1913300000000,2022-10-01,19,133,IA,Monona County,4403,4289,114,2.6
CN1913500000000,2022-10-01,19,135,IA,Monroe County,4009,3906,103,2.6
CN1913700000000,2022-10-01,19,137,IA,Montgomery County,4955,4832,123,2.5
CN1913900000000,2022-10-01,19,139,IA,Muscatine County,21098,20480,618,2.9
CN1914100000000,2022-10-01,19,141,IA,O'Brien County,8256,8078,178,2.2
CN1914300000000,2022-10-01,19,143,IA,Osceola County,3703,3637,66,1.8
CN1914500000000,2022-10-01,19,145,IA,Page County,6458,6288,170,2.6
CN1914700000000,2022-10-01,19,147,IA,Palo Alto County,4509,4405,104,2.3
CN1914900000000,2022-10-01,19,149,IA,Plymouth County,14995,14674,321,2.1
CN1915100000000,2022-10-01,19,151,IA,Pocahontas County,4389,4294,95,2.2
CN1915300000000,2022-10-01,19,153,IA,Polk County,282495,275389,7106,2.5
CN1915500000000,2022-10-01,19,155,IA,Pottawattamie County,48404,47122,1282,2.6
CN1915700000000,2022-10-01,19,157,IA,Poweshiek County,10570,10322,248,2.3
CN1915900000000,2022-10-01,19,159,IA,Ringgold County,2348,2297,51,2.2
CN1916100000000,2022-10-01,19,161,IA,Sac County,5258,5140,118,2.2
CN1916300000000,2022-10-01,19,163,IA,Scott County,90243,87514,2729,3
CN1916500000000,2022-10-01,19,165,IA,Shelby County,6466,6317,149,2.3
CN1916700000000,2022-10-01,19,167,IA,Sioux County,22941,22564,377,1.6
CN1916900000000,2022-10-01,19,169,IA,Story County,61952,60713,1239,2
CN1917100000000,2022-10-01,19,171,IA,Tama County,9199,8967,232,2.5
CN1917300000000,2022-10-01,19,173,IA,Taylor County,3182,3116,66,2.1
CN1917500000000,2022-10-01,19,175,IA,Union County,6148,5990,158,2.6
CN1917700000000,2022-10-01,19,177,IA,Van Buren County,3681,3583,98,2.7
CN1917900000000,2022-10-01,19,179,IA,Wapello County,16865,16339,526,3.1
CN1918100000000,2022-10-01,19,181,IA,Warren County,29925,29246,679,2.3
CN1918300000000,2022-10-01,19,183,IA,Washington County,11939,11649,290,2.4
CN1918500000000,2022-10-01,19,185,IA,Wayne County,2951,2879,72,2.4
CN1918700000000,2022-10-01,19,187,IA,Webster County,18974,18469,505,2.7
CN1918900000000,2022-10-01,19,189,IA,Winnebago County,5018,4883,135,2.7
CN1919100000000,2022-10-01,19,191,IA,Winneshiek County,11786,11522,264,2.2
CN1919300000000,2022-10-01,19,193,IA,Woodbury County,56941,55521,1420,2.5
CN1919500000000,2022-10-01,19,195,IA,Worth County,3999,3909,90,2.3
CN1919700000000,2022-10-01,19,197,IA,Wright County,6645,6489,156,2.3
CN2000100000000,2022-10-01,20,001,KS,Allen County,6291,6120,171,2.7
CN2000300000000,2022-10-01,20,003,KS,Anderson County,4360,4264,96,2.2
CN2000500000000,2022-10-01,20,005,KS,Atchison County,6776,6551,225,3.3
CN2000700000000,2022-10-01,20,007,KS,Barber County,2216,2165,51,2.3
CN2000900000000,2022-10-01,20,009,KS,Barton County,12993,12647,346,2.7
CN2001100000000,2022-10-01,20,011,KS,Bourbon County,6300,6089,211,3.3
CN2001300000000,2022-10-01,20,013,KS,Brown County,5073,4950,123,2.4
CN2001500000000,2022-10-01,20,015,KS,Butler County,32993,32089,904,2.7
CN2001700000000,2022-10-01,20,017,KS,Chase County,1362,1330,32,2.3
CN2001900000000,2022-10-01,20,019,KS,Chautauqua County,1416,1377,39,2.8
CN2002100000000,2022-10-01,20,021,KS,Cherokee County,9784,9535,249,2.5
CN2002300000000,2022-10-01,20,023,KS,Cheyenne County,1225,1194,31,2.5
CN2002500000000,2022-10-01,20,025,KS,Clark County,1096,1074,22,2
CN2002700000000,2022-10-01,20,027,KS,Clay County,3737,3636,101,2.7
CN2002900000000,2022-10-01,20,029,KS,Cloud County,3819,3717,102,2.7
CN2003100000000,2022-10-01,20,031,KS,Coffey County,3904,3776,128,3.3
CN2003300000000,2022-10-01,20,033,KS,Comanche County,857,837,20,2.3
CN2003500000000,2022-10-01,20,035,KS,Cowley County,16489,15981,508,3.1
CN2003700000000,2022-10-01,20,037,KS,Crawford County,19167,18602,565,2.9
CN2003900000000,2022-10-01,20,039,KS,Decatur County,1136,1098,38,3.3
CN2004100000000,2022-10-01,20,041,KS,Dickinson County,8658,8419,239,2.8
CN2004300000000,2022-10-01,20,043,KS,Doniphan County,4005,3901,104,2.6
CN2004500000000,2022-10-01,20,045,KS,Douglas County,67223,65485,1738,2.6
CN2004700000000,2022-10-01,20,047,KS,Edwards County,1377,1343,34,2.5
CN2004900000000,2022-10-01,20,049,KS,Elk County,1190,1154,36,3
CN2005100000000,2022-10-01,20,051,KS,Ellis County,17045,16685,360,2.1
CN2005300000000,2022-10-01,20,053,KS,Ellsworth County,2611,2550,61,2.3
CN2005500000000,2022-10-01,20,055,KS,Finney County,20436,19979,457,2.2
CN2005700000000,2022-10-01,20,057,KS,Ford County,17908,17511,397,2.2
CN2005900000000,2022-10-01,20,059,KS,Franklin County,14966,14615,351,2.3
CN2006100000000,2022-10-01,20,061,KS,Geary County,11374,10929,445,3.9
CN2006300000000,2022-10-01,20,063,KS,Gove County,1361,1327,34,2.5
CN2006500000000,2022-10-01,20,065,KS,Graham County,1175,1143,32,2.7
CN2006700000000,2022-10-01,20,067,KS,Grant County,2816,2738,78,2.8
CN2006900000000,2022-10-01,20,069,KS,Gray County,3163,3098,65,2.1
CN2007100000000,2022-10-01,20,071,KS,Greeley County,794,779,15,1.9
CN2007300000000,2022-10-01,20,073,KS,Greenwood County,3039,2967,72,2.4
CN2007500000000,2022-10-01,20,075,KS,Hamilton County,1605,1576,29,1.8
CN2007700000000,2022-10-01,20,077,KS,Harper County,2765,2704,61,2.2
CN2007900000000,2022-10-01,20,079,KS,Harvey County,17231,16805,426,2.5
CN2008100000000,2022-10-01,20,081,KS,Haskell County,2183,2134,49,2.2
CN2008300000000,2022-10-01,20,083,KS,Hodgeman County,1019,997,22,2.2
CN2008500000000,2022-10-01,20,085,KS,Jackson County,7251,7087,164,2.3
CN2008700000000,2022-10-01,20,087,KS,Jefferson County,10327,10064,263,2.5
CN2008900000000,2022-10-01,20,089,KS,Jewell County,1155,1119,36,3.1
CN2009100000000,2022-10-01,20,091,KS,Johnson County,350528,342075,8453,2.4
CN2009300000000,2022-10-01,20,093,KS,Kearny County,1988,1947,41,2.1
CN2009500000000,2022-10-01,20,095,KS,Kingman County,3298,3214,84,2.5
CN2009700000000,2022-10-01,20,097,KS,Kiowa County,1217,1190,27,2.2
CN2009900000000,2022-10-01,20,099,KS,Labette County,9385,9090,295,3.1
CN2010100000000,2022-10-01,20,101,KS,Lane County,758,736,22,2.9
CN2010300000000,2022-10-01,20,103,KS,Leavenworth County,37514,36433,1081,2.9
CN2010500000000,2022-10-01,20,105,KS,Lincoln County,1720,1679,41,2.4
CN2010700000000,2022-10-01,20,107,KS,Linn County,4365,4206,159,3.6
CN2010900000000,2022-10-01,20,109,KS,Logan County,1617,1585,32,2
CN2011100000000,2022-10-01,20,111,KS,Lyon County,16958,16535,423,2.5
CN2011300000000,2022-10-01,20,113,KS,McPherson County,17289,16944,345,2
CN2011500000000,2022-10-01,20,115,KS,Marion County,5931,5779,152,2.6
CN2011700000000,2022-10-01,20,117,KS,Marshall County,5186,5073,113,2.2
CN2011900000000,2022-10-01,20,119,KS,Meade County,2092,2049,43,2.1
CN2012100000000,2022-10-01,20,121,KS,Miami County,18067,17608,459,2.5
CN2012300000000,2022-10-01,20,123,KS,Mitchell County,3319,3249,70,2.1
CN2012500000000,2022-10-01,20,125,KS,Montgomery County,14652,14188,464,3.2
CN2012700000000,2022-10-01,20,127,KS,Morris County,2998,2926,72,2.4
CN2012900000000,2022-10-01,20,129,KS,Morton County,1114,1083,31,2.8
CN2013100000000,2022-10-01,20,131,KS,Nemaha County,5549,5436,113,2
CN2013300000000,2022-10-01,20,133,KS,Neosho County,6054,5829,225,3.7
CN2013500000000,2022-10-01,20,135,KS,Ness County,1317,1283,34,2.6
CN2013700000000,2022-10-01,20,137,KS,Norton County,2590,2537,53,2
CN2013900000000,2022-10-01,20,139,KS,Osage County,8006,7776,230,2.9
CN2014100000000,2022-10-01,20,141,KS,Osborne County,1904,1865,39,2
CN2014300000000,2022-10-01,20,143,KS,Ottawa County,3040,2960,80,2.6
CN2014500000000,2022-10-01,20,145,KS,Pawnee County,2672,2604,68,2.5
CN2014700000000,2022-10-01,20,147,KS,Phillips County,2645,2578,67,2.5
CN2014900000000,2022-10-01,20,149,KS,Pottawatomie County,12792,12494,298,2.3
CN2015100000000,2022-10-01,20,151,KS,Pratt County,4910,4801,109,2.2
CN2015300000000,2022-10-01,20,153,KS,Rawlins County,1499,1472,27,1.8
CN2015500000000,2022-10-01,20,155,KS,Reno County,29219,28344,875,3
CN2015700000000,2022-10-01,20,157,KS,Republic County,2372,2321,51,2.2
CN2015900000000,2022-10-01,20,159,KS,Rice County,5371,5246,125,2.3
CN2016100000000,2022-10-01,20,161,KS,Riley County,35469,34502,967,2.7
CN2016300000000,2022-10-01,20,163,KS,Rooks County,2406,2338,68,2.8
CN2016500000000,2022-10-01,20,165,KS,Rush County,1632,1593,39,2.4
CN2016700000000,2022-10-01,20,167,KS,Russell County,3312,3230,82,2.5
CN2016900000000,2022-10-01,20,169,KS,Saline County,30192,29419,773,2.6
CN2017100000000,2022-10-01,20,171,KS,Scott County,2666,2608,58,2.2
CN2017300000000,2022-10-01,20,173,KS,Sedgwick County,257478,249670,7808,3
CN2017500000000,2022-10-01,20,175,KS,Seward County,9728,9476,252,2.6
CN2017700000000,2022-10-01,20,177,KS,Shawnee County,91604,89037,2567,2.8
CN2017900000000,2022-10-01,20,179,KS,Sheridan County,1438,1409,29,2
CN2018100000000,2022-10-01,20,181,KS,Sherman County,2759,2692,67,2.4
CN2018300000000,2022-10-01,20,183,KS,Smith County,1983,1939,44,2.2
CN2018500000000,2022-10-01,20,185,KS,Stafford County,1887,1838,49,2.6
CN2018700000000,2022-10-01,20,187,KS,Stanton County,1117,1093,24,2.1
CN2018900000000,2022-10-01,20,189,KS,Stevens County,3007,2947,60,2
CN2019100000000,2022-10-01,20,191,KS,Sumner County,10858,10529,329,3
CN2019300000000,2022-10-01,20,193,KS,Thomas County,4277,4190,87,2
CN2019500000000,2022-10-01,20,195,KS,Trego County,1322,1286,36,2.7
CN2019700000000,2022-10-01,20,197,KS,Wabaunsee County,3717,3630,87,2.3
CN2019900000000,2022-10-01,20,199,KS,Wallace County,848,829,19,2.2
CN2020100000000,2022-10-01,20,201,KS,Washington County,2989,2926,63,2.1
CN2020300000000,2022-10-01,20,203,KS,Wichita County,1149,1122,27,2.3
CN2020500000000,2022-10-01,20,205,KS,Wilson County,3691,3572,119,3.2
CN2020700000000,2022-10-01,20,207,KS,Woodson County,1563,1514,49,3.1
CN2020900000000,2022-10-01,20,209,KS,Wyandotte County,78364,75633,2731,3.5
CN2100100000000,2022-10-01,21,001,KY,Adair County,7258,6917,341,4.7
CN2100300000000,2022-10-01,21,003,KY,Allen County,9084,8743,341,3.8
CN2100500000000,2022-10-01,21,005,KY,Anderson County,11998,11624,374,3.1
CN2100700000000,2022-10-01,21,007,KY,Ballard County,3474,3322,152,4.4
CN2100900000000,2022-10-01,21,009,KY,Barren County,17826,17119,707,4
CN2101100000000,2022-10-01,21,011,KY,Bath County,4751,4524,227,4.8
CN2101300000000,2022-10-01,21,013,KY,Bell County,8190,7779,411,5
CN2101500000000,2022-10-01,21,015,KY,Boone County,72260,69981,2279,3.2
CN2101700000000,2022-10-01,21,017,KY,Bourbon County,9790,9460,330,3.4
CN2101900000000,2022-10-01,21,019,KY,Boyd County,17033,16214,819,4.8
CN2102100000000,2022-10-01,21,021,KY,Boyle County,12750,12245,505,4
CN2102300000000,2022-10-01,21,023,KY,Bracken County,3780,3641,139,3.7
CN2102500000000,2022-10-01,21,025,KY,Breathitt County,3151,2938,213,6.8
CN2102700000000,2022-10-01,21,027,KY,Breckinridge County,7986,7619,367,4.6
CN2102900000000,2022-10-01,21,029,KY,Bullitt County,42495,41093,1402,3.3
CN2103100000000,2022-10-01,21,031,KY,Butler County,5036,4828,208,4.1
CN2103300000000,2022-10-01,21,033,KY,Caldwell County,6182,5970,212,3.4
CN2103500000000,2022-10-01,21,035,KY,Calloway County,17623,16939,684,3.9
CN2103700000000,2022-10-01,21,037,KY,Campbell County,50691,49052,1639,3.2
CN2103900000000,2022-10-01,21,039,KY,Carlisle County,2263,2185,78,3.4
CN2104100000000,2022-10-01,21,041,KY,Carroll County,5852,5676,176,3
CN2104300000000,2022-10-01,21,043,KY,Carter County,9546,9006,540,5.7
CN2104500000000,2022-10-01,21,045,KY,Casey County,6634,6387,247,3.7
CN2104700000000,2022-10-01,21,047,KY,Christian County,24901,23768,1133,4.6
CN2104900000000,2022-10-01,21,049,KY,Clark County,17348,16741,607,3.5
CN2105100000000,2022-10-01,21,051,KY,Clay County,5074,4778,296,5.8
CN2105300000000,2022-10-01,21,053,KY,Clinton County,3600,3431,169,4.7
CN2105500000000,2022-10-01,21,055,KY,Crittenden County,3841,3690,151,3.9
CN2105700000000,2022-10-01,21,057,KY,Cumberland County,3413,3311,102,3
CN2105900000000,2022-10-01,21,059,KY,Daviess County,45678,43823,1855,4.1
CN2106100000000,2022-10-01,21,061,KY,Edmonson County,4776,4551,225,4.7
CN2106300000000,2022-10-01,21,063,KY,Elliott County,1880,1756,124,6.6
CN2106500000000,2022-10-01,21,065,KY,Estill County,5211,4974,237,4.5
CN2106700000000,2022-10-01,21,067,KY,Fayette County,176676,171155,5521,3.1
CN2106900000000,2022-10-01,21,069,KY,Fleming County,6200,5941,259,4.2
CN2107100000000,2022-10-01,21,071,KY,Floyd County,11055,10428,627,5.7
CN2107300000000,2022-10-01,21,073,KY,Franklin County,25150,24314,836,3.3
CN2107500000000,2022-10-01,21,075,KY,Fulton County,2088,1997,91,4.4
CN2107700000000,2022-10-01,21,077,KY,Gallatin County,4029,3883,146,3.6
CN2107900000000,2022-10-01,21,079,KY,Garrard County,8008,7714,294,3.7
CN2108100000000,2022-10-01,21,081,KY,Grant County,11726,11284,442,3.8
CN2108300000000,2022-10-01,21,083,KY,Graves County,15552,14924,628,4
CN2108500000000,2022-10-01,21,085,KY,Grayson County,10421,9977,444,4.3
CN2108700000000,2022-10-01,21,087,KY,Green County,5057,4879,178,3.5
CN2108900000000,2022-10-01,21,089,KY,Greenup County,12796,12135,661,5.2
CN2109100000000,2022-10-01,21,091,KY,Hancock County,3842,3643,199,5.2
CN2109300000000,2022-10-01,21,093,KY,Hardin County,46673,44823,1850,4
CN2109500000000,2022-10-01,21,095,KY,Harlan County,6388,5989,399,6.2
CN2109700000000,2022-10-01,21,097,KY,Harrison County,8858,8551,307,3.5
CN2109900000000,2022-10-01,21,099,KY,Hart County,7617,7313,304,4
CN2110100000000,2022-10-01,21,101,KY,Henderson County,20680,19908,772,3.7
CN2110300000000,2022-10-01,21,103,KY,Henry County,8119,7853,266,3.3
CN2110500000000,2022-10-01,21,105,KY,Hickman County,1686,1618,68,4
CN2110700000000,2022-10-01,21,107,KY,Hopkins County,17941,17196,745,4.2
CN2110900000000,2022-10-01,21,109,KY,Jackson County,4145,3918,227,5.5
CN2111100000000,2022-10-01,21,111,KY,Jefferson County,391058,377675,13383,3.4
CN2111300000000,2022-10-01,21,113,KY,Jessamine County,26728,25841,887,3.3
CN2111500000000,2022-10-01,21,115,KY,Johnson County,6665,6294,371,5.6
CN2111700000000,2022-10-01,21,117,KY,Kenton County,87812,84939,2873,3.3
CN2111900000000,2022-10-01,21,119,KY,Knott County,4317,4050,267,6.2
CN2112100000000,2022-10-01,21,121,KY,Knox County,9986,9456,530,5.3
CN2112300000000,2022-10-01,21,123,KY,Larue County,5725,5483,242,4.2
CN2112500000000,2022-10-01,21,125,KY,Laurel County,25253,24184,1069,4.2
CN2112700000000,2022-10-01,21,127,KY,Lawrence County,5559,5296,263,4.7
CN2112900000000,2022-10-01,21,129,KY,Lee County,2099,1992,107,5.1
CN2113100000000,2022-10-01,21,131,KY,Leslie County,2535,2373,162,6.4
CN2113300000000,2022-10-01,21,133,KY,Letcher County,5874,5503,371,6.3
CN2113500000000,2022-10-01,21,135,KY,Lewis County,4559,4268,291,6.4
CN2113700000000,2022-10-01,21,137,KY,Lincoln County,9350,8919,431,4.6
CN2113900000000,2022-10-01,21,139,KY,Livingston County,3629,3473,156,4.3
CN2114100000000,2022-10-01,21,141,KY,Logan County,12475,12029,446,3.6
CN2114300000000,2022-10-01,21,143,KY,Lyon County,3139,3010,129,4.1
CN2114500000000,2022-10-01,21,145,KY,McCracken County,29817,28657,1160,3.9
CN2114700000000,2022-10-01,21,147,KY,McCreary County,4740,4495,245,5.2
CN2114900000000,2022-10-01,21,149,KY,McLean County,3976,3804,172,4.3
CN2115100000000,2022-10-01,21,151,KY,Madison County,47162,45473,1689,3.6
CN2115300000000,2022-10-01,21,153,KY,Magoffin County,3102,2850,252,8.1
CN2115500000000,2022-10-01,21,155,KY,Marion County,9438,9151,287,3
CN2115700000000,2022-10-01,21,157,KY,Marshall County,14413,13853,560,3.9
CN2115900000000,2022-10-01,21,159,KY,Martin County,2154,1998,156,7.2
CN2116100000000,2022-10-01,21,161,KY,Mason County,6576,6263,313,4.8
CN2116300000000,2022-10-01,21,163,KY,Meade County,11549,11054,495,4.3
CN2116500000000,2022-10-01,21,165,KY,Menifee County,2368,2253,115,4.9
CN2116700000000,2022-10-01,21,167,KY,Mercer County,10165,9798,367,3.6
CN2116900000000,2022-10-01,21,169,KY,Metcalfe County,3919,3757,162,4.1
CN2117100000000,2022-10-01,21,171,KY,Monroe County,4649,4494,155,3.3
CN2117300000000,2022-10-01,21,173,KY,Montgomery County,11928,11426,502,4.2
CN2117500000000,2022-10-01,21,175,KY,Morgan County,4160,3972,188,4.5
CN2117700000000,2022-10-01,21,177,KY,Muhlenberg County,9803,9247,556,5.7
CN2117900000000,2022-10-01,21,179,KY,Nelson County,23705,22929,776,3.3
CN2118100000000,2022-10-01,21,181,KY,Nicholas County,3261,3132,129,4
CN2118300000000,2022-10-01,21,183,KY,Ohio County,9140,8699,441,4.8
CN2118500000000,2022-10-01,21,185,KY,Oldham County,33110,32099,1011,3.1
CN2118700000000,2022-10-01,21,187,KY,Owen County,5260,5079,181,3.4
CN2118900000000,2022-10-01,21,189,KY,Owsley County,1093,1019,74,6.8
CN2119100000000,2022-10-01,21,191,KY,Pendleton County,6945,6700,245,3.5
CN2119300000000,2022-10-01,21,193,KY,Perry County,8047,7648,399,5
CN2119500000000,2022-10-01,21,195,KY,Pike County,19050,18096,954,5
CN2119700000000,2022-10-01,21,197,KY,Powell County,5291,5075,216,4.1
CN2119900000000,2022-10-01,21,199,KY,Pulaski County,25121,23994,1127,4.5
CN2120100000000,2022-10-01,21,201,KY,Robertson County,828,790,38,4.6
CN2120300000000,2022-10-01,21,203,KY,Rockcastle County,6524,6235,289,4.4
CN2120500000000,2022-10-01,21,205,KY,Rowan County,10315,9852,463,4.5
CN2120700000000,2022-10-01,21,207,KY,Russell County,6245,5938,307,4.9
CN2120900000000,2022-10-01,21,209,KY,Scott County,30549,29606,943,3.1
CN2121100000000,2022-10-01,21,211,KY,Shelby County,25792,24977,815,3.2
CN2121300000000,2022-10-01,21,213,KY,Simpson County,8668,8358,310,3.6
CN2121500000000,2022-10-01,21,215,KY,Spencer County,10482,10138,344,3.3
CN2121700000000,2022-10-01,21,217,KY,Taylor County,12281,11836,445,3.6
CN2121900000000,2022-10-01,21,219,KY,Todd County,5842,5650,192,3.3
CN2122100000000,2022-10-01,21,221,KY,Trigg County,6114,5850,264,4.3
CN2122300000000,2022-10-01,21,223,KY,Trimble County,3806,3665,141,3.7
CN2122500000000,2022-10-01,21,225,KY,Union County,5891,5629,262,4.4
CN2122700000000,2022-10-01,21,227,KY,Warren County,66157,63794,2363,3.6
CN2122900000000,2022-10-01,21,229,KY,Washington County,6181,5979,202,3.3
CN2123100000000,2022-10-01,21,231,KY,Wayne County,7075,6711,364,5.1
CN2123300000000,2022-10-01,21,233,KY,Webster County,5205,5002,203,3.9
CN2123500000000,2022-10-01,21,235,KY,Whitley County,13993,13373,620,4.4
CN2123700000000,2022-10-01,21,237,KY,Wolfe County,2278,2163,115,5
CN2123900000000,2022-10-01,21,239,KY,Woodford County,15269,14814,455,3
CN2200100000000,2022-10-01,22,001,LA,Acadia Parish,23915,23112,803,3.4
CN2200300000000,2022-10-01,22,003,LA,Allen Parish,8202,7920,282,3.4
CN2200500000000,2022-10-01,22,005,LA,Ascension Parish,67642,65836,1806,2.7
CN2200700000000,2022-10-01,22,007,LA,Assumption Parish,8874,8523,351,4
CN2200900000000,2022-10-01,22,009,LA,Avoyelles Parish,14310,13802,508,3.5
CN2201100000000,2022-10-01,22,011,LA,Beauregard Parish,14990,14522,468,3.1
CN2201300000000,2022-10-01,22,013,LA,Bienville Parish,5242,5048,194,3.7
CN2201500000000,2022-10-01,22,015,LA,Bossier Parish,58106,56463,1643,2.8
CN2201700000000,2022-10-01,22,017,LA,Caddo Parish,101570,97909,3661,3.6
CN2201900000000,2022-10-01,22,019,LA,Calcasieu Parish,92487,89621,2866,3.1
CN2202100000000,2022-10-01,22,021,LA,Caldwell Parish,3670,3547,123,3.4
CN2202300000000,2022-10-01,22,023,LA,Cameron Parish,3441,3349,92,2.7
CN2202500000000,2022-10-01,22,025,LA,Catahoula Parish,3421,3297,124,3.6
CN2202700000000,2022-10-01,22,027,LA,Claiborne Parish,5425,5241,184,3.4
CN2202900000000,2022-10-01,22,029,LA,Concordia Parish,6868,6581,287,4.2
CN2203100000000,2022-10-01,22,031,LA,De Soto Parish,10906,10524,382,3.5
CN2203300000000,2022-10-01,22,033,LA,East Baton Rouge Parish,235639,228588,7051,3
CN2203500000000,2022-10-01,22,035,LA,East Carroll Parish,1627,1520,107,6.6
CN2203700000000,2022-10-01,22,037,LA,East Feliciana Parish,7951,7740,211,2.7
CN2203900000000,2022-10-01,22,039,LA,Evangeline Parish,11917,11480,437,3.7
CN2204100000000,2022-10-01,22,041,LA,Franklin Parish,7429,7099,330,4.4
CN2204300000000,2022-10-01,22,043,LA,Grant Parish,8371,8114,257,3.1
CN2204500000000,2022-10-01,22,045,LA,Iberia Parish,27623,26577,1046,3.8
CN2204700000000,2022-10-01,22,047,LA,Iberville Parish,14004,13471,533,3.8
CN2204900000000,2022-10-01,22,049,LA,Jackson Parish,6933,6728,205,3
CN2205100000000,2022-10-01,22,051,LA,Jefferson Parish,210491,204018,6473,3.1
CN2205300000000,2022-10-01,22,053,LA,Jefferson Davis Parish,12327,11934,393,3.2
CN2205500000000,2022-10-01,22,055,LA,Lafayette Parish,116779,113426,3353,2.9
CN2205700000000,2022-10-01,22,057,LA,Lafourche Parish,40633,39406,1227,3
CN2205900000000,2022-10-01,22,059,LA,LaSalle Parish,6756,6587,169,2.5
CN2206100000000,2022-10-01,22,061,LA,Lincoln Parish,21621,20932,689,3.2
CN2206300000000,2022-10-01,22,063,LA,Livingston Parish,72523,70620,1903,2.6
CN2206500000000,2022-10-01,22,065,LA,Madison Parish,3489,3338,151,4.3
CN2206700000000,2022-10-01,22,067,LA,Morehouse Parish,9847,9408,439,4.5
CN2206900000000,2022-10-01,22,069,LA,Natchitoches Parish,16660,16058,602,3.6
CN2207100000000,2022-10-01,22,071,LA,Orleans Parish,176138,169544,6594,3.7
CN2207300000000,2022-10-01,22,073,LA,Ouachita Parish,70685,68371,2314,3.3
CN2207500000000,2022-10-01,22,075,LA,Plaquemines Parish,9808,9514,294,3
CN2207700000000,2022-10-01,22,077,LA,Pointe Coupee Parish,9861,9536,325,3.3
CN2207900000000,2022-10-01,22,079,LA,Rapides Parish,56533,54849,1684,3
CN2208100000000,2022-10-01,22,081,LA,Red River Parish,4033,3908,125,3.1
CN2208300000000,2022-10-01,22,083,LA,Richland Parish,8318,8021,297,3.6
CN2208500000000,2022-10-01,22,085,LA,Sabine Parish,9226,8924,302,3.3
CN2208700000000,2022-10-01,22,087,LA,St. Bernard Parish,19983,19287,696,3.5
CN2208900000000,2022-10-01,22,089,LA,St. Charles Parish,24836,24103,733,3
CN2209100000000,2022-10-01,22,091,LA,St. Helena Parish,4294,4101,193,4.5
CN2209300000000,2022-10-01,22,093,LA,St. James Parish,8890,8545,345,3.9
CN2209500000000,2022-10-01,22,095,LA,St. John the Baptist Parish,19025,18253,772,4.1
CN2209700000000,2022-10-01,22,097,LA,St. Landry Parish,31506,30258,1248,4
CN2209900000000,2022-10-01,22,099,LA,St. Martin Parish,22098,21376,722,3.3
CN2210100000000,2022-10-01,22,101,LA,St. Mary Parish,19112,18400,712,3.7
CN2210300000000,2022-10-01,22,103,LA,St. Tammany Parish,120101,116796,3305,2.8
CN2210500000000,2022-10-01,22,105,LA,Tangipahoa Parish,56790,54651,2139,3.8
CN2210700000000,2022-10-01,22,107,LA,Tensas Parish,1322,1263,59,4.5
CN2210900000000,2022-10-01,22,109,LA,Terrebonne Parish,44598,43118,1480,3.3
CN2211100000000,2022-10-01,22,111,LA,Union Parish,9219,8889,330,3.6
CN2211300000000,2022-10-01,22,113,LA,Vermilion Parish,24106,23341,765,3.2
CN2211500000000,2022-10-01,22,115,LA,Vernon Parish,16341,15619,722,4.4
CN2211700000000,2022-10-01,22,117,LA,Washington Parish,17275,16647,628,3.6
CN2211900000000,2022-10-01,22,119,LA,Webster Parish,14172,13621,551,3.9
CN2212100000000,2022-10-01,22,121,LA,West Baton Rouge Parish,14155,13741,414,2.9
CN2212300000000,2022-10-01,22,123,LA,West Carroll Parish,3430,3275,155,4.5
CN2212500000000,2022-10-01,22,125,LA,West Feliciana Parish,5496,5369,127,2.3
CN2212700000000,2022-10-01,22,127,LA,Winn Parish,4714,4544,170,3.6
CN2300100000000,2022-10-01,23,001,ME,Androscoggin County,52846,51442,1404,2.7
CN2300300000000,2022-10-01,23,003,ME,Aroostook County,27425,26546,879,3.2
CN2300500000000,2022-10-01,23,005,ME,Cumberland County,162420,158727,3693,2.3
CN2300700000000,2022-10-01,23,007,ME,Franklin County,13381,12975,406,3
CN2300900000000,2022-10-01,23,009,ME,Hancock County,28868,28178,690,2.4
CN2301100000000,2022-10-01,23,011,ME,Kennebec County,60412,58905,1507,2.5
CN2301300000000,2022-10-01,23,013,ME,Knox County,19542,19056,486,2.5
CN2301500000000,2022-10-01,23,015,ME,Lincoln County,16328,15921,407,2.5
CN2301700000000,2022-10-01,23,017,ME,Oxford County,25096,24364,732,2.9
CN2301900000000,2022-10-01,23,019,ME,Penobscot County,75221,73197,2024,2.7
CN2302100000000,2022-10-01,23,021,ME,Piscataquis County,7058,6840,218,3.1
CN2302300000000,2022-10-01,23,023,ME,Sagadahoc County,18792,18386,406,2.2
CN2302500000000,2022-10-01,23,025,ME,Somerset County,21363,20631,732,3.4
CN2302700000000,2022-10-01,23,027,ME,Waldo County,19964,19463,501,2.5
CN2302900000000,2022-10-01,23,029,ME,Washington County,12869,12463,406,3.2
CN2303100000000,2022-10-01,23,031,ME,York County,111588,109088,2500,2.2
CN2400100000000,2022-10-01,24,001,MD,Allegany County,31369,30205,1164,3.7
CN2400300000000,2022-10-01,24,003,MD,Anne Arundel County,313046,304399,8647,2.8
CN2400500000000,2022-10-01,24,005,MD,Baltimore County,443273,428923,14350,3.2
CN2400900000000,2022-10-01,24,009,MD,Calvert County,49582,48181,1401,2.8
CN2401100000000,2022-10-01,24,011,MD,Caroline County,17173,16663,510,3
CN2401300000000,2022-10-01,24,013,MD,Carroll County,94831,92426,2405,2.5
CN2401500000000,2022-10-01,24,015,MD,Cecil County,54441,52727,1714,3.1
CN2401700000000,2022-10-01,24,017,MD,Charles County,86926,84162,2764,3.2
CN2401900000000,2022-10-01,24,019,MD,Dorchester County,16166,15611,555,3.4
CN2402100000000,2022-10-01,24,021,MD,Frederick County,136605,132669,3936,2.9
CN2402300000000,2022-10-01,24,023,MD,Garrett County,15136,14703,433,2.9
CN2402500000000,2022-10-01,24,025,MD,Harford County,139763,135741,4022,2.9
CN2402700000000,2022-10-01,24,027,MD,Howard County,187139,182324,4815,2.6
CN2402900000000,2022-10-01,24,029,MD,Kent County,9981,9654,327,3.3
CN2403100000000,2022-10-01,24,031,MD,Montgomery County,547554,532109,15445,2.8
CN2403300000000,2022-10-01,24,033,MD,Prince George's County,498711,481949,16762,3.4
CN2403500000000,2022-10-01,24,035,MD,Queen Anne's County,28250,27504,746,2.6
CN2403700000000,2022-10-01,24,037,MD,St. Mary's County,57429,55715,1714,3
CN2403900000000,2022-10-01,24,039,MD,Somerset County,9174,8756,418,4.6
CN2404100000000,2022-10-01,24,041,MD,Talbot County,17601,17053,548,3.1
CN2404300000000,2022-10-01,24,043,MD,Washington County,72448,70119,2329,3.2
CN2404500000000,2022-10-01,24,045,MD,Wicomico County,51075,49180,1895,3.7
CN2404700000000,2022-10-01,24,047,MD,Worcester County,25048,24022,1026,4.1
CN2451000000000,2022-10-01,24,510,MD,Baltimore city,273227,261797,11430,4.2
CN2500100000000,2022-10-01,25,001,MA,Barnstable County,109263,105231,4032,3.7
CN2500300000000,2022-10-01,25,003,MA,Berkshire County,60795,58526,2269,3.7
CN2500500000000,2022-10-01,25,005,MA,Bristol County,296007,284275,11732,4
CN2500700000000,2022-10-01,25,007,MA,Dukes County,9257,8896,361,3.9
CN2500900000000,2022-10-01,25,009,MA,Essex County,419602,404788,14814,3.5
CN2501100000000,2022-10-01,25,011,MA,Franklin County,39930,38747,1183,3
CN2501300000000,2022-10-01,25,013,MA,Hampden County,223254,213683,9571,4.3
CN2501500000000,2022-10-01,25,015,MA,Hampshire County,89504,86717,2787,3.1
CN2501700000000,2022-10-01,25,017,MA,Middlesex County,907810,881114,26696,2.9
CN2501900000000,2022-10-01,25,019,MA,Nantucket County/town,7714,7467,247,3.2
CN2502100000000,2022-10-01,25,021,MA,Norfolk County,391972,379559,12413,3.2
CN2502300000000,2022-10-01,25,023,MA,Plymouth County,281824,272185,9639,3.4
CN2502500000000,2022-10-01,25,025,MA,Suffolk County,451944,436879,15065,3.3
CN2502700000000,2022-10-01,25,027,MA,Worcester County,439835,424475,15360,3.5
CN2600100000000,2022-10-01,26,001,MI,Alcona County,3855,3637,218,5.7
CN2600300000000,2022-10-01,26,003,MI,Alger County,3275,3054,221,6.7
CN2600500000000,2022-10-01,26,005,MI,Allegan County,61338,59320,2018,3.3
CN2600700000000,2022-10-01,26,007,MI,Alpena County,13063,12495,568,4.3
CN2600900000000,2022-10-01,26,009,MI,Antrim County,10004,9527,477,4.8
CN2601100000000,2022-10-01,26,011,MI,Arenac County,5699,5358,341,6
CN2601300000000,2022-10-01,26,013,MI,Baraga County,3021,2850,171,5.7
CN2601500000000,2022-10-01,26,015,MI,Barry County,31557,30484,1073,3.4
CN2601700000000,2022-10-01,26,017,MI,Bay County,48527,46369,2158,4.4
CN2601900000000,2022-10-01,26,019,MI,Benzie County,8684,8328,356,4.1
CN2602100000000,2022-10-01,26,021,MI,Berrien County,71338,68462,2876,4
CN2602300000000,2022-10-01,26,023,MI,Branch County,19550,18769,781,4
CN2602500000000,2022-10-01,26,025,MI,Calhoun County,59316,56749,2567,4.3
CN2602700000000,2022-10-01,26,027,MI,Cass County,23366,22398,968,4.1
CN2602900000000,2022-10-01,26,029,MI,Charlevoix County,12593,12116,477,3.8
CN2603100000000,2022-10-01,26,031,MI,Cheboygan County,10366,9871,495,4.8
CN2603300000000,2022-10-01,26,033,MI,Chippewa County,16063,15324,739,4.6
CN2603500000000,2022-10-01,26,035,MI,Clare County,11048,10402,646,5.8
CN2603700000000,2022-10-01,26,037,MI,Clinton County,40337,38982,1355,3.4
CN2603900000000,2022-10-01,26,039,MI,Crawford County,5395,5103,292,5.4
CN2604100000000,2022-10-01,26,041,MI,Delta County,16442,15745,697,4.2
CN2604300000000,2022-10-01,26,043,MI,Dickinson County,12098,11640,458,3.8
CN2604500000000,2022-10-01,26,045,MI,Eaton County,56010,54013,1997,3.6
CN2604700000000,2022-10-01,26,047,MI,Emmet County,16496,15809,687,4.2
CN2604900000000,2022-10-01,26,049,MI,Genesee County,177127,168228,8899,5
CN2605100000000,2022-10-01,26,051,MI,Gladwin County,9856,9326,530,5.4
CN2605300000000,2022-10-01,26,053,MI,Gogebic County,5583,5338,245,4.4
CN2605500000000,2022-10-01,26,055,MI,Grand Traverse County,49435,47827,1608,3.3
CN2605700000000,2022-10-01,26,057,MI,Gratiot County,17288,16592,696,4
CN2605900000000,2022-10-01,26,059,MI,Hillsdale County,19872,19025,847,4.3
CN2606100000000,2022-10-01,26,061,MI,Houghton County,16658,16012,646,3.9
CN2606300000000,2022-10-01,26,063,MI,Huron County,14853,14285,568,3.8
CN2606500000000,2022-10-01,26,065,MI,Ingham County,146705,141118,5587,3.8
CN2606700000000,2022-10-01,26,067,MI,Ionia County,30022,29003,1019,3.4
CN2606900000000,2022-10-01,26,069,MI,Iosco County,10245,9735,510,5
CN2607100000000,2022-10-01,26,071,MI,Iron County,4617,4379,238,5.2
CN2607300000000,2022-10-01,26,073,MI,Isabella County,31222,29838,1384,4.4
CN2607500000000,2022-10-01,26,075,MI,Jackson County,73252,70374,2878,3.9
CN2607700000000,2022-10-01,26,077,MI,Kalamazoo County,131048,126191,4857,3.7
CN2607900000000,2022-10-01,26,079,MI,Kalkaska County,7814,7439,375,4.8
CN2608100000000,2022-10-01,26,081,MI,Kent County,357633,346112,11521,3.2
CN2608300000000,2022-10-01,26,083,MI,Keweenaw County,922,879,43,4.7
CN2608500000000,2022-10-01,26,085,MI,Lake County,3930,3677,253,6.4
CN2608700000000,2022-10-01,26,087,MI,Lapeer County,40039,38674,1365,3.4
CN2608900000000,2022-10-01,26,089,MI,Leelanau County,10285,9917,368,3.6
CN2609100000000,2022-10-01,26,091,MI,Lenawee County,44563,42762,1801,4
CN2609300000000,2022-10-01,26,093,MI,Livingston County,102945,100372,2573,2.5
CN2609500000000,2022-10-01,26,095,MI,Luce County,2046,1949,97,4.7
CN2609700000000,2022-10-01,26,097,MI,Mackinac County,5330,5124,206,3.9
CN2609900000000,2022-10-01,26,099,MI,Macomb County,441044,426295,14749,3.3
CN2610100000000,2022-10-01,26,101,MI,Manistee County,9658,9196,462,4.8
CN2610300000000,2022-10-01,26,103,MI,Marquette County,32311,30966,1345,4.2
CN2610500000000,2022-10-01,26,105,MI,Mason County,13036,12457,579,4.4
CN2610700000000,2022-10-01,26,107,MI,Mecosta County,18631,17741,890,4.8
CN2610900000000,2022-10-01,26,109,MI,Menominee County,10497,10107,390,3.7
CN2611100000000,2022-10-01,26,111,MI,Midland County,39472,37936,1536,3.9
CN2611300000000,2022-10-01,26,113,MI,Missaukee County,6698,6412,286,4.3
CN2611500000000,2022-10-01,26,115,MI,Monroe County,73786,70564,3222,4.4
CN2611700000000,2022-10-01,26,117,MI,Montcalm County,27521,26443,1078,3.9
CN2611900000000,2022-10-01,26,119,MI,Montmorency County,2979,2795,184,6.2
CN2612100000000,2022-10-01,26,121,MI,Muskegon County,75640,72043,3597,4.8
CN2612300000000,2022-10-01,26,123,MI,Newaygo County,22938,21997,941,4.1
CN2612500000000,2022-10-01,26,125,MI,Oakland County,666312,648182,18130,2.7
CN2612700000000,2022-10-01,26,127,MI,Oceana County,11294,10687,607,5.4
CN2612900000000,2022-10-01,26,129,MI,Ogemaw County,8187,7728,459,5.6
CN2613100000000,2022-10-01,26,131,MI,Ontonagon County,2020,1894,126,6.2
CN2613300000000,2022-10-01,26,133,MI,Osceola County,11345,10898,447,3.9
CN2613500000000,2022-10-01,26,135,MI,Oscoda County,2790,2605,185,6.6
CN2613700000000,2022-10-01,26,137,MI,Otsego County,11366,10854,512,4.5
CN2613900000000,2022-10-01,26,139,MI,Ottawa County,160882,155913,4969,3.1
CN2614100000000,2022-10-01,26,141,MI,Presque Isle County,4856,4597,259,5.3
CN2614300000000,2022-10-01,26,143,MI,Roscommon County,7960,7396,564,7.1
CN2614500000000,2022-10-01,26,145,MI,Saginaw County,81665,77638,4027,4.9
CN2614700000000,2022-10-01,26,147,MI,St. Clair County,74324,71815,2509,3.4
CN2614900000000,2022-10-01,26,149,MI,St. Joseph County,28065,26850,1215,4.3
CN2615100000000,2022-10-01,26,151,MI,Sanilac County,18680,17872,808,4.3
CN2615300000000,2022-10-01,26,153,MI,Schoolcraft County,3033,2864,169,5.6
CN2615500000000,2022-10-01,26,155,MI,Shiawassee County,32111,30813,1298,4
CN2615700000000,2022-10-01,26,157,MI,Tuscola County,22667,21624,1043,4.6
CN2615900000000,2022-10-01,26,159,MI,Van Buren County,33905,32420,1485,4.4
CN2616100000000,2022-10-01,26,161,MI,Washtenaw County,196804,190101,6703,3.4
CN2616300000000,2022-10-01,26,163,MI,Wayne County,793664,761636,32028,4
CN2616500000000,2022-10-01,26,165,MI,Wexford County,14618,13948,670,4.6
CN2700100000000,2022-10-01,27,001,MN,Aitkin County,7455,7228,227,3
CN2700300000000,2022-10-01,27,003,MN,Anoka County,198449,193976,4473,2.3
CN2700500000000,2022-10-01,27,005,MN,Becker County,19474,19081,393,2
CN2700700000000,2022-10-01,27,007,MN,Beltrami County,24933,24393,540,2.2
CN2700900000000,2022-10-01,27,009,MN,Benton County,21692,21177,515,2.4
CN2701100000000,2022-10-01,27,011,MN,Big Stone County,2421,2375,46,1.9
CN2701300000000,2022-10-01,27,013,MN,Blue Earth County,41057,40349,708,1.7
CN2701500000000,2022-10-01,27,015,MN,Brown County,13697,13446,251,1.8
CN2701700000000,2022-10-01,27,017,MN,Carlton County,17719,17249,470,2.7
CN2701900000000,2022-10-01,27,019,MN,Carver County,59417,58332,1085,1.8
CN2702100000000,2022-10-01,27,021,MN,Cass County,14707,14330,377,2.6
CN2702300000000,2022-10-01,27,023,MN,Chippewa County,6414,6306,108,1.7
CN2702500000000,2022-10-01,27,025,MN,Chisago County,29860,29196,664,2.2
CN2702700000000,2022-10-01,27,027,MN,Clay County,37876,37285,591,1.6
CN2702900000000,2022-10-01,27,029,MN,Clearwater County,4504,4345,159,3.5
CN2703100000000,2022-10-01,27,031,MN,Cook County,2854,2786,68,2.4
CN2703300000000,2022-10-01,27,033,MN,Cottonwood County,6715,6575,140,2.1
CN2703500000000,2022-10-01,27,035,MN,Crow Wing County,33472,32691,781,2.3
CN2703700000000,2022-10-01,27,037,MN,Dakota County,242025,237044,4981,2.1
CN2703900000000,2022-10-01,27,039,MN,Dodge County,11866,11670,196,1.7
CN2704100000000,2022-10-01,27,041,MN,Douglas County,21468,21096,372,1.7
CN2704300000000,2022-10-01,27,043,MN,Faribault County,7249,7080,169,2.3
CN2704500000000,2022-10-01,27,045,MN,Fillmore County,11490,11283,207,1.8
CN2704700000000,2022-10-01,27,047,MN,Freeborn County,15972,15627,345,2.2
CN2704900000000,2022-10-01,27,049,MN,Goodhue County,26623,26089,534,2
CN2705100000000,2022-10-01,27,051,MN,Grant County,3314,3263,51,1.5
CN2705300000000,2022-10-01,27,053,MN,Hennepin County,705413,689366,16047,2.3
CN2705500000000,2022-10-01,27,055,MN,Houston County,10548,10383,165,1.6
CN2705700000000,2022-10-01,27,057,MN,Hubbard County,10174,9883,291,2.9
CN2705900000000,2022-10-01,27,059,MN,Isanti County,21616,21093,523,2.4
CN2706100000000,2022-10-01,27,061,MN,Itasca County,21456,20800,656,3.1
CN2706300000000,2022-10-01,27,063,MN,Jackson County,5450,5361,89,1.6
CN2706500000000,2022-10-01,27,065,MN,Kanabec County,9177,8928,249,2.7
CN2706700000000,2022-10-01,27,067,MN,Kandiyohi County,23124,22705,419,1.8
CN2706900000000,2022-10-01,27,069,MN,Kittson County,2250,2207,43,1.9
CN2707100000000,2022-10-01,27,071,MN,Koochiching County,5728,5540,188,3.3
CN2707300000000,2022-10-01,27,073,MN,Lac qui Parle County,3467,3405,62,1.8
CN2707500000000,2022-10-01,27,075,MN,Lake County,5290,5025,265,5
CN2707700000000,2022-10-01,27,077,MN,Lake of the Woods County,2347,2292,55,2.3
CN2707900000000,2022-10-01,27,079,MN,Le Sueur County,15797,15483,314,2
CN2708100000000,2022-10-01,27,081,MN,Lincoln County,3062,3016,46,1.5
CN2708300000000,2022-10-01,27,083,MN,Lyon County,14495,14249,246,1.7
CN2708500000000,2022-10-01,27,085,MN,McLeod County,19138,18738,400,2.1
CN2708700000000,2022-10-01,27,087,MN,Mahnomen County,2269,2185,84,3.7
CN2708900000000,2022-10-01,27,089,MN,Marshall County,5424,5315,109,2
CN2709100000000,2022-10-01,27,091,MN,Martin County,9538,9350,188,2
CN2709300000000,2022-10-01,27,093,MN,Meeker County,13664,13394,270,2
CN2709500000000,2022-10-01,27,095,MN,Mille Lacs County,12543,12185,358,2.9
CN2709700000000,2022-10-01,27,097,MN,Morrison County,17165,16741,424,2.5
CN2709900000000,2022-10-01,27,099,MN,Mower County,20701,20264,437,2.1
CN2710100000000,2022-10-01,27,101,MN,Murray County,4687,4599,88,1.9
CN2710300000000,2022-10-01,27,103,MN,Nicollet County,21108,20792,316,1.5
CN2710500000000,2022-10-01,27,105,MN,Nobles County,11009,10832,177,1.6
CN2710700000000,2022-10-01,27,107,MN,Norman County,3230,3151,79,2.4
CN2710900000000,2022-10-01,27,109,MN,Olmsted County,90720,89076,1644,1.8
CN2711100000000,2022-10-01,27,111,MN,Otter Tail County,31109,30514,595,1.9
CN2711300000000,2022-10-01,27,113,MN,Pennington County,8752,8560,192,2.2
CN2711500000000,2022-10-01,27,115,MN,Pine County,14216,13795,421,3
CN2711700000000,2022-10-01,27,117,MN,Pipestone County,4740,4663,77,1.6
CN2711900000000,2022-10-01,27,119,MN,Polk County,16256,15937,319,2
CN2712100000000,2022-10-01,27,121,MN,Pope County,6538,6438,100,1.5
CN2712300000000,2022-10-01,27,123,MN,Ramsey County,285579,278656,6923,2.4
CN2712500000000,2022-10-01,27,125,MN,Red Lake County,2177,2117,60,2.8
CN2712700000000,2022-10-01,27,127,MN,Redwood County,7589,7441,148,2
CN2712900000000,2022-10-01,27,129,MN,Renville County,8518,8333,185,2.2
CN2713100000000,2022-10-01,27,131,MN,Rice County,37522,36802,720,1.9
CN2713300000000,2022-10-01,27,133,MN,Rock County,6070,5990,80,1.3
CN2713500000000,2022-10-01,27,135,MN,Roseau County,7859,7701,158,2
CN2713700000000,2022-10-01,27,137,MN,St. Louis County,101192,98575,2617,2.6
CN2713900000000,2022-10-01,27,139,MN,Scott County,84287,82680,1607,1.9
CN2714100000000,2022-10-01,27,141,MN,Sherburne County,52934,51792,1142,2.2
CN2714300000000,2022-10-01,27,143,MN,Sibley County,8146,7978,168,2.1
CN2714500000000,2022-10-01,27,145,MN,Stearns County,90163,88317,1846,2
CN2714700000000,2022-10-01,27,147,MN,Steele County,19481,19056,425,2.2
CN2714900000000,2022-10-01,27,149,MN,Stevens County,5417,5345,72,1.3
CN2715100000000,2022-10-01,27,151,MN,Swift County,4844,4748,96,2
CN2715300000000,2022-10-01,27,153,MN,Todd County,13581,13309,272,2
CN2715500000000,2022-10-01,27,155,MN,Traverse County,1662,1636,26,1.6
CN2715700000000,2022-10-01,27,157,MN,Wabasha County,12229,11999,230,1.9
CN2715900000000,2022-10-01,27,159,MN,Wadena County,6075,5912,163,2.7
CN2716100000000,2022-10-01,27,161,MN,Waseca County,8749,8536,213,2.4
CN2716300000000,2022-10-01,27,163,MN,Washington County,144840,141919,2921,2
CN2716500000000,2022-10-01,27,165,MN,Watonwan County,6622,6509,113,1.7
CN2716700000000,2022-10-01,27,167,MN,Wilkin County,3512,3462,50,1.4
CN2716900000000,2022-10-01,27,169,MN,Winona County,28427,27954,473,1.7
CN2717100000000,2022-10-01,27,171,MN,Wright County,76519,75006,1513,2
CN2717300000000,2022-10-01,27,173,MN,Yellow Medicine County,5092,5000,92,1.8
CN2800100000000,2022-10-01,28,001,MS,Adams County,10476,9996,480,4.6
CN2800300000000,2022-10-01,28,003,MS,Alcorn County,14872,14397,475,3.2
CN2800500000000,2022-10-01,28,005,MS,Amite County,4176,3972,204,4.9
CN2800700000000,2022-10-01,28,007,MS,Attala County,6740,6489,251,3.7
CN2800900000000,2022-10-01,28,009,MS,Benton County,3026,2883,143,4.7
CN2801100000000,2022-10-01,28,011,MS,Bolivar County,10901,10442,459,4.2
CN2801300000000,2022-10-01,28,013,MS,Calhoun County,5234,5010,224,4.3
CN2801500000000,2022-10-01,28,015,MS,Carroll County,3229,3095,134,4.1
CN2801700000000,2022-10-01,28,017,MS,Chickasaw County,6406,6093,313,4.9
CN2801900000000,2022-10-01,28,019,MS,Choctaw County,3501,3388,113,3.2
CN2802100000000,2022-10-01,28,021,MS,Claiborne County,2834,2640,194,6.8
CN2802300000000,2022-10-01,28,023,MS,Clarke County,5493,5260,233,4.2
CN2802500000000,2022-10-01,28,025,MS,Clay County,8795,8452,343,3.9
CN2802700000000,2022-10-01,28,027,MS,Coahoma County,7350,6992,358,4.9
CN2802900000000,2022-10-01,28,029,MS,Copiah County,10693,10286,407,3.8
CN2803100000000,2022-10-01,28,031,MS,Covington County,8056,7813,243,3
CN2803300000000,2022-10-01,28,033,MS,DeSoto County,92811,90089,2722,2.9
CN2803500000000,2022-10-01,28,035,MS,Forrest County,33357,32244,1113,3.3
CN2803700000000,2022-10-01,28,037,MS,Franklin County,2595,2456,139,5.4
CN2803900000000,2022-10-01,28,039,MS,George County,8528,8165,363,4.3
CN2804100000000,2022-10-01,28,041,MS,Greene County,4086,3880,206,5
CN2804300000000,2022-10-01,28,043,MS,Grenada County,8582,8289,293,3.4
CN2804500000000,2022-10-01,28,045,MS,Hancock County,18761,18071,690,3.7
CN2804700000000,2022-10-01,28,047,MS,Harrison County,86248,83309,2939,3.4
CN2804900000000,2022-10-01,28,049,MS,Hinds County,101694,98196,3498,3.4
CN2805100000000,2022-10-01,28,051,MS,Holmes County,4987,4703,284,5.7
CN2805300000000,2022-10-01,28,053,MS,Humphreys County,1894,1769,125,6.6
CN2805500000000,2022-10-01,28,055,MS,Issaquena County,301,282,19,6.3
CN2805700000000,2022-10-01,28,057,MS,Itawamba County,10026,9717,309,3.1
CN2805900000000,2022-10-01,28,059,MS,Jackson County,57703,55540,2163,3.7
CN2806100000000,2022-10-01,28,061,MS,Jasper County,5784,5510,274,4.7
CN2806300000000,2022-10-01,28,063,MS,Jefferson County,1795,1596,199,11.1
CN2806500000000,2022-10-01,28,065,MS,Jefferson Davis County,3880,3715,165,4.3
CN2806700000000,2022-10-01,28,067,MS,Jones County,24679,23796,883,3.6
CN2806900000000,2022-10-01,28,069,MS,Kemper County,3170,2980,190,6
CN2807100000000,2022-10-01,28,071,MS,Lafayette County,28437,27674,763,2.7
CN2807300000000,2022-10-01,28,073,MS,Lamar County,31758,30920,838,2.6
CN2807500000000,2022-10-01,28,075,MS,Lauderdale County,28346,27312,1034,3.6
CN2807700000000,2022-10-01,28,077,MS,Lawrence County,4765,4577,188,3.9
CN2807900000000,2022-10-01,28,079,MS,Leake County,7847,7560,287,3.7
CN2808100000000,2022-10-01,28,081,MS,Lee County,40040,38799,1241,3.1
CN2808300000000,2022-10-01,28,083,MS,Leflore County,9084,8643,441,4.9
CN2808500000000,2022-10-01,28,085,MS,Lincoln County,14429,13954,475,3.3
CN2808700000000,2022-10-01,28,087,MS,Lowndes County,24523,23606,917,3.7
CN2808900000000,2022-10-01,28,089,MS,Madison County,53358,51906,1452,2.7
CN2809100000000,2022-10-01,28,091,MS,Marion County,9884,9518,366,3.7
CN2809300000000,2022-10-01,28,093,MS,Marshall County,14084,13561,523,3.7
CN2809500000000,2022-10-01,28,095,MS,Monroe County,15187,14630,557,3.7
CN2809700000000,2022-10-01,28,097,MS,Montgomery County,3835,3694,141,3.7
CN2809900000000,2022-10-01,28,099,MS,Neshoba County,9566,9193,373,3.9
CN2810100000000,2022-10-01,28,101,MS,Newton County,7832,7505,327,4.2
CN2810300000000,2022-10-01,28,103,MS,Noxubee County,3264,3076,188,5.8
CN2810500000000,2022-10-01,28,105,MS,Oktibbeha County,22528,21762,766,3.4
CN2810700000000,2022-10-01,28,107,MS,Panola County,12050,11549,501,4.2
CN2810900000000,2022-10-01,28,109,MS,Pearl River County,23183,22396,787,3.4
CN2811100000000,2022-10-01,28,111,MS,Perry County,4234,4057,177,4.2
CN2811300000000,2022-10-01,28,113,MS,Pike County,13713,13139,574,4.2
CN2811500000000,2022-10-01,28,115,MS,Pontotoc County,14756,14145,611,4.1
CN2811700000000,2022-10-01,28,117,MS,Prentiss County,11147,10789,358,3.2
CN2811900000000,2022-10-01,28,119,MS,Quitman County,2190,2078,112,5.1
CN2812100000000,2022-10-01,28,121,MS,Rankin County,76645,74641,2004,2.6
CN2812300000000,2022-10-01,28,123,MS,Scott County,12140,11777,363,3
CN2812500000000,2022-10-01,28,125,MS,Sharkey County,1255,1192,63,5
CN2812700000000,2022-10-01,28,127,MS,Simpson County,10544,10189,355,3.4
CN2812900000000,2022-10-01,28,129,MS,Smith County,6525,6316,209,3.2
CN2813100000000,2022-10-01,28,131,MS,Stone County,6943,6702,241,3.5
CN2813300000000,2022-10-01,28,133,MS,Sunflower County,6952,6602,350,5
CN2813500000000,2022-10-01,28,135,MS,Tallahatchie County,4468,4309,159,3.6
CN2813700000000,2022-10-01,28,137,MS,Tate County,11939,11532,407,3.4
CN2813900000000,2022-10-01,28,139,MS,Tippah County,9753,9442,311,3.2
CN2814100000000,2022-10-01,28,141,MS,Tishomingo County,8451,8176,275,3.3
CN2814300000000,2022-10-01,28,143,MS,Tunica County,4062,3905,157,3.9
CN2814500000000,2022-10-01,28,145,MS,Union County,14598,14165,433,3
CN2814700000000,2022-10-01,28,147,MS,Walthall County,4845,4618,227,4.7
CN2814900000000,2022-10-01,28,149,MS,Warren County,19017,18324,693,3.6
CN2815100000000,2022-10-01,28,151,MS,Washington County,14348,13603,745,5.2
CN2815300000000,2022-10-01,28,153,MS,Wayne County,6842,6549,293,4.3
CN2815500000000,2022-10-01,28,155,MS,Webster County,3815,3685,130,3.4
CN2815700000000,2022-10-01,28,157,MS,Wilkinson County,2514,2380,134,5.3
CN2815900000000,2022-10-01,28,159,MS,Winston County,7037,6765,272,3.9
CN2816100000000,2022-10-01,28,161,MS,Yalobusha County,4677,4504,173,3.7
CN2816300000000,2022-10-01,28,163,MS,Yazoo County,8755,8416,339,3.9
CN2900100000000,2022-10-01,29,001,MO,Adair County,9779,9514,265,2.7
CN2900300000000,2022-10-01,29,003,MO,Andrew County,9329,9152,177,1.9
CN2900500000000,2022-10-01,29,005,MO,Atchison County,2437,2384,53,2.2
CN2900700000000,2022-10-01,29,007,MO,Audrain County,9806,9528,278,2.8
CN2900900000000,2022-10-01,29,009,MO,Barry County,13851,13502,349,2.5
CN2901100000000,2022-10-01,29,011,MO,Barton County,5099,4983,116,2.3
CN2901300000000,2022-10-01,29,013,MO,Bates County,7522,7348,174,2.3
CN2901500000000,2022-10-01,29,015,MO,Benton County,7211,6973,238,3.3
CN2901700000000,2022-10-01,29,017,MO,Bollinger County,5253,5124,129,2.5
CN2901900000000,2022-10-01,29,019,MO,Boone County,100780,98910,1870,1.9
CN2902100000000,2022-10-01,29,021,MO,Buchanan County,42162,41253,909,2.2
CN2902300000000,2022-10-01,29,023,MO,Butler County,17742,17291,451,2.5
CN2902500000000,2022-10-01,29,025,MO,Caldwell County,4189,4069,120,2.9
CN2902700000000,2022-10-01,29,027,MO,Callaway County,21600,21164,436,2
CN2902900000000,2022-10-01,29,029,MO,Camden County,18592,18089,503,2.7
CN2903100000000,2022-10-01,29,031,MO,Cape Girardeau County,40789,39956,833,2
CN2903300000000,2022-10-01,29,033,MO,Carroll County,4330,4232,98,2.3
CN2903500000000,2022-10-01,29,035,MO,Carter County,2389,2323,66,2.8
CN2903700000000,2022-10-01,29,037,MO,Cass County,55218,54008,1210,2.2
CN2903900000000,2022-10-01,29,039,MO,Cedar County,5517,5375,142,2.6
CN2904100000000,2022-10-01,29,041,MO,Chariton County,3616,3551,65,1.8
CN2904300000000,2022-10-01,29,043,MO,Christian County,47811,46924,887,1.9
CN2904500000000,2022-10-01,29,045,MO,Clark County,2929,2842,87,3
CN2904700000000,2022-10-01,29,047,MO,Clay County,140238,136732,3506,2.5
CN2904900000000,2022-10-01,29,049,MO,Clinton County,10635,10330,305,2.9
CN2905100000000,2022-10-01,29,051,MO,Cole County,39400,38677,723,1.8
CN2905300000000,2022-10-01,29,053,MO,Cooper County,7048,6889,159,2.3
CN2905500000000,2022-10-01,29,055,MO,Crawford County,10709,10455,254,2.4
CN2905700000000,2022-10-01,29,057,MO,Dade County,3388,3319,69,2
CN2905900000000,2022-10-01,29,059,MO,Dallas County,7168,6995,173,2.4
CN2906100000000,2022-10-01,29,061,MO,Daviess County,3851,3762,89,2.3
CN2906300000000,2022-10-01,29,063,MO,DeKalb County,3963,3868,95,2.4
CN2906500000000,2022-10-01,29,065,MO,Dent County,6069,5895,174,2.9
CN2906700000000,2022-10-01,29,067,MO,Douglas County,5184,5053,131,2.5
CN2906900000000,2022-10-01,29,069,MO,Dunklin County,10639,10277,362,3.4
CN2907100000000,2022-10-01,29,071,MO,Franklin County,53243,52148,1095,2.1
CN2907300000000,2022-10-01,29,073,MO,Gasconade County,7639,7491,148,1.9
CN2907500000000,2022-10-01,29,075,MO,Gentry County,3026,2967,59,1.9
CN2907700000000,2022-10-01,29,077,MO,Greene County,156731,153682,3049,1.9
CN2907900000000,2022-10-01,29,079,MO,Grundy County,3912,3812,100,2.6
CN2908100000000,2022-10-01,29,081,MO,Harrison County,3545,3464,81,2.3
CN2908300000000,2022-10-01,29,083,MO,Henry County,10194,9958,236,2.3
CN2908500000000,2022-10-01,29,085,MO,Hickory County,3955,3857,98,2.5
CN2908700000000,2022-10-01,29,087,MO,Holt County,2350,2310,40,1.7
CN2908900000000,2022-10-01,29,089,MO,Howard County,4684,4581,103,2.2
CN2909100000000,2022-10-01,29,091,MO,Howell County,15901,15459,442,2.8
CN2909300000000,2022-10-01,29,093,MO,Iron County,3467,3341,126,3.6
CN2909500000000,2022-10-01,29,095,MO,Jackson County,363110,353607,9503,2.6
CN2909700000000,2022-10-01,29,097,MO,Jasper County,56586,55323,1263,2.2
CN2909900000000,2022-10-01,29,099,MO,Jefferson County,119082,116627,2455,2.1
CN2910100000000,2022-10-01,29,101,MO,Johnson County,22930,22381,549,2.4
CN2910300000000,2022-10-01,29,103,MO,Knox County,1604,1563,41,2.6
CN2910500000000,2022-10-01,29,105,MO,Laclede County,16651,16279,372,2.2
CN2910700000000,2022-10-01,29,107,MO,Lafayette County,16692,16293,399,2.4
CN2910900000000,2022-10-01,29,109,MO,Lawrence County,16945,16571,374,2.2
CN2911100000000,2022-10-01,29,111,MO,Lewis County,4643,4539,104,2.2
CN2911300000000,2022-10-01,29,113,MO,Lincoln County,29355,28713,642,2.2
CN2911500000000,2022-10-01,29,115,MO,Linn County,5125,4989,136,2.7
CN2911700000000,2022-10-01,29,117,MO,Livingston County,7066,6939,127,1.8
CN2911900000000,2022-10-01,29,119,MO,McDonald County,11196,10954,242,2.2
CN2912100000000,2022-10-01,29,121,MO,Macon County,7008,6857,151,2.2
CN2912300000000,2022-10-01,29,123,MO,Madison County,5352,5211,141,2.6
CN2912500000000,2022-10-01,29,125,MO,Maries County,3786,3695,91,2.4
CN2912700000000,2022-10-01,29,127,MO,Marion County,13591,13303,288,2.1
CN2912900000000,2022-10-01,29,129,MO,Mercer County,1570,1533,37,2.4
CN2913100000000,2022-10-01,29,131,MO,Miller County,12664,12391,273,2.2
CN2913300000000,2022-10-01,29,133,MO,Mississippi County,5012,4870,142,2.8
CN2913500000000,2022-10-01,29,135,MO,Moniteau County,6962,6831,131,1.9
CN2913700000000,2022-10-01,29,137,MO,Monroe County,3669,3582,87,2.4
CN2913900000000,2022-10-01,29,139,MO,Montgomery County,5773,5650,123,2.1
CN2914100000000,2022-10-01,29,141,MO,Morgan County,8039,7820,219,2.7
CN2914300000000,2022-10-01,29,143,MO,New Madrid County,7908,7699,209,2.6
CN2914500000000,2022-10-01,29,145,MO,Newton County,26648,26048,600,2.3
CN2914700000000,2022-10-01,29,147,MO,Nodaway County,10986,10765,221,2
CN2914900000000,2022-10-01,29,149,MO,Oregon County,3693,3579,114,3.1
CN2915100000000,2022-10-01,29,151,MO,Osage County,6987,6857,130,1.9
CN2915300000000,2022-10-01,29,153,MO,Ozark County,3322,3213,109,3.3
CN2915500000000,2022-10-01,29,155,MO,Pemiscot County,5645,5461,184,3.3
CN2915700000000,2022-10-01,29,157,MO,Perry County,9454,9272,182,1.9
CN2915900000000,2022-10-01,29,159,MO,Pettis County,19989,19531,458,2.3
CN2916100000000,2022-10-01,29,161,MO,Phelps County,19983,19532,451,2.3
CN2916300000000,2022-10-01,29,163,MO,Pike County,7184,7034,150,2.1
CN2916500000000,2022-10-01,29,165,MO,Platte County,60502,59263,1239,2
CN2916700000000,2022-10-01,29,167,MO,Polk County,14653,14316,337,2.3
CN2916900000000,2022-10-01,29,169,MO,Pulaski County,14623,14227,396,2.7
CN2917100000000,2022-10-01,29,171,MO,Putnam County,2036,1992,44,2.2
CN2917300000000,2022-10-01,29,173,MO,Ralls County,5316,5203,113,2.1
CN2917500000000,2022-10-01,29,175,MO,Randolph County,10173,9937,236,2.3
CN2917700000000,2022-10-01,29,177,MO,Ray County,10943,10595,348,3.2
CN2917900000000,2022-10-01,29,179,MO,Reynolds County,2733,2659,74,2.7
CN2918100000000,2022-10-01,29,181,MO,Ripley County,5096,4957,139,2.7
CN2918300000000,2022-10-01,29,183,MO,St. Charles County,231350,227053,4297,1.9
CN2918500000000,2022-10-01,29,185,MO,St. Clair County,3733,3629,104,2.8
CN2918600000000,2022-10-01,29,186,MO,Ste. Genevieve County,9249,9068,181,2
CN2918700000000,2022-10-01,29,187,MO,St. Francois County,25657,24891,766,3
CN2918900000000,2022-10-01,29,189,MO,St. Louis County,531235,519654,11581,2.2
CN2919500000000,2022-10-01,29,195,MO,Saline County,10249,10015,234,2.3
CN2919700000000,2022-10-01,29,197,MO,Schuyler County,1729,1687,42,2.4
CN2919900000000,2022-10-01,29,199,MO,Scotland County,2174,2128,46,2.1
CN2920100000000,2022-10-01,29,201,MO,Scott County,19866,19446,420,2.1
CN2920300000000,2022-10-01,29,203,MO,Shannon County,3181,3084,97,3
CN2920500000000,2022-10-01,29,205,MO,Shelby County,2855,2803,52,1.8
CN2920700000000,2022-10-01,29,207,MO,Stoddard County,12782,12434,348,2.7
CN2920900000000,2022-10-01,29,209,MO,Stone County,13145,12752,393,3
CN2921100000000,2022-10-01,29,211,MO,Sullivan County,2463,2404,59,2.4
CN2921300000000,2022-10-01,29,213,MO,Taney County,25251,24562,689,2.7
CN2921500000000,2022-10-01,29,215,MO,Texas County,8905,8658,247,2.8
CN2921700000000,2022-10-01,29,217,MO,Vernon County,9003,8790,213,2.4
CN2921900000000,2022-10-01,29,219,MO,Warren County,18840,18432,408,2.2
CN2922100000000,2022-10-01,29,221,MO,Washington County,10046,9763,283,2.8
CN2922300000000,2022-10-01,29,223,MO,Wayne County,4709,4561,148,3.1
CN2922500000000,2022-10-01,29,225,MO,Webster County,17586,17225,361,2.1
CN2922700000000,2022-10-01,29,227,MO,Worth County,1084,1066,18,1.7
CN2922900000000,2022-10-01,29,229,MO,Wright County,7394,7202,192,2.6
CN2951000000000,2022-10-01,29,510,MO,St. Louis city,149956,145943,4013,2.7
CN3000100000000,2022-10-01,30,001,MT,Beaverhead County,5641,5537,104,1.8
CN3000300000000,2022-10-01,30,003,MT,Big Horn County,4657,4483,174,3.7
CN3000500000000,2022-10-01,30,005,MT,Blaine County,2231,2176,55,2.5
CN3000700000000,2022-10-01,30,007,MT,Broadwater County,2817,2737,80,2.8
CN3000900000000,2022-10-01,30,009,MT,Carbon County,5757,5626,131,2.3
CN3001100000000,2022-10-01,30,011,MT,Carter County,700,685,15,2.1
CN3001300000000,2022-10-01,30,013,MT,Cascade County,39463,38561,902,2.3
CN3001500000000,2022-10-01,30,015,MT,Chouteau County,2553,2496,57,2.2
CN3001700000000,2022-10-01,30,017,MT,Custer County,6365,6239,126,2
CN3001900000000,2022-10-01,30,019,MT,Daniels County,879,862,17,1.9
CN3002100000000,2022-10-01,30,021,MT,Dawson County,4526,4436,90,2
CN3002300000000,2022-10-01,30,023,MT,Deer Lodge County,5392,5284,108,2
CN3002500000000,2022-10-01,30,025,MT,Fallon County,1661,1636,25,1.5
CN3002700000000,2022-10-01,30,027,MT,Fergus County,5909,5795,114,1.9
CN3002900000000,2022-10-01,30,029,MT,Flathead County,52324,51047,1277,2.4
CN3003100000000,2022-10-01,30,031,MT,Gallatin County,78017,76568,1449,1.9
CN3003300000000,2022-10-01,30,033,MT,Garfield County,764,749,15,2
CN3003500000000,2022-10-01,30,035,MT,Glacier County,5797,5574,223,3.8
CN3003700000000,2022-10-01,30,037,MT,Golden Valley County,375,365,10,2.7
CN3003900000000,2022-10-01,30,039,MT,Granite County,1641,1594,47,2.9
CN3004100000000,2022-10-01,30,041,MT,Hill County,7568,7403,165,2.2
CN3004300000000,2022-10-01,30,043,MT,Jefferson County,6130,5998,132,2.2
CN3004500000000,2022-10-01,30,045,MT,Judith Basin County,1034,1010,24,2.3
CN3004700000000,2022-10-01,30,047,MT,Lake County,14485,14118,367,2.5
CN3004900000000,2022-10-01,30,049,MT,Lewis and Clark County,38768,37988,780,2
CN3005100000000,2022-10-01,30,051,MT,Liberty County,1006,982,24,2.4
CN3005300000000,2022-10-01,30,053,MT,Lincoln County,8731,8430,301,3.4
CN3005500000000,2022-10-01,30,055,MT,McCone County,1000,983,17,1.7
CN3005700000000,2022-10-01,30,057,MT,Madison County,4843,4740,103,2.1
CN3005900000000,2022-10-01,30,059,MT,Meagher County,992,973,19,1.9
CN3006100000000,2022-10-01,30,061,MT,Mineral County,1875,1803,72,3.8
CN3006300000000,2022-10-01,30,063,MT,Missoula County,67392,65923,1469,2.2
CN3006500000000,2022-10-01,30,065,MT,Musselshell County,2357,2302,55,2.3
CN3006700000000,2022-10-01,30,067,MT,Park County,10098,9864,234,2.3
CN3006900000000,2022-10-01,30,069,MT,Petroleum County,275,268,7,2.5
CN3007100000000,2022-10-01,30,071,MT,Phillips County,1862,1799,63,3.4
CN3007300000000,2022-10-01,30,073,MT,Pondera County,2644,2586,58,2.2
CN3007500000000,2022-10-01,30,075,MT,Powder River County,1030,1010,20,1.9
CN3007700000000,2022-10-01,30,077,MT,Powell County,2953,2885,68,2.3
CN3007900000000,2022-10-01,30,079,MT,Prairie County,491,480,11,2.2
CN3008100000000,2022-10-01,30,081,MT,Ravalli County,22106,21592,514,2.3
CN3008300000000,2022-10-01,30,083,MT,Richland County,5968,5831,137,2.3
CN3008500000000,2022-10-01,30,085,MT,Roosevelt County,4387,4270,117,2.7
CN3008700000000,2022-10-01,30,087,MT,Rosebud County,3630,3524,106,2.9
CN3008900000000,2022-10-01,30,089,MT,Sanders County,5476,5311,165,3
CN3009100000000,2022-10-01,30,091,MT,Sheridan County,1765,1736,29,1.6
CN3009300000000,2022-10-01,30,093,MT,Silver Bow County,17655,17225,430,2.4
CN3009500000000,2022-10-01,30,095,MT,Stillwater County,5437,5324,113,2.1
CN3009700000000,2022-10-01,30,097,MT,Sweet Grass County,1919,1884,35,1.8
CN3009900000000,2022-10-01,30,099,MT,Teton County,2841,2775,66,2.3
CN3010100000000,2022-10-01,30,101,MT,Toole County,2144,2103,41,1.9
CN3010300000000,2022-10-01,30,103,MT,Treasure County,357,350,7,2
CN3010500000000,2022-10-01,30,105,MT,Valley County,4019,3942,77,1.9
CN3010700000000,2022-10-01,30,107,MT,Wheatland County,767,745,22,2.9
CN3010900000000,2022-10-01,30,109,MT,Wibaux County,456,446,10,2.2
CN3011100000000,2022-10-01,30,111,MT,Yellowstone County,85945,84095,1850,2.2
CN3100100000000,2022-10-01,31,001,NE,Adams County,17274,16922,352,2
CN3100300000000,2022-10-01,31,003,NE,Antelope County,3608,3538,70,1.9
CN3100500000000,2022-10-01,31,005,NE,Arthur County,223,217,6,2.7
CN3100700000000,2022-10-01,31,007,NE,Banner County,380,366,14,3.7
CN3100900000000,2022-10-01,31,009,NE,Blaine County,236,226,10,4.2
CN3101100000000,2022-10-01,31,011,NE,Boone County,2967,2911,56,1.9
CN3101300000000,2022-10-01,31,013,NE,Box Butte County,5289,5170,119,2.2
CN3101500000000,2022-10-01,31,015,NE,Boyd County,996,973,23,2.3
CN3101700000000,2022-10-01,31,017,NE,Brown County,1388,1355,33,2.4
CN3101900000000,2022-10-01,31,019,NE,Buffalo County,28630,28041,589,2.1
CN3102100000000,2022-10-01,31,021,NE,Burt County,3500,3422,78,2.2
CN3102300000000,2022-10-01,31,023,NE,Butler County,4686,4589,97,2.1
CN3102500000000,2022-10-01,31,025,NE,Cass County,13771,13423,348,2.5
CN3102700000000,2022-10-01,31,027,NE,Cedar County,4608,4511,97,2.1
CN3102900000000,2022-10-01,31,029,NE,Chase County,2211,2170,41,1.9
CN3103100000000,2022-10-01,31,031,NE,Cherry County,3276,3214,62,1.9
CN3103300000000,2022-10-01,31,033,NE,Cheyenne County,4222,4111,111,2.6
CN3103500000000,2022-10-01,31,035,NE,Clay County,3051,2989,62,2
CN3103700000000,2022-10-01,31,037,NE,Colfax County,5740,5621,119,2.1
CN3103900000000,2022-10-01,31,039,NE,Cuming County,4799,4702,97,2
CN3104100000000,2022-10-01,31,041,NE,Custer County,6214,6107,107,1.7
CN3104300000000,2022-10-01,31,043,NE,Dakota County,11115,10845,270,2.4
CN3104500000000,2022-10-01,31,045,NE,Dawes County,5003,4896,107,2.1
CN3104700000000,2022-10-01,31,047,NE,Dawson County,13615,13281,334,2.5
CN3104900000000,2022-10-01,31,049,NE,Deuel County,1033,1006,27,2.6
CN3105100000000,2022-10-01,31,051,NE,Dixon County,3021,2967,54,1.8
CN3105300000000,2022-10-01,31,053,NE,Dodge County,20827,20392,435,2.1
CN3105500000000,2022-10-01,31,055,NE,Douglas County,309050,300856,8194,2.7
CN3105700000000,2022-10-01,31,057,NE,Dundy County,1166,1145,21,1.8
CN3105900000000,2022-10-01,31,059,NE,Fillmore County,3327,3261,66,2
CN3106100000000,2022-10-01,31,061,NE,Franklin County,1537,1502,35,2.3
CN3106300000000,2022-10-01,31,063,NE,Frontier County,1501,1470,31,2.1
CN3106500000000,2022-10-01,31,065,NE,Furnas County,2496,2442,54,2.2
CN3106700000000,2022-10-01,31,067,NE,Gage County,10758,10505,253,2.4
CN3106900000000,2022-10-01,31,069,NE,Garden County,1091,1066,25,2.3
CN3107100000000,2022-10-01,31,071,NE,Garfield County,1113,1090,23,2.1
CN3107300000000,2022-10-01,31,073,NE,Gosper County,1197,1170,27,2.3
CN3107500000000,2022-10-01,31,075,NE,Grant County,417,409,8,1.9
CN3107700000000,2022-10-01,31,077,NE,Greeley County,1188,1163,25,2.1
CN3107900000000,2022-10-01,31,079,NE,Hall County,32814,32062,752,2.3
CN3108100000000,2022-10-01,31,081,NE,Hamilton County,4884,4779,105,2.1
CN3108300000000,2022-10-01,31,083,NE,Harlan County,1790,1753,37,2.1
CN3108500000000,2022-10-01,31,085,NE,Hayes County,583,573,10,1.7
CN3108700000000,2022-10-01,31,087,NE,Hitchcock County,1279,1248,31,2.4
CN3108900000000,2022-10-01,31,089,NE,Holt County,5497,5388,109,2
CN3109100000000,2022-10-01,31,091,NE,Hooker County,401,389,12,3
CN3109300000000,2022-10-01,31,093,NE,Howard County,3461,3393,68,2
CN3109500000000,2022-10-01,31,095,NE,Jefferson County,4153,4073,80,1.9
CN3109700000000,2022-10-01,31,097,NE,Johnson County,2019,1959,60,3
CN3109900000000,2022-10-01,31,099,NE,Kearney County,3730,3658,72,1.9
CN3110100000000,2022-10-01,31,101,NE,Keith County,4629,4540,89,1.9
CN3110300000000,2022-10-01,31,103,NE,Keya Paha County,522,510,12,2.3
CN3110500000000,2022-10-01,31,105,NE,Kimball County,1948,1903,45,2.3
CN3110700000000,2022-10-01,31,107,NE,Knox County,4539,4444,95,2.1
CN3110900000000,2022-10-01,31,109,NE,Lancaster County,181903,177898,4005,2.2
CN3111100000000,2022-10-01,31,111,NE,Lincoln County,18342,17920,422,2.3
CN3111300000000,2022-10-01,31,113,NE,Logan County,477,465,12,2.5
CN3111500000000,2022-10-01,31,115,NE,Loup County,399,387,12,3
CN3111700000000,2022-10-01,31,117,NE,McPherson County,431,423,8,1.9
CN3111900000000,2022-10-01,31,119,NE,Madison County,19872,19454,418,2.1
CN3112100000000,2022-10-01,31,121,NE,Merrick County,4162,4078,84,2
CN3112300000000,2022-10-01,31,123,NE,Morrill County,2594,2540,54,2.1
CN3112500000000,2022-10-01,31,125,NE,Nance County,1921,1880,41,2.1
CN3112700000000,2022-10-01,31,127,NE,Nemaha County,3665,3574,91,2.5
CN3112900000000,2022-10-01,31,129,NE,Nuckolls County,2461,2403,58,2.4
CN3113100000000,2022-10-01,31,131,NE,Otoe County,8629,8442,187,2.2
CN3113300000000,2022-10-01,31,133,NE,Pawnee County,1463,1428,35,2.4
CN3113500000000,2022-10-01,31,135,NE,Perkins County,1809,1778,31,1.7
CN3113700000000,2022-10-01,31,137,NE,Phelps County,4968,4871,97,2
CN3113900000000,2022-10-01,31,139,NE,Pierce County,4159,4085,74,1.8
CN3114100000000,2022-10-01,31,141,NE,Platte County,18595,18216,379,2
CN3114300000000,2022-10-01,31,143,NE,Polk County,2843,2777,66,2.3
CN3114500000000,2022-10-01,31,145,NE,Red Willow County,5875,5758,117,2
CN3114700000000,2022-10-01,31,147,NE,Richardson County,4134,4052,82,2
CN3114900000000,2022-10-01,31,149,NE,Rock County,877,863,14,1.6
CN3115100000000,2022-10-01,31,151,NE,Saline County,7155,6990,165,2.3
CN3115300000000,2022-10-01,31,153,NE,Sarpy County,100735,98481,2254,2.2
CN3115500000000,2022-10-01,31,155,NE,Saunders County,11594,11341,253,2.2
CN3115700000000,2022-10-01,31,157,NE,Scotts Bluff County,18104,17634,470,2.6
CN3115900000000,2022-10-01,31,159,NE,Seward County,8895,8699,196,2.2
CN3116100000000,2022-10-01,31,161,NE,Sheridan County,2749,2693,56,2
CN3116300000000,2022-10-01,31,163,NE,Sherman County,1637,1604,33,2
CN3116500000000,2022-10-01,31,165,NE,Sioux County,744,730,14,1.9
CN3116700000000,2022-10-01,31,167,NE,Stanton County,3517,3447,70,2
CN3116900000000,2022-10-01,31,169,NE,Thayer County,2654,2600,54,2
CN3117100000000,2022-10-01,31,171,NE,Thomas County,436,426,10,2.3
CN3117300000000,2022-10-01,31,173,NE,Thurston County,3231,3128,103,3.2
CN3117500000000,2022-10-01,31,175,NE,Valley County,2078,2029,49,2.4
CN3117700000000,2022-10-01,31,177,NE,Washington County,11549,11314,235,2
CN3117900000000,2022-10-01,31,179,NE,Wayne County,5858,5751,107,1.8
CN3118100000000,2022-10-01,31,181,NE,Webster County,1660,1611,49,3
CN3118300000000,2022-10-01,31,183,NE,Wheeler County,537,529,8,1.5
CN3118500000000,2022-10-01,31,185,NE,York County,7434,7269,165,2.2
CN3200100000000,2022-10-01,32,001,NV,Churchill County,10731,10272,459,4.3
CN3200300000000,2022-10-01,32,003,NV,Clark County,1163182,1094878,68304,5.9
CN3200500000000,2022-10-01,32,005,NV,Douglas County,22325,21349,976,4.4
CN3200700000000,2022-10-01,32,007,NV,Elko County,25276,24362,914,3.6
CN3200900000000,2022-10-01,32,009,NV,Esmeralda County,388,370,18,4.6
CN3201100000000,2022-10-01,32,011,NV,Eureka County,928,895,33,3.6
CN3201300000000,2022-10-01,32,013,NV,Humboldt County,7564,7269,295,3.9
CN3201500000000,2022-10-01,32,015,NV,Lander County,2934,2841,93,3.2
CN3201700000000,2022-10-01,32,017,NV,Lincoln County,1988,1889,99,5
CN3201900000000,2022-10-01,32,019,NV,Lyon County,23515,22254,1261,5.4
CN3202100000000,2022-10-01,32,021,NV,Mineral County,1954,1869,85,4.4
CN3202300000000,2022-10-01,32,023,NV,Nye County,17724,16600,1124,6.3
CN3202700000000,2022-10-01,32,027,NV,Pershing County,2294,2203,91,4
CN3202900000000,2022-10-01,32,029,NV,Storey County,2123,2030,93,4.4
CN3203100000000,2022-10-01,32,031,NV,Washoe County,259157,249598,9559,3.7
CN3203300000000,2022-10-01,32,033,NV,White Pine County,4461,4314,147,3.3
CN3251000000000,2022-10-01,32,510,NV,Carson City,25406,24365,1041,4.1
CN3300100000000,2022-10-01,33,001,NH,Belknap County,31062,30245,817,2.6
CN3300300000000,2022-10-01,33,003,NH,Carroll County,23084,22440,644,2.8
CN3300500000000,2022-10-01,33,005,NH,Cheshire County,39207,38149,1058,2.7
CN3300700000000,2022-10-01,33,007,NH,Coos County,14342,13893,449,3.1
CN3300900000000,2022-10-01,33,009,NH,Grafton County,48862,47657,1205,2.5
CN3301100000000,2022-10-01,33,011,NH,Hillsborough County,241680,235287,6393,2.6
CN3301300000000,2022-10-01,33,013,NH,Merrimack County,82658,80674,1984,2.4
CN3301500000000,2022-10-01,33,015,NH,Rockingham County,188484,183433,5051,2.7
CN3301700000000,2022-10-01,33,017,NH,Strafford County,74306,72490,1816,2.4
CN3301900000000,2022-10-01,33,019,NH,Sullivan County,22739,22169,570,2.5
CN3400100000000,2022-10-01,34,001,NJ,Atlantic County,124648,119755,4893,3.9
CN3400300000000,2022-10-01,34,003,NJ,Bergen County,509365,495806,13559,2.7
CN3400500000000,2022-10-01,34,005,NJ,Burlington County,250678,243816,6862,2.7
CN3400700000000,2022-10-01,34,007,NJ,Camden County,272718,263778,8940,3.3
CN3400900000000,2022-10-01,34,009,NJ,Cape May County,45143,43108,2035,4.5
CN3401100000000,2022-10-01,34,011,NJ,Cumberland County,70917,68171,2746,3.9
CN3401300000000,2022-10-01,34,013,NJ,Essex County,390220,375748,14472,3.7
CN3401500000000,2022-10-01,34,015,NJ,Gloucester County,162639,157823,4816,3
CN3401700000000,2022-10-01,34,017,NJ,Hudson County,380310,369087,11223,3
CN3401900000000,2022-10-01,34,019,NJ,Hunterdon County,69144,67581,1563,2.3
CN3402100000000,2022-10-01,34,021,NJ,Mercer County,218703,212981,5722,2.6
CN3402300000000,2022-10-01,34,023,NJ,Middlesex County,463233,450619,12614,2.7
CN3402500000000,2022-10-01,34,025,NJ,Monmouth County,350333,341265,9068,2.6
CN3402700000000,2022-10-01,34,027,NJ,Morris County,270954,264389,6565,2.4
CN3402900000000,2022-10-01,34,029,NJ,Ocean County,299999,291245,8754,2.9
CN3403100000000,2022-10-01,34,031,NJ,Passaic County,254135,245057,9078,3.6
CN3403300000000,2022-10-01,34,033,NJ,Salem County,31359,30232,1127,3.6
CN3403500000000,2022-10-01,34,035,NJ,Somerset County,180526,176050,4476,2.5
CN3403700000000,2022-10-01,34,037,NJ,Sussex County,78438,76228,2210,2.8
CN3403900000000,2022-10-01,34,039,NJ,Union County,290608,281516,9092,3.1
CN3404100000000,2022-10-01,34,041,NJ,Warren County,60084,58537,1547,2.6
CN3500100000000,2022-10-01,35,001,NM,Bernalillo County,337329,327497,9832,2.9
CN3500300000000,2022-10-01,35,003,NM,Catron County,1107,1056,51,4.6
CN3500500000000,2022-10-01,35,005,NM,Chaves County,27325,26409,916,3.4
CN3500600000000,2022-10-01,35,006,NM,Cibola County,8101,7747,354,4.4
CN3500700000000,2022-10-01,35,007,NM,Colfax County,5140,4973,167,3.2
CN3500900000000,2022-10-01,35,009,NM,Curry County,21856,21269,587,2.7
CN3501100000000,2022-10-01,35,011,NM,De Baca County,696,675,21,3
CN3501300000000,2022-10-01,35,013,NM,Dona Ana County,100229,96796,3433,3.4
CN3501500000000,2022-10-01,35,015,NM,Eddy County,31695,30896,799,2.5
CN3501700000000,2022-10-01,35,017,NM,Grant County,11430,11041,389,3.4
CN3501900000000,2022-10-01,35,019,NM,Guadalupe County,1486,1424,62,4.2
CN3502100000000,2022-10-01,35,021,NM,Harding County,287,280,7,2.4
CN3502300000000,2022-10-01,35,023,NM,Hidalgo County,1819,1769,50,2.7
CN3502500000000,2022-10-01,35,025,NM,Lea County,28829,27876,953,3.3
CN3502700000000,2022-10-01,35,027,NM,Lincoln County,8624,8343,281,3.3
CN3502800000000,2022-10-01,35,028,NM,Los Alamos County,10816,10622,194,1.8
CN3502900000000,2022-10-01,35,029,NM,Luna County,9542,8838,704,7.4
CN3503100000000,2022-10-01,35,031,NM,McKinley County,22793,21797,996,4.4
CN3503300000000,2022-10-01,35,033,NM,Mora County,1947,1858,89,4.6
CN3503500000000,2022-10-01,35,035,NM,Otero County,25383,24511,872,3.4
CN3503700000000,2022-10-01,35,037,NM,Quay County,2848,2749,99,3.5
CN3503900000000,2022-10-01,35,039,NM,Rio Arriba County,16362,15802,560,3.4
CN3504100000000,2022-10-01,35,041,NM,Roosevelt County,7974,7724,250,3.1
CN3504300000000,2022-10-01,35,043,NM,Sandoval County,68297,66211,2086,3.1
CN3504500000000,2022-10-01,35,045,NM,San Juan County,49998,48194,1804,3.6
CN3504700000000,2022-10-01,35,047,NM,San Miguel County,10321,9892,429,4.2
CN3504900000000,2022-10-01,35,049,NM,Santa Fe County,71404,69316,2088,2.9
CN3505100000000,2022-10-01,35,051,NM,Sierra County,3969,3789,180,4.5
CN3505300000000,2022-10-01,35,053,NM,Socorro County,6108,5895,213,3.5
CN3505500000000,2022-10-01,35,055,NM,Taos County,14486,13909,577,4
CN3505700000000,2022-10-01,35,057,NM,Torrance County,5805,5563,242,4.2
CN3505900000000,2022-10-01,35,059,NM,Union County,1576,1540,36,2.3
CN3506100000000,2022-10-01,35,061,NM,Valencia County,31082,29975,1107,3.6
CN3600100000000,2022-10-01,36,001,NY,Albany County,160622,156420,4202,2.6
CN3600300000000,2022-10-01,36,003,NY,Allegany County,19322,18700,622,3.2
CN3600500000000,2022-10-01,36,005,NY,Bronx County,601766,560591,41175,6.8
CN3600700000000,2022-10-01,36,007,NY,Broome County,82252,79695,2557,3.1
CN3600900000000,2022-10-01,36,009,NY,Cattaraugus County,32664,31607,1057,3.2
CN3601100000000,2022-10-01,36,011,NY,Cayuga County,35730,34774,956,2.7
CN3601300000000,2022-10-01,36,013,NY,Chautauqua County,53671,51972,1699,3.2
CN3601500000000,2022-10-01,36,015,NY,Chemung County,34541,33456,1085,3.1
CN3601700000000,2022-10-01,36,017,NY,Chenango County,21681,21136,545,2.5
CN3601900000000,2022-10-01,36,019,NY,Clinton County,35523,34577,946,2.7
CN3602100000000,2022-10-01,36,021,NY,Columbia County,30420,29740,680,2.2
CN3602300000000,2022-10-01,36,023,NY,Cortland County,22811,22146,665,2.9
CN3602500000000,2022-10-01,36,025,NY,Delaware County,18427,17877,550,3
CN3602700000000,2022-10-01,36,027,NY,Dutchess County,144733,140964,3769,2.6
CN3602900000000,2022-10-01,36,029,NY,Erie County,446058,432641,13417,3
CN3603100000000,2022-10-01,36,031,NY,Essex County,16239,15827,412,2.5
CN3603300000000,2022-10-01,36,033,NY,Franklin County,18950,18408,542,2.9
CN3603500000000,2022-10-01,36,035,NY,Fulton County,22505,21779,726,3.2
CN3603700000000,2022-10-01,36,037,NY,Genesee County,29653,28932,721,2.4
CN3603900000000,2022-10-01,36,039,NY,Greene County,20106,19533,573,2.8
CN3604100000000,2022-10-01,36,041,NY,Hamilton County,2173,2111,62,2.9
CN3604300000000,2022-10-01,36,043,NY,Herkimer County,27118,26303,815,3
CN3604500000000,2022-10-01,36,045,NY,Jefferson County,43584,42219,1365,3.1
CN3604700000000,2022-10-01,36,047,NY,Kings County,1209624,1146441,63183,5.2
CN3604900000000,2022-10-01,36,049,NY,Lewis County,11549,11242,307,2.7
CN3605100000000,2022-10-01,36,051,NY,Livingston County,30086,29294,792,2.6
CN3605300000000,2022-10-01,36,053,NY,Madison County,32990,32115,875,2.7
CN3605500000000,2022-10-01,36,055,NY,Monroe County,364625,353880,10745,2.9
CN3605700000000,2022-10-01,36,057,NY,Montgomery County,22402,21651,751,3.4
CN3605900000000,2022-10-01,36,059,NY,Nassau County,730444,712437,18007,2.5
CN3606100000000,2022-10-01,36,061,NY,New York County,921285,883655,37630,4.1
CN3606300000000,2022-10-01,36,063,NY,Niagara County,98184,95190,2994,3
CN3606500000000,2022-10-01,36,065,NY,Oneida County,99738,96781,2957,3
CN3606700000000,2022-10-01,36,067,NY,Onondaga County,226224,219991,6233,2.8
CN3606900000000,2022-10-01,36,069,NY,Ontario County,55667,54275,1392,2.5
CN3607100000000,2022-10-01,36,071,NY,Orange County,189888,184665,5223,2.8
CN3607300000000,2022-10-01,36,073,NY,Orleans County,16952,16462,490,2.9
CN3607500000000,2022-10-01,36,075,NY,Oswego County,53140,51450,1690,3.2
CN3607700000000,2022-10-01,36,077,NY,Otsego County,27066,26333,733,2.7
CN3607900000000,2022-10-01,36,079,NY,Putnam County,51445,50145,1300,2.5
CN3608100000000,2022-10-01,36,081,NY,Queens County,1140664,1089446,51218,4.5
CN3608300000000,2022-10-01,36,083,NY,Rensselaer County,82763,80644,2119,2.6
CN3608500000000,2022-10-01,36,085,NY,Richmond County,227108,216125,10983,4.8
CN3608700000000,2022-10-01,36,087,NY,Rockland County,159285,155340,3945,2.5
CN3608900000000,2022-10-01,36,089,NY,St. Lawrence County,43447,42032,1415,3.3
CN3609100000000,2022-10-01,36,091,NY,Saratoga County,122492,119792,2700,2.2
CN3609300000000,2022-10-01,36,093,NY,Schenectady County,78481,76250,2231,2.8
CN3609500000000,2022-10-01,36,095,NY,Schoharie County,14749,14344,405,2.7
CN3609700000000,2022-10-01,36,097,NY,Schuyler County,8094,7881,213,2.6
CN3609900000000,2022-10-01,36,099,NY,Seneca County,14883,14499,384,2.6
CN3610100000000,2022-10-01,36,101,NY,Steuben County,40788,39603,1185,2.9
CN3610300000000,2022-10-01,36,103,NY,Suffolk County,800661,779752,20909,2.6
CN3610500000000,2022-10-01,36,105,NY,Sullivan County,37310,36294,1016,2.7
CN3610700000000,2022-10-01,36,107,NY,Tioga County,22218,21648,570,2.6
CN3610900000000,2022-10-01,36,109,NY,Tompkins County,51044,49790,1254,2.5
CN3611100000000,2022-10-01,36,111,NY,Ulster County,87893,85620,2273,2.6
CN3611300000000,2022-10-01,36,113,NY,Warren County,31175,30377,798,2.6
CN3611500000000,2022-10-01,36,115,NY,Washington County,27371,26675,696,2.5
CN3611700000000,2022-10-01,36,117,NY,Wayne County,43145,42029,1116,2.6
CN3611900000000,2022-10-01,36,119,NY,Westchester County,495880,482680,13200,2.7
CN3612100000000,2022-10-01,36,121,NY,Wyoming County,17293,16864,429,2.5
CN3612300000000,2022-10-01,36,123,NY,Yates County,11515,11233,282,2.4
CN3700100000000,2022-10-01,37,001,NC,Alamance County,83231,80131,3100,3.7
CN3700300000000,2022-10-01,37,003,NC,Alexander County,18141,17537,604,3.3
CN3700500000000,2022-10-01,37,005,NC,Alleghany County,4727,4556,171,3.6
CN3700700000000,2022-10-01,37,007,NC,Anson County,10368,9919,449,4.3
CN3700900000000,2022-10-01,37,009,NC,Ashe County,13019,12558,461,3.5
CN3701100000000,2022-10-01,37,011,NC,Avery County,8055,7799,256,3.2
CN3701300000000,2022-10-01,37,013,NC,Beaufort County,20132,19313,819,4.1
CN3701500000000,2022-10-01,37,015,NC,Bertie County,7299,6958,341,4.7
CN3701700000000,2022-10-01,37,017,NC,Bladen County,14588,13954,634,4.3
CN3701900000000,2022-10-01,37,019,NC,Brunswick County,57757,55040,2717,4.7
CN3702100000000,2022-10-01,37,021,NC,Buncombe County,143043,138713,4330,3
CN3702300000000,2022-10-01,37,023,NC,Burke County,41141,39658,1483,3.6
CN3702500000000,2022-10-01,37,025,NC,Cabarrus County,116578,112531,4047,3.5
CN3702700000000,2022-10-01,37,027,NC,Caldwell County,36597,35261,1336,3.7
CN3702900000000,2022-10-01,37,029,NC,Camden County,4741,4556,185,3.9
CN3703100000000,2022-10-01,37,031,NC,Carteret County,32382,31237,1145,3.5
CN3703300000000,2022-10-01,37,033,NC,Caswell County,9695,9299,396,4.1
CN3703500000000,2022-10-01,37,035,NC,Catawba County,79837,77010,2827,3.5
CN3703700000000,2022-10-01,37,037,NC,Chatham County,37588,36343,1245,3.3
CN3703900000000,2022-10-01,37,039,NC,Cherokee County,11197,10736,461,4.1
CN3704100000000,2022-10-01,37,041,NC,Chowan County,5931,5693,238,4
CN3704300000000,2022-10-01,37,043,NC,Clay County,4305,4125,180,4.2
CN3704500000000,2022-10-01,37,045,NC,Cleveland County,49281,47364,1917,3.9
CN3704700000000,2022-10-01,37,047,NC,Columbus County,24019,23049,970,4
CN3704900000000,2022-10-01,37,049,NC,Craven County,41936,40299,1637,3.9
CN3705100000000,2022-10-01,37,051,NC,Cumberland County,126774,120279,6495,5.1
CN3705300000000,2022-10-01,37,053,NC,Currituck County,14656,14155,501,3.4
CN3705500000000,2022-10-01,37,055,NC,Dare County,20089,19395,694,3.5
CN3705700000000,2022-10-01,37,057,NC,Davidson County,82258,79321,2937,3.6
CN3705900000000,2022-10-01,37,059,NC,Davie County,20997,20263,734,3.5
CN3706100000000,2022-10-01,37,061,NC,Duplin County,25206,24281,925,3.7
CN3706300000000,2022-10-01,37,063,NC,Durham County,178658,172800,5858,3.3
CN3706500000000,2022-10-01,37,065,NC,Edgecombe County,20141,18865,1276,6.3
CN3706700000000,2022-10-01,37,067,NC,Forsyth County,190292,183208,7084,3.7
CN3706900000000,2022-10-01,37,069,NC,Franklin County,34176,32930,1246,3.6
CN3707100000000,2022-10-01,37,071,NC,Gaston County,115058,110798,4260,3.7
CN3707300000000,2022-10-01,37,073,NC,Gates County,5145,4947,198,3.8
CN3707500000000,2022-10-01,37,075,NC,Graham County,2929,2788,141,4.8
CN3707700000000,2022-10-01,37,077,NC,Granville County,30362,29375,987,3.3
CN3707900000000,2022-10-01,37,079,NC,Greene County,9652,9337,315,3.3
CN3708100000000,2022-10-01,37,081,NC,Guilford County,260941,250331,10610,4.1
CN3708300000000,2022-10-01,37,083,NC,Halifax County,19314,18239,1075,5.6
CN3708500000000,2022-10-01,37,085,NC,Harnett County,55609,53299,2310,4.2
CN3708700000000,2022-10-01,37,087,NC,Haywood County,30426,29431,995,3.3
CN3708900000000,2022-10-01,37,089,NC,Henderson County,56024,54177,1847,3.3
CN3709100000000,2022-10-01,37,091,NC,Hertford County,8594,8141,453,5.3
CN3709300000000,2022-10-01,37,093,NC,Hoke County,20212,19182,1030,5.1
CN3709500000000,2022-10-01,37,095,NC,Hyde County,1795,1720,75,4.2
CN3709700000000,2022-10-01,37,097,NC,Iredell County,95076,91756,3320,3.5
CN3709900000000,2022-10-01,37,099,NC,Jackson County,20024,19270,754,3.8
CN3710100000000,2022-10-01,37,101,NC,Johnston County,108783,105117,3666,3.4
CN3710300000000,2022-10-01,37,103,NC,Jones County,4338,4182,156,3.6
CN3710500000000,2022-10-01,37,105,NC,Lee County,26384,25249,1135,4.3
CN3710700000000,2022-10-01,37,107,NC,Lenoir County,27873,26863,1010,3.6
CN3710900000000,2022-10-01,37,109,NC,Lincoln County,46634,45133,1501,3.2
CN3711100000000,2022-10-01,37,111,NC,McDowell County,20270,19533,737,3.6
CN3711300000000,2022-10-01,37,113,NC,Macon County,16417,15840,577,3.5
CN3711500000000,2022-10-01,37,115,NC,Madison County,10161,9807,354,3.5
CN3711700000000,2022-10-01,37,117,NC,Martin County,8668,8275,393,4.5
CN3711900000000,2022-10-01,37,119,NC,Mecklenburg County,654387,631331,23056,3.5
CN3712100000000,2022-10-01,37,121,NC,Mitchell County,6136,5873,263,4.3
CN3712300000000,2022-10-01,37,123,NC,Montgomery County,11123,10700,423,3.8
CN3712500000000,2022-10-01,37,125,NC,Moore County,42644,41046,1598,3.7
CN3712700000000,2022-10-01,37,127,NC,Nash County,42138,40033,2105,5
CN3712900000000,2022-10-01,37,129,NC,New Hanover County,130070,125743,4327,3.3
CN3713100000000,2022-10-01,37,131,NC,Northampton County,7304,6943,361,4.9
CN3713300000000,2022-10-01,37,133,NC,Onslow County,68806,65802,3004,4.4
CN3713500000000,2022-10-01,37,135,NC,Orange County,81459,78926,2533,3.1
CN3713700000000,2022-10-01,37,137,NC,Pamlico County,5488,5283,205,3.7
CN3713900000000,2022-10-01,37,139,NC,Pasquotank County,16874,16117,757,4.5
CN3714100000000,2022-10-01,37,141,NC,Pender County,30984,29866,1118,3.6
CN3714300000000,2022-10-01,37,143,NC,Perquimans County,5037,4817,220,4.4
CN3714500000000,2022-10-01,37,145,NC,Person County,18821,18087,734,3.9
CN3714700000000,2022-10-01,37,147,NC,Pitt County,88346,84811,3535,4
CN3714900000000,2022-10-01,37,149,NC,Polk County,9464,9091,373,3.9
CN3715100000000,2022-10-01,37,151,NC,Randolph County,65749,63256,2493,3.8
CN3715300000000,2022-10-01,37,153,NC,Richmond County,17195,16346,849,4.9
CN3715500000000,2022-10-01,37,155,NC,Robeson County,48115,45507,2608,5.4
CN3715700000000,2022-10-01,37,157,NC,Rockingham County,39715,38011,1704,4.3
CN3715900000000,2022-10-01,37,159,NC,Rowan County,68045,65567,2478,3.6
CN3716100000000,2022-10-01,37,161,NC,Rutherford County,24871,23675,1196,4.8
CN3716300000000,2022-10-01,37,163,NC,Sampson County,29494,28434,1060,3.6
CN3716500000000,2022-10-01,37,165,NC,Scotland County,11278,10589,689,6.1
CN3716700000000,2022-10-01,37,167,NC,Stanly County,31015,29955,1060,3.4
CN3716900000000,2022-10-01,37,169,NC,Stokes County,21906,21142,764,3.5
CN3717100000000,2022-10-01,37,171,NC,Surry County,32946,31783,1163,3.5
CN3717300000000,2022-10-01,37,173,NC,Swain County,7235,7007,228,3.2
CN3717500000000,2022-10-01,37,175,NC,Transylvania County,14970,14421,549,3.7
CN3717700000000,2022-10-01,37,177,NC,Tyrrell County,1335,1272,63,4.7
CN3717900000000,2022-10-01,37,179,NC,Union County,130975,126803,4172,3.2
CN3718100000000,2022-10-01,37,181,NC,Vance County,16723,15748,975,5.8
CN3718300000000,2022-10-01,37,183,NC,Wake County,634308,614523,19785,3.1
CN3718500000000,2022-10-01,37,185,NC,Warren County,6405,5999,406,6.3
CN3718700000000,2022-10-01,37,187,NC,Washington County,4399,4178,221,5
CN3718900000000,2022-10-01,37,189,NC,Watauga County,29973,28995,978,3.3
CN3719100000000,2022-10-01,37,191,NC,Wayne County,50704,48650,2054,4.1
CN3719300000000,2022-10-01,37,193,NC,Wilkes County,27440,26377,1063,3.9
CN3719500000000,2022-10-01,37,195,NC,Wilson County,34077,32406,1671,4.9
CN3719700000000,2022-10-01,37,197,NC,Yadkin County,17847,17240,607,3.4
CN3719900000000,2022-10-01,37,199,NC,Yancey County,8322,8017,305,3.7
CN3800100000000,2022-10-01,38,001,ND,Adams County,954,939,15,1.6
CN3800300000000,2022-10-01,38,003,ND,Barnes County,5219,5144,75,1.4
CN3800500000000,2022-10-01,38,005,ND,Benson County,2432,2380,52,2.1
CN3800700000000,2022-10-01,38,007,ND,Billings County,420,414,6,1.4
CN3800900000000,2022-10-01,38,009,ND,Bottineau County,2974,2919,55,1.8
CN3801100000000,2022-10-01,38,011,ND,Bowman County,1536,1517,19,1.2
CN3801300000000,2022-10-01,38,013,ND,Burke County,1049,1037,12,1.1
CN3801500000000,2022-10-01,38,015,ND,Burleigh County,51454,50770,684,1.3
CN3801700000000,2022-10-01,38,017,ND,Cass County,109955,108594,1361,1.2
CN3801900000000,2022-10-01,38,019,ND,Cavalier County,1875,1847,28,1.5
CN3802100000000,2022-10-01,38,021,ND,Dickey County,2212,2187,25,1.1
CN3802300000000,2022-10-01,38,023,ND,Divide County,1473,1461,12,0.8
CN3802500000000,2022-10-01,38,025,ND,Dunn County,3336,3309,27,0.8
CN3802700000000,2022-10-01,38,027,ND,Eddy County,1237,1213,24,1.9
CN3802900000000,2022-10-01,38,029,ND,Emmons County,1484,1438,46,3.1
CN3803100000000,2022-10-01,38,031,ND,Foster County,1513,1494,19,1.3
CN3803300000000,2022-10-01,38,033,ND,Golden Valley County,884,869,15,1.7
CN3803500000000,2022-10-01,38,035,ND,Grand Forks County,37704,37213,491,1.3
CN3803700000000,2022-10-01,38,037,ND,Grant County,1273,1258,15,1.2
CN3803900000000,2022-10-01,38,039,ND,Griggs County,1037,1022,15,1.4
CN3804100000000,2022-10-01,38,041,ND,Hettinger County,1448,1433,15,1
CN3804300000000,2022-10-01,38,043,ND,Kidder County,1356,1322,34,2.5
CN3804500000000,2022-10-01,38,045,ND,LaMoure County,2168,2144,24,1.1
CN3804700000000,2022-10-01,38,047,ND,Logan County,892,876,16,1.8
CN3804900000000,2022-10-01,38,049,ND,McHenry County,3188,3127,61,1.9
CN3805100000000,2022-10-01,38,051,ND,McIntosh County,1079,1063,16,1.5
CN3805300000000,2022-10-01,38,053,ND,McKenzie County,9651,9525,126,1.3
CN3805500000000,2022-10-01,38,055,ND,McLean County,4904,4809,95,1.9
CN3805700000000,2022-10-01,38,057,ND,Mercer County,3540,3463,77,2.2
CN3805900000000,2022-10-01,38,059,ND,Morton County,16944,16675,269,1.6
CN3806100000000,2022-10-01,38,061,ND,Mountrail County,6527,6453,74,1.1
CN3806300000000,2022-10-01,38,063,ND,Nelson County,1463,1433,30,2.1
CN3806500000000,2022-10-01,38,065,ND,Oliver County,890,872,18,2
CN3806700000000,2022-10-01,38,067,ND,Pembina County,3262,3191,71,2.2
CN3806900000000,2022-10-01,38,069,ND,Pierce County,1662,1631,31,1.9
CN3807100000000,2022-10-01,38,071,ND,Ramsey County,5608,5516,92,1.6
CN3807300000000,2022-10-01,38,073,ND,Ransom County,2680,2649,31,1.2
CN3807500000000,2022-10-01,38,075,ND,Renville County,1250,1237,13,1
CN3807700000000,2022-10-01,38,077,ND,Richland County,8993,8881,112,1.2
CN3807900000000,2022-10-01,38,079,ND,Rolette County,4635,4453,182,3.9
CN3808100000000,2022-10-01,38,081,ND,Sargent County,2316,2292,24,1
CN3808300000000,2022-10-01,38,083,ND,Sheridan County,689,679,10,1.5
CN3808500000000,2022-10-01,38,085,ND,Sioux County,1236,1209,27,2.2
CN3808700000000,2022-10-01,38,087,ND,Slope County,360,353,7,1.9
CN3808900000000,2022-10-01,38,089,ND,Stark County,18203,17952,251,1.4
CN3809100000000,2022-10-01,38,091,ND,Steele County,989,974,15,1.5
CN3809300000000,2022-10-01,38,093,ND,Stutsman County,10830,10682,148,1.4
CN3809500000000,2022-10-01,38,095,ND,Towner County,1179,1163,16,1.4
CN3809700000000,2022-10-01,38,097,ND,Traill County,4606,4550,56,1.2
CN3809900000000,2022-10-01,38,099,ND,Walsh County,5322,5224,98,1.8
CN3810100000000,2022-10-01,38,101,ND,Ward County,32125,31636,489,1.5
CN3810300000000,2022-10-01,38,103,ND,Wells County,1935,1901,34,1.8
CN3810500000000,2022-10-01,38,105,ND,Williams County,22493,22118,375,1.7
CN3900100000000,2022-10-01,39,001,OH,Adams County,10924,10423,501,4.6
CN3900300000000,2022-10-01,39,003,OH,Allen County,46313,44409,1904,4.1
CN3900500000000,2022-10-01,39,005,OH,Ashland County,25934,25019,915,3.5
CN3900700000000,2022-10-01,39,007,OH,Ashtabula County,42589,40918,1671,3.9
CN3900900000000,2022-10-01,39,009,OH,Athens County,27018,25826,1192,4.4
CN3901100000000,2022-10-01,39,011,OH,Auglaize County,23882,23116,766,3.2
CN3901300000000,2022-10-01,39,013,OH,Belmont County,26891,25658,1233,4.6
CN3901500000000,2022-10-01,39,015,OH,Brown County,19524,18733,791,4.1
CN3901700000000,2022-10-01,39,017,OH,Butler County,197561,190871,6690,3.4
CN3901900000000,2022-10-01,39,019,OH,Carroll County,12585,12079,506,4
CN3902100000000,2022-10-01,39,021,OH,Champaign County,19000,18345,655,3.4
CN3902300000000,2022-10-01,39,023,OH,Clark County,62195,59868,2327,3.7
CN3902500000000,2022-10-01,39,025,OH,Clermont County,108325,104727,3598,3.3
CN3902700000000,2022-10-01,39,027,OH,Clinton County,17805,17076,729,4.1
CN3902900000000,2022-10-01,39,029,OH,Columbiana County,44400,42560,1840,4.1
CN3903100000000,2022-10-01,39,031,OH,Coshocton County,13686,13092,594,4.3
CN3903300000000,2022-10-01,39,033,OH,Crawford County,17612,16826,786,4.5
CN3903500000000,2022-10-01,39,035,OH,Cuyahoga County,598248,573657,24591,4.1
CN3903700000000,2022-10-01,39,037,OH,Darke County,25355,24523,832,3.3
CN3903900000000,2022-10-01,39,039,OH,Defiance County,17209,16545,664,3.9
CN3904100000000,2022-10-01,39,041,OH,Delaware County,115584,112145,3439,3
CN3904300000000,2022-10-01,39,043,OH,Erie County,36462,35039,1423,3.9
CN3904500000000,2022-10-01,39,045,OH,Fairfield County,80157,77532,2625,3.3
CN3904700000000,2022-10-01,39,047,OH,Fayette County,13631,13148,483,3.5
CN3904900000000,2022-10-01,39,049,OH,Franklin County,707689,684298,23391,3.3
CN3905100000000,2022-10-01,39,051,OH,Fulton County,21568,20820,748,3.5
CN3905300000000,2022-10-01,39,053,OH,Gallia County,12152,11672,480,3.9
CN3905500000000,2022-10-01,39,055,OH,Geauga County,48357,46800,1557,3.2
CN3905700000000,2022-10-01,39,057,OH,Greene County,81824,78998,2826,3.5
CN3905900000000,2022-10-01,39,059,OH,Guernsey County,17533,16790,743,4.2
CN3906100000000,2022-10-01,39,061,OH,Hamilton County,418673,404256,14417,3.4
CN3906300000000,2022-10-01,39,063,OH,Hancock County,39800,38586,1214,3.1
CN3906500000000,2022-10-01,39,065,OH,Hardin County,12799,12289,510,4
CN3906700000000,2022-10-01,39,067,OH,Harrison County,6431,6139,292,4.5
CN3906900000000,2022-10-01,39,069,OH,Henry County,12736,12265,471,3.7
CN3907100000000,2022-10-01,39,071,OH,Highland County,17467,16711,756,4.3
CN3907300000000,2022-10-01,39,073,OH,Hocking County,12914,12434,480,3.7
CN3907500000000,2022-10-01,39,075,OH,Holmes County,21709,21137,572,2.6
CN3907700000000,2022-10-01,39,077,OH,Huron County,27597,26540,1057,3.8
CN3907900000000,2022-10-01,39,079,OH,Jackson County,12268,11734,534,4.4
CN3908100000000,2022-10-01,39,081,OH,Jefferson County,26816,25472,1344,5
CN3908300000000,2022-10-01,39,083,OH,Knox County,30850,29875,975,3.2
CN3908500000000,2022-10-01,39,085,OH,Lake County,124229,119989,4240,3.4
CN3908700000000,2022-10-01,39,087,OH,Lawrence County,23247,22231,1016,4.4
CN3908900000000,2022-10-01,39,089,OH,Licking County,91897,88939,2958,3.2
CN3909100000000,2022-10-01,39,091,OH,Logan County,22463,21748,715,3.2
CN3909300000000,2022-10-01,39,093,OH,Lorain County,152967,147020,5947,3.9
CN3909500000000,2022-10-01,39,095,OH,Lucas County,202484,194034,8450,4.2
CN3909700000000,2022-10-01,39,097,OH,Madison County,20958,20337,621,3
CN3909900000000,2022-10-01,39,099,OH,Mahoning County,97599,93397,4202,4.3
CN3910100000000,2022-10-01,39,101,OH,Marion County,26939,25917,1022,3.8
CN3910300000000,2022-10-01,39,103,OH,Medina County,97547,94316,3231,3.3
CN3910500000000,2022-10-01,39,105,OH,Meigs County,8621,8187,434,5
CN3910700000000,2022-10-01,39,107,OH,Mercer County,22622,21986,636,2.8
CN3910900000000,2022-10-01,39,109,OH,Miami County,53081,51341,1740,3.3
CN3911100000000,2022-10-01,39,111,OH,Monroe County,5157,4888,269,5.2
CN3911300000000,2022-10-01,39,113,OH,Montgomery County,244518,234930,9588,3.9
CN3911500000000,2022-10-01,39,115,OH,Morgan County,6798,6519,279,4.1
CN3911700000000,2022-10-01,39,117,OH,Morrow County,16983,16385,598,3.5
CN3911900000000,2022-10-01,39,119,OH,Muskingum County,40632,39101,1531,3.8
CN3912100000000,2022-10-01,39,121,OH,Noble County,4556,4313,243,5.3
CN3912300000000,2022-10-01,39,123,OH,Ottawa County,20318,19461,857,4.2
CN3912500000000,2022-10-01,39,125,OH,Paulding County,8628,8344,284,3.3
CN3912700000000,2022-10-01,39,127,OH,Perry County,15904,15270,634,4
CN3912900000000,2022-10-01,39,129,OH,Pickaway County,26790,25852,938,3.5
CN3913100000000,2022-10-01,39,131,OH,Pike County,10896,10413,483,4.4
CN3913300000000,2022-10-01,39,133,OH,Portage County,84446,81487,2959,3.5
CN3913500000000,2022-10-01,39,135,OH,Preble County,21806,21117,689,3.2
CN3913700000000,2022-10-01,39,137,OH,Putnam County,18825,18299,526,2.8
CN3913900000000,2022-10-01,39,139,OH,Richland County,49736,47652,2084,4.2
CN3914100000000,2022-10-01,39,141,OH,Ross County,34968,33763,1205,3.4
CN3914300000000,2022-10-01,39,143,OH,Sandusky County,29834,28492,1342,4.5
CN3914500000000,2022-10-01,39,145,OH,Scioto County,29242,27914,1328,4.5
CN3914700000000,2022-10-01,39,147,OH,Seneca County,26045,25040,1005,3.9
CN3914900000000,2022-10-01,39,149,OH,Shelby County,23313,22547,766,3.3
CN3915100000000,2022-10-01,39,151,OH,Stark County,180376,173749,6627,3.7
CN3915300000000,2022-10-01,39,153,OH,Summit County,262758,252944,9814,3.7
CN3915500000000,2022-10-01,39,155,OH,Trumbull County,82409,78794,3615,4.4
CN3915700000000,2022-10-01,39,157,OH,Tuscarawas County,44334,42773,1561,3.5
CN3915900000000,2022-10-01,39,159,OH,Union County,30247,29366,881,2.9
CN3916100000000,2022-10-01,39,161,OH,Van Wert County,14290,13835,455,3.2
CN3916300000000,2022-10-01,39,163,OH,Vinton County,5365,5130,235,4.4
CN3916500000000,2022-10-01,39,165,OH,Warren County,122993,119080,3913,3.2
CN3916700000000,2022-10-01,39,167,OH,Washington County,26464,25369,1095,4.1
CN3916900000000,2022-10-01,39,169,OH,Wayne County,59790,58018,1772,3
CN3917100000000,2022-10-01,39,171,OH,Williams County,18012,17443,569,3.2
CN3917300000000,2022-10-01,39,173,OH,Wood County,69214,66878,2336,3.4
CN3917500000000,2022-10-01,39,175,OH,Wyandot County,13030,12689,341,2.6
CN4000100000000,2022-10-01,40,001,OK,Adair County,8784,8482,302,3.4
CN4000300000000,2022-10-01,40,003,OK,Alfalfa County,2755,2693,62,2.3
CN4000500000000,2022-10-01,40,005,OK,Atoka County,5178,4966,212,4.1
CN4000700000000,2022-10-01,40,007,OK,Beaver County,2644,2589,55,2.1
CN4000900000000,2022-10-01,40,009,OK,Beckham County,10444,10168,276,2.6
CN4001100000000,2022-10-01,40,011,OK,Blaine County,4430,4334,96,2.2
CN4001300000000,2022-10-01,40,013,OK,Bryan County,23313,22652,661,2.8
CN4001500000000,2022-10-01,40,015,OK,Caddo County,11913,11497,416,3.5
CN4001700000000,2022-10-01,40,017,OK,Canadian County,81202,79077,2125,2.6
CN4001900000000,2022-10-01,40,019,OK,Carter County,21521,20768,753,3.5
CN4002100000000,2022-10-01,40,021,OK,Cherokee County,20101,19414,687,3.4
CN4002300000000,2022-10-01,40,023,OK,Choctaw County,6046,5785,261,4.3
CN4002500000000,2022-10-01,40,025,OK,Cimarron County,1676,1653,23,1.4
CN4002700000000,2022-10-01,40,027,OK,Cleveland County,149375,145369,4006,2.7
CN4002900000000,2022-10-01,40,029,OK,Coal County,2381,2310,71,3
CN4003100000000,2022-10-01,40,031,OK,Comanche County,47393,45591,1802,3.8
CN4003300000000,2022-10-01,40,033,OK,Cotton County,2705,2611,94,3.5
CN4003500000000,2022-10-01,40,035,OK,Craig County,5983,5793,190,3.2
CN4003700000000,2022-10-01,40,037,OK,Creek County,31435,30302,1133,3.6
CN4003900000000,2022-10-01,40,039,OK,Custer County,15079,14698,381,2.5
CN4004100000000,2022-10-01,40,041,OK,Delaware County,20134,19527,607,3
CN4004300000000,2022-10-01,40,043,OK,Dewey County,3058,2996,62,2
CN4004500000000,2022-10-01,40,045,OK,Ellis County,2118,2068,50,2.4
CN4004700000000,2022-10-01,40,047,OK,Garfield County,26289,25451,838,3.2
CN4004900000000,2022-10-01,40,049,OK,Garvin County,12849,12469,380,3
CN4005100000000,2022-10-01,40,051,OK,Grady County,27625,26819,806,2.9
CN4005300000000,2022-10-01,40,053,OK,Grant County,2789,2731,58,2.1
CN4005500000000,2022-10-01,40,055,OK,Greer County,1882,1811,71,3.8
CN4005700000000,2022-10-01,40,057,OK,Harmon County,1212,1176,36,3
CN4005900000000,2022-10-01,40,059,OK,Harper County,1847,1812,35,1.9
CN4006100000000,2022-10-01,40,061,OK,Haskell County,4210,4027,183,4.3
CN4006300000000,2022-10-01,40,063,OK,Hughes County,5268,5075,193,3.7
CN4006500000000,2022-10-01,40,065,OK,Jackson County,10849,10531,318,2.9
CN4006700000000,2022-10-01,40,067,OK,Jefferson County,2511,2435,76,3
CN4006900000000,2022-10-01,40,069,OK,Johnston County,3806,3658,148,3.9
CN4007100000000,2022-10-01,40,071,OK,Kay County,18755,18096,659,3.5
CN4007300000000,2022-10-01,40,073,OK,Kingfisher County,9082,8898,184,2
CN4007500000000,2022-10-01,40,075,OK,Kiowa County,3663,3541,122,3.3
CN4007700000000,2022-10-01,40,077,OK,Latimer County,3162,2978,184,5.8
CN4007900000000,2022-10-01,40,079,OK,Le Flore County,19777,19043,734,3.7
CN4008100000000,2022-10-01,40,081,OK,Lincoln County,16326,15801,525,3.2
CN4008300000000,2022-10-01,40,083,OK,Logan County,23565,22916,649,2.8
CN4008500000000,2022-10-01,40,085,OK,Love County,5897,5754,143,2.4
CN4008700000000,2022-10-01,40,087,OK,McClain County,21125,20538,587,2.8
CN4008900000000,2022-10-01,40,089,OK,McCurtain County,15936,15343,593,3.7
CN4009100000000,2022-10-01,40,091,OK,McIntosh County,7249,6909,340,4.7
CN4009300000000,2022-10-01,40,093,OK,Major County,3862,3758,104,2.7
CN4009500000000,2022-10-01,40,095,OK,Marshall County,7302,7066,236,3.2
CN4009700000000,2022-10-01,40,097,OK,Mayes County,19842,19210,632,3.2
CN4009900000000,2022-10-01,40,099,OK,Murray County,6087,5887,200,3.3
CN4010100000000,2022-10-01,40,101,OK,Muskogee County,28771,27768,1003,3.5
CN4010300000000,2022-10-01,40,103,OK,Noble County,5911,5771,140,2.4
CN4010500000000,2022-10-01,40,105,OK,Nowata County,4778,4638,140,2.9
CN4010700000000,2022-10-01,40,107,OK,Okfuskee County,4494,4320,174,3.9
CN4010900000000,2022-10-01,40,109,OK,Oklahoma County,400647,388458,12189,3
CN4011100000000,2022-10-01,40,111,OK,Okmulgee County,15612,14969,643,4.1
CN4011300000000,2022-10-01,40,113,OK,Osage County,20592,19856,736,3.6
CN4011500000000,2022-10-01,40,115,OK,Ottawa County,15500,15064,436,2.8
CN4011700000000,2022-10-01,40,117,OK,Pawnee County,7377,7102,275,3.7
CN4011900000000,2022-10-01,40,119,OK,Payne County,39862,38761,1101,2.8
CN4012100000000,2022-10-01,40,121,OK,Pittsburg County,16411,15707,704,4.3
CN4012300000000,2022-10-01,40,123,OK,Pontotoc County,19602,19081,521,2.7
CN4012500000000,2022-10-01,40,125,OK,Pottawatomie County,33436,32264,1172,3.5
CN4012700000000,2022-10-01,40,127,OK,Pushmataha County,4630,4453,177,3.8
CN4012900000000,2022-10-01,40,129,OK,Roger Mills County,1854,1815,39,2.1
CN4013100000000,2022-10-01,40,131,OK,Rogers County,45609,44246,1363,3
CN4013300000000,2022-10-01,40,133,OK,Seminole County,9319,8926,393,4.2
CN4013500000000,2022-10-01,40,135,OK,Sequoyah County,16958,16381,577,3.4
CN4013700000000,2022-10-01,40,137,OK,Stephens County,19426,18775,651,3.4
CN4013900000000,2022-10-01,40,139,OK,Texas County,12104,11905,199,1.6
CN4014100000000,2022-10-01,40,141,OK,Tillman County,2988,2887,101,3.4
CN4014300000000,2022-10-01,40,143,OK,Tulsa County,325967,315856,10111,3.1
CN4014500000000,2022-10-01,40,145,OK,Wagoner County,39196,37965,1231,3.1
CN4014700000000,2022-10-01,40,147,OK,Washington County,22303,21562,741,3.3
CN4014900000000,2022-10-01,40,149,OK,Washita County,5450,5299,151,2.8
CN4015100000000,2022-10-01,40,151,OK,Woods County,4688,4600,88,1.9
CN4015300000000,2022-10-01,40,153,OK,Woodward County,8664,8393,271,3.1
CN4100100000000,2022-10-01,41,001,OR,Baker County,7493,7148,345,4.6
CN4100300000000,2022-10-01,41,003,OR,Benton County,50116,48092,2024,4
CN4100500000000,2022-10-01,41,005,OR,Clackamas County,228913,219585,9328,4.1
CN4100700000000,2022-10-01,41,007,OR,Clatsop County,19686,18795,891,4.5
CN4100900000000,2022-10-01,41,009,OR,Columbia County,25422,24090,1332,5.2
CN4101100000000,2022-10-01,41,011,OR,Coos County,26717,25210,1507,5.6
CN4101300000000,2022-10-01,41,013,OR,Crook County,11337,10695,642,5.7
CN4101500000000,2022-10-01,41,015,OR,Curry County,9200,8680,520,5.7
CN4101700000000,2022-10-01,41,017,OR,Deschutes County,103527,99010,4517,4.4
CN4101900000000,2022-10-01,41,019,OR,Douglas County,47454,44780,2674,5.6
CN4102100000000,2022-10-01,41,021,OR,Gilliam County,1022,988,34,3.3
CN4102300000000,2022-10-01,41,023,OR,Grant County,3233,3071,162,5
CN4102500000000,2022-10-01,41,025,OR,Harney County,3781,3603,178,4.7
CN4102700000000,2022-10-01,41,027,OR,Hood River County,14404,13892,512,3.6
CN4102900000000,2022-10-01,41,029,OR,Jackson County,108088,102804,5284,4.9
CN4103100000000,2022-10-01,41,031,OR,Jefferson County,10425,9843,582,5.6
CN4103300000000,2022-10-01,41,033,OR,Josephine County,36966,34841,2125,5.7
CN4103500000000,2022-10-01,41,035,OR,Klamath County,30719,28874,1845,6
CN4103700000000,2022-10-01,41,037,OR,Lake County,3692,3496,196,5.3
CN4103900000000,2022-10-01,41,039,OR,Lane County,183711,174435,9276,5
CN4104100000000,2022-10-01,41,041,OR,Lincoln County,20974,19818,1156,5.5
CN4104300000000,2022-10-01,41,043,OR,Linn County,61732,58725,3007,4.9
CN4104500000000,2022-10-01,41,045,OR,Malheur County,12811,12247,564,4.4
CN4104700000000,2022-10-01,41,047,OR,Marion County,173013,165061,7952,4.6
CN4104900000000,2022-10-01,41,049,OR,Morrow County,6195,5932,263,4.2
CN4105100000000,2022-10-01,41,051,OR,Multnomah County,472661,452850,19811,4.2
CN4105300000000,2022-10-01,41,053,OR,Polk County,43523,41544,1979,4.5
CN4105500000000,2022-10-01,41,055,OR,Sherman County,968,937,31,3.2
CN4105700000000,2022-10-01,41,057,OR,Tillamook County,11983,11409,574,4.8
CN4105900000000,2022-10-01,41,059,OR,Umatilla County,38633,36845,1788,4.6
CN4106100000000,2022-10-01,41,061,OR,Union County,12192,11583,609,5
CN4106300000000,2022-10-01,41,063,OR,Wallowa County,3583,3410,173,4.8
CN4106500000000,2022-10-01,41,065,OR,Wasco County,13036,12428,608,4.7
CN4106700000000,2022-10-01,41,067,OR,Washington County,338894,326046,12848,3.8
CN4106900000000,2022-10-01,41,069,OR,Wheeler County,745,722,23,3.1
CN4107100000000,2022-10-01,41,071,OR,Yamhill County,56774,54421,2353,4.1
CN4200100000000,2022-10-01,42,001,PA,Adams County,55345,53737,1608,2.9
CN4200300000000,2022-10-01,42,003,PA,Allegheny County,634556,610169,24387,3.8
CN4200500000000,2022-10-01,42,005,PA,Armstrong County,31133,29825,1308,4.2
CN4200700000000,2022-10-01,42,007,PA,Beaver County,82250,78190,4060,4.9
CN4200900000000,2022-10-01,42,009,PA,Bedford County,24512,23602,910,3.7
CN4201100000000,2022-10-01,42,011,PA,Berks County,214971,206701,8270,3.8
CN4201300000000,2022-10-01,42,013,PA,Blair County,58681,56406,2275,3.9
CN4201500000000,2022-10-01,42,015,PA,Bradford County,28172,27128,1044,3.7
CN4201700000000,2022-10-01,42,017,PA,Bucks County,353047,340486,12561,3.6
CN4201900000000,2022-10-01,42,019,PA,Butler County,99032,95493,3539,3.6
CN4202100000000,2022-10-01,42,021,PA,Cambria County,55464,52980,2484,4.5
CN4202300000000,2022-10-01,42,023,PA,Cameron County,1933,1845,88,4.6
CN4202500000000,2022-10-01,42,025,PA,Carbon County,32695,31207,1488,4.6
CN4202700000000,2022-10-01,42,027,PA,Centre County,80321,77820,2501,3.1
CN4202900000000,2022-10-01,42,029,PA,Chester County,297777,289024,8753,2.9
CN4203100000000,2022-10-01,42,031,PA,Clarion County,15993,15297,696,4.4
CN4203300000000,2022-10-01,42,033,PA,Clearfield County,35056,33468,1588,4.5
CN4203500000000,2022-10-01,42,035,PA,Clinton County,17108,16356,752,4.4
CN4203700000000,2022-10-01,42,037,PA,Columbia County,34263,32883,1380,4
CN4203900000000,2022-10-01,42,039,PA,Crawford County,37951,36406,1545,4.1
CN4204100000000,2022-10-01,42,041,PA,Cumberland County,136294,132081,4213,3.1
CN4204300000000,2022-10-01,42,043,PA,Dauphin County,147294,141926,5368,3.6
CN4204500000000,2022-10-01,42,045,PA,Delaware County,304175,292475,11700,3.8
CN4204700000000,2022-10-01,42,047,PA,Elk County,14318,13748,570,4
CN4204900000000,2022-10-01,42,049,PA,Erie County,126058,120692,5366,4.3
CN4205100000000,2022-10-01,42,051,PA,Fayette County,55065,52240,2825,5.1
CN4205300000000,2022-10-01,42,053,PA,Forest County,1685,1584,101,6
CN4205500000000,2022-10-01,42,055,PA,Franklin County,78796,76138,2658,3.4
CN4205700000000,2022-10-01,42,057,PA,Fulton County,7299,7035,264,3.6
CN4205900000000,2022-10-01,42,059,PA,Greene County,15453,14762,691,4.5
CN4206100000000,2022-10-01,42,061,PA,Huntingdon County,19418,18547,871,4.5
CN4206300000000,2022-10-01,42,063,PA,Indiana County,36688,35077,1611,4.4
CN4206500000000,2022-10-01,42,065,PA,Jefferson County,19427,18635,792,4.1
CN4206700000000,2022-10-01,42,067,PA,Juniata County,12345,11914,431,3.5
CN4206900000000,2022-10-01,42,069,PA,Lackawanna County,106030,101514,4516,4.3
CN4207100000000,2022-10-01,42,071,PA,Lancaster County,291689,282550,9139,3.1
CN4207300000000,2022-10-01,42,073,PA,Lawrence County,39202,37424,1778,4.5
CN4207500000000,2022-10-01,42,075,PA,Lebanon County,74164,71763,2401,3.2
CN4207700000000,2022-10-01,42,077,PA,Lehigh County,198286,190457,7829,3.9
CN4207900000000,2022-10-01,42,079,PA,Luzerne County,159503,151884,7619,4.8
CN4208100000000,2022-10-01,42,081,PA,Lycoming County,55556,53296,2260,4.1
CN4208300000000,2022-10-01,42,083,PA,McKean County,16893,16105,788,4.7
CN4208500000000,2022-10-01,42,085,PA,Mercer County,47831,45729,2102,4.4
CN4208700000000,2022-10-01,42,087,PA,Mifflin County,21136,20273,863,4.1
CN4208900000000,2022-10-01,42,089,PA,Monroe County,82572,78152,4420,5.4
CN4209100000000,2022-10-01,42,091,PA,Montgomery County,469559,454372,15187,3.2
CN4209300000000,2022-10-01,42,093,PA,Montour County,9333,9040,293,3.1
CN4209500000000,2022-10-01,42,095,PA,Northampton County,165280,158902,6378,3.9
CN4209700000000,2022-10-01,42,097,PA,Northumberland County,42333,40514,1819,4.3
CN4209900000000,2022-10-01,42,099,PA,Perry County,24939,24159,780,3.1
CN4210100000000,2022-10-01,42,101,PA,Philadelphia County/city,739878,702807,37071,5
CN4210300000000,2022-10-01,42,103,PA,Pike County,25834,24491,1343,5.2
CN4210500000000,2022-10-01,42,105,PA,Potter County,6841,6512,329,4.8
CN4210700000000,2022-10-01,42,107,PA,Schuylkill County,65898,62893,3005,4.6
CN4210900000000,2022-10-01,42,109,PA,Snyder County,19915,19232,683,3.4
CN4211100000000,2022-10-01,42,111,PA,Somerset County,32198,30775,1423,4.4
CN4211300000000,2022-10-01,42,113,PA,Sullivan County,2536,2435,101,4
CN4211500000000,2022-10-01,42,115,PA,Susquehanna County,20359,19622,737,3.6
CN4211700000000,2022-10-01,42,117,PA,Tioga County,19114,18316,798,4.2
CN4211900000000,2022-10-01,42,119,PA,Union County,19781,19138,643,3.3
CN4212100000000,2022-10-01,42,121,PA,Venango County,21208,20271,937,4.4
CN4212300000000,2022-10-01,42,123,PA,Warren County,17564,16847,717,4.1
CN4212500000000,2022-10-01,42,125,PA,Washington County,104984,100829,4155,4
CN4212700000000,2022-10-01,42,127,PA,Wayne County,22422,21445,977,4.4
CN4212900000000,2022-10-01,42,129,PA,Westmoreland County,176116,169257,6859,3.9
CN4213100000000,2022-10-01,42,131,PA,Wyoming County,13656,13077,579,4.2
CN4213300000000,2022-10-01,42,133,PA,York County,239274,231139,8135,3.4
CN4400100000000,2022-10-01,44,001,RI,Bristol County,26445,25860,585,2.2
CN4400300000000,2022-10-01,44,003,RI,Kent County,93339,91014,2325,2.5
CN4400500000000,2022-10-01,44,005,RI,Newport County,44906,43880,1026,2.3
CN4400700000000,2022-10-01,44,007,RI,Providence County,333152,323084,10068,3
CN4400900000000,2022-10-01,44,009,RI,Washington County,70130,68528,1602,2.3
CN4500100000000,2022-10-01,45,001,SC,Abbeville County,9472,9107,365,3.9
CN4500300000000,2022-10-01,45,003,SC,Aiken County,72372,70001,2371,3.3
CN4500500000000,2022-10-01,45,005,SC,Allendale County,2234,2116,118,5.3
CN4500700000000,2022-10-01,45,007,SC,Anderson County,91731,88954,2777,3
CN4500900000000,2022-10-01,45,009,SC,Bamberg County,4535,4281,254,5.6
CN4501100000000,2022-10-01,45,011,SC,Barnwell County,7413,7090,323,4.4
CN4501300000000,2022-10-01,45,013,SC,Beaufort County,76221,73836,2385,3.1
CN4501500000000,2022-10-01,45,015,SC,Berkeley County,110388,106774,3614,3.3
CN4501700000000,2022-10-01,45,017,SC,Calhoun County,6382,6154,228,3.6
CN4501900000000,2022-10-01,45,019,SC,Charleston County,216274,210462,5812,2.7
CN4502100000000,2022-10-01,45,021,SC,Cherokee County,24438,23315,1123,4.6
CN4502300000000,2022-10-01,45,023,SC,Chester County,13293,12733,560,4.2
CN4502500000000,2022-10-01,45,025,SC,Chesterfield County,20946,20182,764,3.6
CN4502700000000,2022-10-01,45,027,SC,Clarendon County,11821,11331,490,4.1
CN4502900000000,2022-10-01,45,029,SC,Colleton County,15859,15315,544,3.4
CN4503100000000,2022-10-01,45,031,SC,Darlington County,29604,28581,1023,3.5
CN4503300000000,2022-10-01,45,033,SC,Dillon County,12754,12197,557,4.4
CN4503500000000,2022-10-01,45,035,SC,Dorchester County,79990,77555,2435,3
CN4503700000000,2022-10-01,45,037,SC,Edgefield County,10203,9819,384,3.8
CN4503900000000,2022-10-01,45,039,SC,Fairfield County,9137,8735,402,4.4
CN4504100000000,2022-10-01,45,041,SC,Florence County,65777,63647,2130,3.2
CN4504300000000,2022-10-01,45,043,SC,Georgetown County,25975,25068,907,3.5
CN4504500000000,2022-10-01,45,045,SC,Greenville County,260738,253334,7404,2.8
CN4504700000000,2022-10-01,45,047,SC,Greenwood County,29780,28634,1146,3.8
CN4504900000000,2022-10-01,45,049,SC,Hampton County,7815,7598,217,2.8
CN4505100000000,2022-10-01,45,051,SC,Horry County,151005,145497,5508,3.6
CN4505300000000,2022-10-01,45,053,SC,Jasper County,13190,12799,391,3
CN4505500000000,2022-10-01,45,055,SC,Kershaw County,29201,28234,967,3.3
CN4505700000000,2022-10-01,45,057,SC,Lancaster County,43441,41907,1534,3.5
CN4505900000000,2022-10-01,45,059,SC,Laurens County,30170,29163,1007,3.3
CN4506100000000,2022-10-01,45,061,SC,Lee County,6353,6052,301,4.7
CN4506300000000,2022-10-01,45,063,SC,Lexington County,150382,146271,4111,2.7
CN4506500000000,2022-10-01,45,065,SC,McCormick County,3531,3411,120,3.4
CN4506700000000,2022-10-01,45,067,SC,Marion County,12506,11920,586,4.7
CN4506900000000,2022-10-01,45,069,SC,Marlboro County,8064,7548,516,6.4
CN4507100000000,2022-10-01,45,071,SC,Newberry County,19062,18518,544,2.9
CN4507300000000,2022-10-01,45,073,SC,Oconee County,34086,33073,1013,3
CN4507500000000,2022-10-01,45,075,SC,Orangeburg County,32658,31054,1604,4.9
CN4507700000000,2022-10-01,45,077,SC,Pickens County,58237,56346,1891,3.2
CN4507900000000,2022-10-01,45,079,SC,Richland County,195940,189440,6500,3.3
CN4508100000000,2022-10-01,45,081,SC,Saluda County,8374,8126,248,3
CN4508300000000,2022-10-01,45,083,SC,Spartanburg County,154103,149179,4924,3.2
CN4508500000000,2022-10-01,45,085,SC,Sumter County,41503,39880,1623,3.9
CN4508700000000,2022-10-01,45,087,SC,Union County,11204,10665,539,4.8
CN4508900000000,2022-10-01,45,089,SC,Williamsburg County,10561,10070,491,4.6
CN4509100000000,2022-10-01,45,091,SC,York County,147749,143140,4609,3.1
CN4600300000000,2022-10-01,46,003,SD,Aurora County,1488,1461,27,1.8
CN4600500000000,2022-10-01,46,005,SD,Beadle County,9282,9116,166,1.8
CN4600700000000,2022-10-01,46,007,SD,Bennett County,1080,1045,35,3.2
CN4600900000000,2022-10-01,46,009,SD,Bon Homme County,2797,2747,50,1.8
CN4601100000000,2022-10-01,46,011,SD,Brookings County,19534,19134,400,2
CN4601300000000,2022-10-01,46,013,SD,Brown County,20023,19608,415,2.1
CN4601500000000,2022-10-01,46,015,SD,Brule County,2671,2619,52,1.9
CN4601700000000,2022-10-01,46,017,SD,Buffalo County,728,688,40,5.5
CN4601900000000,2022-10-01,46,019,SD,Butte County,5080,4983,97,1.9
CN4602100000000,2022-10-01,46,021,SD,Campbell County,758,736,22,2.9
CN4602300000000,2022-10-01,46,023,SD,Charles Mix County,3776,3689,87,2.3
CN4602500000000,2022-10-01,46,025,SD,Clark County,1946,1908,38,2
CN4602700000000,2022-10-01,46,027,SD,Clay County,7710,7536,174,2.3
CN4602900000000,2022-10-01,46,029,SD,Codington County,15920,15634,286,1.8
CN4603100000000,2022-10-01,46,031,SD,Corson County,1276,1239,37,2.9
CN4603300000000,2022-10-01,46,033,SD,Custer County,4243,4138,105,2.5
CN4603500000000,2022-10-01,46,035,SD,Davison County,11115,10919,196,1.8
CN4603700000000,2022-10-01,46,037,SD,Day County,2644,2582,62,2.3
CN4603900000000,2022-10-01,46,039,SD,Deuel County,2321,2269,52,2.2
CN4604100000000,2022-10-01,46,041,SD,Dewey County,2282,2160,122,5.3
CN4604300000000,2022-10-01,46,043,SD,Douglas County,1502,1475,27,1.8
CN4604500000000,2022-10-01,46,045,SD,Edmunds County,1989,1954,35,1.8
CN4604700000000,2022-10-01,46,047,SD,Fall River County,3008,2943,65,2.2
CN4604900000000,2022-10-01,46,049,SD,Faulk County,1094,1071,23,2.1
CN4605100000000,2022-10-01,46,051,SD,Grant County,4366,4291,75,1.7
CN4605300000000,2022-10-01,46,053,SD,Gregory County,2175,2135,40,1.8
CN4605500000000,2022-10-01,46,055,SD,Haakon County,1104,1081,23,2.1
CN4605700000000,2022-10-01,46,057,SD,Hamlin County,3608,3544,64,1.8
CN4605900000000,2022-10-01,46,059,SD,Hand County,1796,1768,28,1.6
CN4606100000000,2022-10-01,46,061,SD,Hanson County,1783,1743,40,2.2
CN4606300000000,2022-10-01,46,063,SD,Harding County,758,743,15,2
CN4606500000000,2022-10-01,46,065,SD,Hughes County,9868,9711,157,1.6
CN4606700000000,2022-10-01,46,067,SD,Hutchinson County,3596,3532,64,1.8
CN4606900000000,2022-10-01,46,069,SD,Hyde County,645,632,13,2
CN4607100000000,2022-10-01,46,071,SD,Jackson County,1204,1169,35,2.9
CN4607300000000,2022-10-01,46,073,SD,Jerauld County,1278,1258,20,1.6
CN4607500000000,2022-10-01,46,075,SD,Jones County,498,485,13,2.6
CN4607700000000,2022-10-01,46,077,SD,Kingsbury County,2715,2666,49,1.8
CN4607900000000,2022-10-01,46,079,SD,Lake County,6843,6707,136,2
CN4608100000000,2022-10-01,46,081,SD,Lawrence County,14202,13906,296,2.1
CN4608300000000,2022-10-01,46,083,SD,Lincoln County,37701,37108,593,1.6
CN4608500000000,2022-10-01,46,085,SD,Lyman County,1687,1643,44,2.6
CN4608700000000,2022-10-01,46,087,SD,McCook County,3125,3076,49,1.6
CN4608900000000,2022-10-01,46,089,SD,McPherson County,963,936,27,2.8
CN4609100000000,2022-10-01,46,091,SD,Marshall County,2483,2429,54,2.2
CN4609300000000,2022-10-01,46,093,SD,Meade County,14612,14314,298,2
CN4609500000000,2022-10-01,46,095,SD,Mellette County,737,715,22,3
CN4609700000000,2022-10-01,46,097,SD,Miner County,1243,1221,22,1.8
CN4609900000000,2022-10-01,46,099,SD,Minnehaha County,117008,115004,2004,1.7
CN4610100000000,2022-10-01,46,101,SD,Moody County,4027,3947,80,2
CN4610200000000,2022-10-01,46,102,SD,Oglala Lakota County,3746,3547,199,5.3
CN4610300000000,2022-10-01,46,103,SD,Pennington County,60171,58971,1200,2
CN4610500000000,2022-10-01,46,105,SD,Perkins County,1418,1388,30,2.1
CN4610700000000,2022-10-01,46,107,SD,Potter County,1034,1012,22,2.1
CN4610900000000,2022-10-01,46,109,SD,Roberts County,4648,4541,107,2.3
CN4611100000000,2022-10-01,46,111,SD,Sanborn County,1196,1169,27,2.3
CN4611500000000,2022-10-01,46,115,SD,Spink County,3014,2952,62,2.1
CN4611700000000,2022-10-01,46,117,SD,Stanley County,1915,1885,30,1.6
CN4611900000000,2022-10-01,46,119,SD,Sully County,814,799,15,1.8
CN4612100000000,2022-10-01,46,121,SD,Todd County,2954,2850,104,3.5
CN4612300000000,2022-10-01,46,123,SD,Tripp County,3100,3048,52,1.7
CN4612500000000,2022-10-01,46,125,SD,Turner County,4786,4702,84,1.8
CN4612700000000,2022-10-01,46,127,SD,Union County,8757,8556,201,2.3
CN4612900000000,2022-10-01,46,129,SD,Walworth County,2074,2015,59,2.8
CN4613500000000,2022-10-01,46,135,SD,Yankton County,11715,11496,219,1.9
CN4613700000000,2022-10-01,46,137,SD,Ziebach County,945,912,33,3.5
CN4700100000000,2022-10-01,47,001,TN,Anderson County,34968,33767,1201,3.4
CN4700300000000,2022-10-01,47,003,TN,Bedford County,21313,20572,741,3.5
CN4700500000000,2022-10-01,47,005,TN,Benton County,6677,6396,281,4.2
CN4700700000000,2022-10-01,47,007,TN,Bledsoe County,4399,4171,228,5.2
CN4700900000000,2022-10-01,47,009,TN,Blount County,64946,62919,2027,3.1
CN4701100000000,2022-10-01,47,011,TN,Bradley County,49633,47865,1768,3.6
CN4701300000000,2022-10-01,47,013,TN,Campbell County,14826,14217,609,4.1
CN4701500000000,2022-10-01,47,015,TN,Cannon County,6867,6655,212,3.1
CN4701700000000,2022-10-01,47,017,TN,Carroll County,11619,11166,453,3.9
CN4701900000000,2022-10-01,47,019,TN,Carter County,24006,23119,887,3.7
CN4702100000000,2022-10-01,47,021,TN,Cheatham County,22622,22030,592,2.6
CN4702300000000,2022-10-01,47,023,TN,Chester County,8478,8209,269,3.2
CN4702500000000,2022-10-01,47,025,TN,Claiborne County,12725,12236,489,3.8
CN4702700000000,2022-10-01,47,027,TN,Clay County,2816,2696,120,4.3
CN4702900000000,2022-10-01,47,029,TN,Cocke County,14509,13871,638,4.4
CN4703100000000,2022-10-01,47,031,TN,Coffee County,24845,24002,843,3.4
CN4703300000000,2022-10-01,47,033,TN,Crockett County,6811,6598,213,3.1
CN4703500000000,2022-10-01,47,035,TN,Cumberland County,23404,22449,955,4.1
CN4703700000000,2022-10-01,47,037,TN,Davidson County,412181,400826,11355,2.8
CN4703900000000,2022-10-01,47,039,TN,Decatur County,4364,4165,199,4.6
CN4704100000000,2022-10-01,47,041,TN,DeKalb County,7914,7620,294,3.7
CN4704300000000,2022-10-01,47,043,TN,Dickson County,27903,27070,833,3
CN4704500000000,2022-10-01,47,045,TN,Dyer County,16410,15807,603,3.7
CN4704700000000,2022-10-01,47,047,TN,Fayette County,18980,18314,666,3.5
CN4704900000000,2022-10-01,47,049,TN,Fentress County,7755,7470,285,3.7
CN4705100000000,2022-10-01,47,051,TN,Franklin County,18895,18220,675,3.6
CN4705300000000,2022-10-01,47,053,TN,Gibson County,21429,20658,771,3.6
CN4705500000000,2022-10-01,47,055,TN,Giles County,14732,14246,486,3.3
CN4705700000000,2022-10-01,47,057,TN,Grainger County,9675,9291,384,4
CN4705900000000,2022-10-01,47,059,TN,Greene County,28391,27269,1122,4
CN4706100000000,2022-10-01,47,061,TN,Grundy County,5014,4797,217,4.3
CN4706300000000,2022-10-01,47,063,TN,Hamblen County,27980,26963,1017,3.6
CN4706500000000,2022-10-01,47,065,TN,Hamilton County,182920,176606,6314,3.5
CN4706700000000,2022-10-01,47,067,TN,Hancock County,2275,2185,90,4
CN4706900000000,2022-10-01,47,069,TN,Hardeman County,8862,8501,361,4.1
CN4707100000000,2022-10-01,47,071,TN,Hardin County,9930,9529,401,4
CN4707300000000,2022-10-01,47,073,TN,Hawkins County,23098,22176,922,4
CN4707500000000,2022-10-01,47,075,TN,Haywood County,7459,7111,348,4.7
CN4707700000000,2022-10-01,47,077,TN,Henderson County,11592,11165,427,3.7
CN4707900000000,2022-10-01,47,079,TN,Henry County,13523,13006,517,3.8
CN4708100000000,2022-10-01,47,081,TN,Hickman County,11755,11418,337,2.9
CN4708300000000,2022-10-01,47,083,TN,Houston County,3245,3107,138,4.3
CN4708500000000,2022-10-01,47,085,TN,Humphreys County,8623,8316,307,3.6
CN4708700000000,2022-10-01,47,087,TN,Jackson County,4736,4550,186,3.9
CN4708900000000,2022-10-01,47,089,TN,Jefferson County,24860,23966,894,3.6
CN4709100000000,2022-10-01,47,091,TN,Johnson County,7593,7269,324,4.3
CN4709300000000,2022-10-01,47,093,TN,Knox County,248619,241337,7282,2.9
CN4709500000000,2022-10-01,47,095,TN,Lake County,1606,1534,72,4.5
CN4709700000000,2022-10-01,47,097,TN,Lauderdale County,9299,8850,449,4.8
CN4709900000000,2022-10-01,47,099,TN,Lawrence County,19114,18435,679,3.6
CN4710100000000,2022-10-01,47,101,TN,Lewis County,5524,5323,201,3.6
CN4710300000000,2022-10-01,47,103,TN,Lincoln County,16688,16171,517,3.1
CN4710500000000,2022-10-01,47,105,TN,Loudon County,24197,23397,800,3.3
CN4710700000000,2022-10-01,47,107,TN,McMinn County,21003,20105,898,4.3
CN4710900000000,2022-10-01,47,109,TN,McNairy County,8405,8022,383,4.6
CN4711100000000,2022-10-01,47,111,TN,Macon County,11689,11338,351,3
CN4711300000000,2022-10-01,47,113,TN,Madison County,48652,46932,1720,3.5
CN4711500000000,2022-10-01,47,115,TN,Marion County,12246,11788,458,3.7
CN4711700000000,2022-10-01,47,117,TN,Marshall County,15637,15111,526,3.4
CN4711900000000,2022-10-01,47,119,TN,Maury County,52874,51312,1562,3
CN4712100000000,2022-10-01,47,121,TN,Meigs County,5126,4903,223,4.4
CN4712300000000,2022-10-01,47,123,TN,Monroe County,20659,19872,787,3.8
CN4712500000000,2022-10-01,47,125,TN,Montgomery County,87812,84515,3297,3.8
CN4712700000000,2022-10-01,47,127,TN,Moore County,3734,3638,96,2.6
CN4712900000000,2022-10-01,47,129,TN,Morgan County,7783,7472,311,4
CN4713100000000,2022-10-01,47,131,TN,Obion County,12630,12172,458,3.6
CN4713300000000,2022-10-01,47,133,TN,Overton County,9918,9583,335,3.4
CN4713500000000,2022-10-01,47,135,TN,Perry County,2776,2651,125,4.5
CN4713700000000,2022-10-01,47,137,TN,Pickett County,2137,2060,77,3.6
CN4713900000000,2022-10-01,47,139,TN,Polk County,6966,6712,254,3.6
CN4714100000000,2022-10-01,47,141,TN,Putnam County,35198,34002,1196,3.4
CN4714300000000,2022-10-01,47,143,TN,Rhea County,13518,12918,600,4.4
CN4714500000000,2022-10-01,47,145,TN,Roane County,23548,22659,889,3.8
CN4714700000000,2022-10-01,47,147,TN,Robertson County,39206,38104,1102,2.8
CN4714900000000,2022-10-01,47,149,TN,Rutherford County,195210,189958,5252,2.7
CN4715100000000,2022-10-01,47,151,TN,Scott County,8047,7635,412,5.1
CN4715300000000,2022-10-01,47,153,TN,Sequatchie County,6166,5916,250,4.1
CN4715500000000,2022-10-01,47,155,TN,Sevier County,54194,52711,1483,2.7
CN4715700000000,2022-10-01,47,157,TN,Shelby County,431123,411548,19575,4.5
CN4715900000000,2022-10-01,47,159,TN,Smith County,9759,9472,287,2.9
CN4716100000000,2022-10-01,47,161,TN,Stewart County,5571,5367,204,3.7
CN4716300000000,2022-10-01,47,163,TN,Sullivan County,68581,66138,2443,3.6
CN4716500000000,2022-10-01,47,165,TN,Sumner County,108778,105730,3048,2.8
CN4716700000000,2022-10-01,47,167,TN,Tipton County,27228,26207,1021,3.7
CN4716900000000,2022-10-01,47,169,TN,Trousdale County,5717,5553,164,2.9
CN4717100000000,2022-10-01,47,171,TN,Unicoi County,7053,6748,305,4.3
CN4717300000000,2022-10-01,47,173,TN,Union County,7801,7505,296,3.8
CN4717500000000,2022-10-01,47,175,TN,Van Buren County,2076,1993,83,4
CN4717700000000,2022-10-01,47,177,TN,Warren County,16422,15773,649,4
CN4717900000000,2022-10-01,47,179,TN,Washington County,61136,59099,2037,3.3
CN4718100000000,2022-10-01,47,181,TN,Wayne County,6443,6147,296,4.6
CN4718300000000,2022-10-01,47,183,TN,Weakley County,15373,14858,515,3.4
CN4718500000000,2022-10-01,47,185,TN,White County,12012,11583,429,3.6
CN4718700000000,2022-10-01,47,187,TN,Williamson County,138253,134805,3448,2.5
CN4718900000000,2022-10-01,47,189,TN,Wilson County,81892,79705,2187,2.7
CN4800100000000,2022-10-01,48,001,TX,Anderson County,22979,22229,750,3.3
CN4800300000000,2022-10-01,48,003,TX,Andrews County,9599,9322,277,2.9
CN4800500000000,2022-10-01,48,005,TX,Angelina County,35051,33522,1529,4.4
CN4800700000000,2022-10-01,48,007,TX,Aransas County,9273,8801,472,5.1
CN4800900000000,2022-10-01,48,009,TX,Archer County,3942,3817,125,3.2
CN4801100000000,2022-10-01,48,011,TX,Armstrong County,915,891,24,2.6
CN4801300000000,2022-10-01,48,013,TX,Atascosa County,22454,21600,854,3.8
CN4801500000000,2022-10-01,48,015,TX,Austin County,14115,13590,525,3.7
CN4801700000000,2022-10-01,48,017,TX,Bailey County,2252,2156,96,4.3
CN4801900000000,2022-10-01,48,019,TX,Bandera County,10639,10243,396,3.7
CN4802100000000,2022-10-01,48,021,TX,Bastrop County,48507,46955,1552,3.2
CN4802300000000,2022-10-01,48,023,TX,Baylor County,1909,1862,47,2.5
CN4802500000000,2022-10-01,48,025,TX,Bee County,9100,8613,487,5.4
CN4802700000000,2022-10-01,48,027,TX,Bell County,149569,143147,6422,4.3
CN4802900000000,2022-10-01,48,029,TX,Bexar County,982605,947438,35167,3.6
CN4803100000000,2022-10-01,48,031,TX,Blanco County,7142,6945,197,2.8
CN4803300000000,2022-10-01,48,033,TX,Borden County,680,668,12,1.8
CN4803500000000,2022-10-01,48,035,TX,Bosque County,8594,8291,303,3.5
CN4803700000000,2022-10-01,48,037,TX,Bowie County,38400,36705,1695,4.4
CN4803900000000,2022-10-01,48,039,TX,Brazoria County,185112,177503,7609,4.1
CN4804100000000,2022-10-01,48,041,TX,Brazos County,131500,127637,3863,2.9
CN4804300000000,2022-10-01,48,043,TX,Brewster County,4262,4127,135,3.2
CN4804500000000,2022-10-01,48,045,TX,Briscoe County,576,555,21,3.6
CN4804700000000,2022-10-01,48,047,TX,Brooks County,2350,2222,128,5.4
CN4804900000000,2022-10-01,48,049,TX,Brown County,15152,14525,627,4.1
CN4805100000000,2022-10-01,48,051,TX,Burleson County,9029,8704,325,3.6
CN4805300000000,2022-10-01,48,053,TX,Burnet County,25679,24908,771,3
CN4805500000000,2022-10-01,48,055,TX,Caldwell County,21424,20731,693,3.2
CN4805700000000,2022-10-01,48,057,TX,Calhoun County,12246,11849,397,3.2
CN4805900000000,2022-10-01,48,059,TX,Callahan County,6279,6060,219,3.5
CN4806100000000,2022-10-01,48,061,TX,Cameron County,176943,167972,8971,5.1
CN4806300000000,2022-10-01,48,063,TX,Camp County,5063,4839,224,4.4
CN4806500000000,2022-10-01,48,065,TX,Carson County,2953,2863,90,3
CN4806700000000,2022-10-01,48,067,TX,Cass County,11970,11446,524,4.4
CN4806900000000,2022-10-01,48,069,TX,Castro County,3155,3049,106,3.4
CN4807100000000,2022-10-01,48,071,TX,Chambers County,21070,20078,992,4.7
CN4807300000000,2022-10-01,48,073,TX,Cherokee County,20149,19301,848,4.2
CN4807500000000,2022-10-01,48,075,TX,Childress County,3170,3085,85,2.7
CN4807700000000,2022-10-01,48,077,TX,Clay County,4768,4588,180,3.8
CN4807900000000,2022-10-01,48,079,TX,Cochran County,1031,982,49,4.8
CN4808100000000,2022-10-01,48,081,TX,Coke County,1532,1485,47,3.1
CN4808300000000,2022-10-01,48,083,TX,Coleman County,3019,2891,128,4.2
CN4808500000000,2022-10-01,48,085,TX,Collin County,631245,611807,19438,3.1
CN4808700000000,2022-10-01,48,087,TX,Collingsworth County,1055,1018,37,3.5
CN4808900000000,2022-10-01,48,089,TX,Colorado County,10071,9719,352,3.5
CN4809100000000,2022-10-01,48,091,TX,Comal County,82635,79861,2774,3.4
CN4809300000000,2022-10-01,48,093,TX,Comanche County,6320,6104,216,3.4
CN4809500000000,2022-10-01,48,095,TX,Concho County,1216,1175,41,3.4
CN4809700000000,2022-10-01,48,097,TX,Cooke County,19923,19292,631,3.2
CN4809900000000,2022-10-01,48,099,TX,Coryell County,24703,23629,1074,4.3
CN4810100000000,2022-10-01,48,101,TX,Cottle County,922,897,25,2.7
CN4810300000000,2022-10-01,48,103,TX,Crane County,1679,1607,72,4.3
CN4810500000000,2022-10-01,48,105,TX,Crockett County,1440,1393,47,3.3
CN4810700000000,2022-10-01,48,107,TX,Crosby County,2311,2215,96,4.2
CN4810900000000,2022-10-01,48,109,TX,Culberson County,1151,1122,29,2.5
CN4811100000000,2022-10-01,48,111,TX,Dallam County,3722,3628,94,2.5
CN4811300000000,2022-10-01,48,113,TX,Dallas County,1434017,1382842,51175,3.6
CN4811500000000,2022-10-01,48,115,TX,Dawson County,4443,4253,190,4.3
CN4811700000000,2022-10-01,48,117,TX,Deaf Smith County,8671,8419,252,2.9
CN4811900000000,2022-10-01,48,119,TX,Delta County,2514,2414,100,4
CN4812100000000,2022-10-01,48,121,TX,Denton County,556701,539278,17423,3.1
CN4812300000000,2022-10-01,48,123,TX,DeWitt County,9046,8759,287,3.2
CN4812500000000,2022-10-01,48,125,TX,Dickens County,686,652,34,5
CN4812700000000,2022-10-01,48,127,TX,Dimmit County,6250,6020,230,3.7
CN4812900000000,2022-10-01,48,129,TX,Donley County,1467,1414,53,3.6
CN4813100000000,2022-10-01,48,131,TX,Duval County,5048,4851,197,3.9
CN4813300000000,2022-10-01,48,133,TX,Eastland County,6664,6376,288,4.3
CN4813500000000,2022-10-01,48,135,TX,Ector County,84727,81806,2921,3.4
CN4813700000000,2022-10-01,48,137,TX,Edwards County,1086,1057,29,2.7
CN4813900000000,2022-10-01,48,139,TX,Ellis County,104201,100694,3507,3.4
CN4814100000000,2022-10-01,48,141,TX,El Paso County,371420,356075,15345,4.1
CN4814300000000,2022-10-01,48,143,TX,Erath County,21071,20360,711,3.4
CN4814500000000,2022-10-01,48,145,TX,Falls County,6793,6506,287,4.2
CN4814700000000,2022-10-01,48,147,TX,Fannin County,17369,16683,686,3.9
CN4814900000000,2022-10-01,48,149,TX,Fayette County,11902,11491,411,3.5
CN4815100000000,2022-10-01,48,151,TX,Fisher County,1587,1531,56,3.5
CN4815300000000,2022-10-01,48,153,TX,Floyd County,2305,2203,102,4.4
CN4815500000000,2022-10-01,48,155,TX,Foard County,529,511,18,3.4
CN4815700000000,2022-10-01,48,157,TX,Fort Bend County,421538,405717,15821,3.8
CN4815900000000,2022-10-01,48,159,TX,Franklin County,5274,5092,182,3.5
CN4816100000000,2022-10-01,48,161,TX,Freestone County,6257,5944,313,5
CN4816300000000,2022-10-01,48,163,TX,Frio County,9097,8807,290,3.2
CN4816500000000,2022-10-01,48,165,TX,Gaines County,9959,9669,290,2.9
CN4816700000000,2022-10-01,48,167,TX,Galveston County,169799,162912,6887,4.1
CN4816900000000,2022-10-01,48,169,TX,Garza County,1933,1852,81,4.2
CN4817100000000,2022-10-01,48,171,TX,Gillespie County,14666,14298,368,2.5
CN4817300000000,2022-10-01,48,173,TX,Glasscock County,829,807,22,2.7
CN4817500000000,2022-10-01,48,175,TX,Goliad County,3186,3051,135,4.2
CN4817700000000,2022-10-01,48,177,TX,Gonzales County,9278,8975,303,3.3
CN4817900000000,2022-10-01,48,179,TX,Gray County,7607,7283,324,4.3
CN4818100000000,2022-10-01,48,181,TX,Grayson County,66020,63646,2374,3.6
CN4818300000000,2022-10-01,48,183,TX,Gregg County,57251,54932,2319,4.1
CN4818500000000,2022-10-01,48,185,TX,Grimes County,11605,11103,502,4.3
CN4818700000000,2022-10-01,48,187,TX,Guadalupe County,85901,83062,2839,3.3
CN4818900000000,2022-10-01,48,189,TX,Hale County,11309,10744,565,5
CN4819100000000,2022-10-01,48,191,TX,Hall County,1014,970,44,4.3
CN4819300000000,2022-10-01,48,193,TX,Hamilton County,3835,3706,129,3.4
CN4819500000000,2022-10-01,48,195,TX,Hansford County,2810,2736,74,2.6
CN4819700000000,2022-10-01,48,197,TX,Hardeman County,1754,1692,62,3.5
CN4819900000000,2022-10-01,48,199,TX,Hardin County,25014,23843,1171,4.7
CN4820100000000,2022-10-01,48,201,TX,Harris County,2354073,2260925,93148,4
CN4820300000000,2022-10-01,48,203,TX,Harrison County,28805,27584,1221,4.2
CN4820500000000,2022-10-01,48,205,TX,Hartley County,2496,2443,53,2.1
CN4820700000000,2022-10-01,48,207,TX,Haskell County,2720,2638,82,3
CN4820900000000,2022-10-01,48,209,TX,Hays County,139971,135876,4095,2.9
CN4821100000000,2022-10-01,48,211,TX,Hemphill County,1592,1542,50,3.1
CN4821300000000,2022-10-01,48,213,TX,Henderson County,38823,37381,1442,3.7
CN4821500000000,2022-10-01,48,215,TX,Hidalgo County,368595,348114,20481,5.6
CN4821700000000,2022-10-01,48,217,TX,Hill County,18160,17380,780,4.3
CN4821900000000,2022-10-01,48,219,TX,Hockley County,10690,10319,371,3.5
CN4822100000000,2022-10-01,48,221,TX,Hood County,30136,29024,1112,3.7
CN4822300000000,2022-10-01,48,223,TX,Hopkins County,18260,17512,748,4.1
CN4822500000000,2022-10-01,48,225,TX,Houston County,10582,10210,372,3.5
CN4822700000000,2022-10-01,48,227,TX,Howard County,12936,12380,556,4.3
CN4822900000000,2022-10-01,48,229,TX,Hudspeth County,1836,1758,78,4.2
CN4823100000000,2022-10-01,48,231,TX,Hunt County,47216,45382,1834,3.9
CN4823300000000,2022-10-01,48,233,TX,Hutchinson County,8456,8106,350,4.1
CN4823500000000,2022-10-01,48,235,TX,Irion County,772,750,22,2.8
CN4823700000000,2022-10-01,48,237,TX,Jack County,3470,3345,125,3.6
CN4823900000000,2022-10-01,48,239,TX,Jackson County,6916,6682,234,3.4
CN4824100000000,2022-10-01,48,241,TX,Jasper County,12667,11947,720,5.7
CN4824300000000,2022-10-01,48,243,TX,Jeff Davis County,970,933,37,3.8
CN4824500000000,2022-10-01,48,245,TX,Jefferson County,101187,95725,5462,5.4
CN4824700000000,2022-10-01,48,247,TX,Jim Hogg County,1785,1698,87,4.9
CN4824900000000,2022-10-01,48,249,TX,Jim Wells County,15356,14553,803,5.2
CN4825100000000,2022-10-01,48,251,TX,Johnson County,89727,86759,2968,3.3
CN4825300000000,2022-10-01,48,253,TX,Jones County,5757,5511,246,4.3
CN4825500000000,2022-10-01,48,255,TX,Karnes County,6598,6404,194,2.9
CN4825700000000,2022-10-01,48,257,TX,Kaufman County,75835,72996,2839,3.7
CN4825900000000,2022-10-01,48,259,TX,Kendall County,23741,22996,745,3.1
CN4826100000000,2022-10-01,48,261,TX,Kenedy County,114,104,10,8.8
CN4826300000000,2022-10-01,48,263,TX,Kent County,737,724,13,1.8
CN4826500000000,2022-10-01,48,265,TX,Kerr County,22248,21465,783,3.5
CN4826700000000,2022-10-01,48,267,TX,Kimble County,1734,1672,62,3.6
CN4826900000000,2022-10-01,48,269,TX,King County,522,518,4,0.8
CN4827100000000,2022-10-01,48,271,TX,Kinney County,1244,1187,57,4.6
CN4827300000000,2022-10-01,48,273,TX,Kleberg County,12927,12343,584,4.5
CN4827500000000,2022-10-01,48,275,TX,Knox County,1420,1364,56,3.9
CN4827700000000,2022-10-01,48,277,TX,Lamar County,24511,23500,1011,4.1
CN4827900000000,2022-10-01,48,279,TX,Lamb County,5049,4858,191,3.8
CN4828100000000,2022-10-01,48,281,TX,Lampasas County,9414,9070,344,3.7
CN4828300000000,2022-10-01,48,283,TX,La Salle County,4099,3990,109,2.7
CN4828500000000,2022-10-01,48,285,TX,Lavaca County,8991,8698,293,3.3
CN4828700000000,2022-10-01,48,287,TX,Lee County,8677,8387,290,3.3
CN4828900000000,2022-10-01,48,289,TX,Leon County,5955,5667,288,4.8
CN4829100000000,2022-10-01,48,291,TX,Liberty County,35238,33421,1817,5.2
CN4829300000000,2022-10-01,48,293,TX,Limestone County,8324,7950,374,4.5
CN4829500000000,2022-10-01,48,295,TX,Lipscomb County,1439,1395,44,3.1
CN4829700000000,2022-10-01,48,297,TX,Live Oak County,4782,4589,193,4
CN4829900000000,2022-10-01,48,299,TX,Llano County,9287,8937,350,3.8
CN4830100000000,2022-10-01,48,301,TX,Loving County,1437,1433,4,0.3
CN4830300000000,2022-10-01,48,303,TX,Lubbock County,162712,157439,5273,3.2
CN4830500000000,2022-10-01,48,305,TX,Lynn County,2757,2663,94,3.4
CN4830700000000,2022-10-01,48,307,TX,McCulloch County,3130,3002,128,4.1
CN4830900000000,2022-10-01,48,309,TX,McLennan County,127365,123042,4323,3.4
CN4831100000000,2022-10-01,48,311,TX,McMullen County,868,853,15,1.7
CN4831300000000,2022-10-01,48,313,TX,Madison County,4674,4484,190,4.1
CN4831500000000,2022-10-01,48,315,TX,Marion County,4168,3971,197,4.7
CN4831700000000,2022-10-01,48,317,TX,Martin County,2773,2698,75,2.7
CN4831900000000,2022-10-01,48,319,TX,Mason County,1791,1732,59,3.3
CN4832100000000,2022-10-01,48,321,TX,Matagorda County,17173,16283,890,5.2
CN4832300000000,2022-10-01,48,323,TX,Maverick County,22695,21276,1419,6.3
CN4832500000000,2022-10-01,48,325,TX,Medina County,22623,21786,837,3.7
CN4832700000000,2022-10-01,48,327,TX,Menard County,822,793,29,3.5
CN4832900000000,2022-10-01,48,329,TX,Midland County,107543,104712,2831,2.6
CN4833100000000,2022-10-01,48,331,TX,Milam County,10100,9673,427,4.2
CN4833300000000,2022-10-01,48,333,TX,Mills County,1815,1737,78,4.3
CN4833500000000,2022-10-01,48,335,TX,Mitchell County,2254,2163,91,4
CN4833700000000,2022-10-01,48,337,TX,Montague County,9259,8934,325,3.5
CN4833900000000,2022-10-01,48,339,TX,Montgomery County,303833,292543,11290,3.7
CN4834100000000,2022-10-01,48,341,TX,Moore County,11093,10806,287,2.6
CN4834300000000,2022-10-01,48,343,TX,Morris County,4473,4211,262,5.9
CN4834500000000,2022-10-01,48,345,TX,Motley County,496,475,21,4.2
CN4834700000000,2022-10-01,48,347,TX,Nacogdoches County,27932,26761,1171,4.2
CN4834900000000,2022-10-01,48,349,TX,Navarro County,23962,23104,858,3.6
CN4835100000000,2022-10-01,48,351,TX,Newton County,4869,4570,299,6.1
CN4835300000000,2022-10-01,48,353,TX,Nolan County,6615,6374,241,3.6
CN4835500000000,2022-10-01,48,355,TX,Nueces County,163850,156810,7040,4.3
CN4835700000000,2022-10-01,48,357,TX,Ochiltree County,3800,3669,131,3.4
CN4835900000000,2022-10-01,48,359,TX,Oldham County,913,885,28,3.1
CN4836100000000,2022-10-01,48,361,TX,Orange County,35013,33209,1804,5.2
CN4836300000000,2022-10-01,48,363,TX,Palo Pinto County,13127,12644,483,3.7
CN4836500000000,2022-10-01,48,365,TX,Panola County,9598,9201,397,4.1
CN4836700000000,2022-10-01,48,367,TX,Parker County,75186,72792,2394,3.2
CN4836900000000,2022-10-01,48,369,TX,Parmer County,4910,4786,124,2.5
CN4837100000000,2022-10-01,48,371,TX,Pecos County,6125,5904,221,3.6
CN4837300000000,2022-10-01,48,373,TX,Polk County,18688,17746,942,5
CN4837500000000,2022-10-01,48,375,TX,Potter County,54911,53250,1661,3
CN4837700000000,2022-10-01,48,377,TX,Presidio County,2995,2811,184,6.1
CN4837900000000,2022-10-01,48,379,TX,Rains County,6562,6332,230,3.5
CN4838100000000,2022-10-01,48,381,TX,Randall County,75762,73618,2144,2.8
CN4838300000000,2022-10-01,48,383,TX,Reagan County,1599,1549,50,3.1
CN4838500000000,2022-10-01,48,385,TX,Real County,1100,1046,54,4.9
CN4838700000000,2022-10-01,48,387,TX,Red River County,4966,4719,247,5
CN4838900000000,2022-10-01,48,389,TX,Reeves County,8457,8141,316,3.7
CN4839100000000,2022-10-01,48,391,TX,Refugio County,2866,2744,122,4.3
CN4839300000000,2022-10-01,48,393,TX,Roberts County,387,374,13,3.4
CN4839500000000,2022-10-01,48,395,TX,Robertson County,8063,7775,288,3.6
CN4839700000000,2022-10-01,48,397,TX,Rockwall County,59836,57864,1972,3.3
CN4839900000000,2022-10-01,48,399,TX,Runnels County,4579,4426,153,3.3
CN4840100000000,2022-10-01,48,401,TX,Rusk County,22494,21586,908,4
CN4840300000000,2022-10-01,48,403,TX,Sabine County,3831,3591,240,6.3
CN4840500000000,2022-10-01,48,405,TX,San Augustine County,3125,2957,168,5.4
CN4840700000000,2022-10-01,48,407,TX,San Jacinto County,11984,11431,553,4.6
CN4840900000000,2022-10-01,48,409,TX,San Patricio County,29016,27497,1519,5.2
CN4841100000000,2022-10-01,48,411,TX,San Saba County,2194,2119,75,3.4
CN4841300000000,2022-10-01,48,413,TX,Schleicher County,1211,1168,43,3.6
CN4841500000000,2022-10-01,48,415,TX,Scurry County,6275,6035,240,3.8
CN4841700000000,2022-10-01,48,417,TX,Shackelford County,1789,1742,47,2.6
CN4841900000000,2022-10-01,48,419,TX,Shelby County,11039,10606,433,3.9
CN4842100000000,2022-10-01,48,421,TX,Sherman County,1283,1243,40,3.1
CN4842300000000,2022-10-01,48,423,TX,Smith County,111984,107927,4057,3.6
CN4842500000000,2022-10-01,48,425,TX,Somervell County,4619,4444,175,3.8
CN4842700000000,2022-10-01,48,427,TX,Starr County,23729,21626,2103,8.9
CN4842900000000,2022-10-01,48,429,TX,Stephens County,4016,3869,147,3.7
CN4843100000000,2022-10-01,48,431,TX,Sterling County,457,439,18,3.9
CN4843300000000,2022-10-01,48,433,TX,Stonewall County,776,755,21,2.7
CN4843500000000,2022-10-01,48,435,TX,Sutton County,994,940,54,5.4
CN4843700000000,2022-10-01,48,437,TX,Swisher County,2531,2413,118,4.7
CN4843900000000,2022-10-01,48,439,TX,Tarrant County,1151829,1111791,40038,3.5
CN4844100000000,2022-10-01,48,441,TX,Taylor County,68895,66705,2190,3.2
CN4844300000000,2022-10-01,48,443,TX,Terrell County,406,393,13,3.2
CN4844500000000,2022-10-01,48,445,TX,Terry County,4493,4316,177,3.9
CN4844700000000,2022-10-01,48,447,TX,Throckmorton County,687,665,22,3.2
CN4844900000000,2022-10-01,48,449,TX,Titus County,13777,13187,590,4.3
CN4845100000000,2022-10-01,48,451,TX,Tom Green County,55378,53556,1822,3.3
CN4845300000000,2022-10-01,48,453,TX,Travis County,832002,808980,23022,2.8
CN4845500000000,2022-10-01,48,455,TX,Trinity County,5267,5007,260,4.9
CN4845700000000,2022-10-01,48,457,TX,Tyler County,6960,6567,393,5.6
CN4845900000000,2022-10-01,48,459,TX,Upshur County,17848,17142,706,4
CN4846100000000,2022-10-01,48,461,TX,Upton County,2315,2259,56,2.4
CN4846300000000,2022-10-01,48,463,TX,Uvalde County,10949,10463,486,4.4
CN4846500000000,2022-10-01,48,465,TX,Val Verde County,22250,21304,946,4.3
CN4846700000000,2022-10-01,48,467,TX,Van Zandt County,27701,26755,946,3.4
CN4846900000000,2022-10-01,48,469,TX,Victoria County,41382,39750,1632,3.9
CN4847100000000,2022-10-01,48,471,TX,Walker County,24025,22963,1062,4.4
CN4847300000000,2022-10-01,48,473,TX,Waller County,25490,24428,1062,4.2
CN4847500000000,2022-10-01,48,475,TX,Ward County,6287,6085,202,3.2
CN4847700000000,2022-10-01,48,477,TX,Washington County,15020,14440,580,3.9
CN4847900000000,2022-10-01,48,479,TX,Webb County,116995,112695,4300,3.7
CN4848100000000,2022-10-01,48,481,TX,Wharton County,21025,20263,762,3.6
CN4848300000000,2022-10-01,48,483,TX,Wheeler County,1892,1821,71,3.8
CN4848500000000,2022-10-01,48,485,TX,Wichita County,55104,53056,2048,3.7
CN4848700000000,2022-10-01,48,487,TX,Wilbarger County,4669,4451,218,4.7
CN4848900000000,2022-10-01,48,489,TX,Willacy County,7064,6565,499,7.1
CN4849100000000,2022-10-01,48,491,TX,Williamson County,368632,357953,10679,2.9
CN4849300000000,2022-10-01,48,493,TX,Wilson County,26014,25205,809,3.1
CN4849500000000,2022-10-01,48,495,TX,Winkler County,3930,3801,129,3.3
CN4849700000000,2022-10-01,48,497,TX,Wise County,34481,33323,1158,3.4
CN4849900000000,2022-10-01,48,499,TX,Wood County,18371,17578,793,4.3
CN4850100000000,2022-10-01,48,501,TX,Yoakum County,3207,3088,119,3.7
CN4850300000000,2022-10-01,48,503,TX,Young County,7952,7692,260,3.3
CN4850500000000,2022-10-01,48,505,TX,Zapata County,4469,4203,266,6
CN4850700000000,2022-10-01,48,507,TX,Zavala County,3369,3104,265,7.9
CN4900100000000,2022-10-01,49,001,UT,Beaver County,2730,2653,77,2.8
CN4900300000000,2022-10-01,49,003,UT,Box Elder County,27695,27098,597,2.2
CN4900500000000,2022-10-01,49,005,UT,Cache County,72112,70729,1383,1.9
CN4900700000000,2022-10-01,49,007,UT,Carbon County,8399,8127,272,3.2
CN4900900000000,2022-10-01,49,009,UT,Daggett County,402,385,17,4.2
CN4901100000000,2022-10-01,49,011,UT,Davis County,185787,181815,3972,2.1
CN4901300000000,2022-10-01,49,013,UT,Duchesne County,8080,7868,212,2.6
CN4901500000000,2022-10-01,49,015,UT,Emery County,4422,4295,127,2.9
CN4901700000000,2022-10-01,49,017,UT,Garfield County,2974,2885,89,3
CN4901900000000,2022-10-01,49,019,UT,Grand County,7180,7040,140,1.9
CN4902100000000,2022-10-01,49,021,UT,Iron County,28286,27661,625,2.2
CN4902300000000,2022-10-01,49,023,UT,Juab County,6484,6354,130,2
CN4902500000000,2022-10-01,49,025,UT,Kane County,4128,4045,83,2
CN4902700000000,2022-10-01,49,027,UT,Millard County,6035,5903,132,2.2
CN4902900000000,2022-10-01,49,029,UT,Morgan County,5989,5871,118,2
CN4903100000000,2022-10-01,49,031,UT,Piute County,512,492,20,3.9
CN4903300000000,2022-10-01,49,033,UT,Rich County,1138,1110,28,2.5
CN4903500000000,2022-10-01,49,035,UT,Salt Lake County,685796,670696,15100,2.2
CN4903700000000,2022-10-01,49,037,UT,San Juan County,5617,5425,192,3.4
CN4903900000000,2022-10-01,49,039,UT,Sanpete County,13713,13353,360,2.6
CN4904100000000,2022-10-01,49,041,UT,Sevier County,10208,9946,262,2.6
CN4904300000000,2022-10-01,49,043,UT,Summit County,25137,24550,587,2.3
CN4904500000000,2022-10-01,49,045,UT,Tooele County,38681,37715,966,2.5
CN4904700000000,2022-10-01,49,047,UT,Uintah County,14202,13762,440,3.1
CN4904900000000,2022-10-01,49,049,UT,Utah County,348856,341484,7372,2.1
CN4905100000000,2022-10-01,49,051,UT,Wasatch County,17653,17257,396,2.2
CN4905300000000,2022-10-01,49,053,UT,Washington County,88246,86213,2033,2.3
CN4905500000000,2022-10-01,49,055,UT,Wayne County,1495,1451,44,2.9
CN4905700000000,2022-10-01,49,057,UT,Weber County,136019,132899,3120,2.3
CN5000100000000,2022-10-01,50,001,VT,Addison County,20866,20424,442,2.1
CN5000300000000,2022-10-01,50,003,VT,Bennington County,17546,17075,471,2.7
CN5000500000000,2022-10-01,50,005,VT,Caledonia County,14662,14279,383,2.6
CN5000700000000,2022-10-01,50,007,VT,Chittenden County,98080,96088,1992,2
CN5000900000000,2022-10-01,50,009,VT,Essex County,2667,2571,96,3.6
CN5001100000000,2022-10-01,50,011,VT,Franklin County,27983,27359,624,2.2
CN5001300000000,2022-10-01,50,013,VT,Grand Isle County,4125,4031,94,2.3
CN5001500000000,2022-10-01,50,015,VT,Lamoille County,14020,13636,384,2.7
CN5001700000000,2022-10-01,50,017,VT,Orange County,15717,15372,345,2.2
CN5001900000000,2022-10-01,50,019,VT,Orleans County,13287,12845,442,3.3
CN5002100000000,2022-10-01,50,021,VT,Rutland County,29503,28649,854,2.9
CN5002300000000,2022-10-01,50,023,VT,Washington County,33702,32966,736,2.2
CN5002500000000,2022-10-01,50,025,VT,Windham County,21176,20639,537,2.5
CN5002700000000,2022-10-01,50,027,VT,Windsor County,28628,28024,604,2.1
CN5100100000000,2022-10-01,51,001,VA,Accomack County,16008,15529,479,3
CN5100300000000,2022-10-01,51,003,VA,Albemarle County,59278,57618,1660,2.8
CN5100500000000,2022-10-01,51,005,VA,Alleghany County,6808,6603,205,3
CN5100700000000,2022-10-01,51,007,VA,Amelia County,6358,6177,181,2.8
CN5100900000000,2022-10-01,51,009,VA,Amherst County,14943,14460,483,3.2
CN5101100000000,2022-10-01,51,011,VA,Appomattox County,7198,6963,235,3.3
CN5101300000000,2022-10-01,51,013,VA,Arlington County,158030,154707,3323,2.1
CN5101500000000,2022-10-01,51,015,VA,Augusta County,38775,37767,1008,2.6
CN5101700000000,2022-10-01,51,017,VA,Bath County,2615,2557,58,2.2
CN5101900000000,2022-10-01,51,019,VA,Bedford County,38744,37625,1119,2.9
CN5102100000000,2022-10-01,51,021,VA,Bland County,2858,2780,78,2.7
CN5102300000000,2022-10-01,51,023,VA,Botetourt County,17779,17308,471,2.6
CN5102500000000,2022-10-01,51,025,VA,Brunswick County,5943,5675,268,4.5
CN5102700000000,2022-10-01,51,027,VA,Buchanan County,6410,6108,302,4.7
CN5102900000000,2022-10-01,51,029,VA,Buckingham County,6562,6315,247,3.8
CN5103100000000,2022-10-01,51,031,VA,Campbell County,25962,25153,809,3.1
CN5103300000000,2022-10-01,51,033,VA,Caroline County,15507,15004,503,3.2
CN5103500000000,2022-10-01,51,035,VA,Carroll County,13130,12677,453,3.5
CN5103600000000,2022-10-01,51,036,VA,Charles City County,3648,3531,117,3.2
CN5103700000000,2022-10-01,51,037,VA,Charlotte County,5645,5472,173,3.1
CN5104100000000,2022-10-01,51,041,VA,Chesterfield County,195540,189811,5729,2.9
CN5104300000000,2022-10-01,51,043,VA,Clarke County,7768,7571,197,2.5
CN5104500000000,2022-10-01,51,045,VA,Craig County,2332,2256,76,3.3
CN5104700000000,2022-10-01,51,047,VA,Culpeper County,25814,25084,730,2.8
CN5104900000000,2022-10-01,51,049,VA,Cumberland County,4860,4707,153,3.1
CN5105100000000,2022-10-01,51,051,VA,Dickenson County,4609,4406,203,4.4
CN5105300000000,2022-10-01,51,053,VA,Dinwiddie County,13945,13486,459,3.3
CN5105700000000,2022-10-01,51,057,VA,Essex County,5604,5409,195,3.5
CN5105900000000,2022-10-01,51,059,VA,Fairfax County,643974,627614,16360,2.5
CN5106100000000,2022-10-01,51,061,VA,Fauquier County,38207,37193,1014,2.7
CN5106300000000,2022-10-01,51,063,VA,Floyd County,8704,8493,211,2.4
CN5106500000000,2022-10-01,51,065,VA,Fluvanna County,14468,14100,368,2.5
CN5106700000000,2022-10-01,51,067,VA,Franklin County,26701,25878,823,3.1
CN5106900000000,2022-10-01,51,069,VA,Frederick County,52079,50757,1322,2.5
CN5107100000000,2022-10-01,51,071,VA,Giles County,8303,8046,257,3.1
CN5107300000000,2022-10-01,51,073,VA,Gloucester County,19569,19016,553,2.8
CN5107500000000,2022-10-01,51,075,VA,Goochland County,11968,11630,338,2.8
CN5107700000000,2022-10-01,51,077,VA,Grayson County,8307,8092,215,2.6
CN5107900000000,2022-10-01,51,079,VA,Greene County,10851,10583,268,2.5
CN5108100000000,2022-10-01,51,081,VA,Greensville County,4380,4205,175,4
CN5108300000000,2022-10-01,51,083,VA,Halifax County,15581,14963,618,4
CN5108500000000,2022-10-01,51,085,VA,Hanover County,60691,59126,1565,2.6
CN5108700000000,2022-10-01,51,087,VA,Henrico County,186985,181606,5379,2.9
CN5108900000000,2022-10-01,51,089,VA,Henry County,24114,23285,829,3.4
CN5109100000000,2022-10-01,51,091,VA,Highland County,1512,1480,32,2.1
CN5109300000000,2022-10-01,51,093,VA,Isle of Wight County,19746,19185,561,2.8
CN5109500000000,2022-10-01,51,095,VA,James City County,37027,35935,1092,2.9
CN5109700000000,2022-10-01,51,097,VA,King and Queen County,4009,3904,105,2.6
CN5109900000000,2022-10-01,51,099,VA,King George County,14395,14009,386,2.7
CN5110100000000,2022-10-01,51,101,VA,King William County,9677,9411,266,2.7
CN5110300000000,2022-10-01,51,103,VA,Lancaster County,5518,5345,173,3.1
CN5110500000000,2022-10-01,51,105,VA,Lee County,8276,7940,336,4.1
CN5110700000000,2022-10-01,51,107,VA,Loudoun County,234229,228413,5816,2.5
CN5110900000000,2022-10-01,51,109,VA,Louisa County,21211,20658,553,2.6
CN5111100000000,2022-10-01,51,111,VA,Lunenburg County,5283,5082,201,3.8
CN5111300000000,2022-10-01,51,113,VA,Madison County,7746,7569,177,2.3
CN5111500000000,2022-10-01,51,115,VA,Mathews County,4102,3979,123,3
CN5111700000000,2022-10-01,51,117,VA,Mecklenburg County,13394,12929,465,3.5
CN5111900000000,2022-10-01,51,119,VA,Middlesex County,5447,5300,147,2.7
CN5112100000000,2022-10-01,51,121,VA,Montgomery County,53190,51611,1579,3
CN5112500000000,2022-10-01,51,125,VA,Nelson County,7537,7334,203,2.7
CN5112700000000,2022-10-01,51,127,VA,New Kent County,13377,13039,338,2.5
CN5113100000000,2022-10-01,51,131,VA,Northampton County,5739,5546,193,3.4
CN5113300000000,2022-10-01,51,133,VA,Northumberland County,5683,5486,197,3.5
CN5113500000000,2022-10-01,51,135,VA,Nottoway County,7297,7062,235,3.2
CN5113700000000,2022-10-01,51,137,VA,Orange County,17697,17170,527,3
CN5113900000000,2022-10-01,51,139,VA,Page County,12439,12055,384,3.1
CN5114100000000,2022-10-01,51,141,VA,Patrick County,7252,7003,249,3.4
CN5114300000000,2022-10-01,51,143,VA,Pittsylvania County,30454,29504,950,3.1
CN5114500000000,2022-10-01,51,145,VA,Powhatan County,14820,14428,392,2.6
CN5114700000000,2022-10-01,51,147,VA,Prince Edward County,10198,9798,400,3.9
CN5114900000000,2022-10-01,51,149,VA,Prince George County,15546,15001,545,3.5
CN5115300000000,2022-10-01,51,153,VA,Prince William County,252899,245804,7095,2.8
CN5115500000000,2022-10-01,51,155,VA,Pulaski County,16971,16476,495,2.9
CN5115700000000,2022-10-01,51,157,VA,Rappahannock County,3760,3667,93,2.5
CN5115900000000,2022-10-01,51,159,VA,Richmond County,4030,3921,109,2.7
CN5116100000000,2022-10-01,51,161,VA,Roanoke County,50071,48741,1330,2.7
CN5116300000000,2022-10-01,51,163,VA,Rockbridge County,11205,10893,312,2.8
CN5116500000000,2022-10-01,51,165,VA,Rockingham County,43715,42574,1141,2.6
CN5116700000000,2022-10-01,51,167,VA,Russell County,11009,10629,380,3.5
CN5116900000000,2022-10-01,51,169,VA,Scott County,9343,9031,312,3.3
CN5117100000000,2022-10-01,51,171,VA,Shenandoah County,22347,21677,670,3
CN5117300000000,2022-10-01,51,173,VA,Smyth County,13506,13080,426,3.2
CN5117500000000,2022-10-01,51,175,VA,Southampton County,9000,8745,255,2.8
CN5117700000000,2022-10-01,51,177,VA,Spotsylvania County,70051,67894,2157,3.1
CN5117900000000,2022-10-01,51,179,VA,Stafford County,76281,74000,2281,3
CN5118100000000,2022-10-01,51,181,VA,Surry County,3681,3580,101,2.7
CN5118300000000,2022-10-01,51,183,VA,Sussex County,3761,3608,153,4.1
CN5118500000000,2022-10-01,51,185,VA,Tazewell County,15520,14872,648,4.2
CN5118700000000,2022-10-01,51,187,VA,Warren County,20937,20327,610,2.9
CN5119100000000,2022-10-01,51,191,VA,Washington County,26710,25935,775,2.9
CN5119300000000,2022-10-01,51,193,VA,Westmoreland County,9682,9382,300,3.1
CN5119500000000,2022-10-01,51,195,VA,Wise County,12929,12386,543,4.2
CN5119700000000,2022-10-01,51,197,VA,Wythe County,14330,13901,429,3
CN5119900000000,2022-10-01,51,199,VA,York County,33236,32266,970,2.9
CN5151000000000,2022-10-01,51,510,VA,Alexandria city,101501,99125,2376,2.3
CN5152000000000,2022-10-01,51,520,VA,Bristol city,7674,7402,272,3.5
CN5153000000000,2022-10-01,51,530,VA,Buena Vista city,3197,3100,97,3
CN5154000000000,2022-10-01,51,540,VA,Charlottesville city,26171,25497,674,2.6
CN5155000000000,2022-10-01,51,550,VA,Chesapeake city,124097,120303,3794,3.1
CN5157000000000,2022-10-01,51,570,VA,Colonial Heights city,8608,8328,280,3.3
CN5158000000000,2022-10-01,51,580,VA,Covington city,2345,2246,99,4.2
CN5159000000000,2022-10-01,51,590,VA,Danville city,18726,17899,827,4.4
CN5159500000000,2022-10-01,51,595,VA,Emporia city,2340,2241,99,4.2
CN5160000000000,2022-10-01,51,600,VA,Fairfax city,13032,12690,342,2.6
CN5161000000000,2022-10-01,51,610,VA,Falls Church city,8641,8434,207,2.4
CN5162000000000,2022-10-01,51,620,VA,Franklin city,3472,3329,143,4.1
CN5163000000000,2022-10-01,51,630,VA,Fredericksburg city,14488,13983,505,3.5
CN5164000000000,2022-10-01,51,640,VA,Galax city,2883,2796,87,3
CN5165000000000,2022-10-01,51,650,VA,Hampton city,64491,61940,2551,4
CN5166000000000,2022-10-01,51,660,VA,Harrisonburg city,25358,24410,948,3.7
CN5167000000000,2022-10-01,51,670,VA,Hopewell city,9712,9288,424,4.4
CN5167800000000,2022-10-01,51,678,VA,Lexington city,2351,2248,103,4.4
CN5168000000000,2022-10-01,51,680,VA,Lynchburg city,35960,34479,1481,4.1
CN5168300000000,2022-10-01,51,683,VA,Manassas city,21902,21327,575,2.6
CN5168500000000,2022-10-01,51,685,VA,Manassas Park city,9874,9621,253,2.6
CN5169000000000,2022-10-01,51,690,VA,Martinsville city,5626,5362,264,4.7
CN5170000000000,2022-10-01,51,700,VA,Newport News city,88402,85193,3209,3.6
CN5171000000000,2022-10-01,51,710,VA,Norfolk city,110218,106263,3955,3.6
CN5172000000000,2022-10-01,51,720,VA,Norton city,1606,1550,56,3.5
CN5173000000000,2022-10-01,51,730,VA,Petersburg city,12690,12010,680,5.4
CN5173500000000,2022-10-01,51,735,VA,Poquoson city,6393,6230,163,2.5
CN5174000000000,2022-10-01,51,740,VA,Portsmouth city,44070,42388,1682,3.8
CN5175000000000,2022-10-01,51,750,VA,Radford city,9204,8850,354,3.8
CN5176000000000,2022-10-01,51,760,VA,Richmond city,121848,117643,4205,3.5
CN5177000000000,2022-10-01,51,770,VA,Roanoke city,49198,47645,1553,3.2
CN5177500000000,2022-10-01,51,775,VA,Salem city,12957,12561,396,3.1
CN5179000000000,2022-10-01,51,790,VA,Staunton city,12571,12229,342,2.7
CN5180000000000,2022-10-01,51,800,VA,Suffolk city,45616,44198,1418,3.1
CN5181000000000,2022-10-01,51,810,VA,Virginia Beach city,232253,225455,6798,2.9
CN5182000000000,2022-10-01,51,820,VA,Waynesboro city,10922,10596,326,3
CN5183000000000,2022-10-01,51,830,VA,Williamsburg city,6846,6534,312,4.6
CN5184000000000,2022-10-01,51,840,VA,Winchester city,15290,14859,431,2.8
CN5300100000000,2022-10-01,53,001,WA,Adams County,10469,10065,404,3.9
CN5300300000000,2022-10-01,53,003,WA,Asotin County,10736,10327,409,3.8
CN5300500000000,2022-10-01,53,005,WA,Benton County,107914,102933,4981,4.6
CN5300700000000,2022-10-01,53,007,WA,Chelan County,45374,43536,1838,4.1
CN5300900000000,2022-10-01,53,009,WA,Clallam County,29360,27671,1689,5.8
CN5301100000000,2022-10-01,53,011,WA,Clark County,252192,240684,11508,4.6
CN5301300000000,2022-10-01,53,013,WA,Columbia County,1790,1704,86,4.8
CN5301500000000,2022-10-01,53,015,WA,Cowlitz County,49516,46719,2797,5.6
CN5301700000000,2022-10-01,53,017,WA,Douglas County,22345,21339,1006,4.5
CN5301900000000,2022-10-01,53,019,WA,Ferry County,2170,1978,192,8.8
CN5302100000000,2022-10-01,53,021,WA,Franklin County,44557,42244,2313,5.2
CN5302300000000,2022-10-01,53,023,WA,Garfield County,803,752,51,6.4
CN5302500000000,2022-10-01,53,025,WA,Grant County,50386,47887,2499,5
CN5302700000000,2022-10-01,53,027,WA,Grays Harbor County,29515,27539,1976,6.7
CN5302900000000,2022-10-01,53,029,WA,Island County,37425,35576,1849,4.9
CN5303100000000,2022-10-01,53,031,WA,Jefferson County,12995,12308,687,5.3
CN5303300000000,2022-10-01,53,033,WA,King County,1328647,1284661,43986,3.3
CN5303500000000,2022-10-01,53,035,WA,Kitsap County,130486,124676,5810,4.5
CN5303700000000,2022-10-01,53,037,WA,Kittitas County,23120,21934,1186,5.1
CN5303900000000,2022-10-01,53,039,WA,Klickitat County,9867,9345,522,5.3
CN5304100000000,2022-10-01,53,041,WA,Lewis County,35258,33213,2045,5.8
CN5304300000000,2022-10-01,53,043,WA,Lincoln County,4763,4532,231,4.8
CN5304500000000,2022-10-01,53,045,WA,Mason County,25806,24223,1583,6.1
CN5304700000000,2022-10-01,53,047,WA,Okanogan County,19872,18843,1029,5.2
CN5304900000000,2022-10-01,53,049,WA,Pacific County,9063,8356,707,7.8
CN5305100000000,2022-10-01,53,051,WA,Pend Oreille County,5198,4874,324,6.2
CN5305300000000,2022-10-01,53,053,WA,Pierce County,457903,435148,22755,5
CN5305500000000,2022-10-01,53,055,WA,San Juan County,9273,8945,328,3.5
CN5305700000000,2022-10-01,53,057,WA,Skagit County,62175,59134,3041,4.9
CN5305900000000,2022-10-01,53,059,WA,Skamania County,5632,5352,280,5
CN5306100000000,2022-10-01,53,061,WA,Snohomish County,452686,436331,16355,3.6
CN5306300000000,2022-10-01,53,063,WA,Spokane County,265326,253467,11859,4.5
CN5306500000000,2022-10-01,53,065,WA,Stevens County,19322,18194,1128,5.8
CN5306700000000,2022-10-01,53,067,WA,Thurston County,150787,143932,6855,4.5
CN5306900000000,2022-10-01,53,069,WA,Wahkiakum County,1446,1349,97,6.7
CN5307100000000,2022-10-01,53,071,WA,Walla Walla County,31788,30489,1299,4.1
CN5307300000000,2022-10-01,53,073,WA,Whatcom County,116078,110594,5484,4.7
CN5307500000000,2022-10-01,53,075,WA,Whitman County,24066,23026,1040,4.3
CN5307700000000,2022-10-01,53,077,WA,Yakima County,136645,129431,7214,5.3
CN5400100000000,2022-10-01,54,001,WV,Barbour County,7483,7179,304,4.1
CN5400300000000,2022-10-01,54,003,WV,Berkeley County,60235,58548,1687,2.8
CN5400500000000,2022-10-01,54,005,WV,Boone County,7025,6741,284,4
CN5400700000000,2022-10-01,54,007,WV,Braxton County,5004,4768,236,4.7
CN5400900000000,2022-10-01,54,009,WV,Brooke County,9894,9498,396,4
CN5401100000000,2022-10-01,54,011,WV,Cabell County,41787,40457,1330,3.2
CN5401300000000,2022-10-01,54,013,WV,Calhoun County,2447,2293,154,6.3
CN5401500000000,2022-10-01,54,015,WV,Clay County,2931,2794,137,4.7
CN5401700000000,2022-10-01,54,017,WV,Doddridge County,3937,3833,104,2.6
CN5401900000000,2022-10-01,54,019,WV,Fayette County,15807,15201,606,3.8
CN5402100000000,2022-10-01,54,021,WV,Gilmer County,2390,2294,96,4
CN5402300000000,2022-10-01,54,023,WV,Grant County,6006,5832,174,2.9
CN5402500000000,2022-10-01,54,025,WV,Greenbrier County,15452,14920,532,3.4
CN5402700000000,2022-10-01,54,027,WV,Hampshire County,11470,11191,279,2.4
CN5402900000000,2022-10-01,54,029,WV,Hancock County,13042,12466,576,4.4
CN5403100000000,2022-10-01,54,031,WV,Hardy County,5795,5595,200,3.5
CN5403300000000,2022-10-01,54,033,WV,Harrison County,33594,32574,1020,3
CN5403500000000,2022-10-01,54,035,WV,Jackson County,11682,11270,412,3.5
CN5403700000000,2022-10-01,54,037,WV,Jefferson County,30974,30244,730,2.4
CN5403900000000,2022-10-01,54,039,WV,Kanawha County,79277,76666,2611,3.3
CN5404100000000,2022-10-01,54,041,WV,Lewis County,6469,6212,257,4
CN5404300000000,2022-10-01,54,043,WV,Lincoln County,7075,6775,300,4.2
CN5404500000000,2022-10-01,54,045,WV,Logan County,11141,10704,437,3.9
CN5404700000000,2022-10-01,54,047,WV,McDowell County,4098,3869,229,5.6
CN5404900000000,2022-10-01,54,049,WV,Marion County,25469,24526,943,3.7
CN5405100000000,2022-10-01,54,051,WV,Marshall County,12976,12457,519,4
CN5405300000000,2022-10-01,54,053,WV,Mason County,10587,10204,383,3.6
CN5405500000000,2022-10-01,54,055,WV,Mercer County,20800,19986,814,3.9
CN5405700000000,2022-10-01,54,057,WV,Mineral County,12709,12302,407,3.2
CN5405900000000,2022-10-01,54,059,WV,Mingo County,6528,6214,314,4.8
CN5406100000000,2022-10-01,54,061,WV,Monongalia County,56114,54502,1612,2.9
CN5406300000000,2022-10-01,54,063,WV,Monroe County,6320,6160,160,2.5
CN5406500000000,2022-10-01,54,065,WV,Morgan County,8586,8367,219,2.6
CN5406700000000,2022-10-01,54,067,WV,Nicholas County,8902,8545,357,4
CN5406900000000,2022-10-01,54,069,WV,Ohio County,19845,19171,674,3.4
CN5407100000000,2022-10-01,54,071,WV,Pendleton County,3865,3784,81,2.1
CN5407300000000,2022-10-01,54,073,WV,Pleasants County,2693,2573,120,4.5
CN5407500000000,2022-10-01,54,075,WV,Pocahontas County,3703,3579,124,3.3
CN5407700000000,2022-10-01,54,077,WV,Preston County,15822,15276,546,3.5
CN5407900000000,2022-10-01,54,079,WV,Putnam County,27164,26418,746,2.7
CN5408100000000,2022-10-01,54,081,WV,Raleigh County,29901,28905,996,3.3
CN5408300000000,2022-10-01,54,083,WV,Randolph County,11940,11460,480,4
CN5408500000000,2022-10-01,54,085,WV,Ritchie County,4232,4078,154,3.6
CN5408700000000,2022-10-01,54,087,WV,Roane County,4812,4589,223,4.6
CN5408900000000,2022-10-01,54,089,WV,Summers County,4707,4573,134,2.8
CN5409100000000,2022-10-01,54,091,WV,Taylor County,7906,7670,236,3
CN5409300000000,2022-10-01,54,093,WV,Tucker County,3415,3299,116,3.4
CN5409500000000,2022-10-01,54,095,WV,Tyler County,2918,2787,131,4.5
CN5409700000000,2022-10-01,54,097,WV,Upshur County,9740,9344,396,4.1
CN5409900000000,2022-10-01,54,099,WV,Wayne County,15658,15136,522,3.3
CN5410100000000,2022-10-01,54,101,WV,Webster County,3118,2998,120,3.8
CN5410300000000,2022-10-01,54,103,WV,Wetzel County,6416,6135,281,4.4
CN5410500000000,2022-10-01,54,105,WV,Wirt County,2266,2159,107,4.7
CN5410700000000,2022-10-01,54,107,WV,Wood County,36622,35346,1276,3.5
CN5410900000000,2022-10-01,54,109,WV,Wyoming County,7239,6969,270,3.7
CN5500100000000,2022-10-01,55,001,WI,Adams County,7516,7228,288,3.8
CN5500300000000,2022-10-01,55,003,WI,Ashland County,7369,7146,223,3
CN5500500000000,2022-10-01,55,005,WI,Barron County,23167,22577,590,2.5
CN5500700000000,2022-10-01,55,007,WI,Bayfield County,7163,6921,242,3.4
CN5500900000000,2022-10-01,55,009,WI,Brown County,142449,139077,3372,2.4
CN5501100000000,2022-10-01,55,011,WI,Buffalo County,5907,5736,171,2.9
CN5501300000000,2022-10-01,55,013,WI,Burnett County,6957,6723,234,3.4
CN5501500000000,2022-10-01,55,015,WI,Calumet County,27374,26809,565,2.1
CN5501700000000,2022-10-01,55,017,WI,Chippewa County,33224,32390,834,2.5
CN5501900000000,2022-10-01,55,019,WI,Clark County,16857,16496,361,2.1
CN5502100000000,2022-10-01,55,021,WI,Columbia County,31645,30919,726,2.3
CN5502300000000,2022-10-01,55,023,WI,Crawford County,6711,6509,202,3
CN5502500000000,2022-10-01,55,025,WI,Dane County,331700,324916,6784,2
CN5502700000000,2022-10-01,55,027,WI,Dodge County,47111,46039,1072,2.3
CN5502900000000,2022-10-01,55,029,WI,Door County,15185,14845,340,2.2
CN5503100000000,2022-10-01,55,031,WI,Douglas County,22939,22205,734,3.2
CN5503300000000,2022-10-01,55,033,WI,Dunn County,24211,23608,603,2.5
CN5503500000000,2022-10-01,55,035,WI,Eau Claire County,59804,58519,1285,2.1
CN5503700000000,2022-10-01,55,037,WI,Florence County,2095,2030,65,3.1
CN5503900000000,2022-10-01,55,039,WI,Fond du Lac County,55876,54618,1258,2.3
CN5504100000000,2022-10-01,55,041,WI,Forest County,3751,3603,148,3.9
CN5504300000000,2022-10-01,55,043,WI,Grant County,26855,26127,728,2.7
CN5504500000000,2022-10-01,55,045,WI,Green County,20526,20076,450,2.2
CN5504700000000,2022-10-01,55,047,WI,Green Lake County,8978,8721,257,2.9
CN5504900000000,2022-10-01,55,049,WI,Iowa County,13234,12965,269,2
CN5505100000000,2022-10-01,55,051,WI,Iron County,2466,2364,102,4.1
CN5505300000000,2022-10-01,55,053,WI,Jackson County,9111,8834,277,3
CN5505500000000,2022-10-01,55,055,WI,Jefferson County,45726,44648,1078,2.4
CN5505700000000,2022-10-01,55,057,WI,Juneau County,13214,12868,346,2.6
CN5505900000000,2022-10-01,55,059,WI,Kenosha County,90556,87878,2678,3
CN5506100000000,2022-10-01,55,061,WI,Kewaunee County,10606,10370,236,2.2
CN5506300000000,2022-10-01,55,063,WI,La Crosse County,67060,65598,1462,2.2
CN5506500000000,2022-10-01,55,065,WI,Lafayette County,9729,9477,252,2.6
CN5506700000000,2022-10-01,55,067,WI,Langlade County,8934,8655,279,3.1
CN5506900000000,2022-10-01,55,069,WI,Lincoln County,14592,14260,332,2.3
CN5507100000000,2022-10-01,55,071,WI,Manitowoc County,40001,39000,1001,2.5
CN5507300000000,2022-10-01,55,073,WI,Marathon County,72057,70501,1556,2.2
CN5507500000000,2022-10-01,55,075,WI,Marinette County,18570,17967,603,3.2
CN5507700000000,2022-10-01,55,077,WI,Marquette County,7493,7287,206,2.7
CN5507800000000,2022-10-01,55,078,WI,Menominee County,1455,1386,69,4.7
CN5507900000000,2022-10-01,55,079,WI,Milwaukee County,460299,444478,15821,3.4
CN5508100000000,2022-10-01,55,081,WI,Monroe County,22660,22157,503,2.2
CN5508300000000,2022-10-01,55,083,WI,Oconto County,20440,19904,536,2.6
CN5508500000000,2022-10-01,55,085,WI,Oneida County,17392,16960,432,2.5
CN5508700000000,2022-10-01,55,087,WI,Outagamie County,104395,102138,2257,2.2
CN5508900000000,2022-10-01,55,089,WI,Ozaukee County,48705,47537,1168,2.4
CN5509100000000,2022-10-01,55,091,WI,Pepin County,3928,3832,96,2.4
CN5509300000000,2022-10-01,55,093,WI,Pierce County,24245,23592,653,2.7
CN5509500000000,2022-10-01,55,095,WI,Polk County,23854,23207,647,2.7
CN5509700000000,2022-10-01,55,097,WI,Portage County,37913,36991,922,2.4
CN5509900000000,2022-10-01,55,099,WI,Price County,6055,5876,179,3
CN5510100000000,2022-10-01,55,101,WI,Racine County,97813,94824,2989,3.1
CN5510300000000,2022-10-01,55,103,WI,Richland County,8568,8351,217,2.5
CN5510500000000,2022-10-01,55,105,WI,Rock County,85692,83058,2634,3.1
CN5510700000000,2022-10-01,55,107,WI,Rusk County,6226,6042,184,3
CN5510900000000,2022-10-01,55,109,WI,St. Croix County,49533,48261,1272,2.6
CN5511100000000,2022-10-01,55,111,WI,Sauk County,33481,32691,790,2.4
CN5511300000000,2022-10-01,55,113,WI,Sawyer County,7697,7478,219,2.8
CN5511500000000,2022-10-01,55,115,WI,Shawano County,19804,19310,494,2.5
CN5511700000000,2022-10-01,55,117,WI,Sheboygan County,61213,59807,1406,2.3
CN5511900000000,2022-10-01,55,119,WI,Taylor County,10078,9836,242,2.4
CN5512100000000,2022-10-01,55,121,WI,Trempealeau County,14354,14018,336,2.3
CN5512300000000,2022-10-01,55,123,WI,Vernon County,14805,14471,334,2.3
CN5512500000000,2022-10-01,55,125,WI,Vilas County,9800,9498,302,3.1
CN5512700000000,2022-10-01,55,127,WI,Walworth County,57871,56394,1477,2.6
CN5512900000000,2022-10-01,55,129,WI,Washburn County,7422,7220,202,2.7
CN5513100000000,2022-10-01,55,131,WI,Washington County,76353,74618,1735,2.3
CN5513300000000,2022-10-01,55,133,WI,Waukesha County,223789,218561,5228,2.3
CN5513500000000,2022-10-01,55,135,WI,Waupaca County,24407,23779,628,2.6
CN5513700000000,2022-10-01,55,137,WI,Waushara County,10731,10420,311,2.9
CN5513900000000,2022-10-01,55,139,WI,Winnebago County,92762,90614,2148,2.3
CN5514100000000,2022-10-01,55,141,WI,Wood County,32851,31898,953,2.9
CN5600100000000,2022-10-01,56,001,WY,Albany County,21767,21110,657,3
CN5600300000000,2022-10-01,56,003,WY,Big Horn County,5184,4991,193,3.7
CN5600500000000,2022-10-01,56,005,WY,Campbell County,22922,22163,759,3.3
CN5600700000000,2022-10-01,56,007,WY,Carbon County,7387,7109,278,3.8
CN5600900000000,2022-10-01,56,009,WY,Converse County,7726,7517,209,2.7
CN5601100000000,2022-10-01,56,011,WY,Crook County,3953,3844,109,2.8
CN5601300000000,2022-10-01,56,013,WY,Fremont County,19022,18305,717,3.8
CN5601500000000,2022-10-01,56,015,WY,Goshen County,6554,6359,195,3
CN5601700000000,2022-10-01,56,017,WY,Hot Springs County,2289,2222,67,2.9
CN5601900000000,2022-10-01,56,019,WY,Johnson County,4310,4175,135,3.1
CN5602100000000,2022-10-01,56,021,WY,Laramie County,49143,47431,1712,3.5
CN5602300000000,2022-10-01,56,023,WY,Lincoln County,9653,9351,302,3.1
CN5602500000000,2022-10-01,56,025,WY,Natrona County,39532,38065,1467,3.7
CN5602700000000,2022-10-01,56,027,WY,Niobrara County,1222,1188,34,2.8
CN5602900000000,2022-10-01,56,029,WY,Park County,15521,15011,510,3.3
CN5603100000000,2022-10-01,56,031,WY,Platte County,4406,4254,152,3.4
CN5603300000000,2022-10-01,56,033,WY,Sheridan County,16294,15772,522,3.2
CN5603500000000,2022-10-01,56,035,WY,Sublette County,3950,3800,150,3.8
CN5603700000000,2022-10-01,56,037,WY,Sweetwater County,19790,19002,788,4
CN5603900000000,2022-10-01,56,039,WY,Teton County,16615,16156,459,2.8
CN5604100000000,2022-10-01,56,041,WY,Uinta County,9021,8702,319,3.5
CN5604300000000,2022-10-01,56,043,WY,Washakie County,3878,3735,143,3.7
CN5604500000000,2022-10-01,56,045,WY,Weston County,3829,3739,90,2.4
CN7200100000000,2022-10-01,72,001,PR,Adjuntas Municipio,4490,4131,359,8
CN7200300000000,2022-10-01,72,003,PR,Aguada Municipio,13310,12334,976,7.3
CN7200500000000,2022-10-01,72,005,PR,Aguadilla Municipio,16228,14884,1344,8.3
CN7200700000000,2022-10-01,72,007,PR,Aguas Buenas Municipio,7015,6569,446,6.4
CN7200900000000,2022-10-01,72,009,PR,Aibonito Municipio,6836,6344,492,7.2
CN7201100000000,2022-10-01,72,011,PR,Anasco Municipio,10051,9379,672,6.7
CN7201300000000,2022-10-01,72,013,PR,Arecibo Municipio,25907,24116,1791,6.9
CN7201500000000,2022-10-01,72,015,PR,Arroyo Municipio,4882,4474,408,8.4
CN7201700000000,2022-10-01,72,017,PR,Barceloneta Municipio,6323,5791,532,8.4
CN7201900000000,2022-10-01,72,019,PR,Barranquitas Municipio,7812,7252,560,7.2
CN7202100000000,2022-10-01,72,021,PR,Bayamon Municipio,69376,65795,3581,5.2
CN7202300000000,2022-10-01,72,023,PR,Cabo Rojo Municipio,15195,14024,1171,7.7
CN7202500000000,2022-10-01,72,025,PR,Caguas Municipio,51135,48451,2684,5.2
CN7202700000000,2022-10-01,72,027,PR,Camuy Municipio,10527,9746,781,7.4
CN7202900000000,2022-10-01,72,029,PR,Canovanas Municipio,17446,16558,888,5.1
CN7203100000000,2022-10-01,72,031,PR,Carolina Municipio,65480,62264,3216,4.9
CN7203300000000,2022-10-01,72,033,PR,Catano Municipio,8301,7836,465,5.6
CN7203500000000,2022-10-01,72,035,PR,Cayey Municipio,17352,16395,957,5.5
CN7203700000000,2022-10-01,72,037,PR,Ceiba Municipio,3842,3559,283,7.4
CN7203900000000,2022-10-01,72,039,PR,Ciales Municipio,3926,3594,332,8.5
CN7204100000000,2022-10-01,72,041,PR,Cidra Municipio,16529,15700,829,5
CN7204300000000,2022-10-01,72,043,PR,Coamo Municipio,11167,10253,914,8.2
CN7204500000000,2022-10-01,72,045,PR,Comerio Municipio,5276,4896,380,7.2
CN7204700000000,2022-10-01,72,047,PR,Corozal Municipio,9471,8751,720,7.6
CN7204900000000,2022-10-01,72,049,PR,Culebra Municipio,929,910,19,2
CN7205100000000,2022-10-01,72,051,PR,Dorado Municipio,14488,13814,674,4.7
CN7205300000000,2022-10-01,72,053,PR,Fajardo Municipio,11268,10480,788,7
CN7205400000000,2022-10-01,72,054,PR,Florida Municipio,3489,3204,285,8.2
CN7205500000000,2022-10-01,72,055,PR,Guanica Municipio,4070,3678,392,9.6
CN7205700000000,2022-10-01,72,057,PR,Guayama Municipio,11593,10705,888,7.7
CN7205900000000,2022-10-01,72,059,PR,Guayanilla Municipio,5205,4602,603,11.6
CN7206100000000,2022-10-01,72,061,PR,Guaynabo Municipio,40705,39309,1396,3.4
CN7206300000000,2022-10-01,72,063,PR,Gurabo Municipio,20190,19269,921,4.6
CN7206500000000,2022-10-01,72,065,PR,Hatillo Municipio,15118,13624,1494,9.9
CN7206700000000,2022-10-01,72,067,PR,Hormigueros Municipio,6041,5649,392,6.5
CN7206900000000,2022-10-01,72,069,PR,Humacao Municipio,18777,17566,1211,6.4
CN7207100000000,2022-10-01,72,071,PR,Isabela Municipio,13330,12349,981,7.4
CN7207300000000,2022-10-01,72,073,PR,Jayuya Municipio,4575,4112,463,10.1
CN7207500000000,2022-10-01,72,075,PR,Juana Diaz Municipio,16927,15557,1370,8.1
CN7207700000000,2022-10-01,72,077,PR,Juncos Municipio,13415,12446,969,7.2
CN7207900000000,2022-10-01,72,079,PR,Lajas Municipio,5770,5122,648,11.2
CN7208100000000,2022-10-01,72,081,PR,Lares Municipio,8194,7149,1045,12.8
CN7208300000000,2022-10-01,72,083,PR,Las Marias Municipio,2764,2370,394,14.3
CN7208500000000,2022-10-01,72,085,PR,Las Piedras Municipio,12316,11513,803,6.5
CN7208700000000,2022-10-01,72,087,PR,Loiza Municipio,8863,8326,537,6.1
CN7208900000000,2022-10-01,72,089,PR,Luquillo Municipio,6560,6135,425,6.5
CN7209100000000,2022-10-01,72,091,PR,Manati Municipio,12095,11295,800,6.6
CN7209300000000,2022-10-01,72,093,PR,Maricao Municipio,2105,1929,176,8.4
CN7209500000000,2022-10-01,72,095,PR,Maunabo Municipio,3010,2694,316,10.5
CN7209700000000,2022-10-01,72,097,PR,Mayaguez Municipio,24242,22437,1805,7.4
CN7209900000000,2022-10-01,72,099,PR,Moca Municipio,11913,10823,1090,9.1
CN7210100000000,2022-10-01,72,101,PR,Morovis Municipio,8680,8020,660,7.6
CN7210300000000,2022-10-01,72,103,PR,Naguabo Municipio,8820,8288,532,6
CN7210500000000,2022-10-01,72,105,PR,Naranjito Municipio,7569,7013,556,7.3
CN7210700000000,2022-10-01,72,107,PR,Orocovis Municipio,5216,4746,470,9
CN7210900000000,2022-10-01,72,109,PR,Patillas Municipio,4363,3962,401,9.2
CN7211100000000,2022-10-01,72,111,PR,Penuelas Municipio,6171,5451,720,11.7
CN7211300000000,2022-10-01,72,113,PR,Ponce Municipio,48332,44466,3866,8
CN7211500000000,2022-10-01,72,115,PR,Quebradillas Municipio,6618,6041,577,8.7
CN7211700000000,2022-10-01,72,117,PR,Rincon Municipio,5207,4775,432,8.3
CN7211900000000,2022-10-01,72,119,PR,Rio Grande Municipio,18157,17131,1026,5.7
CN7212100000000,2022-10-01,72,121,PR,Sabana Grande Municipio,6472,5885,587,9.1
CN7212300000000,2022-10-01,72,123,PR,Salinas Municipio,7491,6769,722,9.6
CN7212500000000,2022-10-01,72,125,PR,San German Municipio,10437,9575,862,8.3
CN7212700000000,2022-10-01,72,127,PR,San Juan Municipio,142932,136311,6621,4.6
CN7212900000000,2022-10-01,72,129,PR,San Lorenzo Municipio,12434,11570,864,6.9
CN7213100000000,2022-10-01,72,131,PR,San Sebastian Municipio,11551,10288,1263,10.9
CN7213300000000,2022-10-01,72,133,PR,Santa Isabel Municipio,8468,7646,822,9.7
CN7213500000000,2022-10-01,72,135,PR,Toa Alta Municipio,29853,28438,1415,4.7
CN7213700000000,2022-10-01,72,137,PR,Toa Baja Municipio,31050,29506,1544,5
CN7213900000000,2022-10-01,72,139,PR,Trujillo Alto Municipio,29014,27912,1102,3.8
CN7214100000000,2022-10-01,72,141,PR,Utuado Municipio,7415,6788,627,8.5
CN7214300000000,2022-10-01,72,143,PR,Vega Alta Municipio,10554,9761,793,7.5
CN7214500000000,2022-10-01,72,145,PR,Vega Baja Municipio,14082,12982,1100,7.8
CN7214700000000,2022-10-01,72,147,PR,Vieques Municipio,2621,2429,192,7.3
CN7214900000000,2022-10-01,72,149,PR,Villalba Municipio,7679,6848,831,10.8
CN7215100000000,2022-10-01,72,151,PR,Yabucoa Municipio,9159,8366,793,8.7
CN7215300000000,2022-10-01,72,153,PR,Yauco Municipio,10361,9212,1149,11.1
CN0100100000000,2022-11-01,01,001,AL,Autauga County,26949,26412,537,2
CN0100300000000,2022-11-01,01,003,AL,Baldwin County,102495,100375,2120,2.1
CN0100500000000,2022-11-01,01,005,AL,Barbour County,8248,7918,330,4
CN0100700000000,2022-11-01,01,007,AL,Bibb County,8667,8473,194,2.2
CN0100900000000,2022-11-01,01,009,AL,Blount County,25685,25184,501,2
CN0101100000000,2022-11-01,01,011,AL,Bullock County,4650,4541,109,2.3
CN0101300000000,2022-11-01,01,013,AL,Butler County,8779,8534,245,2.8
CN0101500000000,2022-11-01,01,015,AL,Calhoun County,45985,44842,1143,2.5
CN0101700000000,2022-11-01,01,017,AL,Chambers County,15892,15528,364,2.3
CN0101900000000,2022-11-01,01,019,AL,Cherokee County,11636,11391,245,2.1
CN0102100000000,2022-11-01,01,021,AL,Chilton County,20219,19817,402,2
CN0102300000000,2022-11-01,01,023,AL,Choctaw County,4218,4070,148,3.5
CN0102500000000,2022-11-01,01,025,AL,Clarke County,7628,7265,363,4.8
CN0102700000000,2022-11-01,01,027,AL,Clay County,6053,5932,121,2
CN0102900000000,2022-11-01,01,029,AL,Cleburne County,6134,6011,123,2
CN0103100000000,2022-11-01,01,031,AL,Coffee County,21587,21118,469,2.2
CN0103300000000,2022-11-01,01,033,AL,Colbert County,23942,23330,612,2.6
CN0103500000000,2022-11-01,01,035,AL,Conecuh County,4232,4104,128,3
CN0103700000000,2022-11-01,01,037,AL,Coosa County,4497,4384,113,2.5
CN0103900000000,2022-11-01,01,039,AL,Covington County,15036,14676,360,2.4
CN0104100000000,2022-11-01,01,041,AL,Crenshaw County,6064,5927,137,2.3
CN0104300000000,2022-11-01,01,043,AL,Cullman County,38977,38273,704,1.8
CN0104500000000,2022-11-01,01,045,AL,Dale County,20937,20445,492,2.3
CN0104700000000,2022-11-01,01,047,AL,Dallas County,13483,12904,579,4.3
CN0104900000000,2022-11-01,01,049,AL,DeKalb County,31159,30513,646,2.1
CN0105100000000,2022-11-01,01,051,AL,Elmore County,38410,37664,746,1.9
CN0105300000000,2022-11-01,01,053,AL,Escambia County,14207,13777,430,3
CN0105500000000,2022-11-01,01,055,AL,Etowah County,38980,37990,990,2.5
CN0105700000000,2022-11-01,01,057,AL,Fayette County,6508,6358,150,2.3
CN0105900000000,2022-11-01,01,059,AL,Franklin County,14606,14290,316,2.2
CN0106100000000,2022-11-01,01,061,AL,Geneva County,11464,11236,228,2
CN0106300000000,2022-11-01,01,063,AL,Greene County,2729,2634,95,3.5
CN0106500000000,2022-11-01,01,065,AL,Hale County,6138,5944,194,3.2
CN0106700000000,2022-11-01,01,067,AL,Henry County,7124,6950,174,2.4
CN0106900000000,2022-11-01,01,069,AL,Houston County,48227,47151,1076,2.2
CN0107100000000,2022-11-01,01,071,AL,Jackson County,23071,22589,482,2.1
CN0107300000000,2022-11-01,01,073,AL,Jefferson County,319827,312752,7075,2.2
CN0107500000000,2022-11-01,01,075,AL,Lamar County,5666,5539,127,2.2
CN0107700000000,2022-11-01,01,077,AL,Lauderdale County,43093,42120,973,2.3
CN0107900000000,2022-11-01,01,079,AL,Lawrence County,14835,14532,303,2
CN0108100000000,2022-11-01,01,081,AL,Lee County,80332,78684,1648,2.1
CN0108300000000,2022-11-01,01,083,AL,Limestone County,48756,47853,903,1.9
CN0108500000000,2022-11-01,01,085,AL,Lowndes County,3518,3377,141,4
CN0108700000000,2022-11-01,01,087,AL,Macon County,7849,7612,237,3
CN0108900000000,2022-11-01,01,089,AL,Madison County,200392,196710,3682,1.8
CN0109100000000,2022-11-01,01,091,AL,Marengo County,7638,7386,252,3.3
CN0109300000000,2022-11-01,01,093,AL,Marion County,13822,13490,332,2.4
CN0109500000000,2022-11-01,01,095,AL,Marshall County,45414,44613,801,1.8
CN0109700000000,2022-11-01,01,097,AL,Mobile County,192605,187373,5232,2.7
CN0109900000000,2022-11-01,01,099,AL,Monroe County,7141,6883,258,3.6
CN0110100000000,2022-11-01,01,101,AL,Montgomery County,107524,104678,2846,2.6
CN0110300000000,2022-11-01,01,103,AL,Morgan County,61073,59978,1095,1.8
CN0110500000000,2022-11-01,01,105,AL,Perry County,3079,2938,141,4.6
CN0110700000000,2022-11-01,01,107,AL,Pickens County,7838,7619,219,2.8
CN0110900000000,2022-11-01,01,109,AL,Pike County,16210,15820,390,2.4
CN0111100000000,2022-11-01,01,111,AL,Randolph County,9728,9505,223,2.3
CN0111300000000,2022-11-01,01,113,AL,Russell County,23893,23305,588,2.5
CN0111500000000,2022-11-01,01,115,AL,St. Clair County,41838,41040,798,1.9
CN0111700000000,2022-11-01,01,117,AL,Shelby County,120254,118300,1954,1.6
CN0111900000000,2022-11-01,01,119,AL,Sumter County,4623,4487,136,2.9
CN0112100000000,2022-11-01,01,121,AL,Talladega County,36617,35664,953,2.6
CN0112300000000,2022-11-01,01,123,AL,Tallapoosa County,17173,16756,417,2.4
CN0112500000000,2022-11-01,01,125,AL,Tuscaloosa County,104614,102390,2224,2.1
CN0112700000000,2022-11-01,01,127,AL,Walker County,25315,24715,600,2.4
CN0112900000000,2022-11-01,01,129,AL,Washington County,6615,6407,208,3.1
CN0113100000000,2022-11-01,01,131,AL,Wilcox County,2521,2339,182,7.2
CN0113300000000,2022-11-01,01,133,AL,Winston County,10188,9955,233,2.3
CN0201300000000,2022-11-01,02,013,AK,Aleutians East Borough,1544,1491,53,3.4
CN0201600000000,2022-11-01,02,016,AK,Aleutians West Census Area,2602,2495,107,4.1
CN0202000000000,2022-11-01,02,020,AK,Anchorage Borough/municipality,153885,149435,4450,2.9
CN0205000000000,2022-11-01,02,050,AK,Bethel Census Area,6778,6266,512,7.6
CN0206000000000,2022-11-01,02,060,AK,Bristol Bay Borough,251,235,16,6.4
CN0206300000000,2022-11-01,02,063,AK,Chugach Census Area,2860,2762,98,3.4
CN0206600000000,2022-11-01,02,066,AK,Copper River Census Area,1227,1075,152,12.4
CN0206800000000,2022-11-01,02,068,AK,Denali Borough,595,525,70,11.8
CN0207000000000,2022-11-01,02,070,AK,Dillingham Census Area,1502,1420,82,5.5
CN0209000000000,2022-11-01,02,090,AK,Fairbanks North Star Borough,46072,44485,1587,3.4
CN0210000000000,2022-11-01,02,100,AK,Haines Borough,914,851,63,6.9
CN0210500000000,2022-11-01,02,105,AK,Hoonah-Angoon Census Area,993,925,68,6.8
CN0211000000000,2022-11-01,02,110,AK,Juneau Borough/city,16811,16381,430,2.6
CN0212200000000,2022-11-01,02,122,AK,Kenai Peninsula Borough,27193,25991,1202,4.4
CN0213000000000,2022-11-01,02,130,AK,Ketchikan Gateway Borough,6289,6055,234,3.7
CN0215000000000,2022-11-01,02,150,AK,Kodiak Island Borough,5678,5387,291,5.1
CN0215800000000,2022-11-01,02,158,AK,Kusilvak Census Area,2333,2059,274,11.7
CN0216400000000,2022-11-01,02,164,AK,Lake and Peninsula Borough,549,513,36,6.6
CN0217000000000,2022-11-01,02,170,AK,Matanuska-Susitna Borough,50600,48565,2035,4
CN0218000000000,2022-11-01,02,180,AK,Nome Census Area,4275,4035,240,5.6
CN0218500000000,2022-11-01,02,185,AK,North Slope Borough,3034,2901,133,4.4
CN0218800000000,2022-11-01,02,188,AK,Northwest Arctic Borough,2975,2710,265,8.9
CN0219500000000,2022-11-01,02,195,AK,Petersburg Borough,1359,1281,78,5.7
CN0219800000000,2022-11-01,02,198,AK,Prince of Wales-Hyder Census Area,2661,2532,129,4.8
CN0222000000000,2022-11-01,02,220,AK,Sitka Borough/city,4133,4029,104,2.5
CN0223000000000,2022-11-01,02,230,AK,Skagway Municipality,579,521,58,10
CN0224000000000,2022-11-01,02,240,AK,Southeast Fairbanks Census Area,3266,3118,148,4.5
CN0227500000000,2022-11-01,02,275,AK,Wrangell Borough/city,898,853,45,5
CN0228200000000,2022-11-01,02,282,AK,Yakutat Borough/city,273,254,19,7
CN0229000000000,2022-11-01,02,290,AK,Yukon-Koyukuk Census Area,2363,2193,170,7.2
CN0400100000000,2022-11-01,04,001,AZ,Apache County,18926,17564,1362,7.2
CN0400300000000,2022-11-01,04,003,AZ,Cochise County,49202,47142,2060,4.2
CN0400500000000,2022-11-01,04,005,AZ,Coconino County,75205,72318,2887,3.8
CN0400700000000,2022-11-01,04,007,AZ,Gila County,20647,19863,784,3.8
CN0400900000000,2022-11-01,04,009,AZ,Graham County,16543,16001,542,3.3
CN0401100000000,2022-11-01,04,011,AZ,Greenlee County,5002,4876,126,2.5
CN0401200000000,2022-11-01,04,012,AZ,La Paz County,9739,9320,419,4.3
CN0401300000000,2022-11-01,04,013,AZ,Maricopa County,2394406,2320917,73489,3.1
CN0401500000000,2022-11-01,04,015,AZ,Mohave County,90108,86137,3971,4.4
CN0401700000000,2022-11-01,04,017,AZ,Navajo County,40143,38150,1993,5
CN0401900000000,2022-11-01,04,019,AZ,Pima County,491826,474719,17107,3.5
CN0402100000000,2022-11-01,04,021,AZ,Pinal County,203280,196019,7261,3.6
CN0402300000000,2022-11-01,04,023,AZ,Santa Cruz County,19436,17914,1522,7.8
CN0402500000000,2022-11-01,04,025,AZ,Yavapai County,108970,105523,3447,3.2
CN0402700000000,2022-11-01,04,027,AZ,Yuma County,104024,90499,13525,13
CN0500100000000,2022-11-01,05,001,AR,Arkansas County,9263,9015,248,2.7
CN0500300000000,2022-11-01,05,003,AR,Ashley County,6621,6286,335,5.1
CN0500500000000,2022-11-01,05,005,AR,Baxter County,16356,15836,520,3.2
CN0500700000000,2022-11-01,05,007,AR,Benton County,153380,150250,3130,2
CN0500900000000,2022-11-01,05,009,AR,Boone County,15827,15407,420,2.7
CN0501100000000,2022-11-01,05,011,AR,Bradley County,3945,3757,188,4.8
CN0501300000000,2022-11-01,05,013,AR,Calhoun County,2331,2263,68,2.9
CN0501500000000,2022-11-01,05,015,AR,Carroll County,12301,11987,314,2.6
CN0501700000000,2022-11-01,05,017,AR,Chicot County,2831,2691,140,4.9
CN0501900000000,2022-11-01,05,019,AR,Clark County,8484,8143,341,4
CN0502100000000,2022-11-01,05,021,AR,Clay County,5302,5084,218,4.1
CN0502300000000,2022-11-01,05,023,AR,Cleburne County,8810,8491,319,3.6
CN0502500000000,2022-11-01,05,025,AR,Cleveland County,3029,2928,101,3.3
CN0502700000000,2022-11-01,05,027,AR,Columbia County,8935,8587,348,3.9
CN0502900000000,2022-11-01,05,029,AR,Conway County,8285,8019,266,3.2
CN0503100000000,2022-11-01,05,031,AR,Craighead County,57861,56490,1371,2.4
CN0503300000000,2022-11-01,05,033,AR,Crawford County,26242,25540,702,2.7
CN0503500000000,2022-11-01,05,035,AR,Crittenden County,20522,19794,728,3.5
CN0503700000000,2022-11-01,05,037,AR,Cross County,6756,6529,227,3.4
CN0503900000000,2022-11-01,05,039,AR,Dallas County,2680,2587,93,3.5
CN0504100000000,2022-11-01,05,041,AR,Desha County,4879,4665,214,4.4
CN0504300000000,2022-11-01,05,043,AR,Drew County,7343,7058,285,3.9
CN0504500000000,2022-11-01,05,045,AR,Faulkner County,62976,61353,1623,2.6
CN0504700000000,2022-11-01,05,047,AR,Franklin County,7375,7168,207,2.8
CN0504900000000,2022-11-01,05,049,AR,Fulton County,4904,4762,142,2.9
CN0505100000000,2022-11-01,05,051,AR,Garland County,41683,40316,1367,3.3
CN0505300000000,2022-11-01,05,053,AR,Grant County,8418,8190,228,2.7
CN0505500000000,2022-11-01,05,055,AR,Greene County,19964,19057,907,4.5
CN0505700000000,2022-11-01,05,057,AR,Hempstead County,9311,9045,266,2.9
CN0505900000000,2022-11-01,05,059,AR,Hot Spring County,13677,13273,404,3
CN0506100000000,2022-11-01,05,061,AR,Howard County,5214,5049,165,3.2
CN0506300000000,2022-11-01,05,063,AR,Independence County,16589,16132,457,2.8
CN0506500000000,2022-11-01,05,065,AR,Izard County,4515,4313,202,4.5
CN0506700000000,2022-11-01,05,067,AR,Jackson County,5358,5119,239,4.5
CN0506900000000,2022-11-01,05,069,AR,Jefferson County,25293,24188,1105,4.4
CN0507100000000,2022-11-01,05,071,AR,Johnson County,10021,9680,341,3.4
CN0507300000000,2022-11-01,05,073,AR,Lafayette County,2286,2177,109,4.8
CN0507500000000,2022-11-01,05,075,AR,Lawrence County,6837,6626,211,3.1
CN0507700000000,2022-11-01,05,077,AR,Lee County,2468,2368,100,4.1
CN0507900000000,2022-11-01,05,079,AR,Lincoln County,3621,3482,139,3.8
CN0508100000000,2022-11-01,05,081,AR,Little River County,5171,4997,174,3.4
CN0508300000000,2022-11-01,05,083,AR,Logan County,8124,7862,262,3.2
CN0508500000000,2022-11-01,05,085,AR,Lonoke County,34060,33230,830,2.4
CN0508700000000,2022-11-01,05,087,AR,Madison County,7769,7612,157,2
CN0508900000000,2022-11-01,05,089,AR,Marion County,6213,6006,207,3.3
CN0509100000000,2022-11-01,05,091,AR,Miller County,18574,17985,589,3.2
CN0509300000000,2022-11-01,05,093,AR,Mississippi County,16243,15550,693,4.3
CN0509500000000,2022-11-01,05,095,AR,Monroe County,2483,2387,96,3.9
CN0509700000000,2022-11-01,05,097,AR,Montgomery County,2660,2548,112,4.2
CN0509900000000,2022-11-01,05,099,AR,Nevada County,3433,3321,112,3.3
CN0510100000000,2022-11-01,05,101,AR,Newton County,3155,3079,76,2.4
CN0510300000000,2022-11-01,05,103,AR,Ouachita County,9548,9225,323,3.4
CN0510500000000,2022-11-01,05,105,AR,Perry County,4180,4057,123,2.9
CN0510700000000,2022-11-01,05,107,AR,Phillips County,5442,5110,332,6.1
CN0510900000000,2022-11-01,05,109,AR,Pike County,3899,3774,125,3.2
CN0511100000000,2022-11-01,05,111,AR,Poinsett County,9930,9647,283,2.8
CN0511300000000,2022-11-01,05,113,AR,Polk County,7764,7523,241,3.1
CN0511500000000,2022-11-01,05,115,AR,Pope County,27593,26697,896,3.2
CN0511700000000,2022-11-01,05,117,AR,Prairie County,3528,3431,97,2.7
CN0511900000000,2022-11-01,05,119,AR,Pulaski County,188867,183429,5438,2.9
CN0512100000000,2022-11-01,05,121,AR,Randolph County,7097,6881,216,3
CN0512300000000,2022-11-01,05,123,AR,St. Francis County,7356,7044,312,4.2
CN0512500000000,2022-11-01,05,125,AR,Saline County,59907,58497,1410,2.4
CN0512700000000,2022-11-01,05,127,AR,Scott County,4192,4098,94,2.2
CN0512900000000,2022-11-01,05,129,AR,Searcy County,2768,2660,108,3.9
CN0513100000000,2022-11-01,05,131,AR,Sebastian County,55293,53845,1448,2.6
CN0513300000000,2022-11-01,05,133,AR,Sevier County,5393,5212,181,3.4
CN0513500000000,2022-11-01,05,135,AR,Sharp County,5820,5628,192,3.3
CN0513700000000,2022-11-01,05,137,AR,Stone County,4475,4312,163,3.6
CN0513900000000,2022-11-01,05,139,AR,Union County,14660,14047,613,4.2
CN0514100000000,2022-11-01,05,141,AR,Van Buren County,5890,5683,207,3.5
CN0514300000000,2022-11-01,05,143,AR,Washington County,135527,132832,2695,2
CN0514500000000,2022-11-01,05,145,AR,White County,34095,33097,998,2.9
CN0514700000000,2022-11-01,05,147,AR,Woodruff County,2779,2700,79,2.8
CN0514900000000,2022-11-01,05,149,AR,Yell County,7825,7577,248,3.2
CN0600100000000,2022-11-01,06,001,CA,Alameda County,829318,802883,26435,3.2
CN0600300000000,2022-11-01,06,003,CA,Alpine County,482,457,25,5.2
CN0600500000000,2022-11-01,06,005,CA,Amador County,14278,13635,643,4.5
CN0600700000000,2022-11-01,06,007,CA,Butte County,92908,88836,4072,4.4
CN0600900000000,2022-11-01,06,009,CA,Calaveras County,22137,21341,796,3.6
CN0601100000000,2022-11-01,06,011,CA,Colusa County,10010,8875,1135,11.3
CN0601300000000,2022-11-01,06,013,CA,Contra Costa County,553801,534960,18841,3.4
CN0601500000000,2022-11-01,06,015,CA,Del Norte County,9352,8869,483,5.2
CN0601700000000,2022-11-01,06,017,CA,El Dorado County,93870,90790,3080,3.3
CN0601900000000,2022-11-01,06,019,CA,Fresno County,457730,428750,28980,6.3
CN0602100000000,2022-11-01,06,021,CA,Glenn County,12838,12167,671,5.2
CN0602300000000,2022-11-01,06,023,CA,Humboldt County,60222,57873,2349,3.9
CN0602500000000,2022-11-01,06,025,CA,Imperial County,72259,60422,11837,16.4
CN0602700000000,2022-11-01,06,027,CA,Inyo County,8381,8089,292,3.5
CN0602900000000,2022-11-01,06,029,CA,Kern County,397974,372637,25337,6.4
CN0603100000000,2022-11-01,06,031,CA,Kings County,57223,53402,3821,6.7
CN0603300000000,2022-11-01,06,033,CA,Lake County,28078,26588,1490,5.3
CN0603500000000,2022-11-01,06,035,CA,Lassen County,9403,9015,388,4.1
CN0603700000000,2022-11-01,06,037,CA,Los Angeles County,4986416,4760132,226284,4.5
CN0603900000000,2022-11-01,06,039,CA,Madera County,63621,59765,3856,6.1
CN0604100000000,2022-11-01,06,041,CA,Marin County,131436,127994,3442,2.6
CN0604300000000,2022-11-01,06,043,CA,Mariposa County,7221,6911,310,4.3
CN0604500000000,2022-11-01,06,045,CA,Mendocino County,37043,35479,1564,4.2
CN0604700000000,2022-11-01,06,047,CA,Merced County,115314,107113,8201,7.1
CN0604900000000,2022-11-01,06,049,CA,Modoc County,3163,3003,160,5.1
CN0605100000000,2022-11-01,06,051,CA,Mono County,8151,7829,322,4
CN0605300000000,2022-11-01,06,053,CA,Monterey County,221749,210144,11605,5.2
CN0605500000000,2022-11-01,06,055,CA,Napa County,70289,68052,2237,3.2
CN0605700000000,2022-11-01,06,057,CA,Nevada County,48613,47017,1596,3.3
CN0605900000000,2022-11-01,06,059,CA,Orange County,1604830,1556434,48396,3
CN0606100000000,2022-11-01,06,061,CA,Placer County,194970,189114,5856,3
CN0606300000000,2022-11-01,06,063,CA,Plumas County,7188,6745,443,6.2
CN0606500000000,2022-11-01,06,065,CA,Riverside County,1158912,1111121,47791,4.1
CN0606700000000,2022-11-01,06,067,CA,Sacramento County,732375,704273,28102,3.8
CN0606900000000,2022-11-01,06,069,CA,San Benito County,32833,31263,1570,4.8
CN0607100000000,2022-11-01,06,071,CA,San Bernardino County,1013535,973162,40373,4
CN0607300000000,2022-11-01,06,073,CA,San Diego County,1603979,1551106,52873,3.3
CN0607500000000,2022-11-01,06,075,CA,San Francisco County/city,576267,562407,13860,2.4
CN0607700000000,2022-11-01,06,077,CA,San Joaquin County,346744,328767,17977,5.2
CN0607900000000,2022-11-01,06,079,CA,San Luis Obispo County,137828,133807,4021,2.9
CN0608100000000,2022-11-01,06,081,CA,San Mateo County,456452,445890,10562,2.3
CN0608300000000,2022-11-01,06,083,CA,Santa Barbara County,224645,217108,7537,3.4
CN0608500000000,2022-11-01,06,085,CA,Santa Clara County,1053449,1026618,26831,2.5
CN0608700000000,2022-11-01,06,087,CA,Santa Cruz County,134417,128358,6059,4.5
CN0608900000000,2022-11-01,06,089,CA,Shasta County,73864,70609,3255,4.4
CN0609100000000,2022-11-01,06,091,CA,Sierra County,1280,1235,45,3.5
CN0609300000000,2022-11-01,06,093,CA,Siskiyou County,16716,15848,868,5.2
CN0609500000000,2022-11-01,06,095,CA,Solano County,202773,194602,8171,4
CN0609700000000,2022-11-01,06,097,CA,Sonoma County,249031,241494,7537,3
CN0609900000000,2022-11-01,06,099,CA,Stanislaus County,242692,229810,12882,5.3
CN0610100000000,2022-11-01,06,101,CA,Sutter County,46209,43208,3001,6.5
CN0610300000000,2022-11-01,06,103,CA,Tehama County,25755,24531,1224,4.8
CN0610500000000,2022-11-01,06,105,CA,Trinity County,4557,4335,222,4.9
CN0610700000000,2022-11-01,06,107,CA,Tulare County,209242,191939,17303,8.3
CN0610900000000,2022-11-01,06,109,CA,Tuolumne County,19822,18976,846,4.3
CN0611100000000,2022-11-01,06,111,CA,Ventura County,415270,399646,15624,3.8
CN0611300000000,2022-11-01,06,113,CA,Yolo County,109313,104923,4390,4
CN0611500000000,2022-11-01,06,115,CA,Yuba County,31830,30087,1743,5.5
CN0800100000000,2022-11-01,08,001,CO,Adams County,282621,274105,8516,3
CN0800300000000,2022-11-01,08,003,CO,Alamosa County,8186,7897,289,3.5
CN0800500000000,2022-11-01,08,005,CO,Arapahoe County,377019,366620,10399,2.8
CN0800700000000,2022-11-01,08,007,CO,Archuleta County,6868,6685,183,2.7
CN0800900000000,2022-11-01,08,009,CO,Baca County,1936,1905,31,1.6
CN0801100000000,2022-11-01,08,011,CO,Bent County,1719,1662,57,3.3
CN0801300000000,2022-11-01,08,013,CO,Boulder County,204887,200225,4662,2.3
CN0801400000000,2022-11-01,08,014,CO,Broomfield County/city,42724,41672,1052,2.5
CN0801500000000,2022-11-01,08,015,CO,Chaffee County,9712,9478,234,2.4
CN0801700000000,2022-11-01,08,017,CO,Cheyenne County,974,955,19,2
CN0801900000000,2022-11-01,08,019,CO,Clear Creek County,6175,6021,154,2.5
CN0802100000000,2022-11-01,08,021,CO,Conejos County,3892,3782,110,2.8
CN0802300000000,2022-11-01,08,023,CO,Costilla County,1765,1697,68,3.9
CN0802500000000,2022-11-01,08,025,CO,Crowley County,1373,1321,52,3.8
CN0802700000000,2022-11-01,08,027,CO,Custer County,2281,2212,69,3
CN0802900000000,2022-11-01,08,029,CO,Delta County,12850,12419,431,3.4
CN0803100000000,2022-11-01,08,031,CO,Denver County/city,438280,426120,12160,2.8
CN0803300000000,2022-11-01,08,033,CO,Dolores County,1121,1084,37,3.3
CN0803500000000,2022-11-01,08,035,CO,Douglas County,209009,204028,4981,2.4
CN0803700000000,2022-11-01,08,037,CO,Eagle County,33215,32294,921,2.8
CN0803900000000,2022-11-01,08,039,CO,Elbert County,15914,15558,356,2.2
CN0804100000000,2022-11-01,08,041,CO,El Paso County,360094,349392,10702,3
CN0804300000000,2022-11-01,08,043,CO,Fremont County,14255,13639,616,4.3
CN0804500000000,2022-11-01,08,045,CO,Garfield County,29961,29114,847,2.8
CN0804700000000,2022-11-01,08,047,CO,Gilpin County,3953,3856,97,2.5
CN0804900000000,2022-11-01,08,049,CO,Grand County,8880,8647,233,2.6
CN0805100000000,2022-11-01,08,051,CO,Gunnison County,11229,10932,297,2.6
CN0805300000000,2022-11-01,08,053,CO,Hinsdale County,409,397,12,2.9
CN0805500000000,2022-11-01,08,055,CO,Huerfano County,2453,2304,149,6.1
CN0805700000000,2022-11-01,08,057,CO,Jackson County,969,952,17,1.8
CN0805900000000,2022-11-01,08,059,CO,Jefferson County,344774,336097,8677,2.5
CN0806100000000,2022-11-01,08,061,CO,Kiowa County,832,815,17,2
CN0806300000000,2022-11-01,08,063,CO,Kit Carson County,3960,3891,69,1.7
CN0806500000000,2022-11-01,08,065,CO,Lake County,4836,4723,113,2.3
CN0806700000000,2022-11-01,08,067,CO,La Plata County,31167,30339,828,2.7
CN0806900000000,2022-11-01,08,069,CO,Larimer County,210464,205303,5161,2.5
CN0807100000000,2022-11-01,08,071,CO,Las Animas County,5935,5672,263,4.4
CN0807300000000,2022-11-01,08,073,CO,Lincoln County,2100,2043,57,2.7
CN0807500000000,2022-11-01,08,075,CO,Logan County,9989,9744,245,2.5
CN0807700000000,2022-11-01,08,077,CO,Mesa County,77325,75002,2323,3
CN0807900000000,2022-11-01,08,079,CO,Mineral County,457,446,11,2.4
CN0808100000000,2022-11-01,08,081,CO,Moffat County,6740,6546,194,2.9
CN0808300000000,2022-11-01,08,083,CO,Montezuma County,12253,11834,419,3.4
CN0808500000000,2022-11-01,08,085,CO,Montrose County,20886,20272,614,2.9
CN0808700000000,2022-11-01,08,087,CO,Morgan County,15102,14688,414,2.7
CN0808900000000,2022-11-01,08,089,CO,Otero County,7749,7443,306,3.9
CN0809100000000,2022-11-01,08,091,CO,Ouray County,2456,2383,73,3
CN0809300000000,2022-11-01,08,093,CO,Park County,11676,11402,274,2.3
CN0809500000000,2022-11-01,08,095,CO,Phillips County,2259,2216,43,1.9
CN0809700000000,2022-11-01,08,097,CO,Pitkin County,10492,10004,488,4.7
CN0809900000000,2022-11-01,08,099,CO,Prowers County,5952,5802,150,2.5
CN0810100000000,2022-11-01,08,101,CO,Pueblo County,76600,73561,3039,4
CN0810300000000,2022-11-01,08,103,CO,Rio Blanco County,2828,2738,90,3.2
CN0810500000000,2022-11-01,08,105,CO,Rio Grande County,5046,4866,180,3.6
CN0810700000000,2022-11-01,08,107,CO,Routt County,15271,14896,375,2.5
CN0810900000000,2022-11-01,08,109,CO,Saguache County,3191,3087,104,3.3
CN0811100000000,2022-11-01,08,111,CO,San Juan County,487,468,19,3.9
CN0811300000000,2022-11-01,08,113,CO,San Miguel County,4922,4658,264,5.4
CN0811500000000,2022-11-01,08,115,CO,Sedgwick County,994,967,27,2.7
CN0811700000000,2022-11-01,08,117,CO,Summit County,21436,21004,432,2
CN0811900000000,2022-11-01,08,119,CO,Teller County,13495,13137,358,2.7
CN0812100000000,2022-11-01,08,121,CO,Washington County,2610,2554,56,2.1
CN0812300000000,2022-11-01,08,123,CO,Weld County,169718,164864,4854,2.9
CN0812500000000,2022-11-01,08,125,CO,Yuma County,5069,4973,96,1.9
CN0900100000000,2022-11-01,09,001,CT,Fairfield County,480605,464043,16562,3.4
CN0900300000000,2022-11-01,09,003,CT,Hartford County,480549,463967,16582,3.5
CN0900500000000,2022-11-01,09,005,CT,Litchfield County,104502,101248,3254,3.1
CN0900700000000,2022-11-01,09,007,CT,Middlesex County,94438,91643,2795,3
CN0900900000000,2022-11-01,09,009,CT,New Haven County,470242,453615,16627,3.5
CN0901100000000,2022-11-01,09,011,CT,New London County,134232,129662,4570,3.4
CN0901300000000,2022-11-01,09,013,CT,Tolland County,86958,84240,2718,3.1
CN0901500000000,2022-11-01,09,015,CT,Windham County,63911,61721,2190,3.4
CN1000100000000,2022-11-01,10,001,DE,Kent County,79450,75628,3822,4.8
CN1000300000000,2022-11-01,10,003,DE,New Castle County,304388,292293,12095,4
CN1000500000000,2022-11-01,10,005,DE,Sussex County,110162,105205,4957,4.5
CN1100100000000,2022-11-01,11,001,DC,District of Columbia,386175,370463,15712,4.1
CN1200100000000,2022-11-01,12,001,FL,Alachua County,143624,139856,3768,2.6
CN1200300000000,2022-11-01,12,003,FL,Baker County,12752,12427,325,2.5
CN1200500000000,2022-11-01,12,005,FL,Bay County,87912,85756,2156,2.5
CN1200700000000,2022-11-01,12,007,FL,Bradford County,11095,10788,307,2.8
CN1200900000000,2022-11-01,12,009,FL,Brevard County,298189,290374,7815,2.6
CN1201100000000,2022-11-01,12,011,FL,Broward County,1065099,1038374,26725,2.5
CN1201300000000,2022-11-01,12,013,FL,Calhoun County,4839,4694,145,3
CN1201500000000,2022-11-01,12,015,FL,Charlotte County,77289,74472,2817,3.6
CN1201700000000,2022-11-01,12,017,FL,Citrus County,49310,47426,1884,3.8
CN1201900000000,2022-11-01,12,019,FL,Clay County,114096,111297,2799,2.5
CN1202100000000,2022-11-01,12,021,FL,Collier County,189468,184333,5135,2.7
CN1202300000000,2022-11-01,12,023,FL,Columbia County,29518,28688,830,2.8
CN1202700000000,2022-11-01,12,027,FL,DeSoto County,13752,13297,455,3.3
CN1202900000000,2022-11-01,12,029,FL,Dixie County,5815,5638,177,3
CN1203100000000,2022-11-01,12,031,FL,Duval County,515365,501720,13645,2.6
CN1203300000000,2022-11-01,12,033,FL,Escambia County,149501,145442,4059,2.7
CN1203500000000,2022-11-01,12,035,FL,Flagler County,50838,49216,1622,3.2
CN1203700000000,2022-11-01,12,037,FL,Franklin County,4723,4607,116,2.5
CN1203900000000,2022-11-01,12,039,FL,Gadsden County,19323,18652,671,3.5
CN1204100000000,2022-11-01,12,041,FL,Gilchrist County,7482,7272,210,2.8
CN1204300000000,2022-11-01,12,043,FL,Glades County,5221,5069,152,2.9
CN1204500000000,2022-11-01,12,045,FL,Gulf County,5441,5305,136,2.5
CN1204700000000,2022-11-01,12,047,FL,Hamilton County,4145,3987,158,3.8
CN1204900000000,2022-11-01,12,049,FL,Hardee County,8765,8452,313,3.6
CN1205100000000,2022-11-01,12,051,FL,Hendry County,15251,14599,652,4.3
CN1205300000000,2022-11-01,12,053,FL,Hernando County,77403,74906,2497,3.2
CN1205500000000,2022-11-01,12,055,FL,Highlands County,35760,34338,1422,4
CN1205700000000,2022-11-01,12,057,FL,Hillsborough County,812706,792203,20503,2.5
CN1205900000000,2022-11-01,12,059,FL,Holmes County,6998,6804,194,2.8
CN1206100000000,2022-11-01,12,061,FL,Indian River County,67521,65513,2008,3
CN1206300000000,2022-11-01,12,063,FL,Jackson County,16432,15950,482,2.9
CN1206500000000,2022-11-01,12,065,FL,Jefferson County,5792,5637,155,2.7
CN1206700000000,2022-11-01,12,067,FL,Lafayette County,2804,2727,77,2.7
CN1206900000000,2022-11-01,12,069,FL,Lake County,172905,168154,4751,2.7
CN1207100000000,2022-11-01,12,071,FL,Lee County,380847,367178,13669,3.6
CN1207300000000,2022-11-01,12,073,FL,Leon County,161723,157318,4405,2.7
CN1207500000000,2022-11-01,12,075,FL,Levy County,17068,16543,525,3.1
CN1207700000000,2022-11-01,12,077,FL,Liberty County,2636,2566,70,2.7
CN1207900000000,2022-11-01,12,079,FL,Madison County,7815,7580,235,3
CN1208100000000,2022-11-01,12,081,FL,Manatee County,187555,182660,4895,2.6
CN1208300000000,2022-11-01,12,083,FL,Marion County,149341,144665,4676,3.1
CN1208500000000,2022-11-01,12,085,FL,Martin County,76254,74394,1860,2.4
CN1208600000000,2022-11-01,12,086,FL,Miami-Dade County,1379414,1350633,28781,2.1
CN1208700000000,2022-11-01,12,087,FL,Monroe County,49476,48636,840,1.7
CN1208900000000,2022-11-01,12,089,FL,Nassau County,45062,43977,1085,2.4
CN1209100000000,2022-11-01,12,091,FL,Okaloosa County,102551,100221,2330,2.3
CN1209300000000,2022-11-01,12,093,FL,Okeechobee County,17754,17274,480,2.7
CN1209500000000,2022-11-01,12,095,FL,Orange County,801146,780739,20407,2.5
CN1209700000000,2022-11-01,12,097,FL,Osceola County,199400,193464,5936,3
CN1209900000000,2022-11-01,12,099,FL,Palm Beach County,765182,745291,19891,2.6
CN1210100000000,2022-11-01,12,101,FL,Pasco County,260490,253159,7331,2.8
CN1210300000000,2022-11-01,12,103,FL,Pinellas County,514964,502591,12373,2.4
CN1210500000000,2022-11-01,12,105,FL,Polk County,341477,330705,10772,3.2
CN1210700000000,2022-11-01,12,107,FL,Putnam County,27090,26097,993,3.7
CN1210900000000,2022-11-01,12,109,FL,St. Johns County,150322,146958,3364,2.2
CN1211100000000,2022-11-01,12,111,FL,St. Lucie County,155919,151223,4696,3
CN1211300000000,2022-11-01,12,113,FL,Santa Rosa County,87919,85730,2189,2.5
CN1211500000000,2022-11-01,12,115,FL,Sarasota County,196545,191145,5400,2.7
CN1211700000000,2022-11-01,12,117,FL,Seminole County,266762,260277,6485,2.4
CN1211900000000,2022-11-01,12,119,FL,Sumter County,37632,36257,1375,3.7
CN1212100000000,2022-11-01,12,121,FL,Suwannee County,17666,17138,528,3
CN1212300000000,2022-11-01,12,123,FL,Taylor County,8113,7880,233,2.9
CN1212500000000,2022-11-01,12,125,FL,Union County,4549,4416,133,2.9
CN1212700000000,2022-11-01,12,127,FL,Volusia County,267724,259935,7789,2.9
CN1212900000000,2022-11-01,12,129,FL,Wakulla County,16189,15819,370,2.3
CN1213100000000,2022-11-01,12,131,FL,Walton County,34695,33871,824,2.4
CN1213300000000,2022-11-01,12,133,FL,Washington County,9827,9544,283,2.9
CN1300100000000,2022-11-01,13,001,GA,Appling County,9337,9031,306,3.3
CN1300300000000,2022-11-01,13,003,GA,Atkinson County,4311,4218,93,2.2
CN1300500000000,2022-11-01,13,005,GA,Bacon County,4839,4708,131,2.7
CN1300700000000,2022-11-01,13,007,GA,Baker County,1098,1062,36,3.3
CN1300900000000,2022-11-01,13,009,GA,Baldwin County,18119,17442,677,3.7
CN1301100000000,2022-11-01,13,011,GA,Banks County,10849,10628,221,2
CN1301300000000,2022-11-01,13,013,GA,Barrow County,43157,42132,1025,2.4
CN1301500000000,2022-11-01,13,015,GA,Bartow County,52340,50949,1391,2.7
CN1301700000000,2022-11-01,13,017,GA,Ben Hill County,5597,5380,217,3.9
CN1301900000000,2022-11-01,13,019,GA,Berrien County,7703,7482,221,2.9
CN1302100000000,2022-11-01,13,021,GA,Bibb County,65094,62854,2240,3.4
CN1302300000000,2022-11-01,13,023,GA,Bleckley County,4491,4319,172,3.8
CN1302500000000,2022-11-01,13,025,GA,Brantley County,7400,7161,239,3.2
CN1302700000000,2022-11-01,13,027,GA,Brooks County,6625,6428,197,3
CN1302900000000,2022-11-01,13,029,GA,Bryan County,20116,19617,499,2.5
CN1303100000000,2022-11-01,13,031,GA,Bulloch County,38450,37303,1147,3
CN1303300000000,2022-11-01,13,033,GA,Burke County,8913,8497,416,4.7
CN1303500000000,2022-11-01,13,035,GA,Butts County,11348,11052,296,2.6
CN1303700000000,2022-11-01,13,037,GA,Calhoun County,2212,2152,60,2.7
CN1303900000000,2022-11-01,13,039,GA,Camden County,21933,21319,614,2.8
CN1304300000000,2022-11-01,13,043,GA,Candler County,6049,5903,146,2.4
CN1304500000000,2022-11-01,13,045,GA,Carroll County,57259,55670,1589,2.8
CN1304700000000,2022-11-01,13,047,GA,Catoosa County,33473,32656,817,2.4
CN1304900000000,2022-11-01,13,049,GA,Charlton County,5065,4917,148,2.9
CN1305100000000,2022-11-01,13,051,GA,Chatham County,143687,139818,3869,2.7
CN1305300000000,2022-11-01,13,053,GA,Chattahoochee County,1904,1828,76,4
CN1305500000000,2022-11-01,13,055,GA,Chattooga County,9092,8755,337,3.7
CN1305700000000,2022-11-01,13,057,GA,Cherokee County,143016,139858,3158,2.2
CN1305900000000,2022-11-01,13,059,GA,Clarke County,58741,57016,1725,2.9
CN1306100000000,2022-11-01,13,061,GA,Clay County,804,747,57,7.1
CN1306300000000,2022-11-01,13,063,GA,Clayton County,140155,135171,4984,3.6
CN1306500000000,2022-11-01,13,065,GA,Clinch County,2969,2893,76,2.6
CN1306700000000,2022-11-01,13,067,GA,Cobb County,432073,421765,10308,2.4
CN1306900000000,2022-11-01,13,069,GA,Coffee County,18927,18343,584,3.1
CN1307100000000,2022-11-01,13,071,GA,Colquitt County,21747,21182,565,2.6
CN1307300000000,2022-11-01,13,073,GA,Columbia County,75446,73414,2032,2.7
CN1307500000000,2022-11-01,13,075,GA,Cook County,8196,7957,239,2.9
CN1307700000000,2022-11-01,13,077,GA,Coweta County,77802,75909,1893,2.4
CN1307900000000,2022-11-01,13,079,GA,Crawford County,5331,5185,146,2.7
CN1308100000000,2022-11-01,13,081,GA,Crisp County,9838,9477,361,3.7
CN1308300000000,2022-11-01,13,083,GA,Dade County,8054,7852,202,2.5
CN1308500000000,2022-11-01,13,085,GA,Dawson County,13435,13125,310,2.3
CN1308700000000,2022-11-01,13,087,GA,Decatur County,11764,11419,345,2.9
CN1308900000000,2022-11-01,13,089,GA,DeKalb County,405514,393902,11612,2.9
CN1309100000000,2022-11-01,13,091,GA,Dodge County,6796,6569,227,3.3
CN1309300000000,2022-11-01,13,093,GA,Dooly County,4921,4751,170,3.5
CN1309500000000,2022-11-01,13,095,GA,Dougherty County,36178,34743,1435,4
CN1309700000000,2022-11-01,13,097,GA,Douglas County,75166,72940,2226,3
CN1309900000000,2022-11-01,13,099,GA,Early County,4492,4346,146,3.3
CN1310100000000,2022-11-01,13,101,GA,Echols County,1845,1804,41,2.2
CN1310300000000,2022-11-01,13,103,GA,Effingham County,33609,32806,803,2.4
CN1310500000000,2022-11-01,13,105,GA,Elbert County,7936,7679,257,3.2
CN1310700000000,2022-11-01,13,107,GA,Emanuel County,8814,8485,329,3.7
CN1310900000000,2022-11-01,13,109,GA,Evans County,5024,4889,135,2.7
CN1311100000000,2022-11-01,13,111,GA,Fannin County,12097,11801,296,2.4
CN1311300000000,2022-11-01,13,113,GA,Fayette County,59656,58218,1438,2.4
CN1311500000000,2022-11-01,13,115,GA,Floyd County,44336,43096,1240,2.8
CN1311700000000,2022-11-01,13,117,GA,Forsyth County,130431,127624,2807,2.2
CN1311900000000,2022-11-01,13,119,GA,Franklin County,9957,9681,276,2.8
CN1312100000000,2022-11-01,13,121,GA,Fulton County,575981,559236,16745,2.9
CN1312300000000,2022-11-01,13,123,GA,Gilmer County,12261,11902,359,2.9
CN1312500000000,2022-11-01,13,125,GA,Glascock County,1254,1218,36,2.9
CN1312700000000,2022-11-01,13,127,GA,Glynn County,39718,38648,1070,2.7
CN1312900000000,2022-11-01,13,129,GA,Gordon County,28544,27807,737,2.6
CN1313100000000,2022-11-01,13,131,GA,Grady County,10802,10518,284,2.6
CN1313300000000,2022-11-01,13,133,GA,Greene County,7350,7118,232,3.2
CN1313500000000,2022-11-01,13,135,GA,Gwinnett County,501655,489337,12318,2.5
CN1313700000000,2022-11-01,13,137,GA,Habersham County,18747,18215,532,2.8
CN1313900000000,2022-11-01,13,139,GA,Hall County,107212,104871,2341,2.2
CN1314100000000,2022-11-01,13,141,GA,Hancock County,2550,2429,121,4.7
CN1314300000000,2022-11-01,13,143,GA,Haralson County,13040,12668,372,2.9
CN1314500000000,2022-11-01,13,145,GA,Harris County,16845,16421,424,2.5
CN1314700000000,2022-11-01,13,147,GA,Hart County,12104,11764,340,2.8
CN1314900000000,2022-11-01,13,149,GA,Heard County,5322,5183,139,2.6
CN1315100000000,2022-11-01,13,151,GA,Henry County,120785,117269,3516,2.9
CN1315300000000,2022-11-01,13,153,GA,Houston County,70177,68140,2037,2.9
CN1315500000000,2022-11-01,13,155,GA,Irwin County,3526,3394,132,3.7
CN1315700000000,2022-11-01,13,157,GA,Jackson County,45847,44960,887,1.9
CN1315900000000,2022-11-01,13,159,GA,Jasper County,7202,7032,170,2.4
CN1316100000000,2022-11-01,13,161,GA,Jeff Davis County,6003,5787,216,3.6
CN1316300000000,2022-11-01,13,163,GA,Jefferson County,6779,6557,222,3.3
CN1316500000000,2022-11-01,13,165,GA,Jenkins County,3345,3208,137,4.1
CN1316700000000,2022-11-01,13,167,GA,Johnson County,3955,3856,99,2.5
CN1316900000000,2022-11-01,13,169,GA,Jones County,13264,12894,370,2.8
CN1317100000000,2022-11-01,13,171,GA,Lamar County,8396,8139,257,3.1
CN1317300000000,2022-11-01,13,173,GA,Lanier County,3760,3628,132,3.5
CN1317500000000,2022-11-01,13,175,GA,Laurens County,18979,18276,703,3.7
CN1317700000000,2022-11-01,13,177,GA,Lee County,14949,14552,397,2.7
CN1317900000000,2022-11-01,13,179,GA,Liberty County,26251,25465,786,3
CN1318100000000,2022-11-01,13,181,GA,Lincoln County,3476,3364,112,3.2
CN1318300000000,2022-11-01,13,183,GA,Long County,8478,8243,235,2.8
CN1318500000000,2022-11-01,13,185,GA,Lowndes County,50161,48619,1542,3.1
CN1318700000000,2022-11-01,13,187,GA,Lumpkin County,18562,18159,403,2.2
CN1318900000000,2022-11-01,13,189,GA,McDuffie County,8349,7995,354,4.2
CN1319100000000,2022-11-01,13,191,GA,McIntosh County,6207,6027,180,2.9
CN1319300000000,2022-11-01,13,193,GA,Macon County,4457,4281,176,3.9
CN1319500000000,2022-11-01,13,195,GA,Madison County,13563,13199,364,2.7
CN1319700000000,2022-11-01,13,197,GA,Marion County,3258,3143,115,3.5
CN1319900000000,2022-11-01,13,199,GA,Meriwether County,8971,8664,307,3.4
CN1320100000000,2022-11-01,13,201,GA,Miller County,2925,2856,69,2.4
CN1320500000000,2022-11-01,13,205,GA,Mitchell County,8180,7906,274,3.3
CN1320700000000,2022-11-01,13,207,GA,Monroe County,12734,12398,336,2.6
CN1320900000000,2022-11-01,13,209,GA,Montgomery County,3910,3776,134,3.4
CN1321100000000,2022-11-01,13,211,GA,Morgan County,9681,9448,233,2.4
CN1321300000000,2022-11-01,13,213,GA,Murray County,15184,14601,583,3.8
CN1321500000000,2022-11-01,13,215,GA,Muscogee County,75624,72719,2905,3.8
CN1321700000000,2022-11-01,13,217,GA,Newton County,54300,52611,1689,3.1
CN1321900000000,2022-11-01,13,219,GA,Oconee County,20286,19865,421,2.1
CN1322100000000,2022-11-01,13,221,GA,Oglethorpe County,7004,6826,178,2.5
CN1322300000000,2022-11-01,13,223,GA,Paulding County,91564,89329,2235,2.4
CN1322500000000,2022-11-01,13,225,GA,Peach County,11740,11324,416,3.5
CN1322700000000,2022-11-01,13,227,GA,Pickens County,15937,15562,375,2.4
CN1322900000000,2022-11-01,13,229,GA,Pierce County,8914,8686,228,2.6
CN1323100000000,2022-11-01,13,231,GA,Pike County,9213,8980,233,2.5
CN1323300000000,2022-11-01,13,233,GA,Polk County,18412,17872,540,2.9
CN1323500000000,2022-11-01,13,235,GA,Pulaski County,3959,3842,117,3
CN1323700000000,2022-11-01,13,237,GA,Putnam County,8745,8463,282,3.2
CN1323900000000,2022-11-01,13,239,GA,Quitman County,724,681,43,5.9
CN1324100000000,2022-11-01,13,241,GA,Rabun County,7571,7362,209,2.8
CN1324300000000,2022-11-01,13,243,GA,Randolph County,2360,2267,93,3.9
CN1324500000000,2022-11-01,13,245,GA,Richmond County,82106,78819,3287,4
CN1324700000000,2022-11-01,13,247,GA,Rockdale County,45279,43828,1451,3.2
CN1324900000000,2022-11-01,13,249,GA,Schley County,2186,2115,71,3.2
CN1325100000000,2022-11-01,13,251,GA,Screven County,5025,4814,211,4.2
CN1325300000000,2022-11-01,13,253,GA,Seminole County,3036,2937,99,3.3
CN1325500000000,2022-11-01,13,255,GA,Spalding County,29396,28460,936,3.2
CN1325700000000,2022-11-01,13,257,GA,Stephens County,10552,10218,334,3.2
CN1325900000000,2022-11-01,13,259,GA,Stewart County,2628,2533,95,3.6
CN1326100000000,2022-11-01,13,261,GA,Sumter County,12435,11967,468,3.8
CN1326300000000,2022-11-01,13,263,GA,Talbot County,2830,2742,88,3.1
CN1326500000000,2022-11-01,13,265,GA,Taliaferro County,540,518,22,4.1
CN1326700000000,2022-11-01,13,267,GA,Tattnall County,9150,8906,244,2.7
CN1326900000000,2022-11-01,13,269,GA,Taylor County,2612,2494,118,4.5
CN1327100000000,2022-11-01,13,271,GA,Telfair County,3396,3198,198,5.8
CN1327300000000,2022-11-01,13,273,GA,Terrell County,3450,3311,139,4
CN1327500000000,2022-11-01,13,275,GA,Thomas County,16680,16135,545,3.3
CN1327700000000,2022-11-01,13,277,GA,Tift County,20934,20402,532,2.5
CN1327900000000,2022-11-01,13,279,GA,Toombs County,12298,11863,435,3.5
CN1328100000000,2022-11-01,13,281,GA,Towns County,4190,4039,151,3.6
CN1328300000000,2022-11-01,13,283,GA,Treutlen County,2677,2571,106,4
CN1328500000000,2022-11-01,13,285,GA,Troup County,36106,35153,953,2.6
CN1328700000000,2022-11-01,13,287,GA,Turner County,3119,3009,110,3.5
CN1328900000000,2022-11-01,13,289,GA,Twiggs County,2697,2593,104,3.9
CN1329100000000,2022-11-01,13,291,GA,Union County,11431,11154,277,2.4
CN1329300000000,2022-11-01,13,293,GA,Upson County,11774,11438,336,2.9
CN1329500000000,2022-11-01,13,295,GA,Walker County,31280,30414,866,2.8
CN1329700000000,2022-11-01,13,297,GA,Walton County,48079,46838,1241,2.6
CN1329900000000,2022-11-01,13,299,GA,Ware County,15914,15449,465,2.9
CN1330100000000,2022-11-01,13,301,GA,Warren County,2697,2614,83,3.1
CN1330300000000,2022-11-01,13,303,GA,Washington County,7115,6874,241,3.4
CN1330500000000,2022-11-01,13,305,GA,Wayne County,12110,11778,332,2.7
CN1330700000000,2022-11-01,13,307,GA,Webster County,957,925,32,3.3
CN1330900000000,2022-11-01,13,309,GA,Wheeler County,1654,1580,74,4.5
CN1331100000000,2022-11-01,13,311,GA,White County,17039,16661,378,2.2
CN1331300000000,2022-11-01,13,313,GA,Whitfield County,42626,41081,1545,3.6
CN1331500000000,2022-11-01,13,315,GA,Wilcox County,2707,2624,83,3.1
CN1331700000000,2022-11-01,13,317,GA,Wilkes County,3683,3554,129,3.5
CN1331900000000,2022-11-01,13,319,GA,Wilkinson County,3937,3809,128,3.3
CN1332100000000,2022-11-01,13,321,GA,Worth County,8688,8439,249,2.9
CN1500100000000,2022-11-01,15,001,HI,Hawaii County,95094,91160,3934,4.1
CN1500300000000,2022-11-01,15,003,HI,Honolulu County/city,460910,443133,17777,3.9
CN1500700000000,2022-11-01,15,007,HI,Kauai County,36821,35431,1390,3.8
CN1500900000000,2022-11-01,15,009,HI,Maui County,87401,84155,3246,3.7
CN1600100000000,2022-11-01,16,001,ID,Ada County,272037,265971,6066,2.2
CN1600300000000,2022-11-01,16,003,ID,Adams County,1666,1591,75,4.5
CN1600500000000,2022-11-01,16,005,ID,Bannock County,43941,42838,1103,2.5
CN1600700000000,2022-11-01,16,007,ID,Bear Lake County,3193,3120,73,2.3
CN1600900000000,2022-11-01,16,009,ID,Benewah County,4011,3846,165,4.1
CN1601100000000,2022-11-01,16,011,ID,Bingham County,25041,24443,598,2.4
CN1601300000000,2022-11-01,16,013,ID,Blaine County,12719,12396,323,2.5
CN1601500000000,2022-11-01,16,015,ID,Boise County,3774,3643,131,3.5
CN1601700000000,2022-11-01,16,017,ID,Bonner County,21412,20622,790,3.7
CN1601900000000,2022-11-01,16,019,ID,Bonneville County,62366,61021,1345,2.2
CN1602100000000,2022-11-01,16,021,ID,Boundary County,5529,5331,198,3.6
CN1602300000000,2022-11-01,16,023,ID,Butte County,1471,1421,50,3.4
CN1602500000000,2022-11-01,16,025,ID,Camas County,702,683,19,2.7
CN1602700000000,2022-11-01,16,027,ID,Canyon County,115331,112182,3149,2.7
CN1602900000000,2022-11-01,16,029,ID,Caribou County,4139,4012,127,3.1
CN1603100000000,2022-11-01,16,031,ID,Cassia County,15943,15622,321,2
CN1603300000000,2022-11-01,16,033,ID,Clark County,382,365,17,4.5
CN1603500000000,2022-11-01,16,035,ID,Clearwater County,2932,2798,134,4.6
CN1603700000000,2022-11-01,16,037,ID,Custer County,2096,2010,86,4.1
CN1603900000000,2022-11-01,16,039,ID,Elmore County,12906,12572,334,2.6
CN1604100000000,2022-11-01,16,041,ID,Franklin County,7519,7350,169,2.2
CN1604300000000,2022-11-01,16,043,ID,Fremont County,8369,8154,215,2.6
CN1604500000000,2022-11-01,16,045,ID,Gem County,8807,8586,221,2.5
CN1604700000000,2022-11-01,16,047,ID,Gooding County,11524,11292,232,2
CN1604900000000,2022-11-01,16,049,ID,Idaho County,6742,6523,219,3.2
CN1605100000000,2022-11-01,16,051,ID,Jefferson County,15879,15579,300,1.9
CN1605300000000,2022-11-01,16,053,ID,Jerome County,16977,16612,365,2.1
CN1605500000000,2022-11-01,16,055,ID,Kootenai County,83659,80948,2711,3.2
CN1605700000000,2022-11-01,16,057,ID,Latah County,20854,20458,396,1.9
CN1605900000000,2022-11-01,16,059,ID,Lemhi County,3517,3404,113,3.2
CN1606100000000,2022-11-01,16,061,ID,Lewis County,1670,1622,48,2.9
CN1606300000000,2022-11-01,16,063,ID,Lincoln County,3338,3236,102,3.1
CN1606500000000,2022-11-01,16,065,ID,Madison County,23893,23528,365,1.5
CN1606700000000,2022-11-01,16,067,ID,Minidoka County,13749,13463,286,2.1
CN1606900000000,2022-11-01,16,069,ID,Nez Perce County,20879,20351,528,2.5
CN1607100000000,2022-11-01,16,071,ID,Oneida County,2650,2577,73,2.8
CN1607300000000,2022-11-01,16,073,ID,Owyhee County,6264,6087,177,2.8
CN1607500000000,2022-11-01,16,075,ID,Payette County,12070,11736,334,2.8
CN1607700000000,2022-11-01,16,077,ID,Power County,4834,4713,121,2.5
CN1607900000000,2022-11-01,16,079,ID,Shoshone County,5316,5049,267,5
CN1608100000000,2022-11-01,16,081,ID,Teton County,7287,7076,211,2.9
CN1608300000000,2022-11-01,16,083,ID,Twin Falls County,45715,44637,1078,2.4
CN1608500000000,2022-11-01,16,085,ID,Valley County,5259,5067,192,3.7
CN1608700000000,2022-11-01,16,087,ID,Washington County,5124,4980,144,2.8
CN1700100000000,2022-11-01,17,001,IL,Adams County,30522,29501,1021,3.3
CN1700300000000,2022-11-01,17,003,IL,Alexander County,1803,1700,103,5.7
CN1700500000000,2022-11-01,17,005,IL,Bond County,7469,7219,250,3.3
CN1700700000000,2022-11-01,17,007,IL,Boone County,24767,23596,1171,4.7
CN1700900000000,2022-11-01,17,009,IL,Brown County,3086,3024,62,2
CN1701100000000,2022-11-01,17,011,IL,Bureau County,15730,15110,620,3.9
CN1701300000000,2022-11-01,17,013,IL,Calhoun County,2174,2091,83,3.8
CN1701500000000,2022-11-01,17,015,IL,Carroll County,7146,6885,261,3.7
CN1701700000000,2022-11-01,17,017,IL,Cass County,5631,5410,221,3.9
CN1701900000000,2022-11-01,17,019,IL,Champaign County,112408,108699,3709,3.3
CN1702100000000,2022-11-01,17,021,IL,Christian County,13289,12739,550,4.1
CN1702300000000,2022-11-01,17,023,IL,Clark County,7204,6939,265,3.7
CN1702500000000,2022-11-01,17,025,IL,Clay County,5637,5393,244,4.3
CN1702700000000,2022-11-01,17,027,IL,Clinton County,19903,19392,511,2.6
CN1702900000000,2022-11-01,17,029,IL,Coles County,23211,22359,852,3.7
CN1703100000000,2022-11-01,17,031,IL,Cook County,2682673,2557497,125176,4.7
CN1703300000000,2022-11-01,17,033,IL,Crawford County,8241,7952,289,3.5
CN1703500000000,2022-11-01,17,035,IL,Cumberland County,5949,5784,165,2.8
CN1703700000000,2022-11-01,17,037,IL,DeKalb County,53823,51873,1950,3.6
CN1703900000000,2022-11-01,17,039,IL,De Witt County,7425,7149,276,3.7
CN1704100000000,2022-11-01,17,041,IL,Douglas County,10146,9849,297,2.9
CN1704300000000,2022-11-01,17,043,IL,DuPage County,523842,506155,17687,3.4
CN1704500000000,2022-11-01,17,045,IL,Edgar County,9155,8879,276,3
CN1704700000000,2022-11-01,17,047,IL,Edwards County,2395,2301,94,3.9
CN1704900000000,2022-11-01,17,049,IL,Effingham County,19515,18999,516,2.6
CN1705100000000,2022-11-01,17,051,IL,Fayette County,9611,9244,367,3.8
CN1705300000000,2022-11-01,17,053,IL,Ford County,6433,6219,214,3.3
CN1705500000000,2022-11-01,17,055,IL,Franklin County,15662,14896,766,4.9
CN1705700000000,2022-11-01,17,057,IL,Fulton County,14607,13960,647,4.4
CN1705900000000,2022-11-01,17,059,IL,Gallatin County,2012,1911,101,5
CN1706100000000,2022-11-01,17,061,IL,Greene County,5913,5684,229,3.9
CN1706300000000,2022-11-01,17,063,IL,Grundy County,26472,25267,1205,4.6
CN1706500000000,2022-11-01,17,065,IL,Hamilton County,4328,4194,134,3.1
CN1706700000000,2022-11-01,17,067,IL,Hancock County,7876,7597,279,3.5
CN1706900000000,2022-11-01,17,069,IL,Hardin County,1437,1369,68,4.7
CN1707100000000,2022-11-01,17,071,IL,Henderson County,3531,3406,125,3.5
CN1707300000000,2022-11-01,17,073,IL,Henry County,23527,22636,891,3.8
CN1707500000000,2022-11-01,17,075,IL,Iroquois County,12362,11879,483,3.9
CN1707700000000,2022-11-01,17,077,IL,Jackson County,27136,26142,994,3.7
CN1707900000000,2022-11-01,17,079,IL,Jasper County,4883,4733,150,3.1
CN1708100000000,2022-11-01,17,081,IL,Jefferson County,16234,15545,689,4.2
CN1708300000000,2022-11-01,17,083,IL,Jersey County,10562,10231,331,3.1
CN1708500000000,2022-11-01,17,085,IL,Jo Daviess County,10105,9782,323,3.2
CN1708700000000,2022-11-01,17,087,IL,Johnson County,3995,3810,185,4.6
CN1708900000000,2022-11-01,17,089,IL,Kane County,264132,253925,10207,3.9
CN1709100000000,2022-11-01,17,091,IL,Kankakee County,51661,49177,2484,4.8
CN1709300000000,2022-11-01,17,093,IL,Kendall County,73318,70578,2740,3.7
CN1709500000000,2022-11-01,17,095,IL,Knox County,19634,18698,936,4.8
CN1709700000000,2022-11-01,17,097,IL,Lake County,359905,346519,13386,3.7
CN1709900000000,2022-11-01,17,099,IL,LaSalle County,51477,49262,2215,4.3
CN1710100000000,2022-11-01,17,101,IL,Lawrence County,5051,4810,241,4.8
CN1710300000000,2022-11-01,17,103,IL,Lee County,16457,15876,581,3.5
CN1710500000000,2022-11-01,17,105,IL,Livingston County,15434,14885,549,3.6
CN1710700000000,2022-11-01,17,107,IL,Logan County,11398,10919,479,4.2
CN1710900000000,2022-11-01,17,109,IL,McDonough County,13157,12700,457,3.5
CN1711100000000,2022-11-01,17,111,IL,McHenry County,171031,164841,6190,3.6
CN1711300000000,2022-11-01,17,113,IL,McLean County,89744,86954,2790,3.1
CN1711500000000,2022-11-01,17,115,IL,Macon County,45230,43065,2165,4.8
CN1711700000000,2022-11-01,17,117,IL,Macoupin County,22075,21326,749,3.4
CN1711900000000,2022-11-01,17,119,IL,Madison County,131004,126532,4472,3.4
CN1712100000000,2022-11-01,17,121,IL,Marion County,16709,16005,704,4.2
CN1712300000000,2022-11-01,17,123,IL,Marshall County,5100,4886,214,4.2
CN1712500000000,2022-11-01,17,125,IL,Mason County,5887,5640,247,4.2
CN1712700000000,2022-11-01,17,127,IL,Massac County,5336,5092,244,4.6
CN1712900000000,2022-11-01,17,129,IL,Menard County,6156,5958,198,3.2
CN1713100000000,2022-11-01,17,131,IL,Mercer County,7493,7230,263,3.5
CN1713300000000,2022-11-01,17,133,IL,Monroe County,18693,18200,493,2.6
CN1713500000000,2022-11-01,17,135,IL,Montgomery County,10967,10489,478,4.4
CN1713700000000,2022-11-01,17,137,IL,Morgan County,15597,15062,535,3.4
CN1713900000000,2022-11-01,17,139,IL,Moultrie County,7372,7167,205,2.8
CN1714100000000,2022-11-01,17,141,IL,Ogle County,23637,22665,972,4.1
CN1714300000000,2022-11-01,17,143,IL,Peoria County,81937,78366,3571,4.4
CN1714500000000,2022-11-01,17,145,IL,Perry County,7736,7390,346,4.5
CN1714700000000,2022-11-01,17,147,IL,Piatt County,8821,8568,253,2.9
CN1714900000000,2022-11-01,17,149,IL,Pike County,6598,6344,254,3.8
CN1715100000000,2022-11-01,17,151,IL,Pope County,1760,1695,65,3.7
CN1715300000000,2022-11-01,17,153,IL,Pulaski County,1649,1537,112,6.8
CN1715500000000,2022-11-01,17,155,IL,Putnam County,2947,2832,115,3.9
CN1715700000000,2022-11-01,17,157,IL,Randolph County,13378,12949,429,3.2
CN1715900000000,2022-11-01,17,159,IL,Richland County,7173,6921,252,3.5
CN1716100000000,2022-11-01,17,161,IL,Rock Island County,66779,64250,2529,3.8
CN1716300000000,2022-11-01,17,163,IL,St. Clair County,122900,118131,4769,3.9
CN1716500000000,2022-11-01,17,165,IL,Saline County,9359,8926,433,4.6
CN1716700000000,2022-11-01,17,167,IL,Sangamon County,96966,93439,3527,3.6
CN1716900000000,2022-11-01,17,169,IL,Schuyler County,2981,2862,119,4
CN1717100000000,2022-11-01,17,171,IL,Scott County,2279,2183,96,4.2
CN1717300000000,2022-11-01,17,173,IL,Shelby County,9788,9425,363,3.7
CN1717500000000,2022-11-01,17,175,IL,Stark County,2387,2277,110,4.6
CN1717700000000,2022-11-01,17,177,IL,Stephenson County,20538,19677,861,4.2
CN1717900000000,2022-11-01,17,179,IL,Tazewell County,61772,59545,2227,3.6
CN1718100000000,2022-11-01,17,181,IL,Union County,7075,6744,331,4.7
CN1718300000000,2022-11-01,17,183,IL,Vermilion County,31715,30264,1451,4.6
CN1718500000000,2022-11-01,17,185,IL,Wabash County,5716,5547,169,3
CN1718700000000,2022-11-01,17,187,IL,Warren County,7807,7531,276,3.5
CN1718900000000,2022-11-01,17,189,IL,Washington County,9737,9520,217,2.2
CN1719100000000,2022-11-01,17,191,IL,Wayne County,6992,6735,257,3.7
CN1719300000000,2022-11-01,17,193,IL,White County,5993,5766,227,3.8
CN1719500000000,2022-11-01,17,195,IL,Whiteside County,27497,26480,1017,3.7
CN1719700000000,2022-11-01,17,197,IL,Will County,371464,355872,15592,4.2
CN1719900000000,2022-11-01,17,199,IL,Williamson County,31091,29901,1190,3.8
CN1720100000000,2022-11-01,17,201,IL,Winnebago County,132403,126097,6306,4.8
CN1720300000000,2022-11-01,17,203,IL,Woodford County,18228,17643,585,3.2
CN1800100000000,2022-11-01,18,001,IN,Adams County,16827,16466,361,2.1
CN1800300000000,2022-11-01,18,003,IN,Allen County,190242,184981,5261,2.8
CN1800500000000,2022-11-01,18,005,IN,Bartholomew County,44596,43557,1039,2.3
CN1800700000000,2022-11-01,18,007,IN,Benton County,4397,4283,114,2.6
CN1800900000000,2022-11-01,18,009,IN,Blackford County,4758,4581,177,3.7
CN1801100000000,2022-11-01,18,011,IN,Boone County,38684,37892,792,2
CN1801300000000,2022-11-01,18,013,IN,Brown County,7982,7734,248,3.1
CN1801500000000,2022-11-01,18,015,IN,Carroll County,9960,9703,257,2.6
CN1801700000000,2022-11-01,18,017,IN,Cass County,17167,16658,509,3
CN1801900000000,2022-11-01,18,019,IN,Clark County,63015,61349,1666,2.6
CN1802100000000,2022-11-01,18,021,IN,Clay County,11722,11329,393,3.4
CN1802300000000,2022-11-01,18,023,IN,Clinton County,17171,16727,444,2.6
CN1802500000000,2022-11-01,18,025,IN,Crawford County,4774,4631,143,3
CN1802700000000,2022-11-01,18,027,IN,Daviess County,16466,16106,360,2.2
CN1802900000000,2022-11-01,18,029,IN,Dearborn County,26029,25355,674,2.6
CN1803100000000,2022-11-01,18,031,IN,Decatur County,14383,14043,340,2.4
CN1803300000000,2022-11-01,18,033,IN,DeKalb County,22308,21744,564,2.5
CN1803500000000,2022-11-01,18,035,IN,Delaware County,52102,50373,1729,3.3
CN1803700000000,2022-11-01,18,037,IN,Dubois County,21684,21183,501,2.3
CN1803900000000,2022-11-01,18,039,IN,Elkhart County,116504,112948,3556,3.1
CN1804100000000,2022-11-01,18,041,IN,Fayette County,8285,7929,356,4.3
CN1804300000000,2022-11-01,18,043,IN,Floyd County,42440,41407,1033,2.4
CN1804500000000,2022-11-01,18,045,IN,Fountain County,7940,7718,222,2.8
CN1804700000000,2022-11-01,18,047,IN,Franklin County,11272,10987,285,2.5
CN1804900000000,2022-11-01,18,049,IN,Fulton County,9374,9099,275,2.9
CN1805100000000,2022-11-01,18,051,IN,Gibson County,20162,19724,438,2.2
CN1805300000000,2022-11-01,18,053,IN,Grant County,32168,31146,1022,3.2
CN1805500000000,2022-11-01,18,055,IN,Greene County,13653,13180,473,3.5
CN1805700000000,2022-11-01,18,057,IN,Hamilton County,197859,193604,4255,2.2
CN1805900000000,2022-11-01,18,059,IN,Hancock County,43263,42184,1079,2.5
CN1806100000000,2022-11-01,18,061,IN,Harrison County,20560,20053,507,2.5
CN1806300000000,2022-11-01,18,063,IN,Hendricks County,96353,94064,2289,2.4
CN1806500000000,2022-11-01,18,065,IN,Henry County,22249,21550,699,3.1
CN1806700000000,2022-11-01,18,067,IN,Howard County,33097,31535,1562,4.7
CN1806900000000,2022-11-01,18,069,IN,Huntington County,18278,17781,497,2.7
CN1807100000000,2022-11-01,18,071,IN,Jackson County,23563,22958,605,2.6
CN1807300000000,2022-11-01,18,073,IN,Jasper County,15945,15434,511,3.2
CN1807500000000,2022-11-01,18,075,IN,Jay County,8736,8496,240,2.7
CN1807700000000,2022-11-01,18,077,IN,Jefferson County,15052,14614,438,2.9
CN1807900000000,2022-11-01,18,079,IN,Jennings County,13470,13061,409,3
CN1808100000000,2022-11-01,18,081,IN,Johnson County,87995,85891,2104,2.4
CN1808300000000,2022-11-01,18,083,IN,Knox County,18076,17593,483,2.7
CN1808500000000,2022-11-01,18,085,IN,Kosciusko County,40810,39671,1139,2.8
CN1808700000000,2022-11-01,18,087,IN,LaGrange County,21167,20627,540,2.6
CN1808900000000,2022-11-01,18,089,IN,Lake County,228887,219001,9886,4.3
CN1809100000000,2022-11-01,18,091,IN,LaPorte County,46976,45306,1670,3.6
CN1809300000000,2022-11-01,18,093,IN,Lawrence County,20602,19889,713,3.5
CN1809500000000,2022-11-01,18,095,IN,Madison County,60874,58953,1921,3.2
CN1809700000000,2022-11-01,18,097,IN,Marion County,513576,498309,15267,3
CN1809900000000,2022-11-01,18,099,IN,Marshall County,23085,22390,695,3
CN1810100000000,2022-11-01,18,101,IN,Martin County,5399,5248,151,2.8
CN1810300000000,2022-11-01,18,103,IN,Miami County,14162,13645,517,3.7
CN1810500000000,2022-11-01,18,105,IN,Monroe County,72428,70434,1994,2.8
CN1810700000000,2022-11-01,18,107,IN,Montgomery County,18929,18456,473,2.5
CN1810900000000,2022-11-01,18,109,IN,Morgan County,37823,36827,996,2.6
CN1811100000000,2022-11-01,18,111,IN,Newton County,6770,6532,238,3.5
CN1811300000000,2022-11-01,18,113,IN,Noble County,21541,20922,619,2.9
CN1811500000000,2022-11-01,18,115,IN,Ohio County,3223,3150,73,2.3
CN1811700000000,2022-11-01,18,117,IN,Orange County,8097,7838,259,3.2
CN1811900000000,2022-11-01,18,119,IN,Owen County,9528,9237,291,3.1
CN1812100000000,2022-11-01,18,121,IN,Parke County,6948,6742,206,3
CN1812300000000,2022-11-01,18,123,IN,Perry County,8732,8467,265,3
CN1812500000000,2022-11-01,18,125,IN,Pike County,5831,5666,165,2.8
CN1812700000000,2022-11-01,18,127,IN,Porter County,86437,83661,2776,3.2
CN1812900000000,2022-11-01,18,129,IN,Posey County,13065,12762,303,2.3
CN1813100000000,2022-11-01,18,131,IN,Pulaski County,6523,6356,167,2.6
CN1813300000000,2022-11-01,18,133,IN,Putnam County,17114,16595,519,3
CN1813500000000,2022-11-01,18,135,IN,Randolph County,11455,11133,322,2.8
CN1813700000000,2022-11-01,18,137,IN,Ripley County,12741,12364,377,3
CN1813900000000,2022-11-01,18,139,IN,Rush County,8843,8631,212,2.4
CN1814100000000,2022-11-01,18,141,IN,St. Joseph County,132611,127994,4617,3.5
CN1814300000000,2022-11-01,18,143,IN,Scott County,10590,10254,336,3.2
CN1814500000000,2022-11-01,18,145,IN,Shelby County,23981,23398,583,2.4
CN1814700000000,2022-11-01,18,147,IN,Spencer County,10062,9809,253,2.5
CN1814900000000,2022-11-01,18,149,IN,Starke County,9515,9155,360,3.8
CN1815100000000,2022-11-01,18,151,IN,Steuben County,20597,20159,438,2.1
CN1815300000000,2022-11-01,18,153,IN,Sullivan County,7987,7704,283,3.5
CN1815500000000,2022-11-01,18,155,IN,Switzerland County,4747,4619,128,2.7
CN1815700000000,2022-11-01,18,157,IN,Tippecanoe County,98355,95663,2692,2.7
CN1815900000000,2022-11-01,18,159,IN,Tipton County,8833,8589,244,2.8
CN1816100000000,2022-11-01,18,161,IN,Union County,3590,3500,90,2.5
CN1816300000000,2022-11-01,18,163,IN,Vanderburgh County,92952,90257,2695,2.9
CN1816500000000,2022-11-01,18,165,IN,Vermillion County,6589,6363,226,3.4
CN1816700000000,2022-11-01,18,167,IN,Vigo County,46212,44632,1580,3.4
CN1816900000000,2022-11-01,18,169,IN,Wabash County,14597,14206,391,2.7
CN1817100000000,2022-11-01,18,171,IN,Warren County,4094,3984,110,2.7
CN1817300000000,2022-11-01,18,173,IN,Warrick County,32628,31783,845,2.6
CN1817500000000,2022-11-01,18,175,IN,Washington County,13775,13419,356,2.6
CN1817700000000,2022-11-01,18,177,IN,Wayne County,29616,28736,880,3
CN1817900000000,2022-11-01,18,179,IN,Wells County,14366,14034,332,2.3
CN1818100000000,2022-11-01,18,181,IN,White County,13076,12756,320,2.4
CN1818300000000,2022-11-01,18,183,IN,Whitley County,17912,17497,415,2.3
CN1900100000000,2022-11-01,19,001,IA,Adair County,4377,4287,90,2.1
CN1900300000000,2022-11-01,19,003,IA,Adams County,2127,2083,44,2.1
CN1900500000000,2022-11-01,19,005,IA,Allamakee County,7078,6859,219,3.1
CN1900700000000,2022-11-01,19,007,IA,Appanoose County,6070,5887,183,3
CN1900900000000,2022-11-01,19,009,IA,Audubon County,3080,3010,70,2.3
CN1901100000000,2022-11-01,19,011,IA,Benton County,13191,12799,392,3
CN1901300000000,2022-11-01,19,013,IA,Black Hawk County,68311,66408,1903,2.8
CN1901500000000,2022-11-01,19,015,IA,Boone County,14967,14642,325,2.2
CN1901700000000,2022-11-01,19,017,IA,Bremer County,14141,13824,317,2.2
CN1901900000000,2022-11-01,19,019,IA,Buchanan County,11284,11001,283,2.5
CN1902100000000,2022-11-01,19,021,IA,Buena Vista County,12065,11795,270,2.2
CN1902300000000,2022-11-01,19,023,IA,Butler County,8355,8152,203,2.4
CN1902500000000,2022-11-01,19,025,IA,Calhoun County,4224,4117,107,2.5
CN1902700000000,2022-11-01,19,027,IA,Carroll County,10799,10573,226,2.1
CN1902900000000,2022-11-01,19,029,IA,Cass County,6920,6758,162,2.3
CN1903100000000,2022-11-01,19,031,IA,Cedar County,10560,10304,256,2.4
CN1903300000000,2022-11-01,19,033,IA,Cerro Gordo County,22347,21752,595,2.7
CN1903500000000,2022-11-01,19,035,IA,Cherokee County,6151,6012,139,2.3
CN1903700000000,2022-11-01,19,037,IA,Chickasaw County,6616,6464,152,2.3
CN1903900000000,2022-11-01,19,039,IA,Clarke County,5042,4905,137,2.7
CN1904100000000,2022-11-01,19,041,IA,Clay County,8573,8342,231,2.7
CN1904300000000,2022-11-01,19,043,IA,Clayton County,9430,9150,280,3
CN1904500000000,2022-11-01,19,045,IA,Clinton County,22466,21712,754,3.4
CN1904700000000,2022-11-01,19,047,IA,Crawford County,7835,7594,241,3.1
CN1904900000000,2022-11-01,19,049,IA,Dallas County,54578,53448,1130,2.1
CN1905100000000,2022-11-01,19,051,IA,Davis County,4371,4265,106,2.4
CN1905300000000,2022-11-01,19,053,IA,Decatur County,4375,4271,104,2.4
CN1905500000000,2022-11-01,19,055,IA,Delaware County,10538,10312,226,2.1
CN1905700000000,2022-11-01,19,057,IA,Des Moines County,18152,17447,705,3.9
CN1905900000000,2022-11-01,19,059,IA,Dickinson County,10016,9740,276,2.8
CN1906100000000,2022-11-01,19,061,IA,Dubuque County,56387,54953,1434,2.5
CN1906300000000,2022-11-01,19,063,IA,Emmet County,4845,4721,124,2.6
CN1906500000000,2022-11-01,19,065,IA,Fayette County,10452,10159,293,2.8
CN1906700000000,2022-11-01,19,067,IA,Floyd County,8420,8184,236,2.8
CN1906900000000,2022-11-01,19,069,IA,Franklin County,5657,5528,129,2.3
CN1907100000000,2022-11-01,19,071,IA,Fremont County,3773,3673,100,2.7
CN1907300000000,2022-11-01,19,073,IA,Greene County,5439,5325,114,2.1
CN1907500000000,2022-11-01,19,075,IA,Grundy County,6473,6314,159,2.5
CN1907700000000,2022-11-01,19,077,IA,Guthrie County,5697,5546,151,2.7
CN1907900000000,2022-11-01,19,079,IA,Hamilton County,7001,6817,184,2.6
CN1908100000000,2022-11-01,19,081,IA,Hancock County,5708,5572,136,2.4
CN1908300000000,2022-11-01,19,083,IA,Hardin County,7882,7663,219,2.8
CN1908500000000,2022-11-01,19,085,IA,Harrison County,7218,7014,204,2.8
CN1908700000000,2022-11-01,19,087,IA,Henry County,9474,9208,266,2.8
CN1908900000000,2022-11-01,19,089,IA,Howard County,5285,5096,189,3.6
CN1909100000000,2022-11-01,19,091,IA,Humboldt County,4942,4835,107,2.2
CN1909300000000,2022-11-01,19,093,IA,Ida County,3969,3884,85,2.1
CN1909500000000,2022-11-01,19,095,IA,Iowa County,9979,9761,218,2.2
CN1909700000000,2022-11-01,19,097,IA,Jackson County,10645,10362,283,2.7
CN1909900000000,2022-11-01,19,099,IA,Jasper County,18728,18210,518,2.8
CN1910100000000,2022-11-01,19,101,IA,Jefferson County,10042,9806,236,2.4
CN1910300000000,2022-11-01,19,103,IA,Johnson County,87989,85993,1996,2.3
CN1910500000000,2022-11-01,19,105,IA,Jones County,10388,10118,270,2.6
CN1910700000000,2022-11-01,19,107,IA,Keokuk County,5209,5072,137,2.6
CN1910900000000,2022-11-01,19,109,IA,Kossuth County,8337,8151,186,2.2
CN1911100000000,2022-11-01,19,111,IA,Lee County,14657,14011,646,4.4
CN1911300000000,2022-11-01,19,113,IA,Linn County,121152,117446,3706,3.1
CN1911500000000,2022-11-01,19,115,IA,Louisa County,5928,5762,166,2.8
CN1911700000000,2022-11-01,19,117,IA,Lucas County,4572,4477,95,2.1
CN1911900000000,2022-11-01,19,119,IA,Lyon County,7089,6960,129,1.8
CN1912100000000,2022-11-01,19,121,IA,Madison County,8831,8585,246,2.8
CN1912300000000,2022-11-01,19,123,IA,Mahaska County,12356,12051,305,2.5
CN1912500000000,2022-11-01,19,125,IA,Marion County,19543,19133,410,2.1
CN1912700000000,2022-11-01,19,127,IA,Marshall County,17155,16502,653,3.8
CN1912900000000,2022-11-01,19,129,IA,Mills County,7197,7018,179,2.5
CN1913100000000,2022-11-01,19,131,IA,Mitchell County,5867,5743,124,2.1
CN1913300000000,2022-11-01,19,133,IA,Monona County,4388,4269,119,2.7
CN1913500000000,2022-11-01,19,135,IA,Monroe County,4018,3904,114,2.8
CN1913700000000,2022-11-01,19,137,IA,Montgomery County,4958,4832,126,2.5
CN1913900000000,2022-11-01,19,139,IA,Muscatine County,20895,20277,618,3
CN1914100000000,2022-11-01,19,141,IA,O'Brien County,8258,8070,188,2.3
CN1914300000000,2022-11-01,19,143,IA,Osceola County,3713,3644,69,1.9
CN1914500000000,2022-11-01,19,145,IA,Page County,6454,6295,159,2.5
CN1914700000000,2022-11-01,19,147,IA,Palo Alto County,4513,4413,100,2.2
CN1914900000000,2022-11-01,19,149,IA,Plymouth County,15002,14652,350,2.3
CN1915100000000,2022-11-01,19,151,IA,Pocahontas County,4404,4307,97,2.2
CN1915300000000,2022-11-01,19,153,IA,Polk County,278943,271713,7230,2.6
CN1915500000000,2022-11-01,19,155,IA,Pottawattamie County,48094,46784,1310,2.7
CN1915700000000,2022-11-01,19,157,IA,Poweshiek County,10610,10352,258,2.4
CN1915900000000,2022-11-01,19,159,IA,Ringgold County,2349,2295,54,2.3
CN1916100000000,2022-11-01,19,161,IA,Sac County,5246,5127,119,2.3
CN1916300000000,2022-11-01,19,163,IA,Scott County,89123,86298,2825,3.2
CN1916500000000,2022-11-01,19,165,IA,Shelby County,6447,6296,151,2.3
CN1916700000000,2022-11-01,19,167,IA,Sioux County,22844,22472,372,1.6
CN1916900000000,2022-11-01,19,169,IA,Story County,61614,60370,1244,2
CN1917100000000,2022-11-01,19,171,IA,Tama County,9162,8909,253,2.8
CN1917300000000,2022-11-01,19,173,IA,Taylor County,3173,3104,69,2.2
CN1917500000000,2022-11-01,19,175,IA,Union County,6156,6005,151,2.5
CN1917700000000,2022-11-01,19,177,IA,Van Buren County,3651,3557,94,2.6
CN1917900000000,2022-11-01,19,179,IA,Wapello County,16729,16217,512,3.1
CN1918100000000,2022-11-01,19,181,IA,Warren County,29570,28865,705,2.4
CN1918300000000,2022-11-01,19,183,IA,Washington County,11883,11610,273,2.3
CN1918500000000,2022-11-01,19,185,IA,Wayne County,2986,2912,74,2.5
CN1918700000000,2022-11-01,19,187,IA,Webster County,19023,18495,528,2.8
CN1918900000000,2022-11-01,19,189,IA,Winnebago County,5034,4897,137,2.7
CN1919100000000,2022-11-01,19,191,IA,Winneshiek County,11754,11454,300,2.6
CN1919300000000,2022-11-01,19,193,IA,Woodbury County,56599,55087,1512,2.7
CN1919500000000,2022-11-01,19,195,IA,Worth County,3986,3899,87,2.2
CN1919700000000,2022-11-01,19,197,IA,Wright County,6642,6490,152,2.3
CN2000100000000,2022-11-01,20,001,KS,Allen County,6299,6131,168,2.7
CN2000300000000,2022-11-01,20,003,KS,Anderson County,4398,4312,86,2
CN2000500000000,2022-11-01,20,005,KS,Atchison County,6793,6566,227,3.3
CN2000700000000,2022-11-01,20,007,KS,Barber County,2277,2234,43,1.9
CN2000900000000,2022-11-01,20,009,KS,Barton County,13111,12752,359,2.7
CN2001100000000,2022-11-01,20,011,KS,Bourbon County,6302,6100,202,3.2
CN2001300000000,2022-11-01,20,013,KS,Brown County,5127,5007,120,2.3
CN2001500000000,2022-11-01,20,015,KS,Butler County,32839,31954,885,2.7
CN2001700000000,2022-11-01,20,017,KS,Chase County,1350,1323,27,2
CN2001900000000,2022-11-01,20,019,KS,Chautauqua County,1438,1399,39,2.7
CN2002100000000,2022-11-01,20,021,KS,Cherokee County,9814,9551,263,2.7
CN2002300000000,2022-11-01,20,023,KS,Cheyenne County,1275,1246,29,2.3
CN2002500000000,2022-11-01,20,025,KS,Clark County,1134,1114,20,1.8
CN2002700000000,2022-11-01,20,027,KS,Clay County,3800,3705,95,2.5
CN2002900000000,2022-11-01,20,029,KS,Cloud County,3873,3771,102,2.6
CN2003100000000,2022-11-01,20,031,KS,Coffey County,3765,3640,125,3.3
CN2003300000000,2022-11-01,20,033,KS,Comanche County,898,875,23,2.6
CN2003500000000,2022-11-01,20,035,KS,Cowley County,16272,15818,454,2.8
CN2003700000000,2022-11-01,20,037,KS,Crawford County,19189,18667,522,2.7
CN2003900000000,2022-11-01,20,039,KS,Decatur County,1218,1184,34,2.8
CN2004100000000,2022-11-01,20,041,KS,Dickinson County,8679,8457,222,2.6
CN2004300000000,2022-11-01,20,043,KS,Doniphan County,4028,3926,102,2.5
CN2004500000000,2022-11-01,20,045,KS,Douglas County,67503,65899,1604,2.4
CN2004700000000,2022-11-01,20,047,KS,Edwards County,1403,1374,29,2.1
CN2004900000000,2022-11-01,20,049,KS,Elk County,1215,1179,36,3
CN2005100000000,2022-11-01,20,051,KS,Ellis County,17078,16765,313,1.8
CN2005300000000,2022-11-01,20,053,KS,Ellsworth County,2628,2578,50,1.9
CN2005500000000,2022-11-01,20,055,KS,Finney County,20540,20118,422,2.1
CN2005700000000,2022-11-01,20,057,KS,Ford County,17916,17569,347,1.9
CN2005900000000,2022-11-01,20,059,KS,Franklin County,15044,14722,322,2.1
CN2006100000000,2022-11-01,20,061,KS,Geary County,11388,10961,427,3.7
CN2006300000000,2022-11-01,20,063,KS,Gove County,1395,1366,29,2.1
CN2006500000000,2022-11-01,20,065,KS,Graham County,1195,1168,27,2.3
CN2006700000000,2022-11-01,20,067,KS,Grant County,2874,2801,73,2.5
CN2006900000000,2022-11-01,20,069,KS,Gray County,3287,3228,59,1.8
CN2007100000000,2022-11-01,20,071,KS,Greeley County,817,806,11,1.3
CN2007300000000,2022-11-01,20,073,KS,Greenwood County,3050,2986,64,2.1
CN2007500000000,2022-11-01,20,075,KS,Hamilton County,1681,1656,25,1.5
CN2007700000000,2022-11-01,20,077,KS,Harper County,2785,2731,54,1.9
CN2007900000000,2022-11-01,20,079,KS,Harvey County,17158,16761,397,2.3
CN2008100000000,2022-11-01,20,081,KS,Haskell County,2251,2208,43,1.9
CN2008300000000,2022-11-01,20,083,KS,Hodgeman County,1068,1045,23,2.2
CN2008500000000,2022-11-01,20,085,KS,Jackson County,7234,7091,143,2
CN2008700000000,2022-11-01,20,087,KS,Jefferson County,10345,10084,261,2.5
CN2008900000000,2022-11-01,20,089,KS,Jewell County,1181,1152,29,2.5
CN2009100000000,2022-11-01,20,091,KS,Johnson County,348375,340476,7899,2.3
CN2009300000000,2022-11-01,20,093,KS,Kearny County,2051,2015,36,1.8
CN2009500000000,2022-11-01,20,095,KS,Kingman County,3327,3257,70,2.1
CN2009700000000,2022-11-01,20,097,KS,Kiowa County,1248,1223,25,2
CN2009900000000,2022-11-01,20,099,KS,Labette County,9396,9124,272,2.9
CN2010100000000,2022-11-01,20,101,KS,Lane County,779,756,23,3
CN2010300000000,2022-11-01,20,103,KS,Leavenworth County,37288,36274,1014,2.7
CN2010500000000,2022-11-01,20,105,KS,Lincoln County,1731,1697,34,2
CN2010700000000,2022-11-01,20,107,KS,Linn County,4361,4223,138,3.2
CN2010900000000,2022-11-01,20,109,KS,Logan County,1626,1601,25,1.5
CN2011100000000,2022-11-01,20,111,KS,Lyon County,16937,16533,404,2.4
CN2011300000000,2022-11-01,20,113,KS,McPherson County,17276,16965,311,1.8
CN2011500000000,2022-11-01,20,115,KS,Marion County,5991,5868,123,2.1
CN2011700000000,2022-11-01,20,117,KS,Marshall County,5244,5146,98,1.9
CN2011900000000,2022-11-01,20,119,KS,Meade County,2123,2082,41,1.9
CN2012100000000,2022-11-01,20,121,KS,Miami County,17961,17539,422,2.3
CN2012300000000,2022-11-01,20,123,KS,Mitchell County,3329,3270,59,1.8
CN2012500000000,2022-11-01,20,125,KS,Montgomery County,14596,14163,433,3
CN2012700000000,2022-11-01,20,127,KS,Morris County,3022,2961,61,2
CN2012900000000,2022-11-01,20,129,KS,Morton County,1120,1097,23,2.1
CN2013100000000,2022-11-01,20,131,KS,Nemaha County,5618,5520,98,1.7
CN2013300000000,2022-11-01,20,133,KS,Neosho County,6036,5820,216,3.6
CN2013500000000,2022-11-01,20,135,KS,Ness County,1348,1321,27,2
CN2013700000000,2022-11-01,20,137,KS,Norton County,2616,2564,52,2
CN2013900000000,2022-11-01,20,139,KS,Osage County,8019,7803,216,2.7
CN2014100000000,2022-11-01,20,141,KS,Osborne County,1932,1891,41,2.1
CN2014300000000,2022-11-01,20,143,KS,Ottawa County,3059,2984,75,2.5
CN2014500000000,2022-11-01,20,145,KS,Pawnee County,2729,2672,57,2.1
CN2014700000000,2022-11-01,20,147,KS,Phillips County,2686,2627,59,2.2
CN2014900000000,2022-11-01,20,149,KS,Pottawatomie County,12911,12625,286,2.2
CN2015100000000,2022-11-01,20,151,KS,Pratt County,4931,4829,102,2.1
CN2015300000000,2022-11-01,20,153,KS,Rawlins County,1558,1533,25,1.6
CN2015500000000,2022-11-01,20,155,KS,Reno County,29133,28309,824,2.8
CN2015700000000,2022-11-01,20,157,KS,Republic County,2445,2404,41,1.7
CN2015900000000,2022-11-01,20,159,KS,Rice County,5323,5210,113,2.1
CN2016100000000,2022-11-01,20,161,KS,Riley County,35578,34725,853,2.4
CN2016300000000,2022-11-01,20,163,KS,Rooks County,2482,2423,59,2.4
CN2016500000000,2022-11-01,20,165,KS,Rush County,1648,1612,36,2.2
CN2016700000000,2022-11-01,20,167,KS,Russell County,3325,3255,70,2.1
CN2016900000000,2022-11-01,20,169,KS,Saline County,30256,29550,706,2.3
CN2017100000000,2022-11-01,20,171,KS,Scott County,2739,2689,50,1.8
CN2017300000000,2022-11-01,20,173,KS,Sedgwick County,255558,248090,7468,2.9
CN2017500000000,2022-11-01,20,175,KS,Seward County,9781,9543,238,2.4
CN2017700000000,2022-11-01,20,177,KS,Shawnee County,91148,88718,2430,2.7
CN2017900000000,2022-11-01,20,179,KS,Sheridan County,1508,1483,25,1.7
CN2018100000000,2022-11-01,20,181,KS,Sherman County,2796,2737,59,2.1
CN2018300000000,2022-11-01,20,183,KS,Smith County,2028,1989,39,1.9
CN2018500000000,2022-11-01,20,185,KS,Stafford County,1946,1903,43,2.2
CN2018700000000,2022-11-01,20,187,KS,Stanton County,1160,1140,20,1.7
CN2018900000000,2022-11-01,20,189,KS,Stevens County,3074,3015,59,1.9
CN2019100000000,2022-11-01,20,191,KS,Sumner County,10829,10534,295,2.7
CN2019300000000,2022-11-01,20,193,KS,Thomas County,4331,4258,73,1.7
CN2019500000000,2022-11-01,20,195,KS,Trego County,1341,1305,36,2.7
CN2019700000000,2022-11-01,20,197,KS,Wabaunsee County,3748,3669,79,2.1
CN2019900000000,2022-11-01,20,199,KS,Wallace County,877,859,18,2.1
CN2020100000000,2022-11-01,20,201,KS,Washington County,3041,2991,50,1.6
CN2020300000000,2022-11-01,20,203,KS,Wichita County,1199,1176,23,1.9
CN2020500000000,2022-11-01,20,205,KS,Wilson County,3724,3608,116,3.1
CN2020700000000,2022-11-01,20,207,KS,Woodson County,1565,1511,54,3.5
CN2020900000000,2022-11-01,20,209,KS,Wyandotte County,77839,75254,2585,3.3
CN2100100000000,2022-11-01,21,001,KY,Adair County,7222,6917,305,4.2
CN2100300000000,2022-11-01,21,003,KY,Allen County,8975,8673,302,3.4
CN2100500000000,2022-11-01,21,005,KY,Anderson County,11988,11648,340,2.8
CN2100700000000,2022-11-01,21,007,KY,Ballard County,3461,3327,134,3.9
CN2100900000000,2022-11-01,21,009,KY,Barren County,17744,17115,629,3.5
CN2101100000000,2022-11-01,21,011,KY,Bath County,4704,4498,206,4.4
CN2101300000000,2022-11-01,21,013,KY,Bell County,8187,7826,361,4.4
CN2101500000000,2022-11-01,21,015,KY,Boone County,71998,69957,2041,2.8
CN2101700000000,2022-11-01,21,017,KY,Bourbon County,9544,9249,295,3.1
CN2101900000000,2022-11-01,21,019,KY,Boyd County,16994,16248,746,4.4
CN2102100000000,2022-11-01,21,021,KY,Boyle County,12743,12295,448,3.5
CN2102300000000,2022-11-01,21,023,KY,Bracken County,3753,3626,127,3.4
CN2102500000000,2022-11-01,21,025,KY,Breathitt County,3174,2982,192,6
CN2102700000000,2022-11-01,21,027,KY,Breckinridge County,7886,7560,326,4.1
CN2102900000000,2022-11-01,21,029,KY,Bullitt County,42488,41227,1261,3
CN2103100000000,2022-11-01,21,031,KY,Butler County,5016,4833,183,3.6
CN2103300000000,2022-11-01,21,033,KY,Caldwell County,6174,5985,189,3.1
CN2103500000000,2022-11-01,21,035,KY,Calloway County,17475,16866,609,3.5
CN2103700000000,2022-11-01,21,037,KY,Campbell County,50540,49069,1471,2.9
CN2103900000000,2022-11-01,21,039,KY,Carlisle County,2222,2153,69,3.1
CN2104100000000,2022-11-01,21,041,KY,Carroll County,5884,5723,161,2.7
CN2104300000000,2022-11-01,21,043,KY,Carter County,9496,9004,492,5.2
CN2104500000000,2022-11-01,21,045,KY,Casey County,6513,6288,225,3.5
CN2104700000000,2022-11-01,21,047,KY,Christian County,24672,23659,1013,4.1
CN2104900000000,2022-11-01,21,049,KY,Clark County,17223,16687,536,3.1
CN2105100000000,2022-11-01,21,051,KY,Clay County,5049,4788,261,5.2
CN2105300000000,2022-11-01,21,053,KY,Clinton County,3538,3385,153,4.3
CN2105500000000,2022-11-01,21,055,KY,Crittenden County,3818,3682,136,3.6
CN2105700000000,2022-11-01,21,057,KY,Cumberland County,3368,3274,94,2.8
CN2105900000000,2022-11-01,21,059,KY,Daviess County,45160,43481,1679,3.7
CN2106100000000,2022-11-01,21,061,KY,Edmonson County,4750,4553,197,4.1
CN2106300000000,2022-11-01,21,063,KY,Elliott County,1851,1735,116,6.3
CN2106500000000,2022-11-01,21,065,KY,Estill County,5145,4938,207,4
CN2106700000000,2022-11-01,21,067,KY,Fayette County,175521,170641,4880,2.8
CN2106900000000,2022-11-01,21,069,KY,Fleming County,6123,5895,228,3.7
CN2107100000000,2022-11-01,21,071,KY,Floyd County,11044,10481,563,5.1
CN2107300000000,2022-11-01,21,073,KY,Franklin County,25114,24370,744,3
CN2107500000000,2022-11-01,21,075,KY,Fulton County,2085,2003,82,3.9
CN2107700000000,2022-11-01,21,077,KY,Gallatin County,3993,3863,130,3.3
CN2107900000000,2022-11-01,21,079,KY,Garrard County,7945,7681,264,3.3
CN2108100000000,2022-11-01,21,081,KY,Grant County,11645,11264,381,3.3
CN2108300000000,2022-11-01,21,083,KY,Graves County,15442,14868,574,3.7
CN2108500000000,2022-11-01,21,085,KY,Grayson County,10372,9971,401,3.9
CN2108700000000,2022-11-01,21,087,KY,Green County,4999,4844,155,3.1
CN2108900000000,2022-11-01,21,089,KY,Greenup County,12766,12140,626,4.9
CN2109100000000,2022-11-01,21,091,KY,Hancock County,3768,3613,155,4.1
CN2109300000000,2022-11-01,21,093,KY,Hardin County,46325,44665,1660,3.6
CN2109500000000,2022-11-01,21,095,KY,Harlan County,6386,6024,362,5.7
CN2109700000000,2022-11-01,21,097,KY,Harrison County,8786,8522,264,3
CN2109900000000,2022-11-01,21,099,KY,Hart County,7525,7252,273,3.6
CN2110100000000,2022-11-01,21,101,KY,Henderson County,20557,19867,690,3.4
CN2110300000000,2022-11-01,21,103,KY,Henry County,8055,7824,231,2.9
CN2110500000000,2022-11-01,21,105,KY,Hickman County,1626,1566,60,3.7
CN2110700000000,2022-11-01,21,107,KY,Hopkins County,17952,17289,663,3.7
CN2110900000000,2022-11-01,21,109,KY,Jackson County,4137,3939,198,4.8
CN2111100000000,2022-11-01,21,111,KY,Jefferson County,391100,379173,11927,3
CN2111300000000,2022-11-01,21,113,KY,Jessamine County,26585,25794,791,3
CN2111500000000,2022-11-01,21,115,KY,Johnson County,6635,6288,347,5.2
CN2111700000000,2022-11-01,21,117,KY,Kenton County,87513,84937,2576,2.9
CN2111900000000,2022-11-01,21,119,KY,Knott County,4312,4072,240,5.6
CN2112100000000,2022-11-01,21,121,KY,Knox County,10013,9533,480,4.8
CN2112300000000,2022-11-01,21,123,KY,Larue County,5669,5453,216,3.8
CN2112500000000,2022-11-01,21,125,KY,Laurel County,25341,24389,952,3.8
CN2112700000000,2022-11-01,21,127,KY,Lawrence County,5512,5272,240,4.4
CN2112900000000,2022-11-01,21,129,KY,Lee County,2060,1960,100,4.9
CN2113100000000,2022-11-01,21,131,KY,Leslie County,2536,2388,148,5.8
CN2113300000000,2022-11-01,21,133,KY,Letcher County,5847,5506,341,5.8
CN2113500000000,2022-11-01,21,135,KY,Lewis County,4516,4225,291,6.4
CN2113700000000,2022-11-01,21,137,KY,Lincoln County,9348,8947,401,4.3
CN2113900000000,2022-11-01,21,139,KY,Livingston County,3629,3486,143,3.9
CN2114100000000,2022-11-01,21,141,KY,Logan County,12406,12016,390,3.1
CN2114300000000,2022-11-01,21,143,KY,Lyon County,3117,2999,118,3.8
CN2114500000000,2022-11-01,21,145,KY,McCracken County,29875,28828,1047,3.5
CN2114700000000,2022-11-01,21,147,KY,McCreary County,4678,4465,213,4.6
CN2114900000000,2022-11-01,21,149,KY,McLean County,3894,3748,146,3.7
CN2115100000000,2022-11-01,21,151,KY,Madison County,47331,45828,1503,3.2
CN2115300000000,2022-11-01,21,153,KY,Magoffin County,3090,2840,250,8.1
CN2115500000000,2022-11-01,21,155,KY,Marion County,9385,9127,258,2.7
CN2115700000000,2022-11-01,21,157,KY,Marshall County,14290,13761,529,3.7
CN2115900000000,2022-11-01,21,159,KY,Martin County,2137,1992,145,6.8
CN2116100000000,2022-11-01,21,161,KY,Mason County,6569,6292,277,4.2
CN2116300000000,2022-11-01,21,163,KY,Meade County,11431,10993,438,3.8
CN2116500000000,2022-11-01,21,165,KY,Menifee County,2360,2256,104,4.4
CN2116700000000,2022-11-01,21,167,KY,Mercer County,10153,9822,331,3.3
CN2116900000000,2022-11-01,21,169,KY,Metcalfe County,3872,3729,143,3.7
CN2117100000000,2022-11-01,21,171,KY,Monroe County,4594,4457,137,3
CN2117300000000,2022-11-01,21,173,KY,Montgomery County,11900,11447,453,3.8
CN2117500000000,2022-11-01,21,175,KY,Morgan County,4123,3947,176,4.3
CN2117700000000,2022-11-01,21,177,KY,Muhlenberg County,9827,9328,499,5.1
CN2117900000000,2022-11-01,21,179,KY,Nelson County,23660,22955,705,3
CN2118100000000,2022-11-01,21,181,KY,Nicholas County,3224,3105,119,3.7
CN2118300000000,2022-11-01,21,183,KY,Ohio County,9036,8640,396,4.4
CN2118500000000,2022-11-01,21,185,KY,Oldham County,33069,32175,894,2.7
CN2118700000000,2022-11-01,21,187,KY,Owen County,5148,4987,161,3.1
CN2118900000000,2022-11-01,21,189,KY,Owsley County,1062,995,67,6.3
CN2119100000000,2022-11-01,21,191,KY,Pendleton County,6910,6688,222,3.2
CN2119300000000,2022-11-01,21,193,KY,Perry County,8071,7713,358,4.4
CN2119500000000,2022-11-01,21,195,KY,Pike County,19120,18277,843,4.4
CN2119700000000,2022-11-01,21,197,KY,Powell County,5288,5093,195,3.7
CN2119900000000,2022-11-01,21,199,KY,Pulaski County,24991,23984,1007,4
CN2120100000000,2022-11-01,21,201,KY,Robertson County,807,774,33,4.1
CN2120300000000,2022-11-01,21,203,KY,Rockcastle County,6542,6280,262,4
CN2120500000000,2022-11-01,21,205,KY,Rowan County,10288,9872,416,4
CN2120700000000,2022-11-01,21,207,KY,Russell County,6172,5881,291,4.7
CN2120900000000,2022-11-01,21,209,KY,Scott County,30341,29499,842,2.8
CN2121100000000,2022-11-01,21,211,KY,Shelby County,25654,24943,711,2.8
CN2121300000000,2022-11-01,21,213,KY,Simpson County,8688,8406,282,3.2
CN2121500000000,2022-11-01,21,215,KY,Spencer County,10469,10168,301,2.9
CN2121700000000,2022-11-01,21,217,KY,Taylor County,12410,12008,402,3.2
CN2121900000000,2022-11-01,21,219,KY,Todd County,5744,5577,167,2.9
CN2122100000000,2022-11-01,21,221,KY,Trigg County,6039,5789,250,4.1
CN2122300000000,2022-11-01,21,223,KY,Trimble County,3789,3659,130,3.4
CN2122500000000,2022-11-01,21,225,KY,Union County,5811,5570,241,4.1
CN2122700000000,2022-11-01,21,227,KY,Warren County,66053,63936,2117,3.2
CN2122900000000,2022-11-01,21,229,KY,Washington County,6065,5886,179,3
CN2123100000000,2022-11-01,21,231,KY,Wayne County,6934,6612,322,4.6
CN2123300000000,2022-11-01,21,233,KY,Webster County,5159,4977,182,3.5
CN2123500000000,2022-11-01,21,235,KY,Whitley County,14031,13486,545,3.9
CN2123700000000,2022-11-01,21,237,KY,Wolfe County,2211,2108,103,4.7
CN2123900000000,2022-11-01,21,239,KY,Woodford County,14931,14535,396,2.7
CN2200100000000,2022-11-01,22,001,LA,Acadia Parish,23828,23047,781,3.3
CN2200300000000,2022-11-01,22,003,LA,Allen Parish,8192,7881,311,3.8
CN2200500000000,2022-11-01,22,005,LA,Ascension Parish,67911,66141,1770,2.6
CN2200700000000,2022-11-01,22,007,LA,Assumption Parish,8842,8505,337,3.8
CN2200900000000,2022-11-01,22,009,LA,Avoyelles Parish,14203,13688,515,3.6
CN2201100000000,2022-11-01,22,011,LA,Beauregard Parish,14963,14526,437,2.9
CN2201300000000,2022-11-01,22,013,LA,Bienville Parish,5225,5026,199,3.8
CN2201500000000,2022-11-01,22,015,LA,Bossier Parish,58209,56601,1608,2.8
CN2201700000000,2022-11-01,22,017,LA,Caddo Parish,101795,98167,3628,3.6
CN2201900000000,2022-11-01,22,019,LA,Calcasieu Parish,92968,90130,2838,3.1
CN2202100000000,2022-11-01,22,021,LA,Caldwell Parish,3675,3549,126,3.4
CN2202300000000,2022-11-01,22,023,LA,Cameron Parish,3457,3365,92,2.7
CN2202500000000,2022-11-01,22,025,LA,Catahoula Parish,3377,3249,128,3.8
CN2202700000000,2022-11-01,22,027,LA,Claiborne Parish,5394,5218,176,3.3
CN2202900000000,2022-11-01,22,029,LA,Concordia Parish,6857,6574,283,4.1
CN2203100000000,2022-11-01,22,031,LA,De Soto Parish,10923,10541,382,3.5
CN2203300000000,2022-11-01,22,033,LA,East Baton Rouge Parish,236650,229659,6991,3
CN2203500000000,2022-11-01,22,035,LA,East Carroll Parish,1616,1503,113,7
CN2203700000000,2022-11-01,22,037,LA,East Feliciana Parish,7974,7765,209,2.6
CN2203900000000,2022-11-01,22,039,LA,Evangeline Parish,11881,11465,416,3.5
CN2204100000000,2022-11-01,22,041,LA,Franklin Parish,7377,7040,337,4.6
CN2204300000000,2022-11-01,22,043,LA,Grant Parish,8397,8124,273,3.3
CN2204500000000,2022-11-01,22,045,LA,Iberia Parish,27526,26507,1019,3.7
CN2204700000000,2022-11-01,22,047,LA,Iberville Parish,14063,13514,549,3.9
CN2204900000000,2022-11-01,22,049,LA,Jackson Parish,6932,6737,195,2.8
CN2205100000000,2022-11-01,22,051,LA,Jefferson Parish,210402,204097,6305,3
CN2205300000000,2022-11-01,22,053,LA,Jefferson Davis Parish,12306,11911,395,3.2
CN2205500000000,2022-11-01,22,055,LA,Lafayette Parish,116706,113432,3274,2.8
CN2205700000000,2022-11-01,22,057,LA,Lafourche Parish,40556,39368,1188,2.9
CN2205900000000,2022-11-01,22,059,LA,LaSalle Parish,6773,6607,166,2.5
CN2206100000000,2022-11-01,22,061,LA,Lincoln Parish,21742,21043,699,3.2
CN2206300000000,2022-11-01,22,063,LA,Livingston Parish,72745,70892,1853,2.5
CN2206500000000,2022-11-01,22,065,LA,Madison Parish,3447,3302,145,4.2
CN2206700000000,2022-11-01,22,067,LA,Morehouse Parish,9817,9374,443,4.5
CN2206900000000,2022-11-01,22,069,LA,Natchitoches Parish,16632,16020,612,3.7
CN2207100000000,2022-11-01,22,071,LA,Orleans Parish,176041,169573,6468,3.7
CN2207300000000,2022-11-01,22,073,LA,Ouachita Parish,70893,68595,2298,3.2
CN2207500000000,2022-11-01,22,075,LA,Plaquemines Parish,9774,9483,291,3
CN2207700000000,2022-11-01,22,077,LA,Pointe Coupee Parish,9858,9539,319,3.2
CN2207900000000,2022-11-01,22,079,LA,Rapides Parish,56628,54969,1659,2.9
CN2208100000000,2022-11-01,22,081,LA,Red River Parish,3991,3870,121,3
CN2208300000000,2022-11-01,22,083,LA,Richland Parish,8303,7996,307,3.7
CN2208500000000,2022-11-01,22,085,LA,Sabine Parish,9125,8838,287,3.1
CN2208700000000,2022-11-01,22,087,LA,St. Bernard Parish,19960,19261,699,3.5
CN2208900000000,2022-11-01,22,089,LA,St. Charles Parish,24807,24113,694,2.8
CN2209100000000,2022-11-01,22,091,LA,St. Helena Parish,4306,4112,194,4.5
CN2209300000000,2022-11-01,22,093,LA,St. James Parish,8895,8545,350,3.9
CN2209500000000,2022-11-01,22,095,LA,St. John the Baptist Parish,19043,18270,773,4.1
CN2209700000000,2022-11-01,22,097,LA,St. Landry Parish,31551,30306,1245,3.9
CN2209900000000,2022-11-01,22,099,LA,St. Martin Parish,22066,21364,702,3.2
CN2210100000000,2022-11-01,22,101,LA,St. Mary Parish,19097,18395,702,3.7
CN2210300000000,2022-11-01,22,103,LA,St. Tammany Parish,119962,116775,3187,2.7
CN2210500000000,2022-11-01,22,105,LA,Tangipahoa Parish,56835,54701,2134,3.8
CN2210700000000,2022-11-01,22,107,LA,Tensas Parish,1281,1222,59,4.6
CN2210900000000,2022-11-01,22,109,LA,Terrebonne Parish,44471,43054,1417,3.2
CN2211100000000,2022-11-01,22,111,LA,Union Parish,9210,8882,328,3.6
CN2211300000000,2022-11-01,22,113,LA,Vermilion Parish,24004,23285,719,3
CN2211500000000,2022-11-01,22,115,LA,Vernon Parish,16273,15695,578,3.6
CN2211700000000,2022-11-01,22,117,LA,Washington Parish,17315,16709,606,3.5
CN2211900000000,2022-11-01,22,119,LA,Webster Parish,14209,13653,556,3.9
CN2212100000000,2022-11-01,22,121,LA,West Baton Rouge Parish,14219,13809,410,2.9
CN2212300000000,2022-11-01,22,123,LA,West Carroll Parish,3417,3248,169,4.9
CN2212500000000,2022-11-01,22,125,LA,West Feliciana Parish,5508,5380,128,2.3
CN2212700000000,2022-11-01,22,127,LA,Winn Parish,4675,4502,173,3.7
CN2300100000000,2022-11-01,23,001,ME,Androscoggin County,52576,51024,1552,3
CN2300300000000,2022-11-01,23,003,ME,Aroostook County,27169,26140,1029,3.8
CN2300500000000,2022-11-01,23,005,ME,Cumberland County,161675,157783,3892,2.4
CN2300700000000,2022-11-01,23,007,ME,Franklin County,13380,12892,488,3.6
CN2300900000000,2022-11-01,23,009,ME,Hancock County,26811,25909,902,3.4
CN2301100000000,2022-11-01,23,011,ME,Kennebec County,60302,58646,1656,2.7
CN2301300000000,2022-11-01,23,013,ME,Knox County,19031,18457,574,3
CN2301500000000,2022-11-01,23,015,ME,Lincoln County,15643,15177,466,3
CN2301700000000,2022-11-01,23,017,ME,Oxford County,24852,24035,817,3.3
CN2301900000000,2022-11-01,23,019,ME,Penobscot County,74695,72502,2193,2.9
CN2302100000000,2022-11-01,23,021,ME,Piscataquis County,6947,6698,249,3.6
CN2302300000000,2022-11-01,23,023,ME,Sagadahoc County,18620,18195,425,2.3
CN2302500000000,2022-11-01,23,025,ME,Somerset County,21177,20313,864,4.1
CN2302700000000,2022-11-01,23,027,ME,Waldo County,19679,19113,566,2.9
CN2302900000000,2022-11-01,23,029,ME,Washington County,12963,12482,481,3.7
CN2303100000000,2022-11-01,23,031,ME,York County,110915,108075,2840,2.6
CN2400100000000,2022-11-01,24,001,MD,Allegany County,31178,30132,1046,3.4
CN2400300000000,2022-11-01,24,003,MD,Anne Arundel County,311619,303940,7679,2.5
CN2400500000000,2022-11-01,24,005,MD,Baltimore County,441305,428530,12775,2.9
CN2400900000000,2022-11-01,24,009,MD,Calvert County,49342,48149,1193,2.4
CN2401100000000,2022-11-01,24,011,MD,Caroline County,16715,16262,453,2.7
CN2401300000000,2022-11-01,24,013,MD,Carroll County,93585,91483,2102,2.2
CN2401500000000,2022-11-01,24,015,MD,Cecil County,53702,52161,1541,2.9
CN2401700000000,2022-11-01,24,017,MD,Charles County,86754,84291,2463,2.8
CN2401900000000,2022-11-01,24,019,MD,Dorchester County,15644,15136,508,3.2
CN2402100000000,2022-11-01,24,021,MD,Frederick County,135694,132268,3426,2.5
CN2402300000000,2022-11-01,24,023,MD,Garrett County,14676,14264,412,2.8
CN2402500000000,2022-11-01,24,025,MD,Harford County,139067,135518,3549,2.6
CN2402700000000,2022-11-01,24,027,MD,Howard County,186294,182156,4138,2.2
CN2402900000000,2022-11-01,24,029,MD,Kent County,9393,9095,298,3.2
CN2403100000000,2022-11-01,24,031,MD,Montgomery County,545108,531704,13404,2.5
CN2403300000000,2022-11-01,24,033,MD,Prince George's County,496979,482029,14950,3
CN2403500000000,2022-11-01,24,035,MD,Queen Anne's County,27529,26856,673,2.4
CN2403700000000,2022-11-01,24,037,MD,St. Mary's County,56962,55470,1492,2.6
CN2403900000000,2022-11-01,24,039,MD,Somerset County,8651,8294,357,4.1
CN2404100000000,2022-11-01,24,041,MD,Talbot County,17072,16540,532,3.1
CN2404300000000,2022-11-01,24,043,MD,Washington County,71650,69554,2096,2.9
CN2404500000000,2022-11-01,24,045,MD,Wicomico County,49909,48158,1751,3.5
CN2404700000000,2022-11-01,24,047,MD,Worcester County,24690,23361,1329,5.4
CN2451000000000,2022-11-01,24,510,MD,Baltimore city,272506,262070,10436,3.8
CN2500100000000,2022-11-01,25,001,MA,Barnstable County,107705,102973,4732,4.4
CN2500300000000,2022-11-01,25,003,MA,Berkshire County,60448,58064,2384,3.9
CN2500500000000,2022-11-01,25,005,MA,Bristol County,296027,284253,11774,4
CN2500700000000,2022-11-01,25,007,MA,Dukes County,8508,8025,483,5.7
CN2500900000000,2022-11-01,25,009,MA,Essex County,418361,404136,14225,3.4
CN2501100000000,2022-11-01,25,011,MA,Franklin County,39554,38486,1068,2.7
CN2501300000000,2022-11-01,25,013,MA,Hampden County,222872,213535,9337,4.2
CN2501500000000,2022-11-01,25,015,MA,Hampshire County,89298,86642,2656,3
CN2501700000000,2022-11-01,25,017,MA,Middlesex County,904803,880491,24312,2.7
CN2501900000000,2022-11-01,25,019,MA,Nantucket County/town,6849,6499,350,5.1
CN2502100000000,2022-11-01,25,021,MA,Norfolk County,390693,379204,11489,2.9
CN2502300000000,2022-11-01,25,023,MA,Plymouth County,281367,272040,9327,3.3
CN2502500000000,2022-11-01,25,025,MA,Suffolk County,450606,436453,14153,3.1
CN2502700000000,2022-11-01,25,027,MA,Worcester County,438811,424179,14632,3.3
CN2600100000000,2022-11-01,26,001,MI,Alcona County,3802,3559,243,6.4
CN2600300000000,2022-11-01,26,003,MI,Alger County,3126,2866,260,8.3
CN2600500000000,2022-11-01,26,005,MI,Allegan County,61355,59425,1930,3.1
CN2600700000000,2022-11-01,26,007,MI,Alpena County,13075,12503,572,4.4
CN2600900000000,2022-11-01,26,009,MI,Antrim County,9683,9199,484,5
CN2601100000000,2022-11-01,26,011,MI,Arenac County,5685,5326,359,6.3
CN2601300000000,2022-11-01,26,013,MI,Baraga County,3006,2816,190,6.3
CN2601500000000,2022-11-01,26,015,MI,Barry County,31779,30722,1057,3.3
CN2601700000000,2022-11-01,26,017,MI,Bay County,48890,46764,2126,4.3
CN2601900000000,2022-11-01,26,019,MI,Benzie County,8586,8201,385,4.5
CN2602100000000,2022-11-01,26,021,MI,Berrien County,71907,69041,2866,4
CN2602300000000,2022-11-01,26,023,MI,Branch County,19585,18862,723,3.7
CN2602500000000,2022-11-01,26,025,MI,Calhoun County,59646,57222,2424,4.1
CN2602700000000,2022-11-01,26,027,MI,Cass County,23517,22584,933,4
CN2602900000000,2022-11-01,26,029,MI,Charlevoix County,12253,11731,522,4.3
CN2603100000000,2022-11-01,26,031,MI,Cheboygan County,9848,9031,817,8.3
CN2603300000000,2022-11-01,26,033,MI,Chippewa County,15835,14980,855,5.4
CN2603500000000,2022-11-01,26,035,MI,Clare County,11008,10345,663,6
CN2603700000000,2022-11-01,26,037,MI,Clinton County,40653,39382,1271,3.1
CN2603900000000,2022-11-01,26,039,MI,Crawford County,5349,5020,329,6.2
CN2604100000000,2022-11-01,26,041,MI,Delta County,16290,15521,769,4.7
CN2604300000000,2022-11-01,26,043,MI,Dickinson County,12008,11560,448,3.7
CN2604500000000,2022-11-01,26,045,MI,Eaton County,56545,54674,1871,3.3
CN2604700000000,2022-11-01,26,047,MI,Emmet County,16064,15263,801,5
CN2604900000000,2022-11-01,26,049,MI,Genesee County,178168,169686,8482,4.8
CN2605100000000,2022-11-01,26,051,MI,Gladwin County,9823,9278,545,5.5
CN2605300000000,2022-11-01,26,053,MI,Gogebic County,5594,5342,252,4.5
CN2605500000000,2022-11-01,26,055,MI,Grand Traverse County,48701,47130,1571,3.2
CN2605700000000,2022-11-01,26,057,MI,Gratiot County,17289,16612,677,3.9
CN2605900000000,2022-11-01,26,059,MI,Hillsdale County,20051,19224,827,4.1
CN2606100000000,2022-11-01,26,061,MI,Houghton County,16587,15920,667,4
CN2606300000000,2022-11-01,26,063,MI,Huron County,14758,14179,579,3.9
CN2606500000000,2022-11-01,26,065,MI,Ingham County,148107,142839,5268,3.6
CN2606700000000,2022-11-01,26,067,MI,Ionia County,30094,29123,971,3.2
CN2606900000000,2022-11-01,26,069,MI,Iosco County,10177,9641,536,5.3
CN2607100000000,2022-11-01,26,071,MI,Iron County,4586,4347,239,5.2
CN2607300000000,2022-11-01,26,073,MI,Isabella County,31230,29907,1323,4.2
CN2607500000000,2022-11-01,26,075,MI,Jackson County,73710,70958,2752,3.7
CN2607700000000,2022-11-01,26,077,MI,Kalamazoo County,132427,127831,4596,3.5
CN2607900000000,2022-11-01,26,079,MI,Kalkaska County,7744,7326,418,5.4
CN2608100000000,2022-11-01,26,081,MI,Kent County,360126,349266,10860,3
CN2608300000000,2022-11-01,26,083,MI,Keweenaw County,929,874,55,5.9
CN2608500000000,2022-11-01,26,085,MI,Lake County,3890,3642,248,6.4
CN2608700000000,2022-11-01,26,087,MI,Lapeer County,39802,38433,1369,3.4
CN2608900000000,2022-11-01,26,089,MI,Leelanau County,10126,9757,369,3.6
CN2609100000000,2022-11-01,26,091,MI,Lenawee County,44776,43049,1727,3.9
CN2609300000000,2022-11-01,26,093,MI,Livingston County,102289,99851,2438,2.4
CN2609500000000,2022-11-01,26,095,MI,Luce County,2045,1908,137,6.7
CN2609700000000,2022-11-01,26,097,MI,Mackinac County,4473,3981,492,11
CN2609900000000,2022-11-01,26,099,MI,Macomb County,437567,424290,13277,3
CN2610100000000,2022-11-01,26,101,MI,Manistee County,9465,8959,506,5.3
CN2610300000000,2022-11-01,26,103,MI,Marquette County,32298,30951,1347,4.2
CN2610500000000,2022-11-01,26,105,MI,Mason County,12766,12121,645,5.1
CN2610700000000,2022-11-01,26,107,MI,Mecosta County,18660,17793,867,4.6
CN2610900000000,2022-11-01,26,109,MI,Menominee County,10503,10102,401,3.8
CN2611100000000,2022-11-01,26,111,MI,Midland County,39778,38268,1510,3.8
CN2611300000000,2022-11-01,26,113,MI,Missaukee County,6632,6363,269,4.1
CN2611500000000,2022-11-01,26,115,MI,Monroe County,74159,71253,2906,3.9
CN2611700000000,2022-11-01,26,117,MI,Montcalm County,27717,26630,1087,3.9
CN2611900000000,2022-11-01,26,119,MI,Montmorency County,2981,2752,229,7.7
CN2612100000000,2022-11-01,26,121,MI,Muskegon County,76138,72702,3436,4.5
CN2612300000000,2022-11-01,26,123,MI,Newaygo County,23007,22074,933,4.1
CN2612500000000,2022-11-01,26,125,MI,Oakland County,661909,645165,16744,2.5
CN2612700000000,2022-11-01,26,127,MI,Oceana County,10984,10355,629,5.7
CN2612900000000,2022-11-01,26,129,MI,Ogemaw County,8123,7631,492,6.1
CN2613100000000,2022-11-01,26,131,MI,Ontonagon County,1978,1842,136,6.9
CN2613300000000,2022-11-01,26,133,MI,Osceola County,11393,10947,446,3.9
CN2613500000000,2022-11-01,26,135,MI,Oscoda County,2669,2476,193,7.2
CN2613700000000,2022-11-01,26,137,MI,Otsego County,11242,10701,541,4.8
CN2613900000000,2022-11-01,26,139,MI,Ottawa County,161887,157139,4748,2.9
CN2614100000000,2022-11-01,26,141,MI,Presque Isle County,4834,4514,320,6.6
CN2614300000000,2022-11-01,26,143,MI,Roscommon County,7785,7207,578,7.4
CN2614500000000,2022-11-01,26,145,MI,Saginaw County,82381,78485,3896,4.7
CN2614700000000,2022-11-01,26,147,MI,St. Clair County,73813,71434,2379,3.2
CN2614900000000,2022-11-01,26,149,MI,St. Joseph County,28123,26999,1124,4
CN2615100000000,2022-11-01,26,151,MI,Sanilac County,18589,17795,794,4.3
CN2615300000000,2022-11-01,26,153,MI,Schoolcraft County,3036,2853,183,6
CN2615500000000,2022-11-01,26,155,MI,Shiawassee County,32300,31065,1235,3.8
CN2615700000000,2022-11-01,26,157,MI,Tuscola County,22715,21691,1024,4.5
CN2615900000000,2022-11-01,26,159,MI,Van Buren County,34184,32662,1522,4.5
CN2616100000000,2022-11-01,26,161,MI,Washtenaw County,198238,191990,6248,3.2
CN2616300000000,2022-11-01,26,163,MI,Wayne County,785989,757105,28884,3.7
CN2616500000000,2022-11-01,26,165,MI,Wexford County,14569,13952,617,4.2
CN2700100000000,2022-11-01,27,001,MN,Aitkin County,7454,7106,348,4.7
CN2700300000000,2022-11-01,27,003,MN,Anoka County,198783,193965,4818,2.4
CN2700500000000,2022-11-01,27,005,MN,Becker County,19240,18737,503,2.6
CN2700700000000,2022-11-01,27,007,MN,Beltrami County,24948,24203,745,3
CN2700900000000,2022-11-01,27,009,MN,Benton County,21700,21011,689,3.2
CN2701100000000,2022-11-01,27,011,MN,Big Stone County,2334,2279,55,2.4
CN2701300000000,2022-11-01,27,013,MN,Blue Earth County,41087,40265,822,2
CN2701500000000,2022-11-01,27,015,MN,Brown County,13494,13181,313,2.3
CN2701700000000,2022-11-01,27,017,MN,Carlton County,17697,17092,605,3.4
CN2701900000000,2022-11-01,27,019,MN,Carver County,59391,58197,1194,2
CN2702100000000,2022-11-01,27,021,MN,Cass County,14327,13701,626,4.4
CN2702300000000,2022-11-01,27,023,MN,Chippewa County,6343,6211,132,2.1
CN2702500000000,2022-11-01,27,025,MN,Chisago County,29947,29126,821,2.7
CN2702700000000,2022-11-01,27,027,MN,Clay County,37748,37060,688,1.8
CN2702900000000,2022-11-01,27,029,MN,Clearwater County,4447,4232,215,4.8
CN2703100000000,2022-11-01,27,031,MN,Cook County,2723,2611,112,4.1
CN2703300000000,2022-11-01,27,033,MN,Cottonwood County,6739,6599,140,2.1
CN2703500000000,2022-11-01,27,035,MN,Crow Wing County,32989,31860,1129,3.4
CN2703700000000,2022-11-01,27,037,MN,Dakota County,242358,237072,5286,2.2
CN2703900000000,2022-11-01,27,039,MN,Dodge County,11846,11596,250,2.1
CN2704100000000,2022-11-01,27,041,MN,Douglas County,21338,20854,484,2.3
CN2704300000000,2022-11-01,27,043,MN,Faribault County,6980,6773,207,3
CN2704500000000,2022-11-01,27,045,MN,Fillmore County,11379,11126,253,2.2
CN2704700000000,2022-11-01,27,047,MN,Freeborn County,15769,15377,392,2.5
CN2704900000000,2022-11-01,27,049,MN,Goodhue County,26392,25806,586,2.2
CN2705100000000,2022-11-01,27,051,MN,Grant County,3266,3181,85,2.6
CN2705300000000,2022-11-01,27,053,MN,Hennepin County,705426,689167,16259,2.3
CN2705500000000,2022-11-01,27,055,MN,Houston County,10522,10329,193,1.8
CN2705700000000,2022-11-01,27,057,MN,Hubbard County,9971,9560,411,4.1
CN2705900000000,2022-11-01,27,059,MN,Isanti County,21723,21060,663,3.1
CN2706100000000,2022-11-01,27,061,MN,Itasca County,21494,20518,976,4.5
CN2706300000000,2022-11-01,27,063,MN,Jackson County,5340,5238,102,1.9
CN2706500000000,2022-11-01,27,065,MN,Kanabec County,9204,8812,392,4.3
CN2706700000000,2022-11-01,27,067,MN,Kandiyohi County,22940,22408,532,2.3
CN2706900000000,2022-11-01,27,069,MN,Kittson County,2194,2134,60,2.7
CN2707100000000,2022-11-01,27,071,MN,Koochiching County,5673,5422,251,4.4
CN2707300000000,2022-11-01,27,073,MN,Lac qui Parle County,3391,3316,75,2.2
CN2707500000000,2022-11-01,27,075,MN,Lake County,5129,4827,302,5.9
CN2707700000000,2022-11-01,27,077,MN,Lake of the Woods County,2259,2181,78,3.5
CN2707900000000,2022-11-01,27,079,MN,Le Sueur County,15882,15386,496,3.1
CN2708100000000,2022-11-01,27,081,MN,Lincoln County,2953,2889,64,2.2
CN2708300000000,2022-11-01,27,083,MN,Lyon County,14292,14001,291,2
CN2708500000000,2022-11-01,27,085,MN,McLeod County,19081,18597,484,2.5
CN2708700000000,2022-11-01,27,087,MN,Mahnomen County,2247,2144,103,4.6
CN2708900000000,2022-11-01,27,089,MN,Marshall County,5369,5152,217,4
CN2709100000000,2022-11-01,27,091,MN,Martin County,9425,9210,215,2.3
CN2709300000000,2022-11-01,27,093,MN,Meeker County,13595,13216,379,2.8
CN2709500000000,2022-11-01,27,095,MN,Mille Lacs County,12683,12145,538,4.2
CN2709700000000,2022-11-01,27,097,MN,Morrison County,17137,16402,735,4.3
CN2709900000000,2022-11-01,27,099,MN,Mower County,20719,20243,476,2.3
CN2710100000000,2022-11-01,27,101,MN,Murray County,4596,4478,118,2.6
CN2710300000000,2022-11-01,27,103,MN,Nicollet County,21069,20696,373,1.8
CN2710500000000,2022-11-01,27,105,MN,Nobles County,10910,10681,229,2.1
CN2710700000000,2022-11-01,27,107,MN,Norman County,3152,3052,100,3.2
CN2710900000000,2022-11-01,27,109,MN,Olmsted County,90962,89194,1768,1.9
CN2711100000000,2022-11-01,27,111,MN,Otter Tail County,30720,29895,825,2.7
CN2711300000000,2022-11-01,27,113,MN,Pennington County,8758,8522,236,2.7
CN2711500000000,2022-11-01,27,115,MN,Pine County,14209,13617,592,4.2
CN2711700000000,2022-11-01,27,117,MN,Pipestone County,4706,4619,87,1.8
CN2711900000000,2022-11-01,27,119,MN,Polk County,16153,15757,396,2.5
CN2712100000000,2022-11-01,27,121,MN,Pope County,6439,6281,158,2.5
CN2712300000000,2022-11-01,27,123,MN,Ramsey County,285553,278584,6969,2.4
CN2712500000000,2022-11-01,27,125,MN,Red Lake County,2171,2090,81,3.7
CN2712700000000,2022-11-01,27,127,MN,Redwood County,7484,7308,176,2.4
CN2712900000000,2022-11-01,27,129,MN,Renville County,8212,7989,223,2.7
CN2713100000000,2022-11-01,27,131,MN,Rice County,37444,36565,879,2.3
CN2713300000000,2022-11-01,27,133,MN,Rock County,5989,5899,90,1.5
CN2713500000000,2022-11-01,27,135,MN,Roseau County,7822,7636,186,2.4
CN2713700000000,2022-11-01,27,137,MN,St. Louis County,100975,97818,3157,3.1
CN2713900000000,2022-11-01,27,139,MN,Scott County,84410,82661,1749,2.1
CN2714100000000,2022-11-01,27,141,MN,Sherburne County,53133,51754,1379,2.6
CN2714300000000,2022-11-01,27,143,MN,Sibley County,8041,7829,212,2.6
CN2714500000000,2022-11-01,27,145,MN,Stearns County,89817,87564,2253,2.5
CN2714700000000,2022-11-01,27,147,MN,Steele County,19371,18874,497,2.6
CN2714900000000,2022-11-01,27,149,MN,Stevens County,5308,5198,110,2.1
CN2715100000000,2022-11-01,27,151,MN,Swift County,4759,4643,116,2.4
CN2715300000000,2022-11-01,27,153,MN,Todd County,13521,13092,429,3.2
CN2715500000000,2022-11-01,27,155,MN,Traverse County,1629,1592,37,2.3
CN2715700000000,2022-11-01,27,157,MN,Wabasha County,12119,11853,266,2.2
CN2715900000000,2022-11-01,27,159,MN,Wadena County,6095,5870,225,3.7
CN2716100000000,2022-11-01,27,161,MN,Waseca County,8507,8233,274,3.2
CN2716300000000,2022-11-01,27,163,MN,Washington County,144992,141895,3097,2.1
CN2716500000000,2022-11-01,27,165,MN,Watonwan County,6568,6426,142,2.2
CN2716700000000,2022-11-01,27,167,MN,Wilkin County,3396,3338,58,1.7
CN2716900000000,2022-11-01,27,169,MN,Winona County,28371,27821,550,1.9
CN2717100000000,2022-11-01,27,171,MN,Wright County,76700,74845,1855,2.4
CN2717300000000,2022-11-01,27,173,MN,Yellow Medicine County,4997,4887,110,2.2
CN2800100000000,2022-11-01,28,001,MS,Adams County,10540,10066,474,4.5
CN2800300000000,2022-11-01,28,003,MS,Alcorn County,14905,14417,488,3.3
CN2800500000000,2022-11-01,28,005,MS,Amite County,4167,3975,192,4.6
CN2800700000000,2022-11-01,28,007,MS,Attala County,6738,6481,257,3.8
CN2800900000000,2022-11-01,28,009,MS,Benton County,3035,2893,142,4.7
CN2801100000000,2022-11-01,28,011,MS,Bolivar County,10856,10388,468,4.3
CN2801300000000,2022-11-01,28,013,MS,Calhoun County,5168,4966,202,3.9
CN2801500000000,2022-11-01,28,015,MS,Carroll County,3198,3059,139,4.3
CN2801700000000,2022-11-01,28,017,MS,Chickasaw County,6310,6067,243,3.9
CN2801900000000,2022-11-01,28,019,MS,Choctaw County,3479,3363,116,3.3
CN2802100000000,2022-11-01,28,021,MS,Claiborne County,2828,2635,193,6.8
CN2802300000000,2022-11-01,28,023,MS,Clarke County,5469,5237,232,4.2
CN2802500000000,2022-11-01,28,025,MS,Clay County,8762,8445,317,3.6
CN2802700000000,2022-11-01,28,027,MS,Coahoma County,7365,6991,374,5.1
CN2802900000000,2022-11-01,28,029,MS,Copiah County,10700,10267,433,4
CN2803100000000,2022-11-01,28,031,MS,Covington County,8025,7776,249,3.1
CN2803300000000,2022-11-01,28,033,MS,DeSoto County,93043,90298,2745,3
CN2803500000000,2022-11-01,28,035,MS,Forrest County,33299,32189,1110,3.3
CN2803700000000,2022-11-01,28,037,MS,Franklin County,2584,2442,142,5.5
CN2803900000000,2022-11-01,28,039,MS,George County,8500,8135,365,4.3
CN2804100000000,2022-11-01,28,041,MS,Greene County,4098,3888,210,5.1
CN2804300000000,2022-11-01,28,043,MS,Grenada County,8452,8156,296,3.5
CN2804500000000,2022-11-01,28,045,MS,Hancock County,18549,17867,682,3.7
CN2804700000000,2022-11-01,28,047,MS,Harrison County,85790,82811,2979,3.5
CN2804900000000,2022-11-01,28,049,MS,Hinds County,101450,97960,3490,3.4
CN2805100000000,2022-11-01,28,051,MS,Holmes County,4994,4713,281,5.6
CN2805300000000,2022-11-01,28,053,MS,Humphreys County,1858,1740,118,6.4
CN2805500000000,2022-11-01,28,055,MS,Issaquena County,297,277,20,6.7
CN2805700000000,2022-11-01,28,057,MS,Itawamba County,10059,9740,319,3.2
CN2805900000000,2022-11-01,28,059,MS,Jackson County,57510,55321,2189,3.8
CN2806100000000,2022-11-01,28,061,MS,Jasper County,5770,5498,272,4.7
CN2806300000000,2022-11-01,28,063,MS,Jefferson County,1788,1596,192,10.7
CN2806500000000,2022-11-01,28,065,MS,Jefferson Davis County,3849,3672,177,4.6
CN2806700000000,2022-11-01,28,067,MS,Jones County,24611,23705,906,3.7
CN2806900000000,2022-11-01,28,069,MS,Kemper County,3178,2982,196,6.2
CN2807100000000,2022-11-01,28,071,MS,Lafayette County,28374,27598,776,2.7
CN2807300000000,2022-11-01,28,073,MS,Lamar County,31716,30874,842,2.7
CN2807500000000,2022-11-01,28,075,MS,Lauderdale County,28376,27297,1079,3.8
CN2807700000000,2022-11-01,28,077,MS,Lawrence County,4749,4547,202,4.3
CN2807900000000,2022-11-01,28,079,MS,Leake County,7825,7538,287,3.7
CN2808100000000,2022-11-01,28,081,MS,Lee County,40084,38882,1202,3
CN2808300000000,2022-11-01,28,083,MS,Leflore County,9037,8574,463,5.1
CN2808500000000,2022-11-01,28,085,MS,Lincoln County,14395,13904,491,3.4
CN2808700000000,2022-11-01,28,087,MS,Lowndes County,24488,23585,903,3.7
CN2808900000000,2022-11-01,28,089,MS,Madison County,53210,51726,1484,2.8
CN2809100000000,2022-11-01,28,091,MS,Marion County,9808,9449,359,3.7
CN2809300000000,2022-11-01,28,093,MS,Marshall County,14078,13565,513,3.6
CN2809500000000,2022-11-01,28,095,MS,Monroe County,15072,14532,540,3.6
CN2809700000000,2022-11-01,28,097,MS,Montgomery County,3808,3662,146,3.8
CN2809900000000,2022-11-01,28,099,MS,Neshoba County,9576,9173,403,4.2
CN2810100000000,2022-11-01,28,101,MS,Newton County,7769,7461,308,4
CN2810300000000,2022-11-01,28,103,MS,Noxubee County,3240,3071,169,5.2
CN2810500000000,2022-11-01,28,105,MS,Oktibbeha County,22487,21697,790,3.5
CN2810700000000,2022-11-01,28,107,MS,Panola County,12108,11607,501,4.1
CN2810900000000,2022-11-01,28,109,MS,Pearl River County,23147,22344,803,3.5
CN2811100000000,2022-11-01,28,111,MS,Perry County,4230,4049,181,4.3
CN2811300000000,2022-11-01,28,113,MS,Pike County,13712,13126,586,4.3
CN2811500000000,2022-11-01,28,115,MS,Pontotoc County,14568,14123,445,3.1
CN2811700000000,2022-11-01,28,117,MS,Prentiss County,11151,10819,332,3
CN2811900000000,2022-11-01,28,119,MS,Quitman County,2194,2078,116,5.3
CN2812100000000,2022-11-01,28,121,MS,Rankin County,76521,74474,2047,2.7
CN2812300000000,2022-11-01,28,123,MS,Scott County,12146,11790,356,2.9
CN2812500000000,2022-11-01,28,125,MS,Sharkey County,1252,1192,60,4.8
CN2812700000000,2022-11-01,28,127,MS,Simpson County,10527,10162,365,3.5
CN2812900000000,2022-11-01,28,129,MS,Smith County,6456,6245,211,3.3
CN2813100000000,2022-11-01,28,131,MS,Stone County,6952,6698,254,3.7
CN2813300000000,2022-11-01,28,133,MS,Sunflower County,6997,6617,380,5.4
CN2813500000000,2022-11-01,28,135,MS,Tallahatchie County,4402,4240,162,3.7
CN2813700000000,2022-11-01,28,137,MS,Tate County,11966,11552,414,3.5
CN2813900000000,2022-11-01,28,139,MS,Tippah County,9743,9438,305,3.1
CN2814100000000,2022-11-01,28,141,MS,Tishomingo County,8471,8193,278,3.3
CN2814300000000,2022-11-01,28,143,MS,Tunica County,4090,3931,159,3.9
CN2814500000000,2022-11-01,28,145,MS,Union County,14497,14118,379,2.6
CN2814700000000,2022-11-01,28,147,MS,Walthall County,4814,4595,219,4.5
CN2814900000000,2022-11-01,28,149,MS,Warren County,19016,18329,687,3.6
CN2815100000000,2022-11-01,28,151,MS,Washington County,14293,13546,747,5.2
CN2815300000000,2022-11-01,28,153,MS,Wayne County,6849,6556,293,4.3
CN2815500000000,2022-11-01,28,155,MS,Webster County,3758,3628,130,3.5
CN2815700000000,2022-11-01,28,157,MS,Wilkinson County,2518,2387,131,5.2
CN2815900000000,2022-11-01,28,159,MS,Winston County,7022,6746,276,3.9
CN2816100000000,2022-11-01,28,161,MS,Yalobusha County,4632,4455,177,3.8
CN2816300000000,2022-11-01,28,163,MS,Yazoo County,8711,8380,331,3.8
CN2900100000000,2022-11-01,29,001,MO,Adair County,9771,9502,269,2.8
CN2900300000000,2022-11-01,29,003,MO,Andrew County,9301,9130,171,1.8
CN2900500000000,2022-11-01,29,005,MO,Atchison County,2431,2380,51,2.1
CN2900700000000,2022-11-01,29,007,MO,Audrain County,9797,9520,277,2.8
CN2900900000000,2022-11-01,29,009,MO,Barry County,13792,13432,360,2.6
CN2901100000000,2022-11-01,29,011,MO,Barton County,5110,4997,113,2.2
CN2901300000000,2022-11-01,29,013,MO,Bates County,7552,7374,178,2.4
CN2901500000000,2022-11-01,29,015,MO,Benton County,7156,6914,242,3.4
CN2901700000000,2022-11-01,29,017,MO,Bollinger County,5255,5129,126,2.4
CN2901900000000,2022-11-01,29,019,MO,Boone County,100277,98459,1818,1.8
CN2902100000000,2022-11-01,29,021,MO,Buchanan County,41872,40964,908,2.2
CN2902300000000,2022-11-01,29,023,MO,Butler County,17773,17298,475,2.7
CN2902500000000,2022-11-01,29,025,MO,Caldwell County,4184,4087,97,2.3
CN2902700000000,2022-11-01,29,027,MO,Callaway County,21519,21089,430,2
CN2902900000000,2022-11-01,29,029,MO,Camden County,18160,17605,555,3.1
CN2903100000000,2022-11-01,29,031,MO,Cape Girardeau County,40591,39771,820,2
CN2903300000000,2022-11-01,29,033,MO,Carroll County,4315,4224,91,2.1
CN2903500000000,2022-11-01,29,035,MO,Carter County,2403,2323,80,3.3
CN2903700000000,2022-11-01,29,037,MO,Cass County,55095,53904,1191,2.2
CN2903900000000,2022-11-01,29,039,MO,Cedar County,5489,5349,140,2.6
CN2904100000000,2022-11-01,29,041,MO,Chariton County,3617,3554,63,1.7
CN2904300000000,2022-11-01,29,043,MO,Christian County,47687,46805,882,1.8
CN2904500000000,2022-11-01,29,045,MO,Clark County,2924,2831,93,3.2
CN2904700000000,2022-11-01,29,047,MO,Clay County,139019,136223,2796,2
CN2904900000000,2022-11-01,29,049,MO,Clinton County,10536,10311,225,2.1
CN2905100000000,2022-11-01,29,051,MO,Cole County,39250,38529,721,1.8
CN2905300000000,2022-11-01,29,053,MO,Cooper County,7013,6860,153,2.2
CN2905500000000,2022-11-01,29,055,MO,Crawford County,10606,10350,256,2.4
CN2905700000000,2022-11-01,29,057,MO,Dade County,3381,3313,68,2
CN2905900000000,2022-11-01,29,059,MO,Dallas County,7169,6991,178,2.5
CN2906100000000,2022-11-01,29,061,MO,Daviess County,3850,3769,81,2.1
CN2906300000000,2022-11-01,29,063,MO,DeKalb County,3934,3857,77,2
CN2906500000000,2022-11-01,29,065,MO,Dent County,6021,5839,182,3
CN2906700000000,2022-11-01,29,067,MO,Douglas County,5150,5017,133,2.6
CN2906900000000,2022-11-01,29,069,MO,Dunklin County,10644,10232,412,3.9
CN2907100000000,2022-11-01,29,071,MO,Franklin County,52921,51832,1089,2.1
CN2907300000000,2022-11-01,29,073,MO,Gasconade County,7578,7418,160,2.1
CN2907500000000,2022-11-01,29,075,MO,Gentry County,3043,2985,58,1.9
CN2907700000000,2022-11-01,29,077,MO,Greene County,155967,152929,3038,1.9
CN2907900000000,2022-11-01,29,079,MO,Grundy County,3917,3823,94,2.4
CN2908100000000,2022-11-01,29,081,MO,Harrison County,3573,3500,73,2
CN2908300000000,2022-11-01,29,083,MO,Henry County,10137,9905,232,2.3
CN2908500000000,2022-11-01,29,085,MO,Hickory County,3867,3768,99,2.6
CN2908700000000,2022-11-01,29,087,MO,Holt County,2344,2305,39,1.7
CN2908900000000,2022-11-01,29,089,MO,Howard County,4679,4580,99,2.1
CN2909100000000,2022-11-01,29,091,MO,Howell County,15827,15391,436,2.8
CN2909300000000,2022-11-01,29,093,MO,Iron County,3443,3314,129,3.7
CN2909500000000,2022-11-01,29,095,MO,Jackson County,361628,352541,9087,2.5
CN2909700000000,2022-11-01,29,097,MO,Jasper County,56683,55429,1254,2.2
CN2909900000000,2022-11-01,29,099,MO,Jefferson County,118424,115937,2487,2.1
CN2910100000000,2022-11-01,29,101,MO,Johnson County,22761,22229,532,2.3
CN2910300000000,2022-11-01,29,103,MO,Knox County,1642,1602,40,2.4
CN2910500000000,2022-11-01,29,105,MO,Laclede County,16537,16140,397,2.4
CN2910700000000,2022-11-01,29,107,MO,Lafayette County,16626,16263,363,2.2
CN2910900000000,2022-11-01,29,109,MO,Lawrence County,16928,16552,376,2.2
CN2911100000000,2022-11-01,29,111,MO,Lewis County,4632,4526,106,2.3
CN2911300000000,2022-11-01,29,113,MO,Lincoln County,29192,28537,655,2.2
CN2911500000000,2022-11-01,29,115,MO,Linn County,5080,4936,144,2.8
CN2911700000000,2022-11-01,29,117,MO,Livingston County,7046,6926,120,1.7
CN2911900000000,2022-11-01,29,119,MO,McDonald County,11123,10887,236,2.1
CN2912100000000,2022-11-01,29,121,MO,Macon County,7012,6860,152,2.2
CN2912300000000,2022-11-01,29,123,MO,Madison County,5324,5180,144,2.7
CN2912500000000,2022-11-01,29,125,MO,Maries County,3793,3708,85,2.2
CN2912700000000,2022-11-01,29,127,MO,Marion County,13704,13410,294,2.1
CN2912900000000,2022-11-01,29,129,MO,Mercer County,1582,1546,36,2.3
CN2913100000000,2022-11-01,29,131,MO,Miller County,12545,12254,291,2.3
CN2913300000000,2022-11-01,29,133,MO,Mississippi County,5026,4879,147,2.9
CN2913500000000,2022-11-01,29,135,MO,Moniteau County,6950,6823,127,1.8
CN2913700000000,2022-11-01,29,137,MO,Monroe County,3655,3570,85,2.3
CN2913900000000,2022-11-01,29,139,MO,Montgomery County,5720,5598,122,2.1
CN2914100000000,2022-11-01,29,141,MO,Morgan County,7917,7680,237,3
CN2914300000000,2022-11-01,29,143,MO,New Madrid County,7876,7669,207,2.6
CN2914500000000,2022-11-01,29,145,MO,Newton County,26716,26123,593,2.2
CN2914700000000,2022-11-01,29,147,MO,Nodaway County,10915,10699,216,2
CN2914900000000,2022-11-01,29,149,MO,Oregon County,3712,3599,113,3
CN2915100000000,2022-11-01,29,151,MO,Osage County,6990,6861,129,1.8
CN2915300000000,2022-11-01,29,153,MO,Ozark County,3306,3185,121,3.7
CN2915500000000,2022-11-01,29,155,MO,Pemiscot County,5613,5426,187,3.3
CN2915700000000,2022-11-01,29,157,MO,Perry County,9399,9223,176,1.9
CN2915900000000,2022-11-01,29,159,MO,Pettis County,19881,19433,448,2.3
CN2916100000000,2022-11-01,29,161,MO,Phelps County,19978,19507,471,2.4
CN2916300000000,2022-11-01,29,163,MO,Pike County,7127,6983,144,2
CN2916500000000,2022-11-01,29,165,MO,Platte County,60160,59036,1124,1.9
CN2916700000000,2022-11-01,29,167,MO,Polk County,14703,14370,333,2.3
CN2916900000000,2022-11-01,29,169,MO,Pulaski County,14478,14098,380,2.6
CN2917100000000,2022-11-01,29,171,MO,Putnam County,2050,2008,42,2
CN2917300000000,2022-11-01,29,173,MO,Ralls County,5370,5253,117,2.2
CN2917500000000,2022-11-01,29,175,MO,Randolph County,10158,9924,234,2.3
CN2917700000000,2022-11-01,29,177,MO,Ray County,10811,10570,241,2.2
CN2917900000000,2022-11-01,29,179,MO,Reynolds County,2686,2609,77,2.9
CN2918100000000,2022-11-01,29,181,MO,Ripley County,5065,4925,140,2.8
CN2918300000000,2022-11-01,29,183,MO,St. Charles County,229418,225232,4186,1.8
CN2918500000000,2022-11-01,29,185,MO,St. Clair County,3744,3645,99,2.6
CN2918600000000,2022-11-01,29,186,MO,Ste. Genevieve County,9137,8953,184,2
CN2918700000000,2022-11-01,29,187,MO,St. Francois County,25482,24693,789,3.1
CN2918900000000,2022-11-01,29,189,MO,St. Louis County,527909,516190,11719,2.2
CN2919500000000,2022-11-01,29,195,MO,Saline County,10187,9951,236,2.3
CN2919700000000,2022-11-01,29,197,MO,Schuyler County,1747,1701,46,2.6
CN2919900000000,2022-11-01,29,199,MO,Scotland County,2164,2123,41,1.9
CN2920100000000,2022-11-01,29,201,MO,Scott County,19744,19329,415,2.1
CN2920300000000,2022-11-01,29,203,MO,Shannon County,3158,3037,121,3.8
CN2920500000000,2022-11-01,29,205,MO,Shelby County,2855,2802,53,1.9
CN2920700000000,2022-11-01,29,207,MO,Stoddard County,12697,12364,333,2.6
CN2920900000000,2022-11-01,29,209,MO,Stone County,13177,12774,403,3.1
CN2921100000000,2022-11-01,29,211,MO,Sullivan County,2468,2410,58,2.4
CN2921300000000,2022-11-01,29,213,MO,Taney County,25198,24494,704,2.8
CN2921500000000,2022-11-01,29,215,MO,Texas County,8955,8700,255,2.8
CN2921700000000,2022-11-01,29,217,MO,Vernon County,8949,8733,216,2.4
CN2921900000000,2022-11-01,29,219,MO,Warren County,18733,18327,406,2.2
CN2922100000000,2022-11-01,29,221,MO,Washington County,9931,9645,286,2.9
CN2922300000000,2022-11-01,29,223,MO,Wayne County,4683,4526,157,3.4
CN2922500000000,2022-11-01,29,225,MO,Webster County,17562,17213,349,2
CN2922700000000,2022-11-01,29,227,MO,Worth County,1093,1071,22,2
CN2922900000000,2022-11-01,29,229,MO,Wright County,7358,7169,189,2.6
CN2951000000000,2022-11-01,29,510,MO,St. Louis city,149066,144880,4186,2.8
CN3000100000000,2022-11-01,30,001,MT,Beaverhead County,5604,5512,92,1.6
CN3000300000000,2022-11-01,30,003,MT,Big Horn County,4697,4533,164,3.5
CN3000500000000,2022-11-01,30,005,MT,Blaine County,2237,2177,60,2.7
CN3000700000000,2022-11-01,30,007,MT,Broadwater County,2808,2723,85,3
CN3000900000000,2022-11-01,30,009,MT,Carbon County,5754,5621,133,2.3
CN3001100000000,2022-11-01,30,011,MT,Carter County,728,717,11,1.5
CN3001300000000,2022-11-01,30,013,MT,Cascade County,39408,38451,957,2.4
CN3001500000000,2022-11-01,30,015,MT,Chouteau County,2576,2534,42,1.6
CN3001700000000,2022-11-01,30,017,MT,Custer County,6361,6253,108,1.7
CN3001900000000,2022-11-01,30,019,MT,Daniels County,889,874,15,1.7
CN3002100000000,2022-11-01,30,021,MT,Dawson County,4592,4507,85,1.9
CN3002300000000,2022-11-01,30,023,MT,Deer Lodge County,5395,5274,121,2.2
CN3002500000000,2022-11-01,30,025,MT,Fallon County,1672,1650,22,1.3
CN3002700000000,2022-11-01,30,027,MT,Fergus County,5931,5795,136,2.3
CN3002900000000,2022-11-01,30,029,MT,Flathead County,51691,50234,1457,2.8
CN3003100000000,2022-11-01,30,031,MT,Gallatin County,77483,76080,1403,1.8
CN3003300000000,2022-11-01,30,033,MT,Garfield County,777,747,30,3.9
CN3003500000000,2022-11-01,30,035,MT,Glacier County,5626,5381,245,4.4
CN3003700000000,2022-11-01,30,037,MT,Golden Valley County,376,367,9,2.4
CN3003900000000,2022-11-01,30,039,MT,Granite County,1615,1564,51,3.2
CN3004100000000,2022-11-01,30,041,MT,Hill County,7583,7449,134,1.8
CN3004300000000,2022-11-01,30,043,MT,Jefferson County,6148,6015,133,2.2
CN3004500000000,2022-11-01,30,045,MT,Judith Basin County,1061,1042,19,1.8
CN3004700000000,2022-11-01,30,047,MT,Lake County,14359,13997,362,2.5
CN3004900000000,2022-11-01,30,049,MT,Lewis and Clark County,38823,38045,778,2
CN3005100000000,2022-11-01,30,051,MT,Liberty County,1022,1002,20,2
CN3005300000000,2022-11-01,30,053,MT,Lincoln County,8600,8252,348,4
CN3005500000000,2022-11-01,30,055,MT,McCone County,1009,994,15,1.5
CN3005700000000,2022-11-01,30,057,MT,Madison County,4992,4888,104,2.1
CN3005900000000,2022-11-01,30,059,MT,Meagher County,1002,982,20,2
CN3006100000000,2022-11-01,30,061,MT,Mineral County,1840,1755,85,4.6
CN3006300000000,2022-11-01,30,063,MT,Missoula County,67315,65864,1451,2.2
CN3006500000000,2022-11-01,30,065,MT,Musselshell County,2359,2299,60,2.5
CN3006700000000,2022-11-01,30,067,MT,Park County,9867,9585,282,2.9
CN3006900000000,2022-11-01,30,069,MT,Petroleum County,279,271,8,2.9
CN3007100000000,2022-11-01,30,071,MT,Phillips County,1860,1800,60,3.2
CN3007300000000,2022-11-01,30,073,MT,Pondera County,2664,2607,57,2.1
CN3007500000000,2022-11-01,30,075,MT,Powder River County,1053,1037,16,1.5
CN3007700000000,2022-11-01,30,077,MT,Powell County,2954,2881,73,2.5
CN3007900000000,2022-11-01,30,079,MT,Prairie County,498,484,14,2.8
CN3008100000000,2022-11-01,30,081,MT,Ravalli County,21885,21375,510,2.3
CN3008300000000,2022-11-01,30,083,MT,Richland County,5983,5868,115,1.9
CN3008500000000,2022-11-01,30,085,MT,Roosevelt County,4406,4302,104,2.4
CN3008700000000,2022-11-01,30,087,MT,Rosebud County,3605,3497,108,3
CN3008900000000,2022-11-01,30,089,MT,Sanders County,5423,5218,205,3.8
CN3009100000000,2022-11-01,30,091,MT,Sheridan County,1766,1743,23,1.3
CN3009300000000,2022-11-01,30,093,MT,Silver Bow County,17715,17296,419,2.4
CN3009500000000,2022-11-01,30,095,MT,Stillwater County,5448,5353,95,1.7
CN3009700000000,2022-11-01,30,097,MT,Sweet Grass County,1904,1874,30,1.6
CN3009900000000,2022-11-01,30,099,MT,Teton County,2858,2785,73,2.6
CN3010100000000,2022-11-01,30,101,MT,Toole County,2128,2095,33,1.6
CN3010300000000,2022-11-01,30,103,MT,Treasure County,365,358,7,1.9
CN3010500000000,2022-11-01,30,105,MT,Valley County,4037,3968,69,1.7
CN3010700000000,2022-11-01,30,107,MT,Wheatland County,788,760,28,3.6
CN3010900000000,2022-11-01,30,109,MT,Wibaux County,448,441,7,1.6
CN3011100000000,2022-11-01,30,111,MT,Yellowstone County,85759,84088,1671,1.9
CN3100100000000,2022-11-01,31,001,NE,Adams County,17174,16826,348,2
CN3100300000000,2022-11-01,31,003,NE,Antelope County,3653,3585,68,1.9
CN3100500000000,2022-11-01,31,005,NE,Arthur County,235,228,7,3
CN3100700000000,2022-11-01,31,007,NE,Banner County,390,376,14,3.6
CN3100900000000,2022-11-01,31,009,NE,Blaine County,245,236,9,3.7
CN3101100000000,2022-11-01,31,011,NE,Boone County,3005,2957,48,1.6
CN3101300000000,2022-11-01,31,013,NE,Box Butte County,5285,5169,116,2.2
CN3101500000000,2022-11-01,31,015,NE,Boyd County,1023,999,24,2.3
CN3101700000000,2022-11-01,31,017,NE,Brown County,1404,1371,33,2.4
CN3101900000000,2022-11-01,31,019,NE,Buffalo County,28545,27984,561,2
CN3102100000000,2022-11-01,31,021,NE,Burt County,3540,3464,76,2.1
CN3102300000000,2022-11-01,31,023,NE,Butler County,4708,4620,88,1.9
CN3102500000000,2022-11-01,31,025,NE,Cass County,13730,13420,310,2.3
CN3102700000000,2022-11-01,31,027,NE,Cedar County,4635,4545,90,1.9
CN3102900000000,2022-11-01,31,029,NE,Chase County,2239,2197,42,1.9
CN3103100000000,2022-11-01,31,031,NE,Cherry County,3326,3264,62,1.9
CN3103300000000,2022-11-01,31,033,NE,Cheyenne County,4222,4116,106,2.5
CN3103500000000,2022-11-01,31,035,NE,Clay County,3080,3014,66,2.1
CN3103700000000,2022-11-01,31,037,NE,Colfax County,5756,5642,114,2
CN3103900000000,2022-11-01,31,039,NE,Cuming County,4833,4734,99,2
CN3104100000000,2022-11-01,31,041,NE,Custer County,6291,6180,111,1.8
CN3104300000000,2022-11-01,31,043,NE,Dakota County,11108,10824,284,2.6
CN3104500000000,2022-11-01,31,045,NE,Dawes County,5023,4907,116,2.3
CN3104700000000,2022-11-01,31,047,NE,Dawson County,13592,13292,300,2.2
CN3104900000000,2022-11-01,31,049,NE,Deuel County,1042,1013,29,2.8
CN3105100000000,2022-11-01,31,051,NE,Dixon County,3060,2996,64,2.1
CN3105300000000,2022-11-01,31,053,NE,Dodge County,20831,20410,421,2
CN3105500000000,2022-11-01,31,055,NE,Douglas County,307653,300026,7627,2.5
CN3105700000000,2022-11-01,31,057,NE,Dundy County,1177,1160,17,1.4
CN3105900000000,2022-11-01,31,059,NE,Fillmore County,3338,3277,61,1.8
CN3106100000000,2022-11-01,31,061,NE,Franklin County,1553,1515,38,2.4
CN3106300000000,2022-11-01,31,063,NE,Frontier County,1530,1495,35,2.3
CN3106500000000,2022-11-01,31,065,NE,Furnas County,2510,2455,55,2.2
CN3106700000000,2022-11-01,31,067,NE,Gage County,10749,10515,234,2.2
CN3106900000000,2022-11-01,31,069,NE,Garden County,1095,1072,23,2.1
CN3107100000000,2022-11-01,31,071,NE,Garfield County,1124,1103,21,1.9
CN3107300000000,2022-11-01,31,073,NE,Gosper County,1181,1155,26,2.2
CN3107500000000,2022-11-01,31,075,NE,Grant County,428,421,7,1.6
CN3107700000000,2022-11-01,31,077,NE,Greeley County,1209,1186,23,1.9
CN3107900000000,2022-11-01,31,079,NE,Hall County,32837,32094,743,2.3
CN3108100000000,2022-11-01,31,081,NE,Hamilton County,4922,4818,104,2.1
CN3108300000000,2022-11-01,31,083,NE,Harlan County,1794,1759,35,2
CN3108500000000,2022-11-01,31,085,NE,Hayes County,590,581,9,1.5
CN3108700000000,2022-11-01,31,087,NE,Hitchcock County,1291,1260,31,2.4
CN3108900000000,2022-11-01,31,089,NE,Holt County,5587,5471,116,2.1
CN3109100000000,2022-11-01,31,091,NE,Hooker County,372,362,10,2.7
CN3109300000000,2022-11-01,31,093,NE,Howard County,3493,3419,74,2.1
CN3109500000000,2022-11-01,31,095,NE,Jefferson County,4184,4099,85,2
CN3109700000000,2022-11-01,31,097,NE,Johnson County,2016,1959,57,2.8
CN3109900000000,2022-11-01,31,099,NE,Kearney County,3745,3674,71,1.9
CN3110100000000,2022-11-01,31,101,NE,Keith County,4624,4541,83,1.8
CN3110300000000,2022-11-01,31,103,NE,Keya Paha County,548,536,12,2.2
CN3110500000000,2022-11-01,31,105,NE,Kimball County,1948,1910,38,2
CN3110700000000,2022-11-01,31,107,NE,Knox County,4600,4500,100,2.2
CN3110900000000,2022-11-01,31,109,NE,Lancaster County,181430,177440,3990,2.2
CN3111100000000,2022-11-01,31,111,NE,Lincoln County,18276,17886,390,2.1
CN3111300000000,2022-11-01,31,113,NE,Logan County,487,473,14,2.9
CN3111500000000,2022-11-01,31,115,NE,Loup County,410,398,12,2.9
CN3111700000000,2022-11-01,31,117,NE,McPherson County,437,427,10,2.3
CN3111900000000,2022-11-01,31,119,NE,Madison County,19849,19444,405,2
CN3112100000000,2022-11-01,31,121,NE,Merrick County,4195,4114,81,1.9
CN3112300000000,2022-11-01,31,123,NE,Morrill County,2620,2565,55,2.1
CN3112500000000,2022-11-01,31,125,NE,Nance County,1943,1903,40,2.1
CN3112700000000,2022-11-01,31,127,NE,Nemaha County,3676,3581,95,2.6
CN3112900000000,2022-11-01,31,129,NE,Nuckolls County,2481,2422,59,2.4
CN3113100000000,2022-11-01,31,131,NE,Otoe County,8603,8423,180,2.1
CN3113300000000,2022-11-01,31,133,NE,Pawnee County,1475,1446,29,2
CN3113500000000,2022-11-01,31,135,NE,Perkins County,1835,1804,31,1.7
CN3113700000000,2022-11-01,31,137,NE,Phelps County,4989,4895,94,1.9
CN3113900000000,2022-11-01,31,139,NE,Pierce County,4177,4103,74,1.8
CN3114100000000,2022-11-01,31,141,NE,Platte County,18547,18187,360,1.9
CN3114300000000,2022-11-01,31,143,NE,Polk County,2883,2819,64,2.2
CN3114500000000,2022-11-01,31,145,NE,Red Willow County,5885,5772,113,1.9
CN3114700000000,2022-11-01,31,147,NE,Richardson County,4130,4052,78,1.9
CN3114900000000,2022-11-01,31,149,NE,Rock County,903,889,14,1.6
CN3115100000000,2022-11-01,31,151,NE,Saline County,7183,6999,184,2.6
CN3115300000000,2022-11-01,31,153,NE,Sarpy County,100395,98201,2194,2.2
CN3115500000000,2022-11-01,31,155,NE,Saunders County,11587,11360,227,2
CN3115700000000,2022-11-01,31,157,NE,Scotts Bluff County,17972,17506,466,2.6
CN3115900000000,2022-11-01,31,159,NE,Seward County,8941,8738,203,2.3
CN3116100000000,2022-11-01,31,161,NE,Sheridan County,2783,2726,57,2
CN3116300000000,2022-11-01,31,163,NE,Sherman County,1641,1610,31,1.9
CN3116500000000,2022-11-01,31,165,NE,Sioux County,761,745,16,2.1
CN3116700000000,2022-11-01,31,167,NE,Stanton County,3537,3464,73,2.1
CN3116900000000,2022-11-01,31,169,NE,Thayer County,2682,2628,54,2
CN3117100000000,2022-11-01,31,171,NE,Thomas County,443,433,10,2.3
CN3117300000000,2022-11-01,31,173,NE,Thurston County,3254,3152,102,3.1
CN3117500000000,2022-11-01,31,175,NE,Valley County,2097,2047,50,2.4
CN3117700000000,2022-11-01,31,177,NE,Washington County,11558,11319,239,2.1
CN3117900000000,2022-11-01,31,179,NE,Wayne County,5993,5863,130,2.2
CN3118100000000,2022-11-01,31,181,NE,Webster County,1682,1630,52,3.1
CN3118300000000,2022-11-01,31,183,NE,Wheeler County,564,554,10,1.8
CN3118500000000,2022-11-01,31,185,NE,York County,7364,7203,161,2.2
CN3200100000000,2022-11-01,32,001,NV,Churchill County,10564,10118,446,4.2
CN3200300000000,2022-11-01,32,003,NV,Clark County,1160010,1092988,67022,5.8
CN3200500000000,2022-11-01,32,005,NV,Douglas County,21958,21004,954,4.3
CN3200700000000,2022-11-01,32,007,NV,Elko County,24944,24063,881,3.5
CN3200900000000,2022-11-01,32,009,NV,Esmeralda County,378,362,16,4.2
CN3201100000000,2022-11-01,32,011,NV,Eureka County,890,853,37,4.2
CN3201300000000,2022-11-01,32,013,NV,Humboldt County,7387,7111,276,3.7
CN3201500000000,2022-11-01,32,015,NV,Lander County,2889,2798,91,3.1
CN3201700000000,2022-11-01,32,017,NV,Lincoln County,1933,1841,92,4.8
CN3201900000000,2022-11-01,32,019,NV,Lyon County,23323,22107,1216,5.2
CN3202100000000,2022-11-01,32,021,NV,Mineral County,1956,1874,82,4.2
CN3202300000000,2022-11-01,32,023,NV,Nye County,17558,16477,1081,6.2
CN3202700000000,2022-11-01,32,027,NV,Pershing County,2245,2151,94,4.2
CN3202900000000,2022-11-01,32,029,NV,Storey County,2115,2027,88,4.2
CN3203100000000,2022-11-01,32,031,NV,Washoe County,258955,249572,9383,3.6
CN3203300000000,2022-11-01,32,033,NV,White Pine County,4376,4229,147,3.4
CN3251000000000,2022-11-01,32,510,NV,Carson City,25329,24267,1062,4.2
CN3300100000000,2022-11-01,33,001,NH,Belknap County,30740,29902,838,2.7
CN3300300000000,2022-11-01,33,003,NH,Carroll County,22567,21864,703,3.1
CN3300500000000,2022-11-01,33,005,NH,Cheshire County,39276,38231,1045,2.7
CN3300700000000,2022-11-01,33,007,NH,Coos County,14160,13675,485,3.4
CN3300900000000,2022-11-01,33,009,NH,Grafton County,48406,47212,1194,2.5
CN3301100000000,2022-11-01,33,011,NH,Hillsborough County,242658,236100,6558,2.7
CN3301300000000,2022-11-01,33,013,NH,Merrimack County,82655,80689,1966,2.4
CN3301500000000,2022-11-01,33,015,NH,Rockingham County,188633,183436,5197,2.8
CN3301700000000,2022-11-01,33,017,NH,Strafford County,74520,72738,1782,2.4
CN3301900000000,2022-11-01,33,019,NH,Sullivan County,22746,22166,580,2.5
CN3400100000000,2022-11-01,34,001,NJ,Atlantic County,123158,118015,5143,4.2
CN3400300000000,2022-11-01,34,003,NJ,Bergen County,509348,495536,13812,2.7
CN3400500000000,2022-11-01,34,005,NJ,Burlington County,248908,241892,7016,2.8
CN3400700000000,2022-11-01,34,007,NJ,Camden County,271646,262486,9160,3.4
CN3400900000000,2022-11-01,34,009,NJ,Cape May County,43080,40195,2885,6.7
CN3401100000000,2022-11-01,34,011,NJ,Cumberland County,69185,66204,2981,4.3
CN3401300000000,2022-11-01,34,013,NJ,Essex County,388862,374166,14696,3.8
CN3401500000000,2022-11-01,34,015,NJ,Gloucester County,161923,156937,4986,3.1
CN3401700000000,2022-11-01,34,017,NJ,Hudson County,380941,369668,11273,3
CN3401900000000,2022-11-01,34,019,NJ,Hunterdon County,68267,66630,1637,2.4
CN3402100000000,2022-11-01,34,021,NJ,Mercer County,218419,212557,5862,2.7
CN3402300000000,2022-11-01,34,023,NJ,Middlesex County,465535,452396,13139,2.8
CN3402500000000,2022-11-01,34,025,NJ,Monmouth County,350098,340549,9549,2.7
CN3402700000000,2022-11-01,34,027,NJ,Morris County,269817,263019,6798,2.5
CN3402900000000,2022-11-01,34,029,NJ,Ocean County,300106,290876,9230,3.1
CN3403100000000,2022-11-01,34,031,NJ,Passaic County,254670,245296,9374,3.7
CN3403300000000,2022-11-01,34,033,NJ,Salem County,30508,29310,1198,3.9
CN3403500000000,2022-11-01,34,035,NJ,Somerset County,179842,175249,4593,2.6
CN3403700000000,2022-11-01,34,037,NJ,Sussex County,77698,75401,2297,3
CN3403900000000,2022-11-01,34,039,NJ,Union County,290047,280764,9283,3.2
CN3404100000000,2022-11-01,34,041,NJ,Warren County,58999,57390,1609,2.7
CN3500100000000,2022-11-01,35,001,NM,Bernalillo County,338599,329197,9402,2.8
CN3500300000000,2022-11-01,35,003,NM,Catron County,1102,1058,44,4
CN3500500000000,2022-11-01,35,005,NM,Chaves County,27375,26457,918,3.4
CN3500600000000,2022-11-01,35,006,NM,Cibola County,8017,7673,344,4.3
CN3500700000000,2022-11-01,35,007,NM,Colfax County,5132,4973,159,3.1
CN3500900000000,2022-11-01,35,009,NM,Curry County,21791,21243,548,2.5
CN3501100000000,2022-11-01,35,011,NM,De Baca County,700,679,21,3
CN3501300000000,2022-11-01,35,013,NM,Dona Ana County,100214,96654,3560,3.6
CN3501500000000,2022-11-01,35,015,NM,Eddy County,31899,31138,761,2.4
CN3501700000000,2022-11-01,35,017,NM,Grant County,11530,11159,371,3.2
CN3501900000000,2022-11-01,35,019,NM,Guadalupe County,1461,1403,58,4
CN3502100000000,2022-11-01,35,021,NM,Harding County,289,283,6,2.1
CN3502300000000,2022-11-01,35,023,NM,Hidalgo County,1792,1742,50,2.8
CN3502500000000,2022-11-01,35,025,NM,Lea County,29012,28078,934,3.2
CN3502700000000,2022-11-01,35,027,NM,Lincoln County,8636,8369,267,3.1
CN3502800000000,2022-11-01,35,028,NM,Los Alamos County,10801,10628,173,1.6
CN3502900000000,2022-11-01,35,029,NM,Luna County,9543,8612,931,9.8
CN3503100000000,2022-11-01,35,031,NM,McKinley County,22916,21924,992,4.3
CN3503300000000,2022-11-01,35,033,NM,Mora County,1937,1852,85,4.4
CN3503500000000,2022-11-01,35,035,NM,Otero County,25562,24699,863,3.4
CN3503700000000,2022-11-01,35,037,NM,Quay County,2839,2744,95,3.3
CN3503900000000,2022-11-01,35,039,NM,Rio Arriba County,16384,15861,523,3.2
CN3504100000000,2022-11-01,35,041,NM,Roosevelt County,8070,7823,247,3.1
CN3504300000000,2022-11-01,35,043,NM,Sandoval County,68404,66386,2018,3
CN3504500000000,2022-11-01,35,045,NM,San Juan County,49880,48114,1766,3.5
CN3504700000000,2022-11-01,35,047,NM,San Miguel County,10332,9910,422,4.1
CN3504900000000,2022-11-01,35,049,NM,Santa Fe County,72494,70532,1962,2.7
CN3505100000000,2022-11-01,35,051,NM,Sierra County,3954,3776,178,4.5
CN3505300000000,2022-11-01,35,053,NM,Socorro County,6121,5907,214,3.5
CN3505500000000,2022-11-01,35,055,NM,Taos County,14544,13961,583,4
CN3505700000000,2022-11-01,35,057,NM,Torrance County,5515,5276,239,4.3
CN3505900000000,2022-11-01,35,059,NM,Union County,1565,1530,35,2.2
CN3506100000000,2022-11-01,35,061,NM,Valencia County,31218,30158,1060,3.4
CN3600100000000,2022-11-01,36,001,NY,Albany County,159321,154952,4369,2.7
CN3600300000000,2022-11-01,36,003,NY,Allegany County,19072,18386,686,3.6
CN3600500000000,2022-11-01,36,005,NY,Bronx County,601546,559702,41844,7
CN3600700000000,2022-11-01,36,007,NY,Broome County,81668,78987,2681,3.3
CN3600900000000,2022-11-01,36,009,NY,Cattaraugus County,32230,31014,1216,3.8
CN3601100000000,2022-11-01,36,011,NY,Cayuga County,35146,34117,1029,2.9
CN3601300000000,2022-11-01,36,013,NY,Chautauqua County,52688,50776,1912,3.6
CN3601500000000,2022-11-01,36,015,NY,Chemung County,34257,33095,1162,3.4
CN3601700000000,2022-11-01,36,017,NY,Chenango County,21395,20772,623,2.9
CN3601900000000,2022-11-01,36,019,NY,Clinton County,35208,34164,1044,3
CN3602100000000,2022-11-01,36,021,NY,Columbia County,29885,29170,715,2.4
CN3602300000000,2022-11-01,36,023,NY,Cortland County,22624,21837,787,3.5
CN3602500000000,2022-11-01,36,025,NY,Delaware County,18071,17474,597,3.3
CN3602700000000,2022-11-01,36,027,NY,Dutchess County,142623,138707,3916,2.7
CN3602900000000,2022-11-01,36,029,NY,Erie County,440995,426692,14303,3.2
CN3603100000000,2022-11-01,36,031,NY,Essex County,15768,15238,530,3.4
CN3603300000000,2022-11-01,36,033,NY,Franklin County,18644,18010,634,3.4
CN3603500000000,2022-11-01,36,035,NY,Fulton County,22279,21481,798,3.6
CN3603700000000,2022-11-01,36,037,NY,Genesee County,29176,28368,808,2.8
CN3603900000000,2022-11-01,36,039,NY,Greene County,19730,19098,632,3.2
CN3604100000000,2022-11-01,36,041,NY,Hamilton County,2077,1963,114,5.5
CN3604300000000,2022-11-01,36,043,NY,Herkimer County,26901,25953,948,3.5
CN3604500000000,2022-11-01,36,045,NY,Jefferson County,43284,41603,1681,3.9
CN3604700000000,2022-11-01,36,047,NY,Kings County,1207822,1144070,63752,5.3
CN3604900000000,2022-11-01,36,049,NY,Lewis County,11385,10992,393,3.5
CN3605100000000,2022-11-01,36,051,NY,Livingston County,29810,28951,859,2.9
CN3605300000000,2022-11-01,36,053,NY,Madison County,32762,31802,960,2.9
CN3605500000000,2022-11-01,36,055,NY,Monroe County,361817,350596,11221,3.1
CN3605700000000,2022-11-01,36,057,NY,Montgomery County,22185,21370,815,3.7
CN3605900000000,2022-11-01,36,059,NY,Nassau County,723601,705060,18541,2.6
CN3606100000000,2022-11-01,36,061,NY,New York County,919763,881705,38058,4.1
CN3606300000000,2022-11-01,36,063,NY,Niagara County,97143,93847,3296,3.4
CN3606500000000,2022-11-01,36,065,NY,Oneida County,98807,95602,3205,3.2
CN3606700000000,2022-11-01,36,067,NY,Onondaga County,224796,218271,6525,2.9
CN3606900000000,2022-11-01,36,069,NY,Ontario County,55200,53692,1508,2.7
CN3607100000000,2022-11-01,36,071,NY,Orange County,188983,183565,5418,2.9
CN3607300000000,2022-11-01,36,073,NY,Orleans County,16818,16269,549,3.3
CN3607500000000,2022-11-01,36,075,NY,Oswego County,52953,51011,1942,3.7
CN3607700000000,2022-11-01,36,077,NY,Otsego County,26557,25731,826,3.1
CN3607900000000,2022-11-01,36,079,NY,Putnam County,50700,49359,1341,2.6
CN3608100000000,2022-11-01,36,081,NY,Queens County,1139104,1087355,51749,4.5
CN3608300000000,2022-11-01,36,083,NY,Rensselaer County,82056,79850,2206,2.7
CN3608500000000,2022-11-01,36,085,NY,Richmond County,227002,215959,11043,4.9
CN3608700000000,2022-11-01,36,087,NY,Rockland County,158332,154305,4027,2.5
CN3608900000000,2022-11-01,36,089,NY,St. Lawrence County,43072,41451,1621,3.8
CN3609100000000,2022-11-01,36,091,NY,Saratoga County,121423,118555,2868,2.4
CN3609300000000,2022-11-01,36,093,NY,Schenectady County,77791,75522,2269,2.9
CN3609500000000,2022-11-01,36,095,NY,Schoharie County,14628,14166,462,3.2
CN3609700000000,2022-11-01,36,097,NY,Schuyler County,7835,7568,267,3.4
CN3609900000000,2022-11-01,36,099,NY,Seneca County,14584,14171,413,2.8
CN3610100000000,2022-11-01,36,101,NY,Steuben County,40406,39077,1329,3.3
CN3610300000000,2022-11-01,36,103,NY,Suffolk County,794005,771829,22176,2.8
CN3610500000000,2022-11-01,36,105,NY,Sullivan County,36810,35725,1085,2.9
CN3610700000000,2022-11-01,36,107,NY,Tioga County,22065,21456,609,2.8
CN3610900000000,2022-11-01,36,109,NY,Tompkins County,50463,49153,1310,2.6
CN3611100000000,2022-11-01,36,111,NY,Ulster County,86715,84347,2368,2.7
CN3611300000000,2022-11-01,36,113,NY,Warren County,30721,29709,1012,3.3
CN3611500000000,2022-11-01,36,115,NY,Washington County,26816,26042,774,2.9
CN3611700000000,2022-11-01,36,117,NY,Wayne County,42764,41569,1195,2.8
CN3611900000000,2022-11-01,36,119,NY,Westchester County,492828,479200,13628,2.8
CN3612100000000,2022-11-01,36,121,NY,Wyoming County,16910,16376,534,3.2
CN3612300000000,2022-11-01,36,123,NY,Yates County,11368,11048,320,2.8
CN3700100000000,2022-11-01,37,001,NC,Alamance County,82609,79610,2999,3.6
CN3700300000000,2022-11-01,37,003,NC,Alexander County,17991,17426,565,3.1
CN3700500000000,2022-11-01,37,005,NC,Alleghany County,4570,4406,164,3.6
CN3700700000000,2022-11-01,37,007,NC,Anson County,10231,9817,414,4
CN3700900000000,2022-11-01,37,009,NC,Ashe County,12817,12389,428,3.3
CN3701100000000,2022-11-01,37,011,NC,Avery County,7664,7429,235,3.1
CN3701300000000,2022-11-01,37,013,NC,Beaufort County,19907,19136,771,3.9
CN3701500000000,2022-11-01,37,015,NC,Bertie County,7139,6816,323,4.5
CN3701700000000,2022-11-01,37,017,NC,Bladen County,14440,13807,633,4.4
CN3701900000000,2022-11-01,37,019,NC,Brunswick County,56797,54209,2588,4.6
CN3702100000000,2022-11-01,37,021,NC,Buncombe County,141002,136969,4033,2.9
CN3702300000000,2022-11-01,37,023,NC,Burke County,40819,39419,1400,3.4
CN3702500000000,2022-11-01,37,025,NC,Cabarrus County,115722,111773,3949,3.4
CN3702700000000,2022-11-01,37,027,NC,Caldwell County,36330,35058,1272,3.5
CN3702900000000,2022-11-01,37,029,NC,Camden County,4674,4506,168,3.6
CN3703100000000,2022-11-01,37,031,NC,Carteret County,31847,30748,1099,3.5
CN3703300000000,2022-11-01,37,033,NC,Caswell County,9620,9245,375,3.9
CN3703500000000,2022-11-01,37,035,NC,Catawba County,79373,76679,2694,3.4
CN3703700000000,2022-11-01,37,037,NC,Chatham County,37236,36071,1165,3.1
CN3703900000000,2022-11-01,37,039,NC,Cherokee County,11251,10801,450,4
CN3704100000000,2022-11-01,37,041,NC,Chowan County,5972,5735,237,4
CN3704300000000,2022-11-01,37,043,NC,Clay County,4300,4132,168,3.9
CN3704500000000,2022-11-01,37,045,NC,Cleveland County,49424,47576,1848,3.7
CN3704700000000,2022-11-01,37,047,NC,Columbus County,23781,22841,940,4
CN3704900000000,2022-11-01,37,049,NC,Craven County,41843,40264,1579,3.8
CN3705100000000,2022-11-01,37,051,NC,Cumberland County,126435,120058,6377,5
CN3705300000000,2022-11-01,37,053,NC,Currituck County,14559,14070,489,3.4
CN3705500000000,2022-11-01,37,055,NC,Dare County,18771,18063,708,3.8
CN3705700000000,2022-11-01,37,057,NC,Davidson County,81709,78903,2806,3.4
CN3705900000000,2022-11-01,37,059,NC,Davie County,20840,20146,694,3.3
CN3706100000000,2022-11-01,37,061,NC,Duplin County,24737,23843,894,3.6
CN3706300000000,2022-11-01,37,063,NC,Durham County,177985,172375,5610,3.2
CN3706500000000,2022-11-01,37,065,NC,Edgecombe County,19987,18745,1242,6.2
CN3706700000000,2022-11-01,37,067,NC,Forsyth County,189223,182403,6820,3.6
CN3706900000000,2022-11-01,37,069,NC,Franklin County,34007,32801,1206,3.5
CN3707100000000,2022-11-01,37,071,NC,Gaston County,114199,110091,4108,3.6
CN3707300000000,2022-11-01,37,073,NC,Gates County,5089,4911,178,3.5
CN3707500000000,2022-11-01,37,075,NC,Graham County,2847,2708,139,4.9
CN3707700000000,2022-11-01,37,077,NC,Granville County,30127,29198,929,3.1
CN3707900000000,2022-11-01,37,079,NC,Greene County,9557,9268,289,3
CN3708100000000,2022-11-01,37,081,NC,Guilford County,259435,249087,10348,4
CN3708300000000,2022-11-01,37,083,NC,Halifax County,19144,18108,1036,5.4
CN3708500000000,2022-11-01,37,085,NC,Harnett County,55350,53111,2239,4
CN3708700000000,2022-11-01,37,087,NC,Haywood County,29990,29066,924,3.1
CN3708900000000,2022-11-01,37,089,NC,Henderson County,55178,53460,1718,3.1
CN3709100000000,2022-11-01,37,091,NC,Hertford County,8528,8082,446,5.2
CN3709300000000,2022-11-01,37,093,NC,Hoke County,20105,19111,994,4.9
CN3709500000000,2022-11-01,37,095,NC,Hyde County,1707,1629,78,4.6
CN3709700000000,2022-11-01,37,097,NC,Iredell County,94277,91103,3174,3.4
CN3709900000000,2022-11-01,37,099,NC,Jackson County,19768,19040,728,3.7
CN3710100000000,2022-11-01,37,101,NC,Johnston County,108142,104603,3539,3.3
CN3710300000000,2022-11-01,37,103,NC,Jones County,4304,4145,159,3.7
CN3710500000000,2022-11-01,37,105,NC,Lee County,26224,25141,1083,4.1
CN3710700000000,2022-11-01,37,107,NC,Lenoir County,27542,26572,970,3.5
CN3710900000000,2022-11-01,37,109,NC,Lincoln County,46211,44762,1449,3.1
CN3711100000000,2022-11-01,37,111,NC,McDowell County,20243,19528,715,3.5
CN3711300000000,2022-11-01,37,113,NC,Macon County,16159,15626,533,3.3
CN3711500000000,2022-11-01,37,115,NC,Madison County,10023,9679,344,3.4
CN3711700000000,2022-11-01,37,117,NC,Martin County,8593,8218,375,4.4
CN3711900000000,2022-11-01,37,119,NC,Mecklenburg County,649573,627175,22398,3.4
CN3712100000000,2022-11-01,37,121,NC,Mitchell County,6102,5858,244,4
CN3712300000000,2022-11-01,37,123,NC,Montgomery County,11069,10660,409,3.7
CN3712500000000,2022-11-01,37,125,NC,Moore County,42306,40795,1511,3.6
CN3712700000000,2022-11-01,37,127,NC,Nash County,41816,39800,2016,4.8
CN3712900000000,2022-11-01,37,129,NC,New Hanover County,129116,124929,4187,3.2
CN3713100000000,2022-11-01,37,131,NC,Northampton County,7210,6876,334,4.6
CN3713300000000,2022-11-01,37,133,NC,Onslow County,68366,65467,2899,4.2
CN3713500000000,2022-11-01,37,135,NC,Orange County,81075,78603,2472,3
CN3713700000000,2022-11-01,37,137,NC,Pamlico County,5459,5268,191,3.5
CN3713900000000,2022-11-01,37,139,NC,Pasquotank County,16717,15980,737,4.4
CN3714100000000,2022-11-01,37,141,NC,Pender County,30672,29607,1065,3.5
CN3714300000000,2022-11-01,37,143,NC,Perquimans County,4964,4745,219,4.4
CN3714500000000,2022-11-01,37,145,NC,Person County,18731,18019,712,3.8
CN3714700000000,2022-11-01,37,147,NC,Pitt County,87754,84263,3491,4
CN3714900000000,2022-11-01,37,149,NC,Polk County,9290,8956,334,3.6
CN3715100000000,2022-11-01,37,151,NC,Randolph County,65196,62856,2340,3.6
CN3715300000000,2022-11-01,37,153,NC,Richmond County,17045,16224,821,4.8
CN3715500000000,2022-11-01,37,155,NC,Robeson County,47911,45364,2547,5.3
CN3715700000000,2022-11-01,37,157,NC,Rockingham County,39400,37770,1630,4.1
CN3715900000000,2022-11-01,37,159,NC,Rowan County,67448,65054,2394,3.5
CN3716100000000,2022-11-01,37,161,NC,Rutherford County,24653,23502,1151,4.7
CN3716300000000,2022-11-01,37,163,NC,Sampson County,28954,27937,1017,3.5
CN3716500000000,2022-11-01,37,165,NC,Scotland County,11267,10580,687,6.1
CN3716700000000,2022-11-01,37,167,NC,Stanly County,30668,29685,983,3.2
CN3716900000000,2022-11-01,37,169,NC,Stokes County,21720,21006,714,3.3
CN3717100000000,2022-11-01,37,171,NC,Surry County,32642,31554,1088,3.3
CN3717300000000,2022-11-01,37,173,NC,Swain County,7115,6901,214,3
CN3717500000000,2022-11-01,37,175,NC,Transylvania County,14611,14097,514,3.5
CN3717700000000,2022-11-01,37,177,NC,Tyrrell County,1241,1182,59,4.8
CN3717900000000,2022-11-01,37,179,NC,Union County,129858,125771,4087,3.1
CN3718100000000,2022-11-01,37,181,NC,Vance County,16674,15702,972,5.8
CN3718300000000,2022-11-01,37,183,NC,Wake County,631629,612542,19087,3
CN3718500000000,2022-11-01,37,185,NC,Warren County,6297,5913,384,6.1
CN3718700000000,2022-11-01,37,187,NC,Washington County,4326,4096,230,5.3
CN3718900000000,2022-11-01,37,189,NC,Watauga County,29906,28962,944,3.2
CN3719100000000,2022-11-01,37,191,NC,Wayne County,50152,48165,1987,4
CN3719300000000,2022-11-01,37,193,NC,Wilkes County,27510,26475,1035,3.8
CN3719500000000,2022-11-01,37,195,NC,Wilson County,33828,32198,1630,4.8
CN3719700000000,2022-11-01,37,197,NC,Yadkin County,17727,17117,610,3.4
CN3719900000000,2022-11-01,37,199,NC,Yancey County,8147,7867,280,3.4
CN3800100000000,2022-11-01,38,001,ND,Adams County,931,915,16,1.7
CN3800300000000,2022-11-01,38,003,ND,Barnes County,5133,5045,88,1.7
CN3800500000000,2022-11-01,38,005,ND,Benson County,2349,2292,57,2.4
CN3800700000000,2022-11-01,38,007,ND,Billings County,389,382,7,1.8
CN3800900000000,2022-11-01,38,009,ND,Bottineau County,2893,2831,62,2.1
CN3801100000000,2022-11-01,38,011,ND,Bowman County,1506,1482,24,1.6
CN3801300000000,2022-11-01,38,013,ND,Burke County,1027,1008,19,1.9
CN3801500000000,2022-11-01,38,015,ND,Burleigh County,51328,50504,824,1.6
CN3801700000000,2022-11-01,38,017,ND,Cass County,109576,107962,1614,1.5
CN3801900000000,2022-11-01,38,019,ND,Cavalier County,1769,1740,29,1.6
CN3802100000000,2022-11-01,38,021,ND,Dickey County,2153,2120,33,1.5
CN3802300000000,2022-11-01,38,023,ND,Divide County,1441,1420,21,1.5
CN3802500000000,2022-11-01,38,025,ND,Dunn County,3212,3181,31,1
CN3802700000000,2022-11-01,38,027,ND,Eddy County,1185,1161,24,2
CN3802900000000,2022-11-01,38,029,ND,Emmons County,1433,1376,57,4
CN3803100000000,2022-11-01,38,031,ND,Foster County,1480,1456,24,1.6
CN3803300000000,2022-11-01,38,033,ND,Golden Valley County,853,836,17,2
CN3803500000000,2022-11-01,38,035,ND,Grand Forks County,37638,37055,583,1.5
CN3803700000000,2022-11-01,38,037,ND,Grant County,1215,1192,23,1.9
CN3803900000000,2022-11-01,38,039,ND,Griggs County,994,973,21,2.1
CN3804100000000,2022-11-01,38,041,ND,Hettinger County,1390,1366,24,1.7
CN3804300000000,2022-11-01,38,043,ND,Kidder County,1287,1247,40,3.1
CN3804500000000,2022-11-01,38,045,ND,LaMoure County,2070,2039,31,1.5
CN3804700000000,2022-11-01,38,047,ND,Logan County,868,847,21,2.4
CN3804900000000,2022-11-01,38,049,ND,McHenry County,3092,3018,74,2.4
CN3805100000000,2022-11-01,38,051,ND,McIntosh County,1048,1024,24,2.3
CN3805300000000,2022-11-01,38,053,ND,McKenzie County,9547,9398,149,1.6
CN3805500000000,2022-11-01,38,055,ND,McLean County,4755,4637,118,2.5
CN3805700000000,2022-11-01,38,057,ND,Mercer County,3433,3340,93,2.7
CN3805900000000,2022-11-01,38,059,ND,Morton County,16881,16540,341,2
CN3806100000000,2022-11-01,38,061,ND,Mountrail County,6442,6361,81,1.3
CN3806300000000,2022-11-01,38,063,ND,Nelson County,1409,1376,33,2.3
CN3806500000000,2022-11-01,38,065,ND,Oliver County,871,845,26,3
CN3806700000000,2022-11-01,38,067,ND,Pembina County,3161,3062,99,3.1
CN3806900000000,2022-11-01,38,069,ND,Pierce County,1605,1576,29,1.8
CN3807100000000,2022-11-01,38,071,ND,Ramsey County,5514,5401,113,2
CN3807300000000,2022-11-01,38,073,ND,Ransom County,2601,2570,31,1.2
CN3807500000000,2022-11-01,38,075,ND,Renville County,1206,1190,16,1.3
CN3807700000000,2022-11-01,38,077,ND,Richland County,8694,8573,121,1.4
CN3807900000000,2022-11-01,38,079,ND,Rolette County,4592,4386,206,4.5
CN3808100000000,2022-11-01,38,081,ND,Sargent County,2244,2220,24,1.1
CN3808300000000,2022-11-01,38,083,ND,Sheridan County,641,627,14,2.2
CN3808500000000,2022-11-01,38,085,ND,Sioux County,1202,1178,24,2
CN3808700000000,2022-11-01,38,087,ND,Slope County,332,323,9,2.7
CN3808900000000,2022-11-01,38,089,ND,Stark County,18124,17838,286,1.6
CN3809100000000,2022-11-01,38,091,ND,Steele County,941,927,14,1.5
CN3809300000000,2022-11-01,38,093,ND,Stutsman County,10650,10472,178,1.7
CN3809500000000,2022-11-01,38,095,ND,Towner County,1095,1069,26,2.4
CN3809700000000,2022-11-01,38,097,ND,Traill County,4511,4442,69,1.5
CN3809900000000,2022-11-01,38,099,ND,Walsh County,5148,5015,133,2.6
CN3810100000000,2022-11-01,38,101,ND,Ward County,31935,31360,575,1.8
CN3810300000000,2022-11-01,38,103,ND,Wells County,1884,1818,66,3.5
CN3810500000000,2022-11-01,38,105,ND,Williams County,22335,21913,422,1.9
CN3900100000000,2022-11-01,39,001,OH,Adams County,10947,10426,521,4.8
CN3900300000000,2022-11-01,39,003,OH,Allen County,45942,44304,1638,3.6
CN3900500000000,2022-11-01,39,005,OH,Ashland County,25960,25080,880,3.4
CN3900700000000,2022-11-01,39,007,OH,Ashtabula County,42241,40632,1609,3.8
CN3900900000000,2022-11-01,39,009,OH,Athens County,26859,25789,1070,4
CN3901100000000,2022-11-01,39,011,OH,Auglaize County,23838,23236,602,2.5
CN3901300000000,2022-11-01,39,013,OH,Belmont County,26892,25726,1166,4.3
CN3901500000000,2022-11-01,39,015,OH,Brown County,19496,18767,729,3.7
CN3901700000000,2022-11-01,39,017,OH,Butler County,196619,190602,6017,3.1
CN3901900000000,2022-11-01,39,019,OH,Carroll County,12585,12105,480,3.8
CN3902100000000,2022-11-01,39,021,OH,Champaign County,19020,18443,577,3
CN3902300000000,2022-11-01,39,023,OH,Clark County,62046,59951,2095,3.4
CN3902500000000,2022-11-01,39,025,OH,Clermont County,107862,104578,3284,3
CN3902700000000,2022-11-01,39,027,OH,Clinton County,17820,17136,684,3.8
CN3902900000000,2022-11-01,39,029,OH,Columbiana County,44236,42478,1758,4
CN3903100000000,2022-11-01,39,031,OH,Coshocton County,13570,13020,550,4.1
CN3903300000000,2022-11-01,39,033,OH,Crawford County,17593,16891,702,4
CN3903500000000,2022-11-01,39,035,OH,Cuyahoga County,593342,570867,22475,3.8
CN3903700000000,2022-11-01,39,037,OH,Darke County,25529,24784,745,2.9
CN3903900000000,2022-11-01,39,039,OH,Defiance County,17211,16609,602,3.5
CN3904100000000,2022-11-01,39,041,OH,Delaware County,114950,111870,3080,2.7
CN3904300000000,2022-11-01,39,043,OH,Erie County,34721,33323,1398,4
CN3904500000000,2022-11-01,39,045,OH,Fairfield County,79939,77520,2419,3
CN3904700000000,2022-11-01,39,047,OH,Fayette County,13868,13416,452,3.3
CN3904900000000,2022-11-01,39,049,OH,Franklin County,703372,682107,21265,3
CN3905100000000,2022-11-01,39,051,OH,Fulton County,21783,21102,681,3.1
CN3905300000000,2022-11-01,39,053,OH,Gallia County,12077,11600,477,3.9
CN3905500000000,2022-11-01,39,055,OH,Geauga County,48138,46712,1426,3
CN3905700000000,2022-11-01,39,057,OH,Greene County,81698,79141,2557,3.1
CN3905900000000,2022-11-01,39,059,OH,Guernsey County,17466,16713,753,4.3
CN3906100000000,2022-11-01,39,061,OH,Hamilton County,416449,403328,13121,3.2
CN3906300000000,2022-11-01,39,063,OH,Hancock County,39792,38710,1082,2.7
CN3906500000000,2022-11-01,39,065,OH,Hardin County,12812,12357,455,3.6
CN3906700000000,2022-11-01,39,067,OH,Harrison County,6397,6109,288,4.5
CN3906900000000,2022-11-01,39,069,OH,Henry County,12743,12252,491,3.9
CN3907100000000,2022-11-01,39,071,OH,Highland County,17592,16759,833,4.7
CN3907300000000,2022-11-01,39,073,OH,Hocking County,12847,12394,453,3.5
CN3907500000000,2022-11-01,39,075,OH,Holmes County,22003,21369,634,2.9
CN3907700000000,2022-11-01,39,077,OH,Huron County,27433,26379,1054,3.8
CN3907900000000,2022-11-01,39,079,OH,Jackson County,12273,11764,509,4.1
CN3908100000000,2022-11-01,39,081,OH,Jefferson County,26692,25432,1260,4.7
CN3908300000000,2022-11-01,39,083,OH,Knox County,30773,29882,891,2.9
CN3908500000000,2022-11-01,39,085,OH,Lake County,123476,119549,3927,3.2
CN3908700000000,2022-11-01,39,087,OH,Lawrence County,23169,22241,928,4
CN3908900000000,2022-11-01,39,089,OH,Licking County,91589,88900,2689,2.9
CN3909100000000,2022-11-01,39,091,OH,Logan County,22630,21981,649,2.9
CN3909300000000,2022-11-01,39,093,OH,Lorain County,152084,146632,5452,3.6
CN3909500000000,2022-11-01,39,095,OH,Lucas County,203016,195043,7973,3.9
CN3909700000000,2022-11-01,39,097,OH,Madison County,21040,20470,570,2.7
CN3909900000000,2022-11-01,39,099,OH,Mahoning County,97352,93423,3929,4
CN3910100000000,2022-11-01,39,101,OH,Marion County,26853,25927,926,3.4
CN3910300000000,2022-11-01,39,103,OH,Medina County,97002,94079,2923,3
CN3910500000000,2022-11-01,39,105,OH,Meigs County,8569,8159,410,4.8
CN3910700000000,2022-11-01,39,107,OH,Mercer County,22732,22230,502,2.2
CN3910900000000,2022-11-01,39,109,OH,Miami County,53039,51469,1570,3
CN3911100000000,2022-11-01,39,111,OH,Monroe County,5197,4914,283,5.4
CN3911300000000,2022-11-01,39,113,OH,Montgomery County,243677,234835,8842,3.6
CN3911500000000,2022-11-01,39,115,OH,Morgan County,6803,6520,283,4.2
CN3911700000000,2022-11-01,39,117,OH,Morrow County,16943,16389,554,3.3
CN3911900000000,2022-11-01,39,119,OH,Muskingum County,40746,39227,1519,3.7
CN3912100000000,2022-11-01,39,121,OH,Noble County,4518,4269,249,5.5
CN3912300000000,2022-11-01,39,123,OH,Ottawa County,19725,18641,1084,5.5
CN3912500000000,2022-11-01,39,125,OH,Paulding County,8686,8439,247,2.8
CN3912700000000,2022-11-01,39,127,OH,Perry County,15870,15288,582,3.7
CN3912900000000,2022-11-01,39,129,OH,Pickaway County,26748,25908,840,3.1
CN3913100000000,2022-11-01,39,131,OH,Pike County,10908,10417,491,4.5
CN3913300000000,2022-11-01,39,133,OH,Portage County,83930,81207,2723,3.2
CN3913500000000,2022-11-01,39,135,OH,Preble County,21703,21096,607,2.8
CN3913700000000,2022-11-01,39,137,OH,Putnam County,18850,18388,462,2.5
CN3913900000000,2022-11-01,39,139,OH,Richland County,49854,47872,1982,4
CN3914100000000,2022-11-01,39,141,OH,Ross County,35027,33864,1163,3.3
CN3914300000000,2022-11-01,39,143,OH,Sandusky County,29425,28323,1102,3.7
CN3914500000000,2022-11-01,39,145,OH,Scioto County,29084,27758,1326,4.6
CN3914700000000,2022-11-01,39,147,OH,Seneca County,25933,25012,921,3.6
CN3914900000000,2022-11-01,39,149,OH,Shelby County,23236,22571,665,2.9
CN3915100000000,2022-11-01,39,151,OH,Stark County,179511,173265,6246,3.5
CN3915300000000,2022-11-01,39,153,OH,Summit County,261018,251864,9154,3.5
CN3915500000000,2022-11-01,39,155,OH,Trumbull County,82263,78780,3483,4.2
CN3915700000000,2022-11-01,39,157,OH,Tuscarawas County,44117,42671,1446,3.3
CN3915900000000,2022-11-01,39,159,OH,Union County,30254,29501,753,2.5
CN3916100000000,2022-11-01,39,161,OH,Van Wert County,14178,13818,360,2.5
CN3916300000000,2022-11-01,39,163,OH,Vinton County,5362,5131,231,4.3
CN3916500000000,2022-11-01,39,165,OH,Warren County,122463,118915,3548,2.9
CN3916700000000,2022-11-01,39,167,OH,Washington County,26287,25255,1032,3.9
CN3916900000000,2022-11-01,39,169,OH,Wayne County,60190,58594,1596,2.7
CN3917100000000,2022-11-01,39,171,OH,Williams County,17935,17430,505,2.8
CN3917300000000,2022-11-01,39,173,OH,Wood County,69396,67337,2059,3
CN3917500000000,2022-11-01,39,175,OH,Wyandot County,13140,12839,301,2.3
CN4000100000000,2022-11-01,40,001,OK,Adair County,8653,8376,277,3.2
CN4000300000000,2022-11-01,40,003,OK,Alfalfa County,2645,2589,56,2.1
CN4000500000000,2022-11-01,40,005,OK,Atoka County,5142,4948,194,3.8
CN4000700000000,2022-11-01,40,007,OK,Beaver County,2563,2513,50,2
CN4000900000000,2022-11-01,40,009,OK,Beckham County,10321,10069,252,2.4
CN4001100000000,2022-11-01,40,011,OK,Blaine County,4363,4277,86,2
CN4001300000000,2022-11-01,40,013,OK,Bryan County,23343,22740,603,2.6
CN4001500000000,2022-11-01,40,015,OK,Caddo County,11707,11336,371,3.2
CN4001700000000,2022-11-01,40,017,OK,Canadian County,81450,79513,1937,2.4
CN4001900000000,2022-11-01,40,019,OK,Carter County,21461,20772,689,3.2
CN4002100000000,2022-11-01,40,021,OK,Cherokee County,19896,19261,635,3.2
CN4002300000000,2022-11-01,40,023,OK,Choctaw County,6006,5726,280,4.7
CN4002500000000,2022-11-01,40,025,OK,Cimarron County,1594,1572,22,1.4
CN4002700000000,2022-11-01,40,027,OK,Cleveland County,150219,146565,3654,2.4
CN4002900000000,2022-11-01,40,029,OK,Coal County,2357,2293,64,2.7
CN4003100000000,2022-11-01,40,031,OK,Comanche County,47562,45925,1637,3.4
CN4003300000000,2022-11-01,40,033,OK,Cotton County,2665,2580,85,3.2
CN4003500000000,2022-11-01,40,035,OK,Craig County,5881,5704,177,3
CN4003700000000,2022-11-01,40,037,OK,Creek County,31611,30566,1045,3.3
CN4003900000000,2022-11-01,40,039,OK,Custer County,15033,14685,348,2.3
CN4004100000000,2022-11-01,40,041,OK,Delaware County,19957,19390,567,2.8
CN4004300000000,2022-11-01,40,043,OK,Dewey County,3002,2946,56,1.9
CN4004500000000,2022-11-01,40,045,OK,Ellis County,2046,1999,47,2.3
CN4004700000000,2022-11-01,40,047,OK,Garfield County,26081,25354,727,2.8
CN4004900000000,2022-11-01,40,049,OK,Garvin County,12827,12476,351,2.7
CN4005100000000,2022-11-01,40,051,OK,Grady County,27564,26823,741,2.7
CN4005300000000,2022-11-01,40,053,OK,Grant County,2684,2635,49,1.8
CN4005500000000,2022-11-01,40,055,OK,Greer County,1793,1732,61,3.4
CN4005700000000,2022-11-01,40,057,OK,Harmon County,1166,1133,33,2.8
CN4005900000000,2022-11-01,40,059,OK,Harper County,1758,1725,33,1.9
CN4006100000000,2022-11-01,40,061,OK,Haskell County,4145,3976,169,4.1
CN4006300000000,2022-11-01,40,063,OK,Hughes County,5168,4989,179,3.5
CN4006500000000,2022-11-01,40,065,OK,Jackson County,10778,10494,284,2.6
CN4006700000000,2022-11-01,40,067,OK,Jefferson County,2447,2378,69,2.8
CN4006900000000,2022-11-01,40,069,OK,Johnston County,3768,3627,141,3.7
CN4007100000000,2022-11-01,40,071,OK,Kay County,18598,17990,608,3.3
CN4007300000000,2022-11-01,40,073,OK,Kingfisher County,8946,8785,161,1.8
CN4007500000000,2022-11-01,40,075,OK,Kiowa County,3559,3451,108,3
CN4007700000000,2022-11-01,40,077,OK,Latimer County,3125,2957,168,5.4
CN4007900000000,2022-11-01,40,079,OK,Le Flore County,19677,18999,678,3.4
CN4008100000000,2022-11-01,40,081,OK,Lincoln County,16295,15800,495,3
CN4008300000000,2022-11-01,40,083,OK,Logan County,23569,22978,591,2.5
CN4008500000000,2022-11-01,40,085,OK,Love County,5828,5696,132,2.3
CN4008700000000,2022-11-01,40,087,OK,McClain County,21042,20492,550,2.6
CN4008900000000,2022-11-01,40,089,OK,McCurtain County,15585,15027,558,3.6
CN4009100000000,2022-11-01,40,091,OK,McIntosh County,7231,6889,342,4.7
CN4009300000000,2022-11-01,40,093,OK,Major County,3760,3666,94,2.5
CN4009500000000,2022-11-01,40,095,OK,Marshall County,7236,7015,221,3.1
CN4009700000000,2022-11-01,40,097,OK,Mayes County,19798,19189,609,3.1
CN4009900000000,2022-11-01,40,099,OK,Murray County,6038,5859,179,3
CN4010100000000,2022-11-01,40,101,OK,Muskogee County,28803,27868,935,3.2
CN4010300000000,2022-11-01,40,103,OK,Noble County,5876,5758,118,2
CN4010500000000,2022-11-01,40,105,OK,Nowata County,4732,4611,121,2.6
CN4010700000000,2022-11-01,40,107,OK,Okfuskee County,4442,4271,171,3.8
CN4010900000000,2022-11-01,40,109,OK,Oklahoma County,402741,391367,11374,2.8
CN4011100000000,2022-11-01,40,111,OK,Okmulgee County,15687,15052,635,4
CN4011300000000,2022-11-01,40,113,OK,Osage County,20671,19985,686,3.3
CN4011500000000,2022-11-01,40,115,OK,Ottawa County,15476,15072,404,2.6
CN4011700000000,2022-11-01,40,117,OK,Pawnee County,7381,7122,259,3.5
CN4011900000000,2022-11-01,40,119,OK,Payne County,39830,38819,1011,2.5
CN4012100000000,2022-11-01,40,121,OK,Pittsburg County,16421,15754,667,4.1
CN4012300000000,2022-11-01,40,123,OK,Pontotoc County,19605,19122,483,2.5
CN4012500000000,2022-11-01,40,125,OK,Pottawatomie County,33486,32381,1105,3.3
CN4012700000000,2022-11-01,40,127,OK,Pushmataha County,4528,4349,179,4
CN4012900000000,2022-11-01,40,129,OK,Roger Mills County,1796,1758,38,2.1
CN4013100000000,2022-11-01,40,131,OK,Rogers County,45982,44735,1247,2.7
CN4013300000000,2022-11-01,40,133,OK,Seminole County,9302,8929,373,4
CN4013500000000,2022-11-01,40,135,OK,Sequoyah County,16874,16338,536,3.2
CN4013700000000,2022-11-01,40,137,OK,Stephens County,19426,18806,620,3.2
CN4013900000000,2022-11-01,40,139,OK,Texas County,11815,11633,182,1.5
CN4014100000000,2022-11-01,40,141,OK,Tillman County,2925,2812,113,3.9
CN4014300000000,2022-11-01,40,143,OK,Tulsa County,328643,319217,9426,2.9
CN4014500000000,2022-11-01,40,145,OK,Wagoner County,39498,38345,1153,2.9
CN4014700000000,2022-11-01,40,147,OK,Washington County,22290,21601,689,3.1
CN4014900000000,2022-11-01,40,149,OK,Washita County,5334,5196,138,2.6
CN4015100000000,2022-11-01,40,151,OK,Woods County,4599,4522,77,1.7
CN4015300000000,2022-11-01,40,153,OK,Woodward County,8551,8307,244,2.9
CN4100100000000,2022-11-01,41,001,OR,Baker County,7391,6998,393,5.3
CN4100300000000,2022-11-01,41,003,OR,Benton County,50019,48247,1772,3.5
CN4100500000000,2022-11-01,41,005,OR,Clackamas County,228492,219269,9223,4
CN4100700000000,2022-11-01,41,007,OR,Clatsop County,19387,18468,919,4.7
CN4100900000000,2022-11-01,41,009,OR,Columbia County,25399,24059,1340,5.3
CN4101100000000,2022-11-01,41,011,OR,Coos County,26634,25068,1566,5.9
CN4101300000000,2022-11-01,41,013,OR,Crook County,11185,10511,674,6
CN4101500000000,2022-11-01,41,015,OR,Curry County,8969,8418,551,6.1
CN4101700000000,2022-11-01,41,017,OR,Deschutes County,103388,98603,4785,4.6
CN4101900000000,2022-11-01,41,019,OR,Douglas County,47456,44564,2892,6.1
CN4102100000000,2022-11-01,41,021,OR,Gilliam County,1016,981,35,3.4
CN4102300000000,2022-11-01,41,023,OR,Grant County,3207,3003,204,6.4
CN4102500000000,2022-11-01,41,025,OR,Harney County,3775,3557,218,5.8
CN4102700000000,2022-11-01,41,027,OR,Hood River County,13823,13305,518,3.7
CN4102900000000,2022-11-01,41,029,OR,Jackson County,107461,101973,5488,5.1
CN4103100000000,2022-11-01,41,031,OR,Jefferson County,10264,9637,627,6.1
CN4103300000000,2022-11-01,41,033,OR,Josephine County,36970,34635,2335,6.3
CN4103500000000,2022-11-01,41,035,OR,Klamath County,30662,28491,2171,7.1
CN4103700000000,2022-11-01,41,037,OR,Lake County,3641,3413,228,6.3
CN4103900000000,2022-11-01,41,039,OR,Lane County,183192,173784,9408,5.1
CN4104100000000,2022-11-01,41,041,OR,Lincoln County,20533,19324,1209,5.9
CN4104300000000,2022-11-01,41,043,OR,Linn County,61931,58796,3135,5.1
CN4104500000000,2022-11-01,41,045,OR,Malheur County,12597,12015,582,4.6
CN4104700000000,2022-11-01,41,047,OR,Marion County,171687,163796,7891,4.6
CN4104900000000,2022-11-01,41,049,OR,Morrow County,5968,5715,253,4.2
CN4105100000000,2022-11-01,41,051,OR,Multnomah County,472330,452106,20224,4.3
CN4105300000000,2022-11-01,41,053,OR,Polk County,43231,41289,1942,4.5
CN4105500000000,2022-11-01,41,055,OR,Sherman County,950,917,33,3.5
CN4105700000000,2022-11-01,41,057,OR,Tillamook County,11876,11292,584,4.9
CN4105900000000,2022-11-01,41,059,OR,Umatilla County,37868,36073,1795,4.7
CN4106100000000,2022-11-01,41,061,OR,Union County,12162,11519,643,5.3
CN4106300000000,2022-11-01,41,063,OR,Wallowa County,3516,3284,232,6.6
CN4106500000000,2022-11-01,41,065,OR,Wasco County,13161,12466,695,5.3
CN4106700000000,2022-11-01,41,067,OR,Washington County,338167,325676,12491,3.7
CN4106900000000,2022-11-01,41,069,OR,Wheeler County,754,729,25,3.3
CN4107100000000,2022-11-01,41,071,OR,Yamhill County,56580,54313,2267,4
CN4200100000000,2022-11-01,42,001,PA,Adams County,54765,53225,1540,2.8
CN4200300000000,2022-11-01,42,003,PA,Allegheny County,628167,603925,24242,3.9
CN4200500000000,2022-11-01,42,005,PA,Armstrong County,30898,29491,1407,4.6
CN4200700000000,2022-11-01,42,007,PA,Beaver County,81613,77394,4219,5.2
CN4200900000000,2022-11-01,42,009,PA,Bedford County,24215,23206,1009,4.2
CN4201100000000,2022-11-01,42,011,PA,Berks County,213346,205194,8152,3.8
CN4201300000000,2022-11-01,42,013,PA,Blair County,58232,55944,2288,3.9
CN4201500000000,2022-11-01,42,015,PA,Bradford County,27745,26736,1009,3.6
CN4201700000000,2022-11-01,42,017,PA,Bucks County,349520,337292,12228,3.5
CN4201900000000,2022-11-01,42,019,PA,Butler County,97972,94463,3509,3.6
CN4202100000000,2022-11-01,42,021,PA,Cambria County,54993,52436,2557,4.6
CN4202300000000,2022-11-01,42,023,PA,Cameron County,1906,1801,105,5.5
CN4202500000000,2022-11-01,42,025,PA,Carbon County,32425,30888,1537,4.7
CN4202700000000,2022-11-01,42,027,PA,Centre County,79755,77291,2464,3.1
CN4202900000000,2022-11-01,42,029,PA,Chester County,294577,286275,8302,2.8
CN4203100000000,2022-11-01,42,031,PA,Clarion County,15727,15019,708,4.5
CN4203300000000,2022-11-01,42,033,PA,Clearfield County,34765,33078,1687,4.9
CN4203500000000,2022-11-01,42,035,PA,Clinton County,16933,16135,798,4.7
CN4203700000000,2022-11-01,42,037,PA,Columbia County,34154,32690,1464,4.3
CN4203900000000,2022-11-01,42,039,PA,Crawford County,37405,35773,1632,4.4
CN4204100000000,2022-11-01,42,041,PA,Cumberland County,134908,130923,3985,3
CN4204300000000,2022-11-01,42,043,PA,Dauphin County,146074,140787,5287,3.6
CN4204500000000,2022-11-01,42,045,PA,Delaware County,301784,290268,11516,3.8
CN4204700000000,2022-11-01,42,047,PA,Elk County,14118,13535,583,4.1
CN4204900000000,2022-11-01,42,049,PA,Erie County,124860,119219,5641,4.5
CN4205100000000,2022-11-01,42,051,PA,Fayette County,54619,51675,2944,5.4
CN4205300000000,2022-11-01,42,053,PA,Forest County,1645,1542,103,6.3
CN4205500000000,2022-11-01,42,055,PA,Franklin County,77622,75038,2584,3.3
CN4205700000000,2022-11-01,42,057,PA,Fulton County,7164,6932,232,3.2
CN4205900000000,2022-11-01,42,059,PA,Greene County,15287,14602,685,4.5
CN4206100000000,2022-11-01,42,061,PA,Huntingdon County,19171,18190,981,5.1
CN4206300000000,2022-11-01,42,063,PA,Indiana County,36203,34575,1628,4.5
CN4206500000000,2022-11-01,42,065,PA,Jefferson County,19142,18307,835,4.4
CN4206700000000,2022-11-01,42,067,PA,Juniata County,12115,11677,438,3.6
CN4206900000000,2022-11-01,42,069,PA,Lackawanna County,105103,100671,4432,4.2
CN4207100000000,2022-11-01,42,071,PA,Lancaster County,288345,279755,8590,3
CN4207300000000,2022-11-01,42,073,PA,Lawrence County,38712,36864,1848,4.8
CN4207500000000,2022-11-01,42,075,PA,Lebanon County,73490,71199,2291,3.1
CN4207700000000,2022-11-01,42,077,PA,Lehigh County,196317,188455,7862,4
CN4207900000000,2022-11-01,42,079,PA,Luzerne County,158237,150601,7636,4.8
CN4208100000000,2022-11-01,42,081,PA,Lycoming County,55198,52895,2303,4.2
CN4208300000000,2022-11-01,42,083,PA,McKean County,16584,15725,859,5.2
CN4208500000000,2022-11-01,42,085,PA,Mercer County,47362,45250,2112,4.5
CN4208700000000,2022-11-01,42,087,PA,Mifflin County,20892,20006,886,4.2
CN4208900000000,2022-11-01,42,089,PA,Monroe County,82042,77582,4460,5.4
CN4209100000000,2022-11-01,42,091,PA,Montgomery County,464768,450309,14459,3.1
CN4209300000000,2022-11-01,42,093,PA,Montour County,9272,8990,282,3
CN4209500000000,2022-11-01,42,095,PA,Northampton County,163537,157242,6295,3.8
CN4209700000000,2022-11-01,42,097,PA,Northumberland County,41397,39425,1972,4.8
CN4209900000000,2022-11-01,42,099,PA,Perry County,24706,23921,785,3.2
CN4210100000000,2022-11-01,42,101,PA,Philadelphia County/city,735898,699081,36817,5
CN4210300000000,2022-11-01,42,103,PA,Pike County,25626,24246,1380,5.4
CN4210500000000,2022-11-01,42,105,PA,Potter County,6716,6363,353,5.3
CN4210700000000,2022-11-01,42,107,PA,Schuylkill County,65168,62182,2986,4.6
CN4210900000000,2022-11-01,42,109,PA,Snyder County,19663,18966,697,3.5
CN4211100000000,2022-11-01,42,111,PA,Somerset County,31865,30313,1552,4.9
CN4211300000000,2022-11-01,42,113,PA,Sullivan County,2482,2391,91,3.7
CN4211500000000,2022-11-01,42,115,PA,Susquehanna County,19940,19193,747,3.7
CN4211700000000,2022-11-01,42,117,PA,Tioga County,18771,17942,829,4.4
CN4211900000000,2022-11-01,42,119,PA,Union County,19434,18786,648,3.3
CN4212100000000,2022-11-01,42,121,PA,Venango County,20882,19903,979,4.7
CN4212300000000,2022-11-01,42,123,PA,Warren County,17246,16512,734,4.3
CN4212500000000,2022-11-01,42,125,PA,Washington County,103915,99747,4168,4
CN4212700000000,2022-11-01,42,127,PA,Wayne County,22011,21003,1008,4.6
CN4212900000000,2022-11-01,42,129,PA,Westmoreland County,174349,167371,6978,4
CN4213100000000,2022-11-01,42,131,PA,Wyoming County,13503,12943,560,4.1
CN4213300000000,2022-11-01,42,133,PA,York County,237418,229491,7927,3.3
CN4400100000000,2022-11-01,44,001,RI,Bristol County,26385,25745,640,2.4
CN4400300000000,2022-11-01,44,003,RI,Kent County,93061,90605,2456,2.6
CN4400500000000,2022-11-01,44,005,RI,Newport County,44861,43684,1177,2.6
CN4400700000000,2022-11-01,44,007,RI,Providence County,332437,321637,10800,3.2
CN4400900000000,2022-11-01,44,009,RI,Washington County,69852,68049,1803,2.6
CN4500100000000,2022-11-01,45,001,SC,Abbeville County,9434,9118,316,3.3
CN4500300000000,2022-11-01,45,003,SC,Aiken County,71826,69789,2037,2.8
CN4500500000000,2022-11-01,45,005,SC,Allendale County,2176,2072,104,4.8
CN4500700000000,2022-11-01,45,007,SC,Anderson County,90714,88367,2347,2.6
CN4500900000000,2022-11-01,45,009,SC,Bamberg County,4447,4231,216,4.9
CN4501100000000,2022-11-01,45,011,SC,Barnwell County,7296,7014,282,3.9
CN4501300000000,2022-11-01,45,013,SC,Beaufort County,75076,73036,2040,2.7
CN4501500000000,2022-11-01,45,015,SC,Berkeley County,109868,107016,2852,2.6
CN4501700000000,2022-11-01,45,017,SC,Calhoun County,6261,6078,183,2.9
CN4501900000000,2022-11-01,45,019,SC,Charleston County,215691,210739,4952,2.3
CN4502100000000,2022-11-01,45,021,SC,Cherokee County,24177,23190,987,4.1
CN4502300000000,2022-11-01,45,023,SC,Chester County,13119,12626,493,3.8
CN4502500000000,2022-11-01,45,025,SC,Chesterfield County,20607,19953,654,3.2
CN4502700000000,2022-11-01,45,027,SC,Clarendon County,11567,11122,445,3.8
CN4502900000000,2022-11-01,45,029,SC,Colleton County,15617,15156,461,3
CN4503100000000,2022-11-01,45,031,SC,Darlington County,29233,28312,921,3.2
CN4503300000000,2022-11-01,45,033,SC,Dillon County,12588,12038,550,4.4
CN4503500000000,2022-11-01,45,035,SC,Dorchester County,79643,77702,1941,2.4
CN4503700000000,2022-11-01,45,037,SC,Edgefield County,10053,9734,319,3.2
CN4503900000000,2022-11-01,45,039,SC,Fairfield County,8992,8645,347,3.9
CN4504100000000,2022-11-01,45,041,SC,Florence County,65097,63236,1861,2.9
CN4504300000000,2022-11-01,45,043,SC,Georgetown County,25376,24583,793,3.1
CN4504500000000,2022-11-01,45,045,SC,Greenville County,258106,251773,6333,2.5
CN4504700000000,2022-11-01,45,047,SC,Greenwood County,29604,28627,977,3.3
CN4504900000000,2022-11-01,45,049,SC,Hampton County,7656,7458,198,2.6
CN4505100000000,2022-11-01,45,051,SC,Horry County,148586,143569,5017,3.4
CN4505300000000,2022-11-01,45,053,SC,Jasper County,12958,12632,326,2.5
CN4505500000000,2022-11-01,45,055,SC,Kershaw County,28801,27952,849,2.9
CN4505700000000,2022-11-01,45,057,SC,Lancaster County,42949,41582,1367,3.2
CN4505900000000,2022-11-01,45,059,SC,Laurens County,29792,28931,861,2.9
CN4506100000000,2022-11-01,45,061,SC,Lee County,6232,5956,276,4.4
CN4506300000000,2022-11-01,45,063,SC,Lexington County,148560,145031,3529,2.4
CN4506500000000,2022-11-01,45,065,SC,McCormick County,3491,3392,99,2.8
CN4506700000000,2022-11-01,45,067,SC,Marion County,12291,11759,532,4.3
CN4506900000000,2022-11-01,45,069,SC,Marlboro County,8072,7512,560,6.9
CN4507100000000,2022-11-01,45,071,SC,Newberry County,18687,18224,463,2.5
CN4507300000000,2022-11-01,45,073,SC,Oconee County,33669,32817,852,2.5
CN4507500000000,2022-11-01,45,075,SC,Orangeburg County,32234,30880,1354,4.2
CN4507700000000,2022-11-01,45,077,SC,Pickens County,57659,55997,1662,2.9
CN4507900000000,2022-11-01,45,079,SC,Richland County,193927,188234,5693,2.9
CN4508100000000,2022-11-01,45,081,SC,Saluda County,8129,7920,209,2.6
CN4508300000000,2022-11-01,45,083,SC,Spartanburg County,152872,148676,4196,2.7
CN4508500000000,2022-11-01,45,085,SC,Sumter County,41012,39526,1486,3.6
CN4508700000000,2022-11-01,45,087,SC,Union County,11092,10626,466,4.2
CN4508900000000,2022-11-01,45,089,SC,Williamsburg County,10397,9945,452,4.3
CN4509100000000,2022-11-01,45,091,SC,York County,146234,142211,4023,2.8
CN4600300000000,2022-11-01,46,003,SD,Aurora County,1475,1446,29,2
CN4600500000000,2022-11-01,46,005,SD,Beadle County,9215,9063,152,1.6
CN4600700000000,2022-11-01,46,007,SD,Bennett County,1072,1042,30,2.8
CN4600900000000,2022-11-01,46,009,SD,Bon Homme County,2767,2712,55,2
CN4601100000000,2022-11-01,46,011,SD,Brookings County,19427,19075,352,1.8
CN4601300000000,2022-11-01,46,013,SD,Brown County,19930,19516,414,2.1
CN4601500000000,2022-11-01,46,015,SD,Brule County,2633,2593,40,1.5
CN4601700000000,2022-11-01,46,017,SD,Buffalo County,722,682,40,5.5
CN4601900000000,2022-11-01,46,019,SD,Butte County,5042,4947,95,1.9
CN4602100000000,2022-11-01,46,021,SD,Campbell County,752,729,23,3.1
CN4602300000000,2022-11-01,46,023,SD,Charles Mix County,3722,3644,78,2.1
CN4602500000000,2022-11-01,46,025,SD,Clark County,1900,1866,34,1.8
CN4602700000000,2022-11-01,46,027,SD,Clay County,7723,7571,152,2
CN4602900000000,2022-11-01,46,029,SD,Codington County,15864,15590,274,1.7
CN4603100000000,2022-11-01,46,031,SD,Corson County,1262,1226,36,2.9
CN4603300000000,2022-11-01,46,033,SD,Custer County,4220,4087,133,3.2
CN4603500000000,2022-11-01,46,035,SD,Davison County,11041,10864,177,1.6
CN4603700000000,2022-11-01,46,037,SD,Day County,2579,2524,55,2.1
CN4603900000000,2022-11-01,46,039,SD,Deuel County,2273,2210,63,2.8
CN4604100000000,2022-11-01,46,041,SD,Dewey County,2285,2163,122,5.3
CN4604300000000,2022-11-01,46,043,SD,Douglas County,1477,1452,25,1.7
CN4604500000000,2022-11-01,46,045,SD,Edmunds County,1968,1936,32,1.6
CN4604700000000,2022-11-01,46,047,SD,Fall River County,2978,2910,68,2.3
CN4604900000000,2022-11-01,46,049,SD,Faulk County,1072,1049,23,2.1
CN4605100000000,2022-11-01,46,051,SD,Grant County,4327,4240,87,2
CN4605300000000,2022-11-01,46,053,SD,Gregory County,2162,2122,40,1.9
CN4605500000000,2022-11-01,46,055,SD,Haakon County,1084,1067,17,1.6
CN4605700000000,2022-11-01,46,057,SD,Hamlin County,3571,3516,55,1.5
CN4605900000000,2022-11-01,46,059,SD,Hand County,1782,1753,29,1.6
CN4606100000000,2022-11-01,46,061,SD,Hanson County,1762,1726,36,2
CN4606300000000,2022-11-01,46,063,SD,Harding County,743,728,15,2
CN4606500000000,2022-11-01,46,065,SD,Hughes County,9797,9653,144,1.5
CN4606700000000,2022-11-01,46,067,SD,Hutchinson County,3554,3489,65,1.8
CN4606900000000,2022-11-01,46,069,SD,Hyde County,640,625,15,2.3
CN4607100000000,2022-11-01,46,071,SD,Jackson County,1140,1100,40,3.5
CN4607300000000,2022-11-01,46,073,SD,Jerauld County,1260,1243,17,1.3
CN4607500000000,2022-11-01,46,075,SD,Jones County,487,474,13,2.7
CN4607700000000,2022-11-01,46,077,SD,Kingsbury County,2685,2639,46,1.7
CN4607900000000,2022-11-01,46,079,SD,Lake County,6802,6682,120,1.8
CN4608100000000,2022-11-01,46,081,SD,Lawrence County,13961,13687,274,2
CN4608300000000,2022-11-01,46,083,SD,Lincoln County,37629,37076,553,1.5
CN4608500000000,2022-11-01,46,085,SD,Lyman County,1666,1620,46,2.8
CN4608700000000,2022-11-01,46,087,SD,McCook County,3107,3061,46,1.5
CN4608900000000,2022-11-01,46,089,SD,McPherson County,941,918,23,2.4
CN4609100000000,2022-11-01,46,091,SD,Marshall County,2457,2398,59,2.4
CN4609300000000,2022-11-01,46,093,SD,Meade County,14467,14172,295,2
CN4609500000000,2022-11-01,46,095,SD,Mellette County,731,710,21,2.9
CN4609700000000,2022-11-01,46,097,SD,Miner County,1227,1208,19,1.5
CN4609900000000,2022-11-01,46,099,SD,Minnehaha County,116904,114935,1969,1.7
CN4610100000000,2022-11-01,46,101,SD,Moody County,3974,3902,72,1.8
CN4610200000000,2022-11-01,46,102,SD,Oglala Lakota County,3761,3571,190,5.1
CN4610300000000,2022-11-01,46,103,SD,Pennington County,59582,58386,1196,2
CN4610500000000,2022-11-01,46,105,SD,Perkins County,1404,1374,30,2.1
CN4610700000000,2022-11-01,46,107,SD,Potter County,1022,997,25,2.4
CN4610900000000,2022-11-01,46,109,SD,Roberts County,4572,4458,114,2.5
CN4611100000000,2022-11-01,46,111,SD,Sanborn County,1185,1160,25,2.1
CN4611500000000,2022-11-01,46,115,SD,Spink County,2973,2912,61,2.1
CN4611700000000,2022-11-01,46,117,SD,Stanley County,1895,1866,29,1.5
CN4611900000000,2022-11-01,46,119,SD,Sully County,800,785,15,1.9
CN4612100000000,2022-11-01,46,121,SD,Todd County,2946,2851,95,3.2
CN4612300000000,2022-11-01,46,123,SD,Tripp County,3067,3018,49,1.6
CN4612500000000,2022-11-01,46,125,SD,Turner County,4776,4683,93,1.9
CN4612700000000,2022-11-01,46,127,SD,Union County,8731,8545,186,2.1
CN4612900000000,2022-11-01,46,129,SD,Walworth County,2061,1998,63,3.1
CN4613500000000,2022-11-01,46,135,SD,Yankton County,11646,11456,190,1.6
CN4613700000000,2022-11-01,46,137,SD,Ziebach County,946,912,34,3.6
CN4700100000000,2022-11-01,47,001,TN,Anderson County,34814,33724,1090,3.1
CN4700300000000,2022-11-01,47,003,TN,Bedford County,21129,20420,709,3.4
CN4700500000000,2022-11-01,47,005,TN,Benton County,6570,6320,250,3.8
CN4700700000000,2022-11-01,47,007,TN,Bledsoe County,4334,4111,223,5.1
CN4700900000000,2022-11-01,47,009,TN,Blount County,64692,62818,1874,2.9
CN4701100000000,2022-11-01,47,011,TN,Bradley County,49504,47788,1716,3.5
CN4701300000000,2022-11-01,47,013,TN,Campbell County,14768,14186,582,3.9
CN4701500000000,2022-11-01,47,015,TN,Cannon County,6817,6624,193,2.8
CN4701700000000,2022-11-01,47,017,TN,Carroll County,11550,11124,426,3.7
CN4701900000000,2022-11-01,47,019,TN,Carter County,23770,22946,824,3.5
CN4702100000000,2022-11-01,47,021,TN,Cheatham County,22394,21842,552,2.5
CN4702300000000,2022-11-01,47,023,TN,Chester County,8413,8156,257,3.1
CN4702500000000,2022-11-01,47,025,TN,Claiborne County,12570,12112,458,3.6
CN4702700000000,2022-11-01,47,027,TN,Clay County,2786,2672,114,4.1
CN4702900000000,2022-11-01,47,029,TN,Cocke County,14234,13646,588,4.1
CN4703100000000,2022-11-01,47,031,TN,Coffee County,24705,23905,800,3.2
CN4703300000000,2022-11-01,47,033,TN,Crockett County,6746,6546,200,3
CN4703500000000,2022-11-01,47,035,TN,Cumberland County,23110,22189,921,4
CN4703700000000,2022-11-01,47,037,TN,Davidson County,409183,398750,10433,2.5
CN4703900000000,2022-11-01,47,039,TN,Decatur County,4302,4112,190,4.4
CN4704100000000,2022-11-01,47,041,TN,DeKalb County,7887,7603,284,3.6
CN4704300000000,2022-11-01,47,043,TN,Dickson County,27742,26943,799,2.9
CN4704500000000,2022-11-01,47,045,TN,Dyer County,16338,15779,559,3.4
CN4704700000000,2022-11-01,47,047,TN,Fayette County,18918,18285,633,3.3
CN4704900000000,2022-11-01,47,049,TN,Fentress County,7706,7429,277,3.6
CN4705100000000,2022-11-01,47,051,TN,Franklin County,18735,18093,642,3.4
CN4705300000000,2022-11-01,47,053,TN,Gibson County,21308,20600,708,3.3
CN4705500000000,2022-11-01,47,055,TN,Giles County,14581,14140,441,3
CN4705700000000,2022-11-01,47,057,TN,Grainger County,9597,9256,341,3.6
CN4705900000000,2022-11-01,47,059,TN,Greene County,28294,27157,1137,4
CN4706100000000,2022-11-01,47,061,TN,Grundy County,4916,4713,203,4.1
CN4706300000000,2022-11-01,47,063,TN,Hamblen County,27746,26829,917,3.3
CN4706500000000,2022-11-01,47,065,TN,Hamilton County,180449,174837,5612,3.1
CN4706700000000,2022-11-01,47,067,TN,Hancock County,2257,2173,84,3.7
CN4706900000000,2022-11-01,47,069,TN,Hardeman County,8771,8437,334,3.8
CN4707100000000,2022-11-01,47,071,TN,Hardin County,9797,9417,380,3.9
CN4707300000000,2022-11-01,47,073,TN,Hawkins County,22913,22075,838,3.7
CN4707500000000,2022-11-01,47,075,TN,Haywood County,7401,7079,322,4.4
CN4707700000000,2022-11-01,47,077,TN,Henderson County,11507,11100,407,3.5
CN4707900000000,2022-11-01,47,079,TN,Henry County,13302,12825,477,3.6
CN4708100000000,2022-11-01,47,081,TN,Hickman County,11656,11327,329,2.8
CN4708300000000,2022-11-01,47,083,TN,Houston County,3203,3065,138,4.3
CN4708500000000,2022-11-01,47,085,TN,Humphreys County,8508,8231,277,3.3
CN4708700000000,2022-11-01,47,087,TN,Jackson County,4712,4533,179,3.8
CN4708900000000,2022-11-01,47,089,TN,Jefferson County,24656,23841,815,3.3
CN4709100000000,2022-11-01,47,091,TN,Johnson County,7394,7159,235,3.2
CN4709300000000,2022-11-01,47,093,TN,Knox County,247968,241132,6836,2.8
CN4709500000000,2022-11-01,47,095,TN,Lake County,1578,1509,69,4.4
CN4709700000000,2022-11-01,47,097,TN,Lauderdale County,9268,8854,414,4.5
CN4709900000000,2022-11-01,47,099,TN,Lawrence County,18863,18235,628,3.3
CN4710100000000,2022-11-01,47,101,TN,Lewis County,5473,5285,188,3.4
CN4710300000000,2022-11-01,47,103,TN,Lincoln County,16482,15993,489,3
CN4710500000000,2022-11-01,47,105,TN,Loudon County,24127,23375,752,3.1
CN4710700000000,2022-11-01,47,107,TN,McMinn County,20820,19988,832,4
CN4710900000000,2022-11-01,47,109,TN,McNairy County,8300,7925,375,4.5
CN4711100000000,2022-11-01,47,111,TN,Macon County,11609,11275,334,2.9
CN4711300000000,2022-11-01,47,113,TN,Madison County,48168,46587,1581,3.3
CN4711500000000,2022-11-01,47,115,TN,Marion County,12082,11660,422,3.5
CN4711700000000,2022-11-01,47,117,TN,Marshall County,15497,15015,482,3.1
CN4711900000000,2022-11-01,47,119,TN,Maury County,52516,51064,1452,2.8
CN4712100000000,2022-11-01,47,121,TN,Meigs County,5075,4872,203,4
CN4712300000000,2022-11-01,47,123,TN,Monroe County,20464,19755,709,3.5
CN4712500000000,2022-11-01,47,125,TN,Montgomery County,86934,83856,3078,3.5
CN4712700000000,2022-11-01,47,127,TN,Moore County,3721,3630,91,2.4
CN4712900000000,2022-11-01,47,129,TN,Morgan County,7770,7481,289,3.7
CN4713100000000,2022-11-01,47,131,TN,Obion County,12529,12086,443,3.5
CN4713300000000,2022-11-01,47,133,TN,Overton County,9750,9428,322,3.3
CN4713500000000,2022-11-01,47,135,TN,Perry County,2712,2591,121,4.5
CN4713700000000,2022-11-01,47,137,TN,Pickett County,2100,2018,82,3.9
CN4713900000000,2022-11-01,47,139,TN,Polk County,6949,6696,253,3.6
CN4714100000000,2022-11-01,47,141,TN,Putnam County,34965,33798,1167,3.3
CN4714300000000,2022-11-01,47,143,TN,Rhea County,13518,12953,565,4.2
CN4714500000000,2022-11-01,47,145,TN,Roane County,23482,22656,826,3.5
CN4714700000000,2022-11-01,47,147,TN,Robertson County,38992,37943,1049,2.7
CN4714900000000,2022-11-01,47,149,TN,Rutherford County,194152,189234,4918,2.5
CN4715100000000,2022-11-01,47,151,TN,Scott County,7974,7591,383,4.8
CN4715300000000,2022-11-01,47,153,TN,Sequatchie County,6064,5837,227,3.7
CN4715500000000,2022-11-01,47,155,TN,Sevier County,53581,52163,1418,2.6
CN4715700000000,2022-11-01,47,157,TN,Shelby County,428567,411456,17111,4
CN4715900000000,2022-11-01,47,159,TN,Smith County,9683,9415,268,2.8
CN4716100000000,2022-11-01,47,161,TN,Stewart County,5516,5317,199,3.6
CN4716300000000,2022-11-01,47,163,TN,Sullivan County,68018,65770,2248,3.3
CN4716500000000,2022-11-01,47,165,TN,Sumner County,107906,105104,2802,2.6
CN4716700000000,2022-11-01,47,167,TN,Tipton County,27139,26207,932,3.4
CN4716900000000,2022-11-01,47,169,TN,Trousdale County,5690,5525,165,2.9
CN4717100000000,2022-11-01,47,171,TN,Unicoi County,7010,6717,293,4.2
CN4717300000000,2022-11-01,47,173,TN,Union County,7740,7466,274,3.5
CN4717500000000,2022-11-01,47,175,TN,Van Buren County,2042,1961,81,4
CN4717700000000,2022-11-01,47,177,TN,Warren County,16246,15654,592,3.6
CN4717900000000,2022-11-01,47,179,TN,Washington County,60778,58836,1942,3.2
CN4718100000000,2022-11-01,47,181,TN,Wayne County,6379,6113,266,4.2
CN4718300000000,2022-11-01,47,183,TN,Weakley County,15262,14779,483,3.2
CN4718500000000,2022-11-01,47,185,TN,White County,11919,11499,420,3.5
CN4718700000000,2022-11-01,47,187,TN,Williamson County,137253,133881,3372,2.5
CN4718900000000,2022-11-01,47,189,TN,Wilson County,81415,79351,2064,2.5
CN4800100000000,2022-11-01,48,001,TX,Anderson County,22979,22237,742,3.2
CN4800300000000,2022-11-01,48,003,TX,Andrews County,9565,9294,271,2.8
CN4800500000000,2022-11-01,48,005,TX,Angelina County,35073,33554,1519,4.3
CN4800700000000,2022-11-01,48,007,TX,Aransas County,9228,8767,461,5
CN4800900000000,2022-11-01,48,009,TX,Archer County,3945,3825,120,3
CN4801100000000,2022-11-01,48,011,TX,Armstrong County,916,891,25,2.7
CN4801300000000,2022-11-01,48,013,TX,Atascosa County,22491,21649,842,3.7
CN4801500000000,2022-11-01,48,015,TX,Austin County,14071,13567,504,3.6
CN4801700000000,2022-11-01,48,017,TX,Bailey County,2224,2128,96,4.3
CN4801900000000,2022-11-01,48,019,TX,Bandera County,10639,10256,383,3.6
CN4802100000000,2022-11-01,48,021,TX,Bastrop County,48521,46995,1526,3.1
CN4802300000000,2022-11-01,48,023,TX,Baylor County,1925,1877,48,2.5
CN4802500000000,2022-11-01,48,025,TX,Bee County,9043,8557,486,5.4
CN4802700000000,2022-11-01,48,027,TX,Bell County,149824,143501,6323,4.2
CN4802900000000,2022-11-01,48,029,TX,Bexar County,986660,951854,34806,3.5
CN4803100000000,2022-11-01,48,031,TX,Blanco County,7114,6928,186,2.6
CN4803300000000,2022-11-01,48,033,TX,Borden County,719,707,12,1.7
CN4803500000000,2022-11-01,48,035,TX,Bosque County,8554,8263,291,3.4
CN4803700000000,2022-11-01,48,037,TX,Bowie County,38332,36703,1629,4.2
CN4803900000000,2022-11-01,48,039,TX,Brazoria County,185364,177636,7728,4.2
CN4804100000000,2022-11-01,48,041,TX,Brazos County,131972,128020,3952,3
CN4804300000000,2022-11-01,48,043,TX,Brewster County,4284,4152,132,3.1
CN4804500000000,2022-11-01,48,045,TX,Briscoe County,568,548,20,3.5
CN4804700000000,2022-11-01,48,047,TX,Brooks County,2344,2222,122,5.2
CN4804900000000,2022-11-01,48,049,TX,Brown County,15241,14499,742,4.9
CN4805100000000,2022-11-01,48,051,TX,Burleson County,9019,8709,310,3.4
CN4805300000000,2022-11-01,48,053,TX,Burnet County,25672,24926,746,2.9
CN4805500000000,2022-11-01,48,055,TX,Caldwell County,21455,20752,703,3.3
CN4805700000000,2022-11-01,48,057,TX,Calhoun County,12266,11867,399,3.3
CN4805900000000,2022-11-01,48,059,TX,Callahan County,6280,6064,216,3.4
CN4806100000000,2022-11-01,48,061,TX,Cameron County,177169,167777,9392,5.3
CN4806300000000,2022-11-01,48,063,TX,Camp County,5021,4799,222,4.4
CN4806500000000,2022-11-01,48,065,TX,Carson County,2952,2864,88,3
CN4806700000000,2022-11-01,48,067,TX,Cass County,11752,11230,522,4.4
CN4806900000000,2022-11-01,48,069,TX,Castro County,3120,3017,103,3.3
CN4807100000000,2022-11-01,48,071,TX,Chambers County,21091,20092,999,4.7
CN4807300000000,2022-11-01,48,073,TX,Cherokee County,20167,19309,858,4.3
CN4807500000000,2022-11-01,48,075,TX,Childress County,3179,3091,88,2.8
CN4807700000000,2022-11-01,48,077,TX,Clay County,4770,4598,172,3.6
CN4807900000000,2022-11-01,48,079,TX,Cochran County,1010,962,48,4.8
CN4808100000000,2022-11-01,48,081,TX,Coke County,1527,1482,45,2.9
CN4808300000000,2022-11-01,48,083,TX,Coleman County,2984,2851,133,4.5
CN4808500000000,2022-11-01,48,085,TX,Collin County,634755,615238,19517,3.1
CN4808700000000,2022-11-01,48,087,TX,Collingsworth County,1035,999,36,3.5
CN4808900000000,2022-11-01,48,089,TX,Colorado County,10004,9663,341,3.4
CN4809100000000,2022-11-01,48,091,TX,Comal County,82870,80116,2754,3.3
CN4809300000000,2022-11-01,48,093,TX,Comanche County,6256,6033,223,3.6
CN4809500000000,2022-11-01,48,095,TX,Concho County,1208,1169,39,3.2
CN4809700000000,2022-11-01,48,097,TX,Cooke County,19827,19208,619,3.1
CN4809900000000,2022-11-01,48,099,TX,Coryell County,24740,23681,1059,4.3
CN4810100000000,2022-11-01,48,101,TX,Cottle County,908,885,23,2.5
CN4810300000000,2022-11-01,48,103,TX,Crane County,1677,1605,72,4.3
CN4810500000000,2022-11-01,48,105,TX,Crockett County,1426,1380,46,3.2
CN4810700000000,2022-11-01,48,107,TX,Crosby County,2300,2204,96,4.2
CN4810900000000,2022-11-01,48,109,TX,Culberson County,1145,1115,30,2.6
CN4811100000000,2022-11-01,48,111,TX,Dallam County,3685,3589,96,2.6
CN4811300000000,2022-11-01,48,113,TX,Dallas County,1440888,1390209,50679,3.5
CN4811500000000,2022-11-01,48,115,TX,Dawson County,4428,4247,181,4.1
CN4811700000000,2022-11-01,48,117,TX,Deaf Smith County,8658,8401,257,3
CN4811900000000,2022-11-01,48,119,TX,Delta County,2513,2416,97,3.9
CN4812100000000,2022-11-01,48,121,TX,Denton County,559765,542457,17308,3.1
CN4812300000000,2022-11-01,48,123,TX,DeWitt County,8995,8711,284,3.2
CN4812500000000,2022-11-01,48,125,TX,Dickens County,655,622,33,5
CN4812700000000,2022-11-01,48,127,TX,Dimmit County,6230,6004,226,3.6
CN4812900000000,2022-11-01,48,129,TX,Donley County,1451,1396,55,3.8
CN4813100000000,2022-11-01,48,131,TX,Duval County,5024,4830,194,3.9
CN4813300000000,2022-11-01,48,133,TX,Eastland County,6652,6362,290,4.4
CN4813500000000,2022-11-01,48,135,TX,Ector County,85019,82132,2887,3.4
CN4813700000000,2022-11-01,48,137,TX,Edwards County,1073,1041,32,3
CN4813900000000,2022-11-01,48,139,TX,Ellis County,104703,101203,3500,3.3
CN4814100000000,2022-11-01,48,141,TX,El Paso County,372455,357178,15277,4.1
CN4814300000000,2022-11-01,48,143,TX,Erath County,21108,20359,749,3.5
CN4814500000000,2022-11-01,48,145,TX,Falls County,6778,6514,264,3.9
CN4814700000000,2022-11-01,48,147,TX,Fannin County,17401,16721,680,3.9
CN4814900000000,2022-11-01,48,149,TX,Fayette County,11809,11410,399,3.4
CN4815100000000,2022-11-01,48,151,TX,Fisher County,1608,1556,52,3.2
CN4815300000000,2022-11-01,48,153,TX,Floyd County,2284,2188,96,4.2
CN4815500000000,2022-11-01,48,155,TX,Foard County,522,505,17,3.3
CN4815700000000,2022-11-01,48,157,TX,Fort Bend County,421695,405868,15827,3.8
CN4815900000000,2022-11-01,48,159,TX,Franklin County,5264,5080,184,3.5
CN4816100000000,2022-11-01,48,161,TX,Freestone County,6156,5841,315,5.1
CN4816300000000,2022-11-01,48,163,TX,Frio County,9088,8798,290,3.2
CN4816500000000,2022-11-01,48,165,TX,Gaines County,9906,9610,296,3
CN4816700000000,2022-11-01,48,167,TX,Galveston County,169891,162946,6945,4.1
CN4816900000000,2022-11-01,48,169,TX,Garza County,1930,1853,77,4
CN4817100000000,2022-11-01,48,171,TX,Gillespie County,14733,14375,358,2.4
CN4817300000000,2022-11-01,48,173,TX,Glasscock County,821,799,22,2.7
CN4817500000000,2022-11-01,48,175,TX,Goliad County,3195,3059,136,4.3
CN4817700000000,2022-11-01,48,177,TX,Gonzales County,9245,8944,301,3.3
CN4817900000000,2022-11-01,48,179,TX,Gray County,7586,7257,329,4.3
CN4818100000000,2022-11-01,48,181,TX,Grayson County,66322,63977,2345,3.5
CN4818300000000,2022-11-01,48,183,TX,Gregg County,57120,54846,2274,4
CN4818500000000,2022-11-01,48,185,TX,Grimes County,11533,11046,487,4.2
CN4818700000000,2022-11-01,48,187,TX,Guadalupe County,86295,83467,2828,3.3
CN4818900000000,2022-11-01,48,189,TX,Hale County,11302,10737,565,5
CN4819100000000,2022-11-01,48,191,TX,Hall County,1014,968,46,4.5
CN4819300000000,2022-11-01,48,193,TX,Hamilton County,3836,3706,130,3.4
CN4819500000000,2022-11-01,48,195,TX,Hansford County,2768,2698,70,2.5
CN4819700000000,2022-11-01,48,197,TX,Hardeman County,1742,1685,57,3.3
CN4819900000000,2022-11-01,48,199,TX,Hardin County,25033,23866,1167,4.7
CN4820100000000,2022-11-01,48,201,TX,Harris County,2354243,2260917,93326,4
CN4820300000000,2022-11-01,48,203,TX,Harrison County,28751,27560,1191,4.1
CN4820500000000,2022-11-01,48,205,TX,Hartley County,2487,2433,54,2.2
CN4820700000000,2022-11-01,48,207,TX,Haskell County,2702,2621,81,3
CN4820900000000,2022-11-01,48,209,TX,Hays County,140179,136095,4084,2.9
CN4821100000000,2022-11-01,48,211,TX,Hemphill County,1610,1558,52,3.2
CN4821300000000,2022-11-01,48,213,TX,Henderson County,38884,37501,1383,3.6
CN4821500000000,2022-11-01,48,215,TX,Hidalgo County,374227,351816,22411,6
CN4821700000000,2022-11-01,48,217,TX,Hill County,18138,17366,772,4.3
CN4821900000000,2022-11-01,48,219,TX,Hockley County,10628,10266,362,3.4
CN4822100000000,2022-11-01,48,221,TX,Hood County,30131,29045,1086,3.6
CN4822300000000,2022-11-01,48,223,TX,Hopkins County,18505,17753,752,4.1
CN4822500000000,2022-11-01,48,225,TX,Houston County,10527,10199,328,3.1
CN4822700000000,2022-11-01,48,227,TX,Howard County,12872,12328,544,4.2
CN4822900000000,2022-11-01,48,229,TX,Hudspeth County,1823,1752,71,3.9
CN4823100000000,2022-11-01,48,231,TX,Hunt County,47440,45594,1846,3.9
CN4823300000000,2022-11-01,48,233,TX,Hutchinson County,8432,8081,351,4.2
CN4823500000000,2022-11-01,48,235,TX,Irion County,768,746,22,2.9
CN4823700000000,2022-11-01,48,237,TX,Jack County,3456,3330,126,3.6
CN4823900000000,2022-11-01,48,239,TX,Jackson County,6921,6692,229,3.3
CN4824100000000,2022-11-01,48,241,TX,Jasper County,12711,11954,757,6
CN4824300000000,2022-11-01,48,243,TX,Jeff Davis County,950,917,33,3.5
CN4824500000000,2022-11-01,48,245,TX,Jefferson County,101623,95787,5836,5.7
CN4824700000000,2022-11-01,48,247,TX,Jim Hogg County,1769,1685,84,4.7
CN4824900000000,2022-11-01,48,249,TX,Jim Wells County,15348,14528,820,5.3
CN4825100000000,2022-11-01,48,251,TX,Johnson County,89981,86998,2983,3.3
CN4825300000000,2022-11-01,48,253,TX,Jones County,5753,5515,238,4.1
CN4825500000000,2022-11-01,48,255,TX,Karnes County,6616,6413,203,3.1
CN4825700000000,2022-11-01,48,257,TX,Kaufman County,76236,73426,2810,3.7
CN4825900000000,2022-11-01,48,259,TX,Kendall County,23751,23016,735,3.1
CN4826100000000,2022-11-01,48,261,TX,Kenedy County,113,104,9,8
CN4826300000000,2022-11-01,48,263,TX,Kent County,741,725,16,2.2
CN4826500000000,2022-11-01,48,265,TX,Kerr County,22304,21536,768,3.4
CN4826700000000,2022-11-01,48,267,TX,Kimble County,1732,1675,57,3.3
CN4826900000000,2022-11-01,48,269,TX,King County,520,514,6,1.2
CN4827100000000,2022-11-01,48,271,TX,Kinney County,1226,1174,52,4.2
CN4827300000000,2022-11-01,48,273,TX,Kleberg County,13010,12406,604,4.6
CN4827500000000,2022-11-01,48,275,TX,Knox County,1401,1350,51,3.6
CN4827700000000,2022-11-01,48,277,TX,Lamar County,24349,23332,1017,4.2
CN4827900000000,2022-11-01,48,279,TX,Lamb County,5021,4824,197,3.9
CN4828100000000,2022-11-01,48,281,TX,Lampasas County,9402,9072,330,3.5
CN4828300000000,2022-11-01,48,283,TX,La Salle County,4133,4033,100,2.4
CN4828500000000,2022-11-01,48,285,TX,Lavaca County,8963,8682,281,3.1
CN4828700000000,2022-11-01,48,287,TX,Lee County,8571,8291,280,3.3
CN4828900000000,2022-11-01,48,289,TX,Leon County,5928,5638,290,4.9
CN4829100000000,2022-11-01,48,291,TX,Liberty County,35277,33407,1870,5.3
CN4829300000000,2022-11-01,48,293,TX,Limestone County,8254,7896,358,4.3
CN4829500000000,2022-11-01,48,295,TX,Lipscomb County,1423,1377,46,3.2
CN4829700000000,2022-11-01,48,297,TX,Live Oak County,4744,4554,190,4
CN4829900000000,2022-11-01,48,299,TX,Llano County,9233,8903,330,3.6
CN4830100000000,2022-11-01,48,301,TX,Loving County,1385,1379,6,0.4
CN4830300000000,2022-11-01,48,303,TX,Lubbock County,163472,158188,5284,3.2
CN4830500000000,2022-11-01,48,305,TX,Lynn County,2743,2653,90,3.3
CN4830700000000,2022-11-01,48,307,TX,McCulloch County,3089,2959,130,4.2
CN4830900000000,2022-11-01,48,309,TX,McLennan County,127699,123406,4293,3.4
CN4831100000000,2022-11-01,48,311,TX,McMullen County,860,847,13,1.5
CN4831300000000,2022-11-01,48,313,TX,Madison County,4671,4481,190,4.1
CN4831500000000,2022-11-01,48,315,TX,Marion County,4147,3957,190,4.6
CN4831700000000,2022-11-01,48,317,TX,Martin County,2781,2706,75,2.7
CN4831900000000,2022-11-01,48,319,TX,Mason County,1772,1714,58,3.3
CN4832100000000,2022-11-01,48,321,TX,Matagorda County,16916,15997,919,5.4
CN4832300000000,2022-11-01,48,323,TX,Maverick County,23049,21481,1568,6.8
CN4832500000000,2022-11-01,48,325,TX,Medina County,22683,21845,838,3.7
CN4832700000000,2022-11-01,48,327,TX,Menard County,815,787,28,3.4
CN4832900000000,2022-11-01,48,329,TX,Midland County,108338,105578,2760,2.5
CN4833100000000,2022-11-01,48,331,TX,Milam County,10077,9654,423,4.2
CN4833300000000,2022-11-01,48,333,TX,Mills County,1825,1744,81,4.4
CN4833500000000,2022-11-01,48,335,TX,Mitchell County,2226,2142,84,3.8
CN4833700000000,2022-11-01,48,337,TX,Montague County,9155,8840,315,3.4
CN4833900000000,2022-11-01,48,339,TX,Montgomery County,303624,292447,11177,3.7
CN4834100000000,2022-11-01,48,341,TX,Moore County,11093,10796,297,2.7
CN4834300000000,2022-11-01,48,343,TX,Morris County,4486,4229,257,5.7
CN4834500000000,2022-11-01,48,345,TX,Motley County,487,470,17,3.5
CN4834700000000,2022-11-01,48,347,TX,Nacogdoches County,27814,26613,1201,4.3
CN4834900000000,2022-11-01,48,349,TX,Navarro County,23904,23058,846,3.5
CN4835100000000,2022-11-01,48,351,TX,Newton County,4896,4571,325,6.6
CN4835300000000,2022-11-01,48,353,TX,Nolan County,6611,6373,238,3.6
CN4835500000000,2022-11-01,48,355,TX,Nueces County,163542,156574,6968,4.3
CN4835700000000,2022-11-01,48,357,TX,Ochiltree County,3782,3646,136,3.6
CN4835900000000,2022-11-01,48,359,TX,Oldham County,911,885,26,2.9
CN4836100000000,2022-11-01,48,361,TX,Orange County,35090,33232,1858,5.3
CN4836300000000,2022-11-01,48,363,TX,Palo Pinto County,13081,12607,474,3.6
CN4836500000000,2022-11-01,48,365,TX,Panola County,9506,9106,400,4.2
CN4836700000000,2022-11-01,48,367,TX,Parker County,75294,72934,2360,3.1
CN4836900000000,2022-11-01,48,369,TX,Parmer County,4863,4740,123,2.5
CN4837100000000,2022-11-01,48,371,TX,Pecos County,6209,5983,226,3.6
CN4837300000000,2022-11-01,48,373,TX,Polk County,18692,17744,948,5.1
CN4837500000000,2022-11-01,48,375,TX,Potter County,55131,53479,1652,3
CN4837700000000,2022-11-01,48,377,TX,Presidio County,3005,2835,170,5.7
CN4837900000000,2022-11-01,48,379,TX,Rains County,6553,6328,225,3.4
CN4838100000000,2022-11-01,48,381,TX,Randall County,76132,73999,2133,2.8
CN4838300000000,2022-11-01,48,383,TX,Reagan County,1581,1529,52,3.3
CN4838500000000,2022-11-01,48,385,TX,Real County,1106,1049,57,5.2
CN4838700000000,2022-11-01,48,387,TX,Red River County,4932,4693,239,4.8
CN4838900000000,2022-11-01,48,389,TX,Reeves County,8482,8169,313,3.7
CN4839100000000,2022-11-01,48,391,TX,Refugio County,2863,2743,120,4.2
CN4839300000000,2022-11-01,48,393,TX,Roberts County,379,366,13,3.4
CN4839500000000,2022-11-01,48,395,TX,Robertson County,8066,7778,288,3.6
CN4839700000000,2022-11-01,48,397,TX,Rockwall County,60127,58162,1965,3.3
CN4839900000000,2022-11-01,48,399,TX,Runnels County,4585,4424,161,3.5
CN4840100000000,2022-11-01,48,401,TX,Rusk County,22409,21523,886,4
CN4840300000000,2022-11-01,48,403,TX,Sabine County,3823,3571,252,6.6
CN4840500000000,2022-11-01,48,405,TX,San Augustine County,3094,2932,162,5.2
CN4840700000000,2022-11-01,48,407,TX,San Jacinto County,11948,11402,546,4.6
CN4840900000000,2022-11-01,48,409,TX,San Patricio County,28948,27458,1490,5.1
CN4841100000000,2022-11-01,48,411,TX,San Saba County,2179,2105,74,3.4
CN4841300000000,2022-11-01,48,413,TX,Schleicher County,1211,1169,42,3.5
CN4841500000000,2022-11-01,48,415,TX,Scurry County,6236,5997,239,3.8
CN4841700000000,2022-11-01,48,417,TX,Shackelford County,1753,1710,43,2.5
CN4841900000000,2022-11-01,48,419,TX,Shelby County,10917,10485,432,4
CN4842100000000,2022-11-01,48,421,TX,Sherman County,1275,1236,39,3.1
CN4842300000000,2022-11-01,48,423,TX,Smith County,112290,108307,3983,3.5
CN4842500000000,2022-11-01,48,425,TX,Somervell County,4626,4452,174,3.8
CN4842700000000,2022-11-01,48,427,TX,Starr County,23752,21498,2254,9.5
CN4842900000000,2022-11-01,48,429,TX,Stephens County,3998,3857,141,3.5
CN4843100000000,2022-11-01,48,431,TX,Sterling County,456,439,17,3.7
CN4843300000000,2022-11-01,48,433,TX,Stonewall County,753,733,20,2.7
CN4843500000000,2022-11-01,48,435,TX,Sutton County,976,924,52,5.3
CN4843700000000,2022-11-01,48,437,TX,Swisher County,2502,2390,112,4.5
CN4843900000000,2022-11-01,48,439,TX,Tarrant County,1154744,1115209,39535,3.4
CN4844100000000,2022-11-01,48,441,TX,Taylor County,69126,66939,2187,3.2
CN4844300000000,2022-11-01,48,443,TX,Terrell County,403,390,13,3.2
CN4844500000000,2022-11-01,48,445,TX,Terry County,4406,4229,177,4
CN4844700000000,2022-11-01,48,447,TX,Throckmorton County,659,637,22,3.3
CN4844900000000,2022-11-01,48,449,TX,Titus County,13736,13156,580,4.2
CN4845100000000,2022-11-01,48,451,TX,Tom Green County,55579,53785,1794,3.2
CN4845300000000,2022-11-01,48,453,TX,Travis County,832702,810079,22623,2.7
CN4845500000000,2022-11-01,48,455,TX,Trinity County,5240,4979,261,5
CN4845700000000,2022-11-01,48,457,TX,Tyler County,6945,6559,386,5.6
CN4845900000000,2022-11-01,48,459,TX,Upshur County,17792,17093,699,3.9
CN4846100000000,2022-11-01,48,461,TX,Upton County,2312,2260,52,2.2
CN4846300000000,2022-11-01,48,463,TX,Uvalde County,10924,10454,470,4.3
CN4846500000000,2022-11-01,48,465,TX,Val Verde County,22395,21385,1010,4.5
CN4846700000000,2022-11-01,48,467,TX,Van Zandt County,27662,26730,932,3.4
CN4846900000000,2022-11-01,48,469,TX,Victoria County,41553,39954,1599,3.8
CN4847100000000,2022-11-01,48,471,TX,Walker County,23908,22840,1068,4.5
CN4847300000000,2022-11-01,48,473,TX,Waller County,25485,24410,1075,4.2
CN4847500000000,2022-11-01,48,475,TX,Ward County,6224,6020,204,3.3
CN4847700000000,2022-11-01,48,477,TX,Washington County,14960,14382,578,3.9
CN4847900000000,2022-11-01,48,479,TX,Webb County,117404,112930,4474,3.8
CN4848100000000,2022-11-01,48,481,TX,Wharton County,20932,20168,764,3.6
CN4848300000000,2022-11-01,48,483,TX,Wheeler County,1875,1804,71,3.8
CN4848500000000,2022-11-01,48,485,TX,Wichita County,55326,53304,2022,3.7
CN4848700000000,2022-11-01,48,487,TX,Wilbarger County,4634,4417,217,4.7
CN4848900000000,2022-11-01,48,489,TX,Willacy County,7014,6527,487,6.9
CN4849100000000,2022-11-01,48,491,TX,Williamson County,369386,358749,10637,2.9
CN4849300000000,2022-11-01,48,493,TX,Wilson County,26087,25293,794,3
CN4849500000000,2022-11-01,48,495,TX,Winkler County,3940,3805,135,3.4
CN4849700000000,2022-11-01,48,497,TX,Wise County,34519,33373,1146,3.3
CN4849900000000,2022-11-01,48,499,TX,Wood County,18244,17456,788,4.3
CN4850100000000,2022-11-01,48,501,TX,Yoakum County,3179,3062,117,3.7
CN4850300000000,2022-11-01,48,503,TX,Young County,7870,7616,254,3.2
CN4850500000000,2022-11-01,48,505,TX,Zapata County,4474,4188,286,6.4
CN4850700000000,2022-11-01,48,507,TX,Zavala County,3377,3112,265,7.8
CN4900100000000,2022-11-01,49,001,UT,Beaver County,2832,2751,81,2.9
CN4900300000000,2022-11-01,49,003,UT,Box Elder County,27799,27205,594,2.1
CN4900500000000,2022-11-01,49,005,UT,Cache County,72912,71492,1420,1.9
CN4900700000000,2022-11-01,49,007,UT,Carbon County,8398,8121,277,3.3
CN4900900000000,2022-11-01,49,009,UT,Daggett County,387,365,22,5.7
CN4901100000000,2022-11-01,49,011,UT,Davis County,185634,181689,3945,2.1
CN4901300000000,2022-11-01,49,013,UT,Duchesne County,8116,7907,209,2.6
CN4901500000000,2022-11-01,49,015,UT,Emery County,4423,4292,131,3
CN4901700000000,2022-11-01,49,017,UT,Garfield County,2639,2496,143,5.4
CN4901900000000,2022-11-01,49,019,UT,Grand County,6836,6659,177,2.6
CN4902100000000,2022-11-01,49,021,UT,Iron County,28571,27890,681,2.4
CN4902300000000,2022-11-01,49,023,UT,Juab County,6500,6386,114,1.8
CN4902500000000,2022-11-01,49,025,UT,Kane County,4089,3984,105,2.6
CN4902700000000,2022-11-01,49,027,UT,Millard County,6166,6033,133,2.2
CN4902900000000,2022-11-01,49,029,UT,Morgan County,5992,5871,121,2
CN4903100000000,2022-11-01,49,031,UT,Piute County,518,493,25,4.8
CN4903300000000,2022-11-01,49,033,UT,Rich County,1066,1039,27,2.5
CN4903500000000,2022-11-01,49,035,UT,Salt Lake County,687771,673027,14744,2.1
CN4903700000000,2022-11-01,49,037,UT,San Juan County,5498,5302,196,3.6
CN4903900000000,2022-11-01,49,039,UT,Sanpete County,13793,13427,366,2.7
CN4904100000000,2022-11-01,49,041,UT,Sevier County,10296,10039,257,2.5
CN4904300000000,2022-11-01,49,043,UT,Summit County,25519,24911,608,2.4
CN4904500000000,2022-11-01,49,045,UT,Tooele County,38870,37917,953,2.5
CN4904700000000,2022-11-01,49,047,UT,Uintah County,14179,13766,413,2.9
CN4904900000000,2022-11-01,49,049,UT,Utah County,350067,342627,7440,2.1
CN4905100000000,2022-11-01,49,051,UT,Wasatch County,17750,17334,416,2.3
CN4905300000000,2022-11-01,49,053,UT,Washington County,88747,86672,2075,2.3
CN4905500000000,2022-11-01,49,055,UT,Wayne County,1436,1372,64,4.5
CN4905700000000,2022-11-01,49,057,UT,Weber County,136171,133044,3127,2.3
CN5000100000000,2022-11-01,50,001,VT,Addison County,20832,20318,514,2.5
CN5000300000000,2022-11-01,50,003,VT,Bennington County,17606,17019,587,3.3
CN5000500000000,2022-11-01,50,005,VT,Caledonia County,14667,14197,470,3.2
CN5000700000000,2022-11-01,50,007,VT,Chittenden County,98137,95914,2223,2.3
CN5000900000000,2022-11-01,50,009,VT,Essex County,2649,2535,114,4.3
CN5001100000000,2022-11-01,50,011,VT,Franklin County,27845,27134,711,2.6
CN5001300000000,2022-11-01,50,013,VT,Grand Isle County,4192,4024,168,4
CN5001500000000,2022-11-01,50,015,VT,Lamoille County,13980,13500,480,3.4
CN5001700000000,2022-11-01,50,017,VT,Orange County,15684,15300,384,2.4
CN5001900000000,2022-11-01,50,019,VT,Orleans County,13231,12683,548,4.1
CN5002100000000,2022-11-01,50,021,VT,Rutland County,29757,28766,991,3.3
CN5002300000000,2022-11-01,50,023,VT,Washington County,33987,33115,872,2.6
CN5002500000000,2022-11-01,50,025,VT,Windham County,21203,20539,664,3.1
CN5002700000000,2022-11-01,50,027,VT,Windsor County,28818,28096,722,2.5
CN5100100000000,2022-11-01,51,001,VA,Accomack County,15904,15364,540,3.4
CN5100300000000,2022-11-01,51,003,VA,Albemarle County,58946,57315,1631,2.8
CN5100500000000,2022-11-01,51,005,VA,Alleghany County,6691,6480,211,3.2
CN5100700000000,2022-11-01,51,007,VA,Amelia County,6313,6125,188,3
CN5100900000000,2022-11-01,51,009,VA,Amherst County,14910,14422,488,3.3
CN5101100000000,2022-11-01,51,011,VA,Appomattox County,7187,6942,245,3.4
CN5101300000000,2022-11-01,51,013,VA,Arlington County,157229,153849,3380,2.1
CN5101500000000,2022-11-01,51,015,VA,Augusta County,38828,37816,1012,2.6
CN5101700000000,2022-11-01,51,017,VA,Bath County,2606,2540,66,2.5
CN5101900000000,2022-11-01,51,019,VA,Bedford County,38701,37551,1150,3
CN5102100000000,2022-11-01,51,021,VA,Bland County,2841,2759,82,2.9
CN5102300000000,2022-11-01,51,023,VA,Botetourt County,17788,17305,483,2.7
CN5102500000000,2022-11-01,51,025,VA,Brunswick County,5912,5631,281,4.8
CN5102700000000,2022-11-01,51,027,VA,Buchanan County,6402,6089,313,4.9
CN5102900000000,2022-11-01,51,029,VA,Buckingham County,6564,6278,286,4.4
CN5103100000000,2022-11-01,51,031,VA,Campbell County,25938,25101,837,3.2
CN5103300000000,2022-11-01,51,033,VA,Caroline County,15426,14893,533,3.5
CN5103500000000,2022-11-01,51,035,VA,Carroll County,13043,12592,451,3.5
CN5103600000000,2022-11-01,51,036,VA,Charles City County,3619,3499,120,3.3
CN5103700000000,2022-11-01,51,037,VA,Charlotte County,5653,5458,195,3.4
CN5104100000000,2022-11-01,51,041,VA,Chesterfield County,194262,188455,5807,3
CN5104300000000,2022-11-01,51,043,VA,Clarke County,7717,7520,197,2.6
CN5104500000000,2022-11-01,51,045,VA,Craig County,2331,2256,75,3.2
CN5104700000000,2022-11-01,51,047,VA,Culpeper County,25677,24944,733,2.9
CN5104900000000,2022-11-01,51,049,VA,Cumberland County,4842,4674,168,3.5
CN5105100000000,2022-11-01,51,051,VA,Dickenson County,4597,4377,220,4.8
CN5105300000000,2022-11-01,51,053,VA,Dinwiddie County,13846,13390,456,3.3
CN5105700000000,2022-11-01,51,057,VA,Essex County,5575,5375,200,3.6
CN5105900000000,2022-11-01,51,059,VA,Fairfax County,640663,624300,16363,2.6
CN5106100000000,2022-11-01,51,061,VA,Fauquier County,37968,36945,1023,2.7
CN5106300000000,2022-11-01,51,063,VA,Floyd County,8698,8473,225,2.6
CN5106500000000,2022-11-01,51,065,VA,Fluvanna County,14424,14032,392,2.7
CN5106700000000,2022-11-01,51,067,VA,Franklin County,26690,25869,821,3.1
CN5106900000000,2022-11-01,51,069,VA,Frederick County,51975,50614,1361,2.6
CN5107100000000,2022-11-01,51,071,VA,Giles County,8337,8042,295,3.5
CN5107300000000,2022-11-01,51,073,VA,Gloucester County,19511,18928,583,3
CN5107500000000,2022-11-01,51,075,VA,Goochland County,11889,11551,338,2.8
CN5107700000000,2022-11-01,51,077,VA,Grayson County,8304,8093,211,2.5
CN5107900000000,2022-11-01,51,079,VA,Greene County,10816,10530,286,2.6
CN5108100000000,2022-11-01,51,081,VA,Greensville County,4380,4205,175,4
CN5108300000000,2022-11-01,51,083,VA,Halifax County,15532,14870,662,4.3
CN5108500000000,2022-11-01,51,085,VA,Hanover County,60255,58690,1565,2.6
CN5108700000000,2022-11-01,51,087,VA,Henrico County,185811,180306,5505,3
CN5108900000000,2022-11-01,51,089,VA,Henry County,24068,23192,876,3.6
CN5109100000000,2022-11-01,51,091,VA,Highland County,1480,1444,36,2.4
CN5109300000000,2022-11-01,51,093,VA,Isle of Wight County,19686,19096,590,3
CN5109500000000,2022-11-01,51,095,VA,James City County,36896,35789,1107,3
CN5109700000000,2022-11-01,51,097,VA,King and Queen County,3981,3868,113,2.8
CN5109900000000,2022-11-01,51,099,VA,King George County,14346,13958,388,2.7
CN5110100000000,2022-11-01,51,101,VA,King William County,9616,9348,268,2.8
CN5110300000000,2022-11-01,51,103,VA,Lancaster County,5542,5361,181,3.3
CN5110500000000,2022-11-01,51,105,VA,Lee County,8262,7922,340,4.1
CN5110700000000,2022-11-01,51,107,VA,Loudoun County,233024,227079,5945,2.6
CN5110900000000,2022-11-01,51,109,VA,Louisa County,21240,20662,578,2.7
CN5111100000000,2022-11-01,51,111,VA,Lunenburg County,5237,5040,197,3.8
CN5111300000000,2022-11-01,51,113,VA,Madison County,7708,7531,177,2.3
CN5111500000000,2022-11-01,51,115,VA,Mathews County,4084,3962,122,3
CN5111700000000,2022-11-01,51,117,VA,Mecklenburg County,13390,12893,497,3.7
CN5111900000000,2022-11-01,51,119,VA,Middlesex County,5400,5246,154,2.9
CN5112100000000,2022-11-01,51,121,VA,Montgomery County,53128,51608,1520,2.9
CN5112500000000,2022-11-01,51,125,VA,Nelson County,7510,7297,213,2.8
CN5112700000000,2022-11-01,51,127,VA,New Kent County,13300,12946,354,2.7
CN5113100000000,2022-11-01,51,131,VA,Northampton County,5657,5432,225,4
CN5113300000000,2022-11-01,51,133,VA,Northumberland County,5711,5498,213,3.7
CN5113500000000,2022-11-01,51,135,VA,Nottoway County,7250,7028,222,3.1
CN5113700000000,2022-11-01,51,137,VA,Orange County,17635,17061,574,3.3
CN5113900000000,2022-11-01,51,139,VA,Page County,12354,11928,426,3.4
CN5114100000000,2022-11-01,51,141,VA,Patrick County,7173,6914,259,3.6
CN5114300000000,2022-11-01,51,143,VA,Pittsylvania County,30425,29472,953,3.1
CN5114500000000,2022-11-01,51,145,VA,Powhatan County,14737,14331,406,2.8
CN5114700000000,2022-11-01,51,147,VA,Prince Edward County,10151,9756,395,3.9
CN5114900000000,2022-11-01,51,149,VA,Prince George County,15452,14887,565,3.7
CN5115300000000,2022-11-01,51,153,VA,Prince William County,251516,244410,7106,2.8
CN5115500000000,2022-11-01,51,155,VA,Pulaski County,16969,16481,488,2.9
CN5115700000000,2022-11-01,51,157,VA,Rappahannock County,3740,3647,93,2.5
CN5115900000000,2022-11-01,51,159,VA,Richmond County,4035,3919,116,2.9
CN5116100000000,2022-11-01,51,161,VA,Roanoke County,50102,48766,1336,2.7
CN5116300000000,2022-11-01,51,163,VA,Rockbridge County,11007,10687,320,2.9
CN5116500000000,2022-11-01,51,165,VA,Rockingham County,43588,42427,1161,2.7
CN5116700000000,2022-11-01,51,167,VA,Russell County,10951,10545,406,3.7
CN5116900000000,2022-11-01,51,169,VA,Scott County,9341,9003,338,3.6
CN5117100000000,2022-11-01,51,171,VA,Shenandoah County,22121,21459,662,3
CN5117300000000,2022-11-01,51,173,VA,Smyth County,13473,13026,447,3.3
CN5117500000000,2022-11-01,51,175,VA,Southampton County,8957,8701,256,2.9
CN5117700000000,2022-11-01,51,177,VA,Spotsylvania County,69699,67503,2196,3.2
CN5117900000000,2022-11-01,51,179,VA,Stafford County,75922,73559,2363,3.1
CN5118100000000,2022-11-01,51,181,VA,Surry County,3742,3626,116,3.1
CN5118300000000,2022-11-01,51,183,VA,Sussex County,3732,3564,168,4.5
CN5118500000000,2022-11-01,51,185,VA,Tazewell County,15470,14799,671,4.3
CN5118700000000,2022-11-01,51,187,VA,Warren County,20828,20218,610,2.9
CN5119100000000,2022-11-01,51,191,VA,Washington County,26671,25861,810,3
CN5119300000000,2022-11-01,51,193,VA,Westmoreland County,9665,9341,324,3.4
CN5119500000000,2022-11-01,51,195,VA,Wise County,12951,12382,569,4.4
CN5119700000000,2022-11-01,51,197,VA,Wythe County,14284,13835,449,3.1
CN5119900000000,2022-11-01,51,199,VA,York County,33104,32129,975,2.9
CN5151000000000,2022-11-01,51,510,VA,Alexandria city,101006,98579,2427,2.4
CN5152000000000,2022-11-01,51,520,VA,Bristol city,7678,7390,288,3.8
CN5153000000000,2022-11-01,51,530,VA,Buena Vista city,3145,3054,91,2.9
CN5154000000000,2022-11-01,51,540,VA,Charlottesville city,26048,25365,683,2.6
CN5155000000000,2022-11-01,51,550,VA,Chesapeake city,123619,119768,3851,3.1
CN5157000000000,2022-11-01,51,570,VA,Colonial Heights city,8562,8269,293,3.4
CN5158000000000,2022-11-01,51,580,VA,Covington city,2299,2197,102,4.4
CN5159000000000,2022-11-01,51,590,VA,Danville city,18921,18005,916,4.8
CN5159500000000,2022-11-01,51,595,VA,Emporia city,2344,2242,102,4.4
CN5160000000000,2022-11-01,51,600,VA,Fairfax city,12946,12624,322,2.5
CN5161000000000,2022-11-01,51,610,VA,Falls Church city,8604,8391,213,2.5
CN5162000000000,2022-11-01,51,620,VA,Franklin city,3469,3317,152,4.4
CN5163000000000,2022-11-01,51,630,VA,Fredericksburg city,14415,13902,513,3.6
CN5164000000000,2022-11-01,51,640,VA,Galax city,2874,2783,91,3.2
CN5165000000000,2022-11-01,51,650,VA,Hampton city,64297,61668,2629,4.1
CN5166000000000,2022-11-01,51,660,VA,Harrisonburg city,25247,24358,889,3.5
CN5167000000000,2022-11-01,51,670,VA,Hopewell city,9658,9218,440,4.6
CN5167800000000,2022-11-01,51,678,VA,Lexington city,2318,2220,98,4.2
CN5168000000000,2022-11-01,51,680,VA,Lynchburg city,35846,34403,1443,4
CN5168300000000,2022-11-01,51,683,VA,Manassas city,21795,21212,583,2.7
CN5168500000000,2022-11-01,51,685,VA,Manassas Park city,9826,9572,254,2.6
CN5169000000000,2022-11-01,51,690,VA,Martinsville city,5642,5363,279,4.9
CN5170000000000,2022-11-01,51,700,VA,Newport News city,88147,84820,3327,3.8
CN5171000000000,2022-11-01,51,710,VA,Norfolk city,109847,105801,4046,3.7
CN5172000000000,2022-11-01,51,720,VA,Norton city,1603,1544,59,3.7
CN5173000000000,2022-11-01,51,730,VA,Petersburg city,12643,11922,721,5.7
CN5173500000000,2022-11-01,51,735,VA,Poquoson city,6353,6199,154,2.4
CN5174000000000,2022-11-01,51,740,VA,Portsmouth city,43963,42207,1756,4
CN5175000000000,2022-11-01,51,750,VA,Radford city,9186,8850,336,3.7
CN5176000000000,2022-11-01,51,760,VA,Richmond city,121199,116819,4380,3.6
CN5177000000000,2022-11-01,51,770,VA,Roanoke city,49312,47674,1638,3.3
CN5177500000000,2022-11-01,51,775,VA,Salem city,12957,12567,390,3
CN5179000000000,2022-11-01,51,790,VA,Staunton city,12605,12260,345,2.7
CN5180000000000,2022-11-01,51,800,VA,Suffolk city,45459,43994,1465,3.2
CN5181000000000,2022-11-01,51,810,VA,Virginia Beach city,231524,224522,7002,3
CN5182000000000,2022-11-01,51,820,VA,Waynesboro city,10953,10624,329,3
CN5183000000000,2022-11-01,51,830,VA,Williamsburg city,6805,6508,297,4.4
CN5184000000000,2022-11-01,51,840,VA,Winchester city,15243,14810,433,2.8
CN5300100000000,2022-11-01,53,001,WA,Adams County,9704,9170,534,5.5
CN5300300000000,2022-11-01,53,003,WA,Asotin County,10745,10306,439,4.1
CN5300500000000,2022-11-01,53,005,WA,Benton County,107655,101892,5763,5.4
CN5300700000000,2022-11-01,53,007,WA,Chelan County,44305,41983,2322,5.2
CN5300900000000,2022-11-01,53,009,WA,Clallam County,28920,26972,1948,6.7
CN5301100000000,2022-11-01,53,011,WA,Clark County,254341,241466,12875,5.1
CN5301300000000,2022-11-01,53,013,WA,Columbia County,1795,1692,103,5.7
CN5301500000000,2022-11-01,53,015,WA,Cowlitz County,49982,46889,3093,6.2
CN5301700000000,2022-11-01,53,017,WA,Douglas County,21871,20592,1279,5.8
CN5301900000000,2022-11-01,53,019,WA,Ferry County,2255,2000,255,11.3
CN5302100000000,2022-11-01,53,021,WA,Franklin County,43920,41066,2854,6.5
CN5302300000000,2022-11-01,53,023,WA,Garfield County,803,738,65,8.1
CN5302500000000,2022-11-01,53,025,WA,Grant County,48973,45741,3232,6.6
CN5302700000000,2022-11-01,53,027,WA,Grays Harbor County,29840,27615,2225,7.5
CN5302900000000,2022-11-01,53,029,WA,Island County,37821,35763,2058,5.4
CN5303100000000,2022-11-01,53,031,WA,Jefferson County,12861,12086,775,6
CN5303300000000,2022-11-01,53,033,WA,King County,1318307,1280562,37745,2.9
CN5303500000000,2022-11-01,53,035,WA,Kitsap County,131268,124927,6341,4.8
CN5303700000000,2022-11-01,53,037,WA,Kittitas County,22629,21295,1334,5.9
CN5303900000000,2022-11-01,53,039,WA,Klickitat County,9716,9114,602,6.2
CN5304100000000,2022-11-01,53,041,WA,Lewis County,35574,33231,2343,6.6
CN5304300000000,2022-11-01,53,043,WA,Lincoln County,4713,4439,274,5.8
CN5304500000000,2022-11-01,53,045,WA,Mason County,25597,23830,1767,6.9
CN5304700000000,2022-11-01,53,047,WA,Okanogan County,19582,18138,1444,7.4
CN5304900000000,2022-11-01,53,049,WA,Pacific County,9007,8317,690,7.7
CN5305100000000,2022-11-01,53,051,WA,Pend Oreille County,5280,4879,401,7.6
CN5305300000000,2022-11-01,53,053,WA,Pierce County,460091,434624,25467,5.5
CN5305500000000,2022-11-01,53,055,WA,San Juan County,9175,8797,378,4.1
CN5305700000000,2022-11-01,53,057,WA,Skagit County,62303,58757,3546,5.7
CN5305900000000,2022-11-01,53,059,WA,Skamania County,5693,5349,344,6
CN5306100000000,2022-11-01,53,061,WA,Snohomish County,448844,434911,13933,3.1
CN5306300000000,2022-11-01,53,063,WA,Spokane County,268287,254335,13952,5.2
CN5306500000000,2022-11-01,53,065,WA,Stevens County,19614,18185,1429,7.3
CN5306700000000,2022-11-01,53,067,WA,Thurston County,152309,144652,7657,5
CN5306900000000,2022-11-01,53,069,WA,Wahkiakum County,1439,1329,110,7.6
CN5307100000000,2022-11-01,53,071,WA,Walla Walla County,31560,30118,1442,4.6
CN5307300000000,2022-11-01,53,073,WA,Whatcom County,116667,110594,6073,5.2
CN5307500000000,2022-11-01,53,075,WA,Whitman County,24063,23071,992,4.1
CN5307700000000,2022-11-01,53,077,WA,Yakima County,129267,120048,9219,7.1
CN5400100000000,2022-11-01,54,001,WV,Barbour County,7400,7116,284,3.8
CN5400300000000,2022-11-01,54,003,WV,Berkeley County,58984,57359,1625,2.8
CN5400500000000,2022-11-01,54,005,WV,Boone County,6941,6674,267,3.8
CN5400700000000,2022-11-01,54,007,WV,Braxton County,5055,4804,251,5
CN5400900000000,2022-11-01,54,009,WV,Brooke County,9705,9341,364,3.8
CN5401100000000,2022-11-01,54,011,WV,Cabell County,41000,39718,1282,3.1
CN5401300000000,2022-11-01,54,013,WV,Calhoun County,2507,2318,189,7.5
CN5401500000000,2022-11-01,54,015,WV,Clay County,2925,2778,147,5
CN5401700000000,2022-11-01,54,017,WV,Doddridge County,3953,3845,108,2.7
CN5401900000000,2022-11-01,54,019,WV,Fayette County,15715,15047,668,4.3
CN5402100000000,2022-11-01,54,021,WV,Gilmer County,2413,2308,105,4.4
CN5402300000000,2022-11-01,54,023,WV,Grant County,6077,5891,186,3.1
CN5402500000000,2022-11-01,54,025,WV,Greenbrier County,15500,15003,497,3.2
CN5402700000000,2022-11-01,54,027,WV,Hampshire County,11470,11189,281,2.4
CN5402900000000,2022-11-01,54,029,WV,Hancock County,12781,12221,560,4.4
CN5403100000000,2022-11-01,54,031,WV,Hardy County,5847,5639,208,3.6
CN5403300000000,2022-11-01,54,033,WV,Harrison County,33159,32119,1040,3.1
CN5403500000000,2022-11-01,54,035,WV,Jackson County,11619,11178,441,3.8
CN5403700000000,2022-11-01,54,037,WV,Jefferson County,30580,29854,726,2.4
CN5403900000000,2022-11-01,54,039,WV,Kanawha County,78474,75872,2602,3.3
CN5404100000000,2022-11-01,54,041,WV,Lewis County,6430,6175,255,4
CN5404300000000,2022-11-01,54,043,WV,Lincoln County,6927,6646,281,4.1
CN5404500000000,2022-11-01,54,045,WV,Logan County,11095,10663,432,3.9
CN5404700000000,2022-11-01,54,047,WV,McDowell County,4144,3910,234,5.6
CN5404900000000,2022-11-01,54,049,WV,Marion County,25268,24335,933,3.7
CN5405100000000,2022-11-01,54,051,WV,Marshall County,12808,12249,559,4.4
CN5405300000000,2022-11-01,54,053,WV,Mason County,10654,10267,387,3.6
CN5405500000000,2022-11-01,54,055,WV,Mercer County,20598,19805,793,3.8
CN5405700000000,2022-11-01,54,057,WV,Mineral County,12568,12148,420,3.3
CN5405900000000,2022-11-01,54,059,WV,Mingo County,6551,6249,302,4.6
CN5406100000000,2022-11-01,54,061,WV,Monongalia County,55076,53482,1594,2.9
CN5406300000000,2022-11-01,54,063,WV,Monroe County,6456,6295,161,2.5
CN5406500000000,2022-11-01,54,065,WV,Morgan County,8609,8379,230,2.7
CN5406700000000,2022-11-01,54,067,WV,Nicholas County,8895,8526,369,4.1
CN5406900000000,2022-11-01,54,069,WV,Ohio County,19525,18845,680,3.5
CN5407100000000,2022-11-01,54,071,WV,Pendleton County,3933,3840,93,2.4
CN5407300000000,2022-11-01,54,073,WV,Pleasants County,2703,2568,135,5
CN5407500000000,2022-11-01,54,075,WV,Pocahontas County,3953,3763,190,4.8
CN5407700000000,2022-11-01,54,077,WV,Preston County,15670,15135,535,3.4
CN5407900000000,2022-11-01,54,079,WV,Putnam County,26757,25972,785,2.9
CN5408100000000,2022-11-01,54,081,WV,Raleigh County,29558,28588,970,3.3
CN5408300000000,2022-11-01,54,083,WV,Randolph County,11954,11435,519,4.3
CN5408500000000,2022-11-01,54,085,WV,Ritchie County,4259,4110,149,3.5
CN5408700000000,2022-11-01,54,087,WV,Roane County,4864,4625,239,4.9
CN5408900000000,2022-11-01,54,089,WV,Summers County,4717,4577,140,3
CN5409100000000,2022-11-01,54,091,WV,Taylor County,7873,7627,246,3.1
CN5409300000000,2022-11-01,54,093,WV,Tucker County,3411,3295,116,3.4
CN5409500000000,2022-11-01,54,095,WV,Tyler County,2949,2804,145,4.9
CN5409700000000,2022-11-01,54,097,WV,Upshur County,9729,9343,386,4
CN5409900000000,2022-11-01,54,099,WV,Wayne County,15401,14859,542,3.5
CN5410100000000,2022-11-01,54,101,WV,Webster County,3229,3103,126,3.9
CN5410300000000,2022-11-01,54,103,WV,Wetzel County,6460,6161,299,4.6
CN5410500000000,2022-11-01,54,105,WV,Wirt County,2256,2149,107,4.7
CN5410700000000,2022-11-01,54,107,WV,Wood County,36183,34850,1333,3.7
CN5410900000000,2022-11-01,54,109,WV,Wyoming County,7215,6941,274,3.8
CN5500100000000,2022-11-01,55,001,WI,Adams County,7411,7108,303,4.1
CN5500300000000,2022-11-01,55,003,WI,Ashland County,7132,6913,219,3.1
CN5500500000000,2022-11-01,55,005,WI,Barron County,23075,22460,615,2.7
CN5500700000000,2022-11-01,55,007,WI,Bayfield County,6987,6717,270,3.9
CN5500900000000,2022-11-01,55,009,WI,Brown County,141607,138474,3133,2.2
CN5501100000000,2022-11-01,55,011,WI,Buffalo County,5904,5717,187,3.2
CN5501300000000,2022-11-01,55,013,WI,Burnett County,6929,6686,243,3.5
CN5501500000000,2022-11-01,55,015,WI,Calumet County,27408,26840,568,2.1
CN5501700000000,2022-11-01,55,017,WI,Chippewa County,33509,32639,870,2.6
CN5501900000000,2022-11-01,55,019,WI,Clark County,16938,16575,363,2.1
CN5502100000000,2022-11-01,55,021,WI,Columbia County,31775,31090,685,2.2
CN5502300000000,2022-11-01,55,023,WI,Crawford County,6712,6514,198,2.9
CN5502500000000,2022-11-01,55,025,WI,Dane County,332320,326012,6308,1.9
CN5502700000000,2022-11-01,55,027,WI,Dodge County,46769,45772,997,2.1
CN5502900000000,2022-11-01,55,029,WI,Door County,13972,13608,364,2.6
CN5503100000000,2022-11-01,55,031,WI,Douglas County,22710,21963,747,3.3
CN5503300000000,2022-11-01,55,033,WI,Dunn County,24296,23683,613,2.5
CN5503500000000,2022-11-01,55,035,WI,Eau Claire County,60115,58837,1278,2.1
CN5503700000000,2022-11-01,55,037,WI,Florence County,2073,2004,69,3.3
CN5503900000000,2022-11-01,55,039,WI,Fond du Lac County,55771,54583,1188,2.1
CN5504100000000,2022-11-01,55,041,WI,Forest County,3713,3582,131,3.5
CN5504300000000,2022-11-01,55,043,WI,Grant County,26774,26168,606,2.3
CN5504500000000,2022-11-01,55,045,WI,Green County,20660,20239,421,2
CN5504700000000,2022-11-01,55,047,WI,Green Lake County,8816,8560,256,2.9
CN5504900000000,2022-11-01,55,049,WI,Iowa County,13374,13104,270,2
CN5505100000000,2022-11-01,55,051,WI,Iron County,2435,2333,102,4.2
CN5505300000000,2022-11-01,55,053,WI,Jackson County,9069,8790,279,3.1
CN5505500000000,2022-11-01,55,055,WI,Jefferson County,45587,44566,1021,2.2
CN5505700000000,2022-11-01,55,057,WI,Juneau County,13103,12724,379,2.9
CN5505900000000,2022-11-01,55,059,WI,Kenosha County,89801,87348,2453,2.7
CN5506100000000,2022-11-01,55,061,WI,Kewaunee County,10639,10407,232,2.2
CN5506300000000,2022-11-01,55,063,WI,La Crosse County,67088,65685,1403,2.1
CN5506500000000,2022-11-01,55,065,WI,Lafayette County,9806,9594,212,2.2
CN5506700000000,2022-11-01,55,067,WI,Langlade County,8989,8708,281,3.1
CN5506900000000,2022-11-01,55,069,WI,Lincoln County,14536,14219,317,2.2
CN5507100000000,2022-11-01,55,071,WI,Manitowoc County,39563,38582,981,2.5
CN5507300000000,2022-11-01,55,073,WI,Marathon County,72119,70614,1505,2.1
CN5507500000000,2022-11-01,55,075,WI,Marinette County,18543,17932,611,3.3
CN5507700000000,2022-11-01,55,077,WI,Marquette County,7467,7244,223,3
CN5507800000000,2022-11-01,55,078,WI,Menominee County,1454,1396,58,4
CN5507900000000,2022-11-01,55,079,WI,Milwaukee County,455810,441375,14435,3.2
CN5508100000000,2022-11-01,55,081,WI,Monroe County,22649,22132,517,2.3
CN5508300000000,2022-11-01,55,083,WI,Oconto County,20404,19893,511,2.5
CN5508500000000,2022-11-01,55,085,WI,Oneida County,17199,16733,466,2.7
CN5508700000000,2022-11-01,55,087,WI,Outagamie County,104140,101979,2161,2.1
CN5508900000000,2022-11-01,55,089,WI,Ozaukee County,48367,47286,1081,2.2
CN5509100000000,2022-11-01,55,091,WI,Pepin County,3914,3818,96,2.5
CN5509300000000,2022-11-01,55,093,WI,Pierce County,24240,23576,664,2.7
CN5509500000000,2022-11-01,55,095,WI,Polk County,23895,23115,780,3.3
CN5509700000000,2022-11-01,55,097,WI,Portage County,37623,36725,898,2.4
CN5509900000000,2022-11-01,55,099,WI,Price County,6040,5853,187,3.1
CN5510100000000,2022-11-01,55,101,WI,Racine County,97393,94615,2778,2.9
CN5510300000000,2022-11-01,55,103,WI,Richland County,8556,8355,201,2.3
CN5510500000000,2022-11-01,55,105,WI,Rock County,85395,82933,2462,2.9
CN5510700000000,2022-11-01,55,107,WI,Rusk County,6271,6084,187,3
CN5510900000000,2022-11-01,55,109,WI,St. Croix County,49459,48146,1313,2.7
CN5511100000000,2022-11-01,55,111,WI,Sauk County,33320,32535,785,2.4
CN5511300000000,2022-11-01,55,113,WI,Sawyer County,7535,7261,274,3.6
CN5511500000000,2022-11-01,55,115,WI,Shawano County,19904,19449,455,2.3
CN5511700000000,2022-11-01,55,117,WI,Sheboygan County,60873,59548,1325,2.2
CN5511900000000,2022-11-01,55,119,WI,Taylor County,10075,9801,274,2.7
CN5512100000000,2022-11-01,55,121,WI,Trempealeau County,14299,13929,370,2.6
CN5512300000000,2022-11-01,55,123,WI,Vernon County,14904,14576,328,2.2
CN5512500000000,2022-11-01,55,125,WI,Vilas County,9517,9200,317,3.3
CN5512700000000,2022-11-01,55,127,WI,Walworth County,57016,55672,1344,2.4
CN5512900000000,2022-11-01,55,129,WI,Washburn County,7332,7118,214,2.9
CN5513100000000,2022-11-01,55,131,WI,Washington County,75779,74178,1601,2.1
CN5513300000000,2022-11-01,55,133,WI,Waukesha County,221980,217081,4899,2.2
CN5513500000000,2022-11-01,55,135,WI,Waupaca County,24395,23802,593,2.4
CN5513700000000,2022-11-01,55,137,WI,Waushara County,10745,10449,296,2.8
CN5513900000000,2022-11-01,55,139,WI,Winnebago County,92642,90609,2033,2.2
CN5514100000000,2022-11-01,55,141,WI,Wood County,32529,31592,937,2.9
CN5600100000000,2022-11-01,56,001,WY,Albany County,22169,21503,666,3
CN5600300000000,2022-11-01,56,003,WY,Big Horn County,5042,4855,187,3.7
CN5600500000000,2022-11-01,56,005,WY,Campbell County,23333,22574,759,3.3
CN5600700000000,2022-11-01,56,007,WY,Carbon County,7156,6869,287,4
CN5600900000000,2022-11-01,56,009,WY,Converse County,7755,7557,198,2.6
CN5601100000000,2022-11-01,56,011,WY,Crook County,3751,3644,107,2.9
CN5601300000000,2022-11-01,56,013,WY,Fremont County,19029,18294,735,3.9
CN5601500000000,2022-11-01,56,015,WY,Goshen County,6392,6199,193,3
CN5601700000000,2022-11-01,56,017,WY,Hot Springs County,2300,2236,64,2.8
CN5601900000000,2022-11-01,56,019,WY,Johnson County,4189,4041,148,3.5
CN5602100000000,2022-11-01,56,021,WY,Laramie County,50101,48380,1721,3.4
CN5602300000000,2022-11-01,56,023,WY,Lincoln County,9535,9201,334,3.5
CN5602500000000,2022-11-01,56,025,WY,Natrona County,40458,38937,1521,3.8
CN5602700000000,2022-11-01,56,027,WY,Niobrara County,1165,1124,41,3.5
CN5602900000000,2022-11-01,56,029,WY,Park County,14681,14110,571,3.9
CN5603100000000,2022-11-01,56,031,WY,Platte County,4296,4141,155,3.6
CN5603300000000,2022-11-01,56,033,WY,Sheridan County,16260,15716,544,3.3
CN5603500000000,2022-11-01,56,035,WY,Sublette County,3816,3664,152,4
CN5603700000000,2022-11-01,56,037,WY,Sweetwater County,20107,19314,793,3.9
CN5603900000000,2022-11-01,56,039,WY,Teton County,15111,14438,673,4.5
CN5604100000000,2022-11-01,56,041,WY,Uinta County,9148,8798,350,3.8
CN5604300000000,2022-11-01,56,043,WY,Washakie County,3821,3680,141,3.7
CN5604500000000,2022-11-01,56,045,WY,Weston County,3853,3760,93,2.4
CN7200100000000,2022-11-01,72,001,PR,Adjuntas Municipio,4599,4248,351,7.6
CN7200300000000,2022-11-01,72,003,PR,Aguada Municipio,13618,12656,962,7.1
CN7200500000000,2022-11-01,72,005,PR,Aguadilla Municipio,16681,15269,1412,8.5
CN7200700000000,2022-11-01,72,007,PR,Aguas Buenas Municipio,7190,6757,433,6
CN7200900000000,2022-11-01,72,009,PR,Aibonito Municipio,7002,6527,475,6.8
CN7201100000000,2022-11-01,72,011,PR,Anasco Municipio,10284,9619,665,6.5
CN7201300000000,2022-11-01,72,013,PR,Arecibo Municipio,26572,24788,1784,6.7
CN7201500000000,2022-11-01,72,015,PR,Arroyo Municipio,5001,4577,424,8.5
CN7201700000000,2022-11-01,72,017,PR,Barceloneta Municipio,6473,5958,515,8
CN7201900000000,2022-11-01,72,019,PR,Barranquitas Municipio,8075,7478,597,7.4
CN7202100000000,2022-11-01,72,021,PR,Bayamon Municipio,71099,67599,3500,4.9
CN7202300000000,2022-11-01,72,023,PR,Cabo Rojo Municipio,15459,14370,1089,7
CN7202500000000,2022-11-01,72,025,PR,Caguas Municipio,52333,49807,2526,4.8
CN7202700000000,2022-11-01,72,027,PR,Camuy Municipio,10769,10008,761,7.1
CN7202900000000,2022-11-01,72,029,PR,Canovanas Municipio,17925,17026,899,5
CN7203100000000,2022-11-01,72,031,PR,Carolina Municipio,67164,63996,3168,4.7
CN7203300000000,2022-11-01,72,033,PR,Catano Municipio,8473,8045,428,5.1
CN7203500000000,2022-11-01,72,035,PR,Cayey Municipio,17733,16841,892,5
CN7203700000000,2022-11-01,72,037,PR,Ceiba Municipio,3928,3654,274,7
CN7203900000000,2022-11-01,72,039,PR,Ciales Municipio,4022,3701,321,8
CN7204100000000,2022-11-01,72,041,PR,Cidra Municipio,16971,16142,829,4.9
CN7204300000000,2022-11-01,72,043,PR,Coamo Municipio,11406,10507,899,7.9
CN7204500000000,2022-11-01,72,045,PR,Comerio Municipio,5406,5043,363,6.7
CN7204700000000,2022-11-01,72,047,PR,Corozal Municipio,9736,9013,723,7.4
CN7204900000000,2022-11-01,72,049,PR,Culebra Municipio,967,946,21,2.2
CN7205100000000,2022-11-01,72,051,PR,Dorado Municipio,14807,14196,611,4.1
CN7205300000000,2022-11-01,72,053,PR,Fajardo Municipio,11534,10768,766,6.6
CN7205400000000,2022-11-01,72,054,PR,Florida Municipio,3589,3301,288,8
CN7205500000000,2022-11-01,72,055,PR,Guanica Municipio,4175,3791,384,9.2
CN7205700000000,2022-11-01,72,057,PR,Guayama Municipio,11828,10948,880,7.4
CN7205900000000,2022-11-01,72,059,PR,Guayanilla Municipio,5319,4731,588,11.1
CN7206100000000,2022-11-01,72,061,PR,Guaynabo Municipio,41642,40338,1304,3.1
CN7206300000000,2022-11-01,72,063,PR,Gurabo Municipio,20656,19816,840,4.1
CN7206500000000,2022-11-01,72,065,PR,Hatillo Municipio,15832,14006,1826,11.5
CN7206700000000,2022-11-01,72,067,PR,Hormigueros Municipio,6160,5816,344,5.6
CN7206900000000,2022-11-01,72,069,PR,Humacao Municipio,19299,18091,1208,6.3
CN7207100000000,2022-11-01,72,071,PR,Isabela Municipio,13609,12670,939,6.9
CN7207300000000,2022-11-01,72,073,PR,Jayuya Municipio,4695,4243,452,9.6
CN7207500000000,2022-11-01,72,075,PR,Juana Diaz Municipio,17336,16009,1327,7.7
CN7207700000000,2022-11-01,72,077,PR,Juncos Municipio,13711,12812,899,6.6
CN7207900000000,2022-11-01,72,079,PR,Lajas Municipio,5870,5287,583,9.9
CN7208100000000,2022-11-01,72,081,PR,Lares Municipio,8426,7422,1004,11.9
CN7208300000000,2022-11-01,72,083,PR,Las Marias Municipio,2851,2446,405,14.2
CN7208500000000,2022-11-01,72,085,PR,Las Piedras Municipio,12599,11840,759,6
CN7208700000000,2022-11-01,72,087,PR,Loiza Municipio,9080,8565,515,5.7
CN7208900000000,2022-11-01,72,089,PR,Luquillo Municipio,6724,6300,424,6.3
CN7209100000000,2022-11-01,72,091,PR,Manati Municipio,12400,11616,784,6.3
CN7209300000000,2022-11-01,72,093,PR,Maricao Municipio,2178,2002,176,8.1
CN7209500000000,2022-11-01,72,095,PR,Maunabo Municipio,3065,2770,295,9.6
CN7209700000000,2022-11-01,72,097,PR,Mayaguez Municipio,24885,23164,1721,6.9
CN7209900000000,2022-11-01,72,099,PR,Moca Municipio,12209,11109,1100,9
CN7210100000000,2022-11-01,72,101,PR,Morovis Municipio,8884,8257,627,7.1
CN7210300000000,2022-11-01,72,103,PR,Naguabo Municipio,9032,8515,517,5.7
CN7210500000000,2022-11-01,72,105,PR,Naranjito Municipio,7783,7223,560,7.2
CN7210700000000,2022-11-01,72,107,PR,Orocovis Municipio,5337,4887,450,8.4
CN7210900000000,2022-11-01,72,109,PR,Patillas Municipio,4462,4055,407,9.1
CN7211100000000,2022-11-01,72,111,PR,Penuelas Municipio,6264,5597,667,10.6
CN7211300000000,2022-11-01,72,113,PR,Ponce Municipio,49233,45588,3645,7.4
CN7211500000000,2022-11-01,72,115,PR,Quebradillas Municipio,6768,6197,571,8.4
CN7211700000000,2022-11-01,72,117,PR,Rincon Municipio,5556,4900,656,11.8
CN7211900000000,2022-11-01,72,119,PR,Rio Grande Municipio,18593,17633,960,5.2
CN7212100000000,2022-11-01,72,121,PR,Sabana Grande Municipio,6546,6010,536,8.2
CN7212300000000,2022-11-01,72,123,PR,Salinas Municipio,7662,6934,728,9.5
CN7212500000000,2022-11-01,72,125,PR,San German Municipio,10619,9814,805,7.6
CN7212700000000,2022-11-01,72,127,PR,San Juan Municipio,146650,139788,6862,4.7
CN7212900000000,2022-11-01,72,129,PR,San Lorenzo Municipio,12708,11903,805,6.3
CN7213100000000,2022-11-01,72,131,PR,San Sebastian Municipio,11828,10580,1248,10.6
CN7213300000000,2022-11-01,72,133,PR,Santa Isabel Municipio,8576,7780,796,9.3
CN7213500000000,2022-11-01,72,135,PR,Toa Alta Municipio,30595,29239,1356,4.4
CN7213700000000,2022-11-01,72,137,PR,Toa Baja Municipio,31830,30348,1482,4.7
CN7213900000000,2022-11-01,72,139,PR,Trujillo Alto Municipio,29660,28679,981,3.3
CN7214100000000,2022-11-01,72,141,PR,Utuado Municipio,7620,7000,620,8.1
CN7214300000000,2022-11-01,72,143,PR,Vega Alta Municipio,10815,10045,770,7.1
CN7214500000000,2022-11-01,72,145,PR,Vega Baja Municipio,14479,13402,1077,7.4
CN7214700000000,2022-11-01,72,147,PR,Vieques Municipio,2674,2512,162,6.1
CN7214900000000,2022-11-01,72,149,PR,Villalba Municipio,7919,7020,899,11.4
CN7215100000000,2022-11-01,72,151,PR,Yabucoa Municipio,9353,8601,752,8
CN7215300000000,2022-11-01,72,153,PR,Yauco Municipio,10599,9466,1133,10.7
CN0100100000000,2022-12-01,01,001,AL,Autauga County,26860,26350,510,1.9
CN0100300000000,2022-12-01,01,003,AL,Baldwin County,102420,100366,2054,2
CN0100500000000,2022-12-01,01,005,AL,Barbour County,8265,7934,331,4
CN0100700000000,2022-12-01,01,007,AL,Bibb County,8698,8510,188,2.2
CN0100900000000,2022-12-01,01,009,AL,Blount County,25680,25224,456,1.8
CN0101100000000,2022-12-01,01,011,AL,Bullock County,4588,4481,107,2.3
CN0101300000000,2022-12-01,01,013,AL,Butler County,8751,8504,247,2.8
CN0101500000000,2022-12-01,01,015,AL,Calhoun County,46022,44967,1055,2.3
CN0101700000000,2022-12-01,01,017,AL,Chambers County,15926,15581,345,2.2
CN0101900000000,2022-12-01,01,019,AL,Cherokee County,11629,11390,239,2.1
CN0102100000000,2022-12-01,01,021,AL,Chilton County,20212,19851,361,1.8
CN0102300000000,2022-12-01,01,023,AL,Choctaw County,4296,4137,159,3.7
CN0102500000000,2022-12-01,01,025,AL,Clarke County,7805,7309,496,6.4
CN0102700000000,2022-12-01,01,027,AL,Clay County,6083,5948,135,2.2
CN0102900000000,2022-12-01,01,029,AL,Cleburne County,6135,6020,115,1.9
CN0103100000000,2022-12-01,01,031,AL,Coffee County,21560,21110,450,2.1
CN0103300000000,2022-12-01,01,033,AL,Colbert County,23761,23144,617,2.6
CN0103500000000,2022-12-01,01,035,AL,Conecuh County,4229,4102,127,3
CN0103700000000,2022-12-01,01,037,AL,Coosa County,4503,4407,96,2.1
CN0103900000000,2022-12-01,01,039,AL,Covington County,14911,14551,360,2.4
CN0104100000000,2022-12-01,01,041,AL,Crenshaw County,5941,5823,118,2
CN0104300000000,2022-12-01,01,043,AL,Cullman County,38921,38270,651,1.7
CN0104500000000,2022-12-01,01,045,AL,Dale County,20917,20438,479,2.3
CN0104700000000,2022-12-01,01,047,AL,Dallas County,13482,12872,610,4.5
CN0104900000000,2022-12-01,01,049,AL,DeKalb County,31063,30463,600,1.9
CN0105100000000,2022-12-01,01,051,AL,Elmore County,38316,37607,709,1.9
CN0105300000000,2022-12-01,01,053,AL,Escambia County,14200,13762,438,3.1
CN0105500000000,2022-12-01,01,055,AL,Etowah County,38985,38061,924,2.4
CN0105700000000,2022-12-01,01,057,AL,Fayette County,6513,6366,147,2.3
CN0105900000000,2022-12-01,01,059,AL,Franklin County,14625,14279,346,2.4
CN0106100000000,2022-12-01,01,061,AL,Geneva County,11374,11164,210,1.8
CN0106300000000,2022-12-01,01,063,AL,Greene County,2730,2637,93,3.4
CN0106500000000,2022-12-01,01,065,AL,Hale County,6062,5877,185,3.1
CN0106700000000,2022-12-01,01,067,AL,Henry County,7085,6938,147,2.1
CN0106900000000,2022-12-01,01,069,AL,Houston County,48366,47297,1069,2.2
CN0107100000000,2022-12-01,01,071,AL,Jackson County,23050,22569,481,2.1
CN0107300000000,2022-12-01,01,073,AL,Jefferson County,321280,314635,6645,2.1
CN0107500000000,2022-12-01,01,075,AL,Lamar County,5675,5537,138,2.4
CN0107700000000,2022-12-01,01,077,AL,Lauderdale County,42715,41761,954,2.2
CN0107900000000,2022-12-01,01,079,AL,Lawrence County,14847,14570,277,1.9
CN0108100000000,2022-12-01,01,081,AL,Lee County,80224,78709,1515,1.9
CN0108300000000,2022-12-01,01,083,AL,Limestone County,48785,47955,830,1.7
CN0108500000000,2022-12-01,01,085,AL,Lowndes County,3502,3360,142,4.1
CN0108700000000,2022-12-01,01,087,AL,Macon County,7816,7595,221,2.8
CN0108900000000,2022-12-01,01,089,AL,Madison County,200888,197426,3462,1.7
CN0109100000000,2022-12-01,01,091,AL,Marengo County,7606,7372,234,3.1
CN0109300000000,2022-12-01,01,093,AL,Marion County,13864,13518,346,2.5
CN0109500000000,2022-12-01,01,095,AL,Marshall County,45361,44606,755,1.7
CN0109700000000,2022-12-01,01,097,AL,Mobile County,193070,187782,5288,2.7
CN0109900000000,2022-12-01,01,099,AL,Monroe County,7171,6897,274,3.8
CN0110100000000,2022-12-01,01,101,AL,Montgomery County,107372,104612,2760,2.6
CN0110300000000,2022-12-01,01,103,AL,Morgan County,61306,60309,997,1.6
CN0110500000000,2022-12-01,01,105,AL,Perry County,3044,2915,129,4.2
CN0110700000000,2022-12-01,01,107,AL,Pickens County,7781,7583,198,2.5
CN0110900000000,2022-12-01,01,109,AL,Pike County,16124,15761,363,2.3
CN0111100000000,2022-12-01,01,111,AL,Randolph County,9648,9449,199,2.1
CN0111300000000,2022-12-01,01,113,AL,Russell County,23941,23403,538,2.2
CN0111500000000,2022-12-01,01,115,AL,St. Clair County,41973,41238,735,1.8
CN0111700000000,2022-12-01,01,117,AL,Shelby County,120776,118982,1794,1.5
CN0111900000000,2022-12-01,01,119,AL,Sumter County,4588,4469,119,2.6
CN0112100000000,2022-12-01,01,121,AL,Talladega County,36886,35959,927,2.5
CN0112300000000,2022-12-01,01,123,AL,Tallapoosa County,17201,16798,403,2.3
CN0112500000000,2022-12-01,01,125,AL,Tuscaloosa County,104543,102536,2007,1.9
CN0112700000000,2022-12-01,01,127,AL,Walker County,25387,24811,576,2.3
CN0112900000000,2022-12-01,01,129,AL,Washington County,6650,6397,253,3.8
CN0113100000000,2022-12-01,01,131,AL,Wilcox County,2553,2348,205,8
CN0113300000000,2022-12-01,01,133,AL,Winston County,10163,9938,225,2.2
CN0201300000000,2022-12-01,02,013,AK,Aleutians East Borough,996,948,48,4.8
CN0201600000000,2022-12-01,02,016,AK,Aleutians West Census Area,2543,2432,111,4.4
CN0202000000000,2022-12-01,02,020,AK,Anchorage Borough/municipality,154196,149978,4218,2.7
CN0205000000000,2022-12-01,02,050,AK,Bethel Census Area,6791,6305,486,7.2
CN0206000000000,2022-12-01,02,060,AK,Bristol Bay Borough,241,222,19,7.9
CN0206300000000,2022-12-01,02,063,AK,Chugach Census Area,2886,2801,85,2.9
CN0206600000000,2022-12-01,02,066,AK,Copper River Census Area,1237,1091,146,11.8
CN0206800000000,2022-12-01,02,068,AK,Denali Borough,593,523,70,11.8
CN0207000000000,2022-12-01,02,070,AK,Dillingham Census Area,1613,1537,76,4.7
CN0209000000000,2022-12-01,02,090,AK,Fairbanks North Star Borough,46383,44876,1507,3.2
CN0210000000000,2022-12-01,02,100,AK,Haines Borough,910,836,74,8.1
CN0210500000000,2022-12-01,02,105,AK,Hoonah-Angoon Census Area,1059,968,91,8.6
CN0211000000000,2022-12-01,02,110,AK,Juneau Borough/city,16810,16377,433,2.6
CN0212200000000,2022-12-01,02,122,AK,Kenai Peninsula Borough,27154,25960,1194,4.4
CN0213000000000,2022-12-01,02,130,AK,Ketchikan Gateway Borough,6246,6013,233,3.7
CN0215000000000,2022-12-01,02,150,AK,Kodiak Island Borough,5348,5031,317,5.9
CN0215800000000,2022-12-01,02,158,AK,Kusilvak Census Area,2383,2115,268,11.2
CN0216400000000,2022-12-01,02,164,AK,Lake and Peninsula Borough,559,522,37,6.6
CN0217000000000,2022-12-01,02,170,AK,Matanuska-Susitna Borough,50837,48786,2051,4
CN0218000000000,2022-12-01,02,180,AK,Nome Census Area,4197,3971,226,5.4
CN0218500000000,2022-12-01,02,185,AK,North Slope Borough,3057,2931,126,4.1
CN0218800000000,2022-12-01,02,188,AK,Northwest Arctic Borough,2950,2708,242,8.2
CN0219500000000,2022-12-01,02,195,AK,Petersburg Borough,1338,1252,86,6.4
CN0219800000000,2022-12-01,02,198,AK,Prince of Wales-Hyder Census Area,2657,2528,129,4.9
CN0222000000000,2022-12-01,02,220,AK,Sitka Borough/city,4370,4262,108,2.5
CN0223000000000,2022-12-01,02,230,AK,Skagway Municipality,580,515,65,11.2
CN0224000000000,2022-12-01,02,240,AK,Southeast Fairbanks Census Area,3266,3119,147,4.5
CN0227500000000,2022-12-01,02,275,AK,Wrangell Borough/city,909,865,44,4.8
CN0228200000000,2022-12-01,02,282,AK,Yakutat Borough/city,278,260,18,6.5
CN0229000000000,2022-12-01,02,290,AK,Yukon-Koyukuk Census Area,2327,2160,167,7.2
CN0400100000000,2022-12-01,04,001,AZ,Apache County,18826,17510,1316,7
CN0400300000000,2022-12-01,04,003,AZ,Cochise County,49152,47203,1949,4
CN0400500000000,2022-12-01,04,005,AZ,Coconino County,74672,71840,2832,3.8
CN0400700000000,2022-12-01,04,007,AZ,Gila County,20474,19730,744,3.6
CN0400900000000,2022-12-01,04,009,AZ,Graham County,16415,15911,504,3.1
CN0401100000000,2022-12-01,04,011,AZ,Greenlee County,4936,4818,118,2.4
CN0401200000000,2022-12-01,04,012,AZ,La Paz County,9547,9154,393,4.1
CN0401300000000,2022-12-01,04,013,AZ,Maricopa County,2397411,2328187,69224,2.9
CN0401500000000,2022-12-01,04,015,AZ,Mohave County,89561,85931,3630,4.1
CN0401700000000,2022-12-01,04,017,AZ,Navajo County,40016,38078,1938,4.8
CN0401900000000,2022-12-01,04,019,AZ,Pima County,493570,477507,16063,3.3
CN0402100000000,2022-12-01,04,021,AZ,Pinal County,202645,195741,6904,3.4
CN0402300000000,2022-12-01,04,023,AZ,Santa Cruz County,19402,18117,1285,6.6
CN0402500000000,2022-12-01,04,025,AZ,Yavapai County,108284,104996,3288,3
CN0402700000000,2022-12-01,04,027,AZ,Yuma County,100191,89402,10789,10.8
CN0500100000000,2022-12-01,05,001,AR,Arkansas County,9281,9038,243,2.6
CN0500300000000,2022-12-01,05,003,AR,Ashley County,6574,6215,359,5.5
CN0500500000000,2022-12-01,05,005,AR,Baxter County,16386,15839,547,3.3
CN0500700000000,2022-12-01,05,007,AR,Benton County,152558,149374,3184,2.1
CN0500900000000,2022-12-01,05,009,AR,Boone County,15828,15394,434,2.7
CN0501100000000,2022-12-01,05,011,AR,Bradley County,3966,3755,211,5.3
CN0501300000000,2022-12-01,05,013,AR,Calhoun County,2326,2256,70,3
CN0501500000000,2022-12-01,05,015,AR,Carroll County,12155,11820,335,2.8
CN0501700000000,2022-12-01,05,017,AR,Chicot County,2807,2666,141,5
CN0501900000000,2022-12-01,05,019,AR,Clark County,8421,8071,350,4.2
CN0502100000000,2022-12-01,05,021,AR,Clay County,5235,5021,214,4.1
CN0502300000000,2022-12-01,05,023,AR,Cleburne County,8780,8447,333,3.8
CN0502500000000,2022-12-01,05,025,AR,Cleveland County,3022,2924,98,3.2
CN0502700000000,2022-12-01,05,027,AR,Columbia County,8904,8538,366,4.1
CN0502900000000,2022-12-01,05,029,AR,Conway County,8325,8051,274,3.3
CN0503100000000,2022-12-01,05,031,AR,Craighead County,57876,56525,1351,2.3
CN0503300000000,2022-12-01,05,033,AR,Crawford County,26233,25531,702,2.7
CN0503500000000,2022-12-01,05,035,AR,Crittenden County,20510,19768,742,3.6
CN0503700000000,2022-12-01,05,037,AR,Cross County,6693,6475,218,3.3
CN0503900000000,2022-12-01,05,039,AR,Dallas County,2674,2573,101,3.8
CN0504100000000,2022-12-01,05,041,AR,Desha County,4870,4636,234,4.8
CN0504300000000,2022-12-01,05,043,AR,Drew County,7377,7078,299,4.1
CN0504500000000,2022-12-01,05,045,AR,Faulkner County,63108,61442,1666,2.6
CN0504700000000,2022-12-01,05,047,AR,Franklin County,7311,7116,195,2.7
CN0504900000000,2022-12-01,05,049,AR,Fulton County,4900,4753,147,3
CN0505100000000,2022-12-01,05,051,AR,Garland County,41932,40507,1425,3.4
CN0505300000000,2022-12-01,05,053,AR,Grant County,8409,8194,215,2.6
CN0505500000000,2022-12-01,05,055,AR,Greene County,19536,18978,558,2.9
CN0505700000000,2022-12-01,05,057,AR,Hempstead County,9270,8991,279,3
CN0505900000000,2022-12-01,05,059,AR,Hot Spring County,13698,13294,404,2.9
CN0506100000000,2022-12-01,05,061,AR,Howard County,5193,5032,161,3.1
CN0506300000000,2022-12-01,05,063,AR,Independence County,16657,16172,485,2.9
CN0506500000000,2022-12-01,05,065,AR,Izard County,4539,4288,251,5.5
CN0506700000000,2022-12-01,05,067,AR,Jackson County,5338,5059,279,5.2
CN0506900000000,2022-12-01,05,069,AR,Jefferson County,25453,24283,1170,4.6
CN0507100000000,2022-12-01,05,071,AR,Johnson County,10004,9638,366,3.7
CN0507300000000,2022-12-01,05,073,AR,Lafayette County,2266,2153,113,5
CN0507500000000,2022-12-01,05,075,AR,Lawrence County,6777,6569,208,3.1
CN0507700000000,2022-12-01,05,077,AR,Lee County,2444,2331,113,4.6
CN0507900000000,2022-12-01,05,079,AR,Lincoln County,3611,3473,138,3.8
CN0508100000000,2022-12-01,05,081,AR,Little River County,5179,5018,161,3.1
CN0508300000000,2022-12-01,05,083,AR,Logan County,8112,7828,284,3.5
CN0508500000000,2022-12-01,05,085,AR,Lonoke County,34042,33227,815,2.4
CN0508700000000,2022-12-01,05,087,AR,Madison County,7687,7523,164,2.1
CN0508900000000,2022-12-01,05,089,AR,Marion County,6218,5990,228,3.7
CN0509100000000,2022-12-01,05,091,AR,Miller County,18651,18048,603,3.2
CN0509300000000,2022-12-01,05,093,AR,Mississippi County,16208,15481,727,4.5
CN0509500000000,2022-12-01,05,095,AR,Monroe County,2491,2389,102,4.1
CN0509700000000,2022-12-01,05,097,AR,Montgomery County,2608,2476,132,5.1
CN0509900000000,2022-12-01,05,099,AR,Nevada County,3424,3309,115,3.4
CN0510100000000,2022-12-01,05,101,AR,Newton County,3150,3065,85,2.7
CN0510300000000,2022-12-01,05,103,AR,Ouachita County,9590,9244,346,3.6
CN0510500000000,2022-12-01,05,105,AR,Perry County,4176,4054,122,2.9
CN0510700000000,2022-12-01,05,107,AR,Phillips County,5437,5076,361,6.6
CN0510900000000,2022-12-01,05,109,AR,Pike County,3862,3744,118,3.1
CN0511100000000,2022-12-01,05,111,AR,Poinsett County,9904,9614,290,2.9
CN0511300000000,2022-12-01,05,113,AR,Polk County,7715,7458,257,3.3
CN0511500000000,2022-12-01,05,115,AR,Pope County,27681,26682,999,3.6
CN0511700000000,2022-12-01,05,117,AR,Prairie County,3482,3398,84,2.4
CN0511900000000,2022-12-01,05,119,AR,Pulaski County,189308,183822,5486,2.9
CN0512100000000,2022-12-01,05,121,AR,Randolph County,7051,6833,218,3.1
CN0512300000000,2022-12-01,05,123,AR,St. Francis County,7330,7000,330,4.5
CN0512500000000,2022-12-01,05,125,AR,Saline County,60053,58618,1435,2.4
CN0512700000000,2022-12-01,05,127,AR,Scott County,4179,4089,90,2.2
CN0512900000000,2022-12-01,05,129,AR,Searcy County,2731,2609,122,4.5
CN0513100000000,2022-12-01,05,131,AR,Sebastian County,55309,53874,1435,2.6
CN0513300000000,2022-12-01,05,133,AR,Sevier County,5398,5218,180,3.3
CN0513500000000,2022-12-01,05,135,AR,Sharp County,5820,5611,209,3.6
CN0513700000000,2022-12-01,05,137,AR,Stone County,4419,4244,175,4
CN0513900000000,2022-12-01,05,139,AR,Union County,14698,14058,640,4.4
CN0514100000000,2022-12-01,05,141,AR,Van Buren County,5868,5632,236,4
CN0514300000000,2022-12-01,05,143,AR,Washington County,134660,132048,2612,1.9
CN0514500000000,2022-12-01,05,145,AR,White County,34096,33086,1010,3
CN0514700000000,2022-12-01,05,147,AR,Woodruff County,2778,2690,88,3.2
CN0514900000000,2022-12-01,05,149,AR,Yell County,7815,7536,279,3.6
CN0600100000000,2022-12-01,06,001,CA,Alameda County,830100,805675,24425,2.9
CN0600300000000,2022-12-01,06,003,CA,Alpine County,563,539,24,4.3
CN0600500000000,2022-12-01,06,005,CA,Amador County,14190,13572,618,4.4
CN0600700000000,2022-12-01,06,007,CA,Butte County,92734,88731,4003,4.3
CN0600900000000,2022-12-01,06,009,CA,Calaveras County,22200,21433,767,3.5
CN0601100000000,2022-12-01,06,011,CA,Colusa County,10045,8625,1420,14.1
CN0601300000000,2022-12-01,06,013,CA,Contra Costa County,553801,536583,17218,3.1
CN0601500000000,2022-12-01,06,015,CA,Del Norte County,9258,8784,474,5.1
CN0601700000000,2022-12-01,06,017,CA,El Dorado County,93681,90775,2906,3.1
CN0601900000000,2022-12-01,06,019,CA,Fresno County,459690,430521,29169,6.3
CN0602100000000,2022-12-01,06,021,CA,Glenn County,12947,12228,719,5.6
CN0602300000000,2022-12-01,06,023,CA,Humboldt County,59806,57569,2237,3.7
CN0602500000000,2022-12-01,06,025,CA,Imperial County,72272,61287,10985,15.2
CN0602700000000,2022-12-01,06,027,CA,Inyo County,8344,8060,284,3.4
CN0602900000000,2022-12-01,06,029,CA,Kern County,393145,366569,26576,6.8
CN0603100000000,2022-12-01,06,031,CA,Kings County,57764,53708,4056,7
CN0603300000000,2022-12-01,06,033,CA,Lake County,28224,26711,1513,5.4
CN0603500000000,2022-12-01,06,035,CA,Lassen County,8867,8459,408,4.6
CN0603700000000,2022-12-01,06,037,CA,Los Angeles County,4965511,4747043,218468,4.4
CN0603900000000,2022-12-01,06,039,CA,Madera County,64970,60966,4004,6.2
CN0604100000000,2022-12-01,06,041,CA,Marin County,131593,128432,3161,2.4
CN0604300000000,2022-12-01,06,043,CA,Mariposa County,7077,6760,317,4.5
CN0604500000000,2022-12-01,06,045,CA,Mendocino County,37097,35503,1594,4.3
CN0604700000000,2022-12-01,06,047,CA,Merced County,114181,105188,8993,7.9
CN0604900000000,2022-12-01,06,049,CA,Modoc County,3089,2894,195,6.3
CN0605100000000,2022-12-01,06,051,CA,Mono County,8668,8365,303,3.5
CN0605300000000,2022-12-01,06,053,CA,Monterey County,215385,200210,15175,7
CN0605500000000,2022-12-01,06,055,CA,Napa County,69987,67789,2198,3.1
CN0605700000000,2022-12-01,06,057,CA,Nevada County,49054,47527,1527,3.1
CN0605900000000,2022-12-01,06,059,CA,Orange County,1608725,1564859,43866,2.7
CN0606100000000,2022-12-01,06,061,CA,Placer County,194667,189190,5477,2.8
CN0606300000000,2022-12-01,06,063,CA,Plumas County,6986,6464,522,7.5
CN0606500000000,2022-12-01,06,065,CA,Riverside County,1161750,1118014,43736,3.8
CN0606700000000,2022-12-01,06,067,CA,Sacramento County,731032,704770,26262,3.6
CN0606900000000,2022-12-01,06,069,CA,San Benito County,32882,31251,1631,5
CN0607100000000,2022-12-01,06,071,CA,San Bernardino County,1016438,979614,36824,3.6
CN0607300000000,2022-12-01,06,073,CA,San Diego County,1606945,1558813,48132,3
CN0607500000000,2022-12-01,06,075,CA,San Francisco County/city,578965,566040,12925,2.2
CN0607700000000,2022-12-01,06,077,CA,San Joaquin County,346891,328952,17939,5.2
CN0607900000000,2022-12-01,06,079,CA,San Luis Obispo County,137450,133760,3690,2.7
CN0608100000000,2022-12-01,06,081,CA,San Mateo County,458245,448611,9634,2.1
CN0608300000000,2022-12-01,06,083,CA,Santa Barbara County,221269,213668,7601,3.4
CN0608500000000,2022-12-01,06,085,CA,Santa Clara County,1059173,1034662,24511,2.3
CN0608700000000,2022-12-01,06,087,CA,Santa Cruz County,131866,125307,6559,5
CN0608900000000,2022-12-01,06,089,CA,Shasta County,73501,70302,3199,4.4
CN0609100000000,2022-12-01,06,091,CA,Sierra County,1286,1233,53,4.1
CN0609300000000,2022-12-01,06,093,CA,Siskiyou County,16163,15199,964,6
CN0609500000000,2022-12-01,06,095,CA,Solano County,203724,195962,7762,3.8
CN0609700000000,2022-12-01,06,097,CA,Sonoma County,249325,242301,7024,2.8
CN0609900000000,2022-12-01,06,099,CA,Stanislaus County,243061,230221,12840,5.3
CN0610100000000,2022-12-01,06,101,CA,Sutter County,46259,43005,3254,7
CN0610300000000,2022-12-01,06,103,CA,Tehama County,25427,24184,1243,4.9
CN0610500000000,2022-12-01,06,105,CA,Trinity County,4464,4234,230,5.2
CN0610700000000,2022-12-01,06,107,CA,Tulare County,208051,190413,17638,8.5
CN0610900000000,2022-12-01,06,109,CA,Tuolumne County,19720,18905,815,4.1
CN0611100000000,2022-12-01,06,111,CA,Ventura County,416426,401924,14502,3.5
CN0611300000000,2022-12-01,06,113,CA,Yolo County,109374,105067,4307,3.9
CN0611500000000,2022-12-01,06,115,CA,Yuba County,32034,30226,1808,5.6
CN0800100000000,2022-12-01,08,001,CO,Adams County,281080,273162,7918,2.8
CN0800300000000,2022-12-01,08,003,CO,Alamosa County,8324,8059,265,3.2
CN0800500000000,2022-12-01,08,005,CO,Arapahoe County,374024,364558,9466,2.5
CN0800700000000,2022-12-01,08,007,CO,Archuleta County,7002,6819,183,2.6
CN0800900000000,2022-12-01,08,009,CO,Baca County,2119,2089,30,1.4
CN0801100000000,2022-12-01,08,011,CO,Bent County,1846,1792,54,2.9
CN0801300000000,2022-12-01,08,013,CO,Boulder County,201999,197828,4171,2.1
CN0801400000000,2022-12-01,08,014,CO,Broomfield County/city,42383,41431,952,2.2
CN0801500000000,2022-12-01,08,015,CO,Chaffee County,9804,9560,244,2.5
CN0801700000000,2022-12-01,08,017,CO,Cheyenne County,1092,1072,20,1.8
CN0801900000000,2022-12-01,08,019,CO,Clear Creek County,6146,5997,149,2.4
CN0802100000000,2022-12-01,08,021,CO,Conejos County,4053,3951,102,2.5
CN0802300000000,2022-12-01,08,023,CO,Costilla County,1844,1776,68,3.7
CN0802500000000,2022-12-01,08,025,CO,Crowley County,1376,1331,45,3.3
CN0802700000000,2022-12-01,08,027,CO,Custer County,2348,2282,66,2.8
CN0802900000000,2022-12-01,08,029,CO,Delta County,13257,12844,413,3.1
CN0803100000000,2022-12-01,08,031,CO,Denver County/city,435240,423763,11477,2.6
CN0803300000000,2022-12-01,08,033,CO,Dolores County,1195,1168,27,2.3
CN0803500000000,2022-12-01,08,035,CO,Douglas County,207407,202932,4475,2.2
CN0803700000000,2022-12-01,08,037,CO,Eagle County,36256,35523,733,2
CN0803900000000,2022-12-01,08,039,CO,Elbert County,16068,15754,314,2
CN0804100000000,2022-12-01,08,041,CO,El Paso County,357368,347703,9665,2.7
CN0804300000000,2022-12-01,08,043,CO,Fremont County,14076,13505,571,4.1
CN0804500000000,2022-12-01,08,045,CO,Garfield County,32032,31244,788,2.5
CN0804700000000,2022-12-01,08,047,CO,Gilpin County,3925,3838,87,2.2
CN0804900000000,2022-12-01,08,049,CO,Grand County,9765,9545,220,2.3
CN0805100000000,2022-12-01,08,051,CO,Gunnison County,11958,11708,250,2.1
CN0805300000000,2022-12-01,08,053,CO,Hinsdale County,417,405,12,2.9
CN0805500000000,2022-12-01,08,055,CO,Huerfano County,2512,2375,137,5.5
CN0805700000000,2022-12-01,08,057,CO,Jackson County,1026,1008,18,1.8
CN0805900000000,2022-12-01,08,059,CO,Jefferson County,342384,334406,7978,2.3
CN0806100000000,2022-12-01,08,061,CO,Kiowa County,945,930,15,1.6
CN0806300000000,2022-12-01,08,063,CO,Kit Carson County,4288,4229,59,1.4
CN0806500000000,2022-12-01,08,065,CO,Lake County,5169,5073,96,1.9
CN0806700000000,2022-12-01,08,067,CO,La Plata County,31464,30651,813,2.6
CN0806900000000,2022-12-01,08,069,CO,Larimer County,209338,204615,4723,2.3
CN0807100000000,2022-12-01,08,071,CO,Las Animas County,6063,5807,256,4.2
CN0807300000000,2022-12-01,08,073,CO,Lincoln County,2195,2135,60,2.7
CN0807500000000,2022-12-01,08,075,CO,Logan County,10242,10030,212,2.1
CN0807700000000,2022-12-01,08,077,CO,Mesa County,76893,74665,2228,2.9
CN0807900000000,2022-12-01,08,079,CO,Mineral County,507,498,9,1.8
CN0808100000000,2022-12-01,08,081,CO,Moffat County,6906,6702,204,3
CN0808300000000,2022-12-01,08,083,CO,Montezuma County,12340,11929,411,3.3
CN0808500000000,2022-12-01,08,085,CO,Montrose County,21298,20694,604,2.8
CN0808700000000,2022-12-01,08,087,CO,Morgan County,15635,15251,384,2.5
CN0808900000000,2022-12-01,08,089,CO,Otero County,7914,7640,274,3.5
CN0809100000000,2022-12-01,08,091,CO,Ouray County,2491,2424,67,2.7
CN0809300000000,2022-12-01,08,093,CO,Park County,11682,11411,271,2.3
CN0809500000000,2022-12-01,08,095,CO,Phillips County,2533,2495,38,1.5
CN0809700000000,2022-12-01,08,097,CO,Pitkin County,10952,10682,270,2.5
CN0809900000000,2022-12-01,08,099,CO,Prowers County,6329,6195,134,2.1
CN0810100000000,2022-12-01,08,101,CO,Pueblo County,76199,73407,2792,3.7
CN0810300000000,2022-12-01,08,103,CO,Rio Blanco County,2920,2836,84,2.9
CN0810500000000,2022-12-01,08,105,CO,Rio Grande County,5347,5162,185,3.5
CN0810700000000,2022-12-01,08,107,CO,Routt County,16462,16139,323,2
CN0810900000000,2022-12-01,08,109,CO,Saguache County,3408,3312,96,2.8
CN0811100000000,2022-12-01,08,111,CO,San Juan County,523,508,15,2.9
CN0811300000000,2022-12-01,08,113,CO,San Miguel County,6049,5901,148,2.4
CN0811500000000,2022-12-01,08,115,CO,Sedgwick County,1088,1061,27,2.5
CN0811700000000,2022-12-01,08,117,CO,Summit County,23292,22911,381,1.6
CN0811900000000,2022-12-01,08,119,CO,Teller County,13392,13059,333,2.5
CN0812100000000,2022-12-01,08,121,CO,Washington County,2831,2775,56,2
CN0812300000000,2022-12-01,08,123,CO,Weld County,169617,165027,4590,2.7
CN0812500000000,2022-12-01,08,125,CO,Yuma County,5711,5628,83,1.5
CN0900100000000,2022-12-01,09,001,CT,Fairfield County,478276,462832,15444,3.2
CN0900300000000,2022-12-01,09,003,CT,Hartford County,476711,461105,15606,3.3
CN0900500000000,2022-12-01,09,005,CT,Litchfield County,103885,100761,3124,3
CN0900700000000,2022-12-01,09,007,CT,Middlesex County,93752,91094,2658,2.8
CN0900900000000,2022-12-01,09,009,CT,New Haven County,466692,451090,15602,3.3
CN0901100000000,2022-12-01,09,011,CT,New London County,132291,128072,4219,3.2
CN0901300000000,2022-12-01,09,013,CT,Tolland County,86214,83725,2489,2.9
CN0901500000000,2022-12-01,09,015,CT,Windham County,63589,61479,2110,3.3
CN1000100000000,2022-12-01,10,001,DE,Kent County,79531,75761,3770,4.7
CN1000300000000,2022-12-01,10,003,DE,New Castle County,305146,293303,11843,3.9
CN1000500000000,2022-12-01,10,005,DE,Sussex County,109899,104912,4987,4.5
CN1100100000000,2022-12-01,11,001,DC,District of Columbia,386520,370787,15733,4.1
CN1200100000000,2022-12-01,12,001,FL,Alachua County,142790,139756,3034,2.1
CN1200300000000,2022-12-01,12,003,FL,Baker County,12845,12581,264,2.1
CN1200500000000,2022-12-01,12,005,FL,Bay County,88160,86181,1979,2.2
CN1200700000000,2022-12-01,12,007,FL,Bradford County,11070,10806,264,2.4
CN1200900000000,2022-12-01,12,009,FL,Brevard County,299634,292704,6930,2.3
CN1201100000000,2022-12-01,12,011,FL,Broward County,1064280,1040981,23299,2.2
CN1201300000000,2022-12-01,12,013,FL,Calhoun County,4835,4715,120,2.5
CN1201500000000,2022-12-01,12,015,FL,Charlotte County,77705,75257,2448,3.2
CN1201700000000,2022-12-01,12,017,FL,Citrus County,49489,47804,1685,3.4
CN1201900000000,2022-12-01,12,019,FL,Clay County,115071,112692,2379,2.1
CN1202100000000,2022-12-01,12,021,FL,Collier County,189333,185035,4298,2.3
CN1202300000000,2022-12-01,12,023,FL,Columbia County,29548,28824,724,2.5
CN1202700000000,2022-12-01,12,027,FL,DeSoto County,13896,13515,381,2.7
CN1202900000000,2022-12-01,12,029,FL,Dixie County,5840,5681,159,2.7
CN1203100000000,2022-12-01,12,031,FL,Duval County,520153,507994,12159,2.3
CN1203300000000,2022-12-01,12,033,FL,Escambia County,149014,145270,3744,2.5
CN1203500000000,2022-12-01,12,035,FL,Flagler County,50984,49557,1427,2.8
CN1203700000000,2022-12-01,12,037,FL,Franklin County,4709,4599,110,2.3
CN1203900000000,2022-12-01,12,039,FL,Gadsden County,19112,18521,591,3.1
CN1204100000000,2022-12-01,12,041,FL,Gilchrist County,7428,7251,177,2.4
CN1204300000000,2022-12-01,12,043,FL,Glades County,5237,5111,126,2.4
CN1204500000000,2022-12-01,12,045,FL,Gulf County,5445,5328,117,2.1
CN1204700000000,2022-12-01,12,047,FL,Hamilton County,4147,4018,129,3.1
CN1204900000000,2022-12-01,12,049,FL,Hardee County,8767,8528,239,2.7
CN1205100000000,2022-12-01,12,051,FL,Hendry County,15227,14719,508,3.3
CN1205300000000,2022-12-01,12,053,FL,Hernando County,77448,75239,2209,2.9
CN1205500000000,2022-12-01,12,055,FL,Highlands County,36090,34835,1255,3.5
CN1205700000000,2022-12-01,12,057,FL,Hillsborough County,814320,796465,17855,2.2
CN1205900000000,2022-12-01,12,059,FL,Holmes County,7052,6886,166,2.4
CN1206100000000,2022-12-01,12,061,FL,Indian River County,67806,66008,1798,2.7
CN1206300000000,2022-12-01,12,063,FL,Jackson County,16576,16156,420,2.5
CN1206500000000,2022-12-01,12,065,FL,Jefferson County,5742,5604,138,2.4
CN1206700000000,2022-12-01,12,067,FL,Lafayette County,2773,2711,62,2.2
CN1206900000000,2022-12-01,12,069,FL,Lake County,172924,168754,4170,2.4
CN1207100000000,2022-12-01,12,071,FL,Lee County,384222,372810,11412,3
CN1207300000000,2022-12-01,12,073,FL,Leon County,160044,156396,3648,2.3
CN1207500000000,2022-12-01,12,075,FL,Levy County,17052,16592,460,2.7
CN1207700000000,2022-12-01,12,077,FL,Liberty County,2634,2572,62,2.4
CN1207900000000,2022-12-01,12,079,FL,Madison County,7773,7577,196,2.5
CN1208100000000,2022-12-01,12,081,FL,Manatee County,187674,183383,4291,2.3
CN1208300000000,2022-12-01,12,083,FL,Marion County,149506,145399,4107,2.7
CN1208500000000,2022-12-01,12,085,FL,Martin County,76825,75193,1632,2.1
CN1208600000000,2022-12-01,12,086,FL,Miami-Dade County,1397307,1369536,27771,2
CN1208700000000,2022-12-01,12,087,FL,Monroe County,50326,49593,733,1.5
CN1208900000000,2022-12-01,12,089,FL,Nassau County,45462,44520,942,2.1
CN1209100000000,2022-12-01,12,091,FL,Okaloosa County,102501,100483,2018,2
CN1209300000000,2022-12-01,12,093,FL,Okeechobee County,17786,17379,407,2.3
CN1209500000000,2022-12-01,12,095,FL,Orange County,800794,783159,17635,2.2
CN1209700000000,2022-12-01,12,097,FL,Osceola County,199271,194081,5190,2.6
CN1209900000000,2022-12-01,12,099,FL,Palm Beach County,765740,748620,17120,2.2
CN1210100000000,2022-12-01,12,101,FL,Pasco County,260632,254247,6385,2.4
CN1210300000000,2022-12-01,12,103,FL,Pinellas County,515727,504691,11036,2.1
CN1210500000000,2022-12-01,12,105,FL,Polk County,341181,331805,9376,2.7
CN1210700000000,2022-12-01,12,107,FL,Putnam County,27155,26293,862,3.2
CN1210900000000,2022-12-01,12,109,FL,St. Johns County,151932,149088,2844,1.9
CN1211100000000,2022-12-01,12,111,FL,St. Lucie County,157029,152862,4167,2.7
CN1211300000000,2022-12-01,12,113,FL,Santa Rosa County,87577,85625,1952,2.2
CN1211500000000,2022-12-01,12,115,FL,Sarasota County,196570,191870,4700,2.4
CN1211700000000,2022-12-01,12,117,FL,Seminole County,266782,261086,5696,2.1
CN1211900000000,2022-12-01,12,119,FL,Sumter County,37755,36486,1269,3.4
CN1212100000000,2022-12-01,12,121,FL,Suwannee County,17650,17211,439,2.5
CN1212300000000,2022-12-01,12,123,FL,Taylor County,8063,7847,216,2.7
CN1212500000000,2022-12-01,12,125,FL,Union County,4556,4450,106,2.3
CN1212700000000,2022-12-01,12,127,FL,Volusia County,268696,261800,6896,2.6
CN1212900000000,2022-12-01,12,129,FL,Wakulla County,16071,15754,317,2
CN1213100000000,2022-12-01,12,131,FL,Walton County,34700,33969,731,2.1
CN1213300000000,2022-12-01,12,133,FL,Washington County,9857,9620,237,2.4
CN1300100000000,2022-12-01,13,001,GA,Appling County,9155,8830,325,3.5
CN1300300000000,2022-12-01,13,003,GA,Atkinson County,4255,4159,96,2.3
CN1300500000000,2022-12-01,13,005,GA,Bacon County,4818,4680,138,2.9
CN1300700000000,2022-12-01,13,007,GA,Baker County,1075,1035,40,3.7
CN1300900000000,2022-12-01,13,009,GA,Baldwin County,17913,17282,631,3.5
CN1301100000000,2022-12-01,13,011,GA,Banks County,10831,10602,229,2.1
CN1301300000000,2022-12-01,13,013,GA,Barrow County,43355,42326,1029,2.4
CN1301500000000,2022-12-01,13,015,GA,Bartow County,52571,51153,1418,2.7
CN1301700000000,2022-12-01,13,017,GA,Ben Hill County,5546,5312,234,4.2
CN1301900000000,2022-12-01,13,019,GA,Berrien County,7671,7443,228,3
CN1302100000000,2022-12-01,13,021,GA,Bibb County,65578,63388,2190,3.3
CN1302300000000,2022-12-01,13,023,GA,Bleckley County,4464,4292,172,3.9
CN1302500000000,2022-12-01,13,025,GA,Brantley County,7368,7136,232,3.1
CN1302700000000,2022-12-01,13,027,GA,Brooks County,6517,6326,191,2.9
CN1302900000000,2022-12-01,13,029,GA,Bryan County,20079,19606,473,2.4
CN1303100000000,2022-12-01,13,031,GA,Bulloch County,38960,37813,1147,2.9
CN1303300000000,2022-12-01,13,033,GA,Burke County,8893,8485,408,4.6
CN1303500000000,2022-12-01,13,035,GA,Butts County,11392,11097,295,2.6
CN1303700000000,2022-12-01,13,037,GA,Calhoun County,2168,2109,59,2.7
CN1303900000000,2022-12-01,13,039,GA,Camden County,22174,21572,602,2.7
CN1304300000000,2022-12-01,13,043,GA,Candler County,6101,5979,122,2
CN1304500000000,2022-12-01,13,045,GA,Carroll County,57433,55865,1568,2.7
CN1304700000000,2022-12-01,13,047,GA,Catoosa County,33681,32834,847,2.5
CN1304900000000,2022-12-01,13,049,GA,Charlton County,5055,4910,145,2.9
CN1305100000000,2022-12-01,13,051,GA,Chatham County,143644,139863,3781,2.6
CN1305300000000,2022-12-01,13,053,GA,Chattahoochee County,1907,1830,77,4
CN1305500000000,2022-12-01,13,055,GA,Chattooga County,9206,8722,484,5.3
CN1305700000000,2022-12-01,13,057,GA,Cherokee County,143651,140499,3152,2.2
CN1305900000000,2022-12-01,13,059,GA,Clarke County,58599,56909,1690,2.9
CN1306100000000,2022-12-01,13,061,GA,Clay County,773,727,46,6
CN1306300000000,2022-12-01,13,063,GA,Clayton County,140715,135852,4863,3.5
CN1306500000000,2022-12-01,13,065,GA,Clinch County,2932,2859,73,2.5
CN1306700000000,2022-12-01,13,067,GA,Cobb County,434069,423794,10275,2.4
CN1306900000000,2022-12-01,13,069,GA,Coffee County,18979,18350,629,3.3
CN1307100000000,2022-12-01,13,071,GA,Colquitt County,21532,20974,558,2.6
CN1307300000000,2022-12-01,13,073,GA,Columbia County,75635,73636,1999,2.6
CN1307500000000,2022-12-01,13,075,GA,Cook County,8146,7918,228,2.8
CN1307700000000,2022-12-01,13,077,GA,Coweta County,78148,76260,1888,2.4
CN1307900000000,2022-12-01,13,079,GA,Crawford County,5352,5204,148,2.8
CN1308100000000,2022-12-01,13,081,GA,Crisp County,9696,9361,335,3.5
CN1308300000000,2022-12-01,13,083,GA,Dade County,8068,7864,204,2.5
CN1308500000000,2022-12-01,13,085,GA,Dawson County,13461,13150,311,2.3
CN1308700000000,2022-12-01,13,087,GA,Decatur County,11664,11304,360,3.1
CN1308900000000,2022-12-01,13,089,GA,DeKalb County,407408,395950,11458,2.8
CN1309100000000,2022-12-01,13,091,GA,Dodge County,6767,6532,235,3.5
CN1309300000000,2022-12-01,13,093,GA,Dooly County,5003,4844,159,3.2
CN1309500000000,2022-12-01,13,095,GA,Dougherty County,36321,34939,1382,3.8
CN1309700000000,2022-12-01,13,097,GA,Douglas County,75503,73307,2196,2.9
CN1309900000000,2022-12-01,13,099,GA,Early County,4346,4203,143,3.3
CN1310100000000,2022-12-01,13,101,GA,Echols County,1801,1762,39,2.2
CN1310300000000,2022-12-01,13,103,GA,Effingham County,33602,32815,787,2.3
CN1310500000000,2022-12-01,13,105,GA,Elbert County,8020,7771,249,3.1
CN1310700000000,2022-12-01,13,107,GA,Emanuel County,8949,8606,343,3.8
CN1310900000000,2022-12-01,13,109,GA,Evans County,5010,4880,130,2.6
CN1311100000000,2022-12-01,13,111,GA,Fannin County,12119,11811,308,2.5
CN1311300000000,2022-12-01,13,113,GA,Fayette County,59943,58515,1428,2.4
CN1311500000000,2022-12-01,13,115,GA,Floyd County,44717,43459,1258,2.8
CN1311700000000,2022-12-01,13,117,GA,Forsyth County,130984,128192,2792,2.1
CN1311900000000,2022-12-01,13,119,GA,Franklin County,9685,9408,277,2.9
CN1312100000000,2022-12-01,13,121,GA,Fulton County,578443,561930,16513,2.9
CN1312300000000,2022-12-01,13,123,GA,Gilmer County,12376,12012,364,2.9
CN1312500000000,2022-12-01,13,125,GA,Glascock County,1235,1196,39,3.2
CN1312700000000,2022-12-01,13,127,GA,Glynn County,39890,38851,1039,2.6
CN1312900000000,2022-12-01,13,129,GA,Gordon County,28748,27941,807,2.8
CN1313100000000,2022-12-01,13,131,GA,Grady County,10806,10522,284,2.6
CN1313300000000,2022-12-01,13,133,GA,Greene County,7255,7036,219,3
CN1313500000000,2022-12-01,13,135,GA,Gwinnett County,503871,491592,12279,2.4
CN1313700000000,2022-12-01,13,137,GA,Habersham County,18957,18375,582,3.1
CN1313900000000,2022-12-01,13,139,GA,Hall County,108074,105699,2375,2.2
CN1314100000000,2022-12-01,13,141,GA,Hancock County,2490,2375,115,4.6
CN1314300000000,2022-12-01,13,143,GA,Haralson County,13083,12719,364,2.8
CN1314500000000,2022-12-01,13,145,GA,Harris County,16897,16471,426,2.5
CN1314700000000,2022-12-01,13,147,GA,Hart County,12200,11870,330,2.7
CN1314900000000,2022-12-01,13,149,GA,Heard County,5337,5194,143,2.7
CN1315100000000,2022-12-01,13,151,GA,Henry County,121350,117926,3424,2.8
CN1315300000000,2022-12-01,13,153,GA,Houston County,70499,68517,1982,2.8
CN1315500000000,2022-12-01,13,155,GA,Irwin County,3419,3294,125,3.7
CN1315700000000,2022-12-01,13,157,GA,Jackson County,45795,44918,877,1.9
CN1315900000000,2022-12-01,13,159,GA,Jasper County,7218,7040,178,2.5
CN1316100000000,2022-12-01,13,161,GA,Jeff Davis County,6092,5858,234,3.8
CN1316300000000,2022-12-01,13,163,GA,Jefferson County,6599,6373,226,3.4
CN1316500000000,2022-12-01,13,165,GA,Jenkins County,3425,3286,139,4.1
CN1316700000000,2022-12-01,13,167,GA,Johnson County,3921,3816,105,2.7
CN1316900000000,2022-12-01,13,169,GA,Jones County,13332,12967,365,2.7
CN1317100000000,2022-12-01,13,171,GA,Lamar County,8410,8171,239,2.8
CN1317300000000,2022-12-01,13,173,GA,Lanier County,3741,3621,120,3.2
CN1317500000000,2022-12-01,13,175,GA,Laurens County,18843,18148,695,3.7
CN1317700000000,2022-12-01,13,177,GA,Lee County,15012,14624,388,2.6
CN1317900000000,2022-12-01,13,179,GA,Liberty County,26143,25392,751,2.9
CN1318100000000,2022-12-01,13,181,GA,Lincoln County,3451,3346,105,3
CN1318300000000,2022-12-01,13,183,GA,Long County,8400,8168,232,2.8
CN1318500000000,2022-12-01,13,185,GA,Lowndes County,50198,48693,1505,3
CN1318700000000,2022-12-01,13,187,GA,Lumpkin County,18678,18270,408,2.2
CN1318900000000,2022-12-01,13,189,GA,McDuffie County,8364,8020,344,4.1
CN1319100000000,2022-12-01,13,191,GA,McIntosh County,6188,6012,176,2.8
CN1319300000000,2022-12-01,13,193,GA,Macon County,4393,4231,162,3.7
CN1319500000000,2022-12-01,13,195,GA,Madison County,13508,13155,353,2.6
CN1319700000000,2022-12-01,13,197,GA,Marion County,3260,3145,115,3.5
CN1319900000000,2022-12-01,13,199,GA,Meriwether County,8979,8674,305,3.4
CN1320100000000,2022-12-01,13,201,GA,Miller County,2885,2819,66,2.3
CN1320500000000,2022-12-01,13,205,GA,Mitchell County,8072,7803,269,3.3
CN1320700000000,2022-12-01,13,207,GA,Monroe County,12781,12460,321,2.5
CN1320900000000,2022-12-01,13,209,GA,Montgomery County,4018,3879,139,3.5
CN1321100000000,2022-12-01,13,211,GA,Morgan County,9662,9427,235,2.4
CN1321300000000,2022-12-01,13,213,GA,Murray County,15314,14656,658,4.3
CN1321500000000,2022-12-01,13,215,GA,Muscogee County,75956,73129,2827,3.7
CN1321700000000,2022-12-01,13,217,GA,Newton County,54472,52837,1635,3
CN1321900000000,2022-12-01,13,219,GA,Oconee County,20233,19799,434,2.1
CN1322100000000,2022-12-01,13,221,GA,Oglethorpe County,6956,6777,179,2.6
CN1322300000000,2022-12-01,13,223,GA,Paulding County,91960,89757,2203,2.4
CN1322500000000,2022-12-01,13,225,GA,Peach County,11717,11316,401,3.4
CN1322700000000,2022-12-01,13,227,GA,Pickens County,16015,15638,377,2.4
CN1322900000000,2022-12-01,13,229,GA,Pierce County,8879,8648,231,2.6
CN1323100000000,2022-12-01,13,231,GA,Pike County,9232,9003,229,2.5
CN1323300000000,2022-12-01,13,233,GA,Polk County,18268,17742,526,2.9
CN1323500000000,2022-12-01,13,235,GA,Pulaski County,3954,3835,119,3
CN1323700000000,2022-12-01,13,237,GA,Putnam County,8668,8384,284,3.3
CN1323900000000,2022-12-01,13,239,GA,Quitman County,719,682,37,5.1
CN1324100000000,2022-12-01,13,241,GA,Rabun County,7681,7457,224,2.9
CN1324300000000,2022-12-01,13,243,GA,Randolph County,2400,2303,97,4
CN1324500000000,2022-12-01,13,245,GA,Richmond County,82342,79151,3191,3.9
CN1324700000000,2022-12-01,13,247,GA,Rockdale County,45478,44043,1435,3.2
CN1324900000000,2022-12-01,13,249,GA,Schley County,2210,2138,72,3.3
CN1325100000000,2022-12-01,13,251,GA,Screven County,5037,4819,218,4.3
CN1325300000000,2022-12-01,13,253,GA,Seminole County,2973,2868,105,3.5
CN1325500000000,2022-12-01,13,255,GA,Spalding County,29490,28580,910,3.1
CN1325700000000,2022-12-01,13,257,GA,Stephens County,10492,10142,350,3.3
CN1325900000000,2022-12-01,13,259,GA,Stewart County,2609,2524,85,3.3
CN1326100000000,2022-12-01,13,261,GA,Sumter County,12552,12082,470,3.7
CN1326300000000,2022-12-01,13,263,GA,Talbot County,2781,2696,85,3.1
CN1326500000000,2022-12-01,13,265,GA,Taliaferro County,530,511,19,3.6
CN1326700000000,2022-12-01,13,267,GA,Tattnall County,8969,8718,251,2.8
CN1326900000000,2022-12-01,13,269,GA,Taylor County,2600,2484,116,4.5
CN1327100000000,2022-12-01,13,271,GA,Telfair County,3437,3215,222,6.5
CN1327300000000,2022-12-01,13,273,GA,Terrell County,3467,3319,148,4.3
CN1327500000000,2022-12-01,13,275,GA,Thomas County,16664,16144,520,3.1
CN1327700000000,2022-12-01,13,277,GA,Tift County,20752,20202,550,2.7
CN1327900000000,2022-12-01,13,279,GA,Toombs County,12604,12177,427,3.4
CN1328100000000,2022-12-01,13,281,GA,Towns County,4193,4040,153,3.6
CN1328300000000,2022-12-01,13,283,GA,Treutlen County,2689,2589,100,3.7
CN1328500000000,2022-12-01,13,285,GA,Troup County,36183,35230,953,2.6
CN1328700000000,2022-12-01,13,287,GA,Turner County,3149,3037,112,3.6
CN1328900000000,2022-12-01,13,289,GA,Twiggs County,2730,2614,116,4.2
CN1329100000000,2022-12-01,13,291,GA,Union County,11323,11032,291,2.6
CN1329300000000,2022-12-01,13,293,GA,Upson County,11791,11481,310,2.6
CN1329500000000,2022-12-01,13,295,GA,Walker County,31590,30545,1045,3.3
CN1329700000000,2022-12-01,13,297,GA,Walton County,48287,47054,1233,2.6
CN1329900000000,2022-12-01,13,299,GA,Ware County,15858,15404,454,2.9
CN1330100000000,2022-12-01,13,301,GA,Warren County,2710,2630,80,3
CN1330300000000,2022-12-01,13,303,GA,Washington County,7004,6753,251,3.6
CN1330500000000,2022-12-01,13,305,GA,Wayne County,12111,11764,347,2.9
CN1330700000000,2022-12-01,13,307,GA,Webster County,961,929,32,3.3
CN1330900000000,2022-12-01,13,309,GA,Wheeler County,1692,1606,86,5.1
CN1331100000000,2022-12-01,13,311,GA,White County,17197,16824,373,2.2
CN1331300000000,2022-12-01,13,313,GA,Whitfield County,43022,41316,1706,4
CN1331500000000,2022-12-01,13,315,GA,Wilcox County,2638,2558,80,3
CN1331700000000,2022-12-01,13,317,GA,Wilkes County,3619,3490,129,3.6
CN1331900000000,2022-12-01,13,319,GA,Wilkinson County,3918,3802,116,3
CN1332100000000,2022-12-01,13,321,GA,Worth County,8703,8436,267,3.1
CN1500100000000,2022-12-01,15,001,HI,Hawaii County,95171,91591,3580,3.8
CN1500300000000,2022-12-01,15,003,HI,Honolulu County/city,461503,445727,15776,3.4
CN1500700000000,2022-12-01,15,007,HI,Kauai County,36593,35336,1257,3.4
CN1500900000000,2022-12-01,15,009,HI,Maui County,87661,84759,2902,3.3
CN1600100000000,2022-12-01,16,001,ID,Ada County,274817,269479,5338,1.9
CN1600300000000,2022-12-01,16,003,ID,Adams County,1642,1567,75,4.6
CN1600500000000,2022-12-01,16,005,ID,Bannock County,43566,42579,987,2.3
CN1600700000000,2022-12-01,16,007,ID,Bear Lake County,3151,3086,65,2.1
CN1600900000000,2022-12-01,16,009,ID,Benewah County,3955,3787,168,4.2
CN1601100000000,2022-12-01,16,011,ID,Bingham County,24420,23813,607,2.5
CN1601300000000,2022-12-01,16,013,ID,Blaine County,13127,12855,272,2.1
CN1601500000000,2022-12-01,16,015,ID,Boise County,3851,3726,125,3.2
CN1601700000000,2022-12-01,16,017,ID,Bonner County,21242,20436,806,3.8
CN1601900000000,2022-12-01,16,019,ID,Bonneville County,62597,61282,1315,2.1
CN1602100000000,2022-12-01,16,021,ID,Boundary County,5427,5198,229,4.2
CN1602300000000,2022-12-01,16,023,ID,Butte County,1462,1421,41,2.8
CN1602500000000,2022-12-01,16,025,ID,Camas County,705,682,23,3.3
CN1602700000000,2022-12-01,16,027,ID,Canyon County,115984,112955,3029,2.6
CN1602900000000,2022-12-01,16,029,ID,Caribou County,4058,3951,107,2.6
CN1603100000000,2022-12-01,16,031,ID,Cassia County,15430,15151,279,1.8
CN1603300000000,2022-12-01,16,033,ID,Clark County,370,356,14,3.8
CN1603500000000,2022-12-01,16,035,ID,Clearwater County,2861,2732,129,4.5
CN1603700000000,2022-12-01,16,037,ID,Custer County,1978,1911,67,3.4
CN1603900000000,2022-12-01,16,039,ID,Elmore County,12713,12412,301,2.4
CN1604100000000,2022-12-01,16,041,ID,Franklin County,7550,7377,173,2.3
CN1604300000000,2022-12-01,16,043,ID,Fremont County,8182,7991,191,2.3
CN1604500000000,2022-12-01,16,045,ID,Gem County,8844,8616,228,2.6
CN1604700000000,2022-12-01,16,047,ID,Gooding County,11469,11243,226,2
CN1604900000000,2022-12-01,16,049,ID,Idaho County,6634,6408,226,3.4
CN1605100000000,2022-12-01,16,051,ID,Jefferson County,15853,15559,294,1.9
CN1605300000000,2022-12-01,16,053,ID,Jerome County,16897,16532,365,2.2
CN1605500000000,2022-12-01,16,055,ID,Kootenai County,83838,81028,2810,3.4
CN1605700000000,2022-12-01,16,057,ID,Latah County,20038,19667,371,1.9
CN1605900000000,2022-12-01,16,059,ID,Lemhi County,3427,3302,125,3.6
CN1606100000000,2022-12-01,16,061,ID,Lewis County,1642,1596,46,2.8
CN1606300000000,2022-12-01,16,063,ID,Lincoln County,3476,3365,111,3.2
CN1606500000000,2022-12-01,16,065,ID,Madison County,23498,23147,351,1.5
CN1606700000000,2022-12-01,16,067,ID,Minidoka County,13074,12775,299,2.3
CN1606900000000,2022-12-01,16,069,ID,Nez Perce County,20871,20370,501,2.4
CN1607100000000,2022-12-01,16,071,ID,Oneida County,2647,2576,71,2.7
CN1607300000000,2022-12-01,16,073,ID,Owyhee County,6172,5977,195,3.2
CN1607500000000,2022-12-01,16,075,ID,Payette County,11901,11587,314,2.6
CN1607700000000,2022-12-01,16,077,ID,Power County,4517,4385,132,2.9
CN1607900000000,2022-12-01,16,079,ID,Shoshone County,5326,5064,262,4.9
CN1608100000000,2022-12-01,16,081,ID,Teton County,7221,7094,127,1.8
CN1608300000000,2022-12-01,16,083,ID,Twin Falls County,45832,44736,1096,2.4
CN1608500000000,2022-12-01,16,085,ID,Valley County,5419,5231,188,3.5
CN1608700000000,2022-12-01,16,087,ID,Washington County,5014,4869,145,2.9
CN1700100000000,2022-12-01,17,001,IL,Adams County,30509,29635,874,2.9
CN1700300000000,2022-12-01,17,003,IL,Alexander County,1792,1703,89,5
CN1700500000000,2022-12-01,17,005,IL,Bond County,7396,7145,251,3.4
CN1700700000000,2022-12-01,17,007,IL,Boone County,24969,23640,1329,5.3
CN1700900000000,2022-12-01,17,009,IL,Brown County,3076,3020,56,1.8
CN1701100000000,2022-12-01,17,011,IL,Bureau County,15598,14932,666,4.3
CN1701300000000,2022-12-01,17,013,IL,Calhoun County,2155,2076,79,3.7
CN1701500000000,2022-12-01,17,015,IL,Carroll County,7044,6790,254,3.6
CN1701700000000,2022-12-01,17,017,IL,Cass County,5614,5393,221,3.9
CN1701900000000,2022-12-01,17,019,IL,Champaign County,109149,105765,3384,3.1
CN1702100000000,2022-12-01,17,021,IL,Christian County,13165,12645,520,3.9
CN1702300000000,2022-12-01,17,023,IL,Clark County,7215,6937,278,3.9
CN1702500000000,2022-12-01,17,025,IL,Clay County,5556,5320,236,4.2
CN1702700000000,2022-12-01,17,027,IL,Clinton County,19778,19262,516,2.6
CN1702900000000,2022-12-01,17,029,IL,Coles County,23039,22242,797,3.5
CN1703100000000,2022-12-01,17,031,IL,Cook County,2674236,2555492,118744,4.4
CN1703300000000,2022-12-01,17,033,IL,Crawford County,8212,7943,269,3.3
CN1703500000000,2022-12-01,17,035,IL,Cumberland County,5942,5767,175,2.9
CN1703700000000,2022-12-01,17,037,IL,DeKalb County,53575,51668,1907,3.6
CN1703900000000,2022-12-01,17,039,IL,De Witt County,7346,7075,271,3.7
CN1704100000000,2022-12-01,17,041,IL,Douglas County,9996,9693,303,3
CN1704300000000,2022-12-01,17,043,IL,DuPage County,522574,505675,16899,3.2
CN1704500000000,2022-12-01,17,045,IL,Edgar County,9064,8806,258,2.8
CN1704700000000,2022-12-01,17,047,IL,Edwards County,2357,2273,84,3.6
CN1704900000000,2022-12-01,17,049,IL,Effingham County,19722,19194,528,2.7
CN1705100000000,2022-12-01,17,051,IL,Fayette County,9618,9223,395,4.1
CN1705300000000,2022-12-01,17,053,IL,Ford County,6211,5988,223,3.6
CN1705500000000,2022-12-01,17,055,IL,Franklin County,15632,14889,743,4.8
CN1705700000000,2022-12-01,17,057,IL,Fulton County,14436,13787,649,4.5
CN1705900000000,2022-12-01,17,059,IL,Gallatin County,1991,1906,85,4.3
CN1706100000000,2022-12-01,17,061,IL,Greene County,5821,5593,228,3.9
CN1706300000000,2022-12-01,17,063,IL,Grundy County,26490,25193,1297,4.9
CN1706500000000,2022-12-01,17,065,IL,Hamilton County,4328,4205,123,2.8
CN1706700000000,2022-12-01,17,067,IL,Hancock County,7732,7473,259,3.3
CN1706900000000,2022-12-01,17,069,IL,Hardin County,1489,1428,61,4.1
CN1707100000000,2022-12-01,17,071,IL,Henderson County,3504,3386,118,3.4
CN1707300000000,2022-12-01,17,073,IL,Henry County,23305,22431,874,3.8
CN1707500000000,2022-12-01,17,075,IL,Iroquois County,12217,11733,484,4
CN1707700000000,2022-12-01,17,077,IL,Jackson County,27034,26124,910,3.4
CN1707900000000,2022-12-01,17,079,IL,Jasper County,4889,4735,154,3.1
CN1708100000000,2022-12-01,17,081,IL,Jefferson County,16207,15573,634,3.9
CN1708300000000,2022-12-01,17,083,IL,Jersey County,10517,10197,320,3
CN1708500000000,2022-12-01,17,085,IL,Jo Daviess County,10110,9748,362,3.6
CN1708700000000,2022-12-01,17,087,IL,Johnson County,3991,3789,202,5.1
CN1708900000000,2022-12-01,17,089,IL,Kane County,264131,253251,10880,4.1
CN1709100000000,2022-12-01,17,091,IL,Kankakee County,51686,49231,2455,4.7
CN1709300000000,2022-12-01,17,093,IL,Kendall County,73187,70378,2809,3.8
CN1709500000000,2022-12-01,17,095,IL,Knox County,19351,18458,893,4.6
CN1709700000000,2022-12-01,17,097,IL,Lake County,362902,348363,14539,4
CN1709900000000,2022-12-01,17,099,IL,LaSalle County,51350,49019,2331,4.5
CN1710100000000,2022-12-01,17,101,IL,Lawrence County,5047,4813,234,4.6
CN1710300000000,2022-12-01,17,103,IL,Lee County,16446,15844,602,3.7
CN1710500000000,2022-12-01,17,105,IL,Livingston County,15279,14758,521,3.4
CN1710700000000,2022-12-01,17,107,IL,Logan County,11351,10913,438,3.9
CN1710900000000,2022-12-01,17,109,IL,McDonough County,12915,12505,410,3.2
CN1711100000000,2022-12-01,17,111,IL,McHenry County,171036,164544,6492,3.8
CN1711300000000,2022-12-01,17,113,IL,McLean County,89073,86511,2562,2.9
CN1711500000000,2022-12-01,17,115,IL,Macon County,44996,42976,2020,4.5
CN1711700000000,2022-12-01,17,117,IL,Macoupin County,21912,21197,715,3.3
CN1711900000000,2022-12-01,17,119,IL,Madison County,130356,126291,4065,3.1
CN1712100000000,2022-12-01,17,121,IL,Marion County,16669,16013,656,3.9
CN1712300000000,2022-12-01,17,123,IL,Marshall County,5060,4849,211,4.2
CN1712500000000,2022-12-01,17,125,IL,Mason County,5783,5538,245,4.2
CN1712700000000,2022-12-01,17,127,IL,Massac County,5303,5079,224,4.2
CN1712900000000,2022-12-01,17,129,IL,Menard County,6127,5928,199,3.2
CN1713100000000,2022-12-01,17,131,IL,Mercer County,7434,7141,293,3.9
CN1713300000000,2022-12-01,17,133,IL,Monroe County,18582,18143,439,2.4
CN1713500000000,2022-12-01,17,135,IL,Montgomery County,10851,10400,451,4.2
CN1713700000000,2022-12-01,17,137,IL,Morgan County,15480,14949,531,3.4
CN1713900000000,2022-12-01,17,139,IL,Moultrie County,7353,7147,206,2.8
CN1714100000000,2022-12-01,17,141,IL,Ogle County,23371,22360,1011,4.3
CN1714300000000,2022-12-01,17,143,IL,Peoria County,81810,78333,3477,4.3
CN1714500000000,2022-12-01,17,145,IL,Perry County,7683,7353,330,4.3
CN1714700000000,2022-12-01,17,147,IL,Piatt County,8545,8294,251,2.9
CN1714900000000,2022-12-01,17,149,IL,Pike County,6576,6317,259,3.9
CN1715100000000,2022-12-01,17,151,IL,Pope County,1744,1681,63,3.6
CN1715300000000,2022-12-01,17,153,IL,Pulaski County,1614,1517,97,6
CN1715500000000,2022-12-01,17,155,IL,Putnam County,2967,2831,136,4.6
CN1715700000000,2022-12-01,17,157,IL,Randolph County,13335,12908,427,3.2
CN1715900000000,2022-12-01,17,159,IL,Richland County,7137,6916,221,3.1
CN1716100000000,2022-12-01,17,161,IL,Rock Island County,66581,64023,2558,3.8
CN1716300000000,2022-12-01,17,163,IL,St. Clair County,122224,117974,4250,3.5
CN1716500000000,2022-12-01,17,165,IL,Saline County,9320,8921,399,4.3
CN1716700000000,2022-12-01,17,167,IL,Sangamon County,96634,93329,3305,3.4
CN1716900000000,2022-12-01,17,169,IL,Schuyler County,2954,2821,133,4.5
CN1717100000000,2022-12-01,17,171,IL,Scott County,2292,2165,127,5.5
CN1717300000000,2022-12-01,17,173,IL,Shelby County,9673,9311,362,3.7
CN1717500000000,2022-12-01,17,175,IL,Stark County,2360,2245,115,4.9
CN1717700000000,2022-12-01,17,177,IL,Stephenson County,20428,19572,856,4.2
CN1717900000000,2022-12-01,17,179,IL,Tazewell County,61591,59416,2175,3.5
CN1718100000000,2022-12-01,17,181,IL,Union County,7070,6724,346,4.9
CN1718300000000,2022-12-01,17,183,IL,Vermilion County,31578,30183,1395,4.4
CN1718500000000,2022-12-01,17,185,IL,Wabash County,5731,5576,155,2.7
CN1718700000000,2022-12-01,17,187,IL,Warren County,7778,7519,259,3.3
CN1718900000000,2022-12-01,17,189,IL,Washington County,9725,9527,198,2
CN1719100000000,2022-12-01,17,191,IL,Wayne County,6982,6754,228,3.3
CN1719300000000,2022-12-01,17,193,IL,White County,5975,5779,196,3.3
CN1719500000000,2022-12-01,17,195,IL,Whiteside County,27465,26485,980,3.6
CN1719700000000,2022-12-01,17,197,IL,Will County,371023,355076,15947,4.3
CN1719900000000,2022-12-01,17,199,IL,Williamson County,31013,29911,1102,3.6
CN1720100000000,2022-12-01,17,201,IL,Winnebago County,132572,126591,5981,4.5
CN1720300000000,2022-12-01,17,203,IL,Woodford County,18137,17577,560,3.1
CN1800100000000,2022-12-01,18,001,IN,Adams County,16876,16571,305,1.8
CN1800300000000,2022-12-01,18,003,IN,Allen County,188712,184282,4430,2.3
CN1800500000000,2022-12-01,18,005,IN,Bartholomew County,44602,43722,880,2
CN1800700000000,2022-12-01,18,007,IN,Benton County,4452,4360,92,2.1
CN1800900000000,2022-12-01,18,009,IN,Blackford County,4761,4627,134,2.8
CN1801100000000,2022-12-01,18,011,IN,Boone County,38476,37837,639,1.7
CN1801300000000,2022-12-01,18,013,IN,Brown County,7922,7690,232,2.9
CN1801500000000,2022-12-01,18,015,IN,Carroll County,10012,9793,219,2.2
CN1801700000000,2022-12-01,18,017,IN,Cass County,17222,16748,474,2.8
CN1801900000000,2022-12-01,18,019,IN,Clark County,62614,61201,1413,2.3
CN1802100000000,2022-12-01,18,021,IN,Clay County,11711,11364,347,3
CN1802300000000,2022-12-01,18,023,IN,Clinton County,17226,16860,366,2.1
CN1802500000000,2022-12-01,18,025,IN,Crawford County,4768,4620,148,3.1
CN1802700000000,2022-12-01,18,027,IN,Daviess County,16641,16363,278,1.7
CN1802900000000,2022-12-01,18,029,IN,Dearborn County,25986,25384,602,2.3
CN1803100000000,2022-12-01,18,031,IN,Decatur County,14570,14259,311,2.1
CN1803300000000,2022-12-01,18,033,IN,DeKalb County,22384,21872,512,2.3
CN1803500000000,2022-12-01,18,035,IN,Delaware County,51653,50232,1421,2.8
CN1803700000000,2022-12-01,18,037,IN,Dubois County,21986,21570,416,1.9
CN1803900000000,2022-12-01,18,039,IN,Elkhart County,116222,112956,3266,2.8
CN1804100000000,2022-12-01,18,041,IN,Fayette County,8243,7932,311,3.8
CN1804300000000,2022-12-01,18,043,IN,Floyd County,42206,41330,876,2.1
CN1804500000000,2022-12-01,18,045,IN,Fountain County,7998,7793,205,2.6
CN1804700000000,2022-12-01,18,047,IN,Franklin County,11314,11049,265,2.3
CN1804900000000,2022-12-01,18,049,IN,Fulton County,9397,9144,253,2.7
CN1805100000000,2022-12-01,18,051,IN,Gibson County,20296,19934,362,1.8
CN1805300000000,2022-12-01,18,053,IN,Grant County,32025,31164,861,2.7
CN1805500000000,2022-12-01,18,055,IN,Greene County,13567,13124,443,3.3
CN1805700000000,2022-12-01,18,057,IN,Hamilton County,196645,193199,3446,1.8
CN1805900000000,2022-12-01,18,059,IN,Hancock County,43048,42128,920,2.1
CN1806100000000,2022-12-01,18,061,IN,Harrison County,20434,20014,420,2.1
CN1806300000000,2022-12-01,18,063,IN,Hendricks County,95780,93901,1879,2
CN1806500000000,2022-12-01,18,065,IN,Henry County,22268,21635,633,2.8
CN1806700000000,2022-12-01,18,067,IN,Howard County,32984,31552,1432,4.3
CN1806900000000,2022-12-01,18,069,IN,Huntington County,18203,17777,426,2.3
CN1807100000000,2022-12-01,18,071,IN,Jackson County,23664,23142,522,2.2
CN1807300000000,2022-12-01,18,073,IN,Jasper County,16051,15549,502,3.1
CN1807500000000,2022-12-01,18,075,IN,Jay County,8800,8587,213,2.4
CN1807700000000,2022-12-01,18,077,IN,Jefferson County,15052,14672,380,2.5
CN1807900000000,2022-12-01,18,079,IN,Jennings County,13539,13167,372,2.7
CN1808100000000,2022-12-01,18,081,IN,Johnson County,87485,85784,1701,1.9
CN1808300000000,2022-12-01,18,083,IN,Knox County,18235,17838,397,2.2
CN1808500000000,2022-12-01,18,085,IN,Kosciusko County,40872,39842,1030,2.5
CN1808700000000,2022-12-01,18,087,IN,LaGrange County,21212,20761,451,2.1
CN1808900000000,2022-12-01,18,089,IN,Lake County,228823,219007,9816,4.3
CN1809100000000,2022-12-01,18,091,IN,LaPorte County,46951,45359,1592,3.4
CN1809300000000,2022-12-01,18,093,IN,Lawrence County,20365,19753,612,3
CN1809500000000,2022-12-01,18,095,IN,Madison County,60584,58893,1691,2.8
CN1809700000000,2022-12-01,18,097,IN,Marion County,509854,496950,12904,2.5
CN1809900000000,2022-12-01,18,099,IN,Marshall County,23235,22575,660,2.8
CN1810100000000,2022-12-01,18,101,IN,Martin County,5452,5322,130,2.4
CN1810300000000,2022-12-01,18,103,IN,Miami County,14160,13702,458,3.2
CN1810500000000,2022-12-01,18,105,IN,Monroe County,70050,68585,1465,2.1
CN1810700000000,2022-12-01,18,107,IN,Montgomery County,18937,18548,389,2.1
CN1810900000000,2022-12-01,18,109,IN,Morgan County,37595,36738,857,2.3
CN1811100000000,2022-12-01,18,111,IN,Newton County,6816,6574,242,3.6
CN1811300000000,2022-12-01,18,113,IN,Noble County,21709,21128,581,2.7
CN1811500000000,2022-12-01,18,115,IN,Ohio County,3215,3148,67,2.1
CN1811700000000,2022-12-01,18,117,IN,Orange County,8262,8036,226,2.7
CN1811900000000,2022-12-01,18,119,IN,Owen County,9297,9021,276,3
CN1812100000000,2022-12-01,18,121,IN,Parke County,6958,6766,192,2.8
CN1812300000000,2022-12-01,18,123,IN,Perry County,8791,8546,245,2.8
CN1812500000000,2022-12-01,18,125,IN,Pike County,5906,5760,146,2.5
CN1812700000000,2022-12-01,18,127,IN,Porter County,86314,83660,2654,3.1
CN1812900000000,2022-12-01,18,129,IN,Posey County,13068,12834,234,1.8
CN1813100000000,2022-12-01,18,131,IN,Pulaski County,6611,6463,148,2.2
CN1813300000000,2022-12-01,18,133,IN,Putnam County,17026,16593,433,2.5
CN1813500000000,2022-12-01,18,135,IN,Randolph County,11513,11218,295,2.6
CN1813700000000,2022-12-01,18,137,IN,Ripley County,12857,12514,343,2.7
CN1813900000000,2022-12-01,18,139,IN,Rush County,8921,8748,173,1.9
CN1814100000000,2022-12-01,18,141,IN,St. Joseph County,131738,127642,4096,3.1
CN1814300000000,2022-12-01,18,143,IN,Scott County,10535,10240,295,2.8
CN1814500000000,2022-12-01,18,145,IN,Shelby County,23851,23377,474,2
CN1814700000000,2022-12-01,18,147,IN,Spencer County,10061,9831,230,2.3
CN1814900000000,2022-12-01,18,149,IN,Starke County,9573,9191,382,4
CN1815100000000,2022-12-01,18,151,IN,Steuben County,20415,20007,408,2
CN1815300000000,2022-12-01,18,153,IN,Sullivan County,8016,7765,251,3.1
CN1815500000000,2022-12-01,18,155,IN,Switzerland County,4724,4624,100,2.1
CN1815700000000,2022-12-01,18,157,IN,Tippecanoe County,97869,95836,2033,2.1
CN1815900000000,2022-12-01,18,159,IN,Tipton County,8939,8713,226,2.5
CN1816100000000,2022-12-01,18,161,IN,Union County,3605,3519,86,2.4
CN1816300000000,2022-12-01,18,163,IN,Vanderburgh County,92797,90482,2315,2.5
CN1816500000000,2022-12-01,18,165,IN,Vermillion County,6631,6399,232,3.5
CN1816700000000,2022-12-01,18,167,IN,Vigo County,46062,44668,1394,3
CN1816900000000,2022-12-01,18,169,IN,Wabash County,14481,14151,330,2.3
CN1817100000000,2022-12-01,18,171,IN,Warren County,4138,4034,104,2.5
CN1817300000000,2022-12-01,18,173,IN,Warrick County,32543,31828,715,2.2
CN1817500000000,2022-12-01,18,175,IN,Washington County,13776,13473,303,2.2
CN1817700000000,2022-12-01,18,177,IN,Wayne County,29672,28884,788,2.7
CN1817900000000,2022-12-01,18,179,IN,Wells County,14326,14052,274,1.9
CN1818100000000,2022-12-01,18,181,IN,White County,13132,12848,284,2.2
CN1818300000000,2022-12-01,18,183,IN,Whitley County,17841,17482,359,2
CN1900100000000,2022-12-01,19,001,IA,Adair County,4355,4265,90,2.1
CN1900300000000,2022-12-01,19,003,IA,Adams County,2109,2071,38,1.8
CN1900500000000,2022-12-01,19,005,IA,Allamakee County,7110,6753,357,5
CN1900700000000,2022-12-01,19,007,IA,Appanoose County,6055,5860,195,3.2
CN1900900000000,2022-12-01,19,009,IA,Audubon County,3041,2984,57,1.9
CN1901100000000,2022-12-01,19,011,IA,Benton County,13215,12770,445,3.4
CN1901300000000,2022-12-01,19,013,IA,Black Hawk County,68369,66196,2173,3.2
CN1901500000000,2022-12-01,19,015,IA,Boone County,14940,14600,340,2.3
CN1901700000000,2022-12-01,19,017,IA,Bremer County,14115,13764,351,2.5
CN1901900000000,2022-12-01,19,019,IA,Buchanan County,11290,10954,336,3
CN1902100000000,2022-12-01,19,021,IA,Buena Vista County,11953,11701,252,2.1
CN1902300000000,2022-12-01,19,023,IA,Butler County,8377,8100,277,3.3
CN1902500000000,2022-12-01,19,025,IA,Calhoun County,4201,4092,109,2.6
CN1902700000000,2022-12-01,19,027,IA,Carroll County,10757,10551,206,1.9
CN1902900000000,2022-12-01,19,029,IA,Cass County,6831,6671,160,2.3
CN1903100000000,2022-12-01,19,031,IA,Cedar County,10501,10186,315,3
CN1903300000000,2022-12-01,19,033,IA,Cerro Gordo County,22392,21713,679,3
CN1903500000000,2022-12-01,19,035,IA,Cherokee County,6117,5972,145,2.4
CN1903700000000,2022-12-01,19,037,IA,Chickasaw County,6561,6397,164,2.5
CN1903900000000,2022-12-01,19,039,IA,Clarke County,5006,4869,137,2.7
CN1904100000000,2022-12-01,19,041,IA,Clay County,8602,8346,256,3
CN1904300000000,2022-12-01,19,043,IA,Clayton County,9538,9050,488,5.1
CN1904500000000,2022-12-01,19,045,IA,Clinton County,22396,21558,838,3.7
CN1904700000000,2022-12-01,19,047,IA,Crawford County,8029,7548,481,6
CN1904900000000,2022-12-01,19,049,IA,Dallas County,54440,53356,1084,2
CN1905100000000,2022-12-01,19,051,IA,Davis County,4355,4227,128,2.9
CN1905300000000,2022-12-01,19,053,IA,Decatur County,4317,4220,97,2.2
CN1905500000000,2022-12-01,19,055,IA,Delaware County,10504,10235,269,2.6
CN1905700000000,2022-12-01,19,057,IA,Des Moines County,18112,17355,757,4.2
CN1905900000000,2022-12-01,19,059,IA,Dickinson County,9974,9638,336,3.4
CN1906100000000,2022-12-01,19,061,IA,Dubuque County,56534,54832,1702,3
CN1906300000000,2022-12-01,19,063,IA,Emmet County,4858,4705,153,3.1
CN1906500000000,2022-12-01,19,065,IA,Fayette County,10411,10047,364,3.5
CN1906700000000,2022-12-01,19,067,IA,Floyd County,8394,8123,271,3.2
CN1906900000000,2022-12-01,19,069,IA,Franklin County,5618,5460,158,2.8
CN1907100000000,2022-12-01,19,071,IA,Fremont County,3739,3647,92,2.5
CN1907300000000,2022-12-01,19,073,IA,Greene County,5417,5308,109,2
CN1907500000000,2022-12-01,19,075,IA,Grundy County,6454,6277,177,2.7
CN1907700000000,2022-12-01,19,077,IA,Guthrie County,5686,5520,166,2.9
CN1907900000000,2022-12-01,19,079,IA,Hamilton County,6992,6801,191,2.7
CN1908100000000,2022-12-01,19,081,IA,Hancock County,5680,5541,139,2.4
CN1908300000000,2022-12-01,19,083,IA,Hardin County,7796,7561,235,3
CN1908500000000,2022-12-01,19,085,IA,Harrison County,7122,6945,177,2.5
CN1908700000000,2022-12-01,19,087,IA,Henry County,9440,9137,303,3.2
CN1908900000000,2022-12-01,19,089,IA,Howard County,5258,5081,177,3.4
CN1909100000000,2022-12-01,19,091,IA,Humboldt County,4916,4798,118,2.4
CN1909300000000,2022-12-01,19,093,IA,Ida County,3999,3896,103,2.6
CN1909500000000,2022-12-01,19,095,IA,Iowa County,9935,9672,263,2.6
CN1909700000000,2022-12-01,19,097,IA,Jackson County,10661,10314,347,3.3
CN1909900000000,2022-12-01,19,099,IA,Jasper County,18696,18103,593,3.2
CN1910100000000,2022-12-01,19,101,IA,Jefferson County,9938,9700,238,2.4
CN1910300000000,2022-12-01,19,103,IA,Johnson County,86582,84638,1944,2.2
CN1910500000000,2022-12-01,19,105,IA,Jones County,10457,10087,370,3.5
CN1910700000000,2022-12-01,19,107,IA,Keokuk County,5201,5041,160,3.1
CN1910900000000,2022-12-01,19,109,IA,Kossuth County,8338,8157,181,2.2
CN1911100000000,2022-12-01,19,111,IA,Lee County,14636,13961,675,4.6
CN1911300000000,2022-12-01,19,113,IA,Linn County,121283,117351,3932,3.2
CN1911500000000,2022-12-01,19,115,IA,Louisa County,5930,5732,198,3.3
CN1911700000000,2022-12-01,19,117,IA,Lucas County,4549,4459,90,2
CN1911900000000,2022-12-01,19,119,IA,Lyon County,7116,6963,153,2.2
CN1912100000000,2022-12-01,19,121,IA,Madison County,8835,8564,271,3.1
CN1912300000000,2022-12-01,19,123,IA,Mahaska County,12268,11951,317,2.6
CN1912500000000,2022-12-01,19,125,IA,Marion County,19484,19066,418,2.1
CN1912700000000,2022-12-01,19,127,IA,Marshall County,17640,16379,1261,7.1
CN1912900000000,2022-12-01,19,129,IA,Mills County,7132,6953,179,2.5
CN1913100000000,2022-12-01,19,131,IA,Mitchell County,5774,5654,120,2.1
CN1913300000000,2022-12-01,19,133,IA,Monona County,4374,4250,124,2.8
CN1913500000000,2022-12-01,19,135,IA,Monroe County,4048,3905,143,3.5
CN1913700000000,2022-12-01,19,137,IA,Montgomery County,4954,4830,124,2.5
CN1913900000000,2022-12-01,19,139,IA,Muscatine County,20781,20136,645,3.1
CN1914100000000,2022-12-01,19,141,IA,O'Brien County,8235,8023,212,2.6
CN1914300000000,2022-12-01,19,143,IA,Osceola County,3736,3667,69,1.8
CN1914500000000,2022-12-01,19,145,IA,Page County,6428,6270,158,2.5
CN1914700000000,2022-12-01,19,147,IA,Palo Alto County,4466,4357,109,2.4
CN1914900000000,2022-12-01,19,149,IA,Plymouth County,14911,14575,336,2.3
CN1915100000000,2022-12-01,19,151,IA,Pocahontas County,4204,4105,99,2.4
CN1915300000000,2022-12-01,19,153,IA,Polk County,279049,271360,7689,2.8
CN1915500000000,2022-12-01,19,155,IA,Pottawattamie County,47757,46381,1376,2.9
CN1915700000000,2022-12-01,19,157,IA,Poweshiek County,10348,10052,296,2.9
CN1915900000000,2022-12-01,19,159,IA,Ringgold County,2340,2294,46,2
CN1916100000000,2022-12-01,19,161,IA,Sac County,5233,5109,124,2.4
CN1916300000000,2022-12-01,19,163,IA,Scott County,88533,85551,2982,3.4
CN1916500000000,2022-12-01,19,165,IA,Shelby County,6428,6266,162,2.5
CN1916700000000,2022-12-01,19,167,IA,Sioux County,22724,22289,435,1.9
CN1916900000000,2022-12-01,19,169,IA,Story County,61058,59955,1103,1.8
CN1917100000000,2022-12-01,19,171,IA,Tama County,9360,8927,433,4.6
CN1917300000000,2022-12-01,19,173,IA,Taylor County,3167,3108,59,1.9
CN1917500000000,2022-12-01,19,175,IA,Union County,6154,6005,149,2.4
CN1917700000000,2022-12-01,19,177,IA,Van Buren County,3673,3560,113,3.1
CN1917900000000,2022-12-01,19,179,IA,Wapello County,16878,16157,721,4.3
CN1918100000000,2022-12-01,19,181,IA,Warren County,29543,28820,723,2.4
CN1918300000000,2022-12-01,19,183,IA,Washington County,11736,11419,317,2.7
CN1918500000000,2022-12-01,19,185,IA,Wayne County,2978,2911,67,2.2
CN1918700000000,2022-12-01,19,187,IA,Webster County,18911,18354,557,2.9
CN1918900000000,2022-12-01,19,189,IA,Winnebago County,4980,4837,143,2.9
CN1919100000000,2022-12-01,19,191,IA,Winneshiek County,11603,11227,376,3.2
CN1919300000000,2022-12-01,19,193,IA,Woodbury County,56607,54898,1709,3
CN1919500000000,2022-12-01,19,195,IA,Worth County,3986,3887,99,2.5
CN1919700000000,2022-12-01,19,197,IA,Wright County,6604,6453,151,2.3
CN2000100000000,2022-12-01,20,001,KS,Allen County,6327,6155,172,2.7
CN2000300000000,2022-12-01,20,003,KS,Anderson County,4439,4346,93,2.1
CN2000500000000,2022-12-01,20,005,KS,Atchison County,6768,6564,204,3
CN2000700000000,2022-12-01,20,007,KS,Barber County,2309,2265,44,1.9
CN2000900000000,2022-12-01,20,009,KS,Barton County,13171,12831,340,2.6
CN2001100000000,2022-12-01,20,011,KS,Bourbon County,6322,6112,210,3.3
CN2001300000000,2022-12-01,20,013,KS,Brown County,5170,5056,114,2.2
CN2001500000000,2022-12-01,20,015,KS,Butler County,32822,31945,877,2.7
CN2001700000000,2022-12-01,20,017,KS,Chase County,1379,1351,28,2
CN2001900000000,2022-12-01,20,019,KS,Chautauqua County,1455,1409,46,3.2
CN2002100000000,2022-12-01,20,021,KS,Cherokee County,9814,9580,234,2.4
CN2002300000000,2022-12-01,20,023,KS,Cheyenne County,1324,1294,30,2.3
CN2002500000000,2022-12-01,20,025,KS,Clark County,1138,1117,21,1.8
CN2002700000000,2022-12-01,20,027,KS,Clay County,3822,3737,85,2.2
CN2002900000000,2022-12-01,20,029,KS,Cloud County,3859,3761,98,2.5
CN2003100000000,2022-12-01,20,031,KS,Coffey County,3767,3642,125,3.3
CN2003300000000,2022-12-01,20,033,KS,Comanche County,895,874,21,2.3
CN2003500000000,2022-12-01,20,035,KS,Cowley County,16242,15811,431,2.7
CN2003700000000,2022-12-01,20,037,KS,Crawford County,19137,18630,507,2.6
CN2003900000000,2022-12-01,20,039,KS,Decatur County,1241,1208,33,2.7
CN2004100000000,2022-12-01,20,041,KS,Dickinson County,8697,8466,231,2.7
CN2004300000000,2022-12-01,20,043,KS,Doniphan County,4034,3949,85,2.1
CN2004500000000,2022-12-01,20,045,KS,Douglas County,66361,64775,1586,2.4
CN2004700000000,2022-12-01,20,047,KS,Edwards County,1449,1421,28,1.9
CN2004900000000,2022-12-01,20,049,KS,Elk County,1255,1222,33,2.6
CN2005100000000,2022-12-01,20,051,KS,Ellis County,17124,16797,327,1.9
CN2005300000000,2022-12-01,20,053,KS,Ellsworth County,2662,2605,57,2.1
CN2005500000000,2022-12-01,20,055,KS,Finney County,20722,20329,393,1.9
CN2005700000000,2022-12-01,20,057,KS,Ford County,17962,17600,362,2
CN2005900000000,2022-12-01,20,059,KS,Franklin County,14958,14622,336,2.2
CN2006100000000,2022-12-01,20,061,KS,Geary County,11296,10895,401,3.5
CN2006300000000,2022-12-01,20,063,KS,Gove County,1427,1400,27,1.9
CN2006500000000,2022-12-01,20,065,KS,Graham County,1212,1185,27,2.2
CN2006700000000,2022-12-01,20,067,KS,Grant County,2871,2797,74,2.6
CN2006900000000,2022-12-01,20,069,KS,Gray County,3316,3253,63,1.9
CN2007100000000,2022-12-01,20,071,KS,Greeley County,832,821,11,1.3
CN2007300000000,2022-12-01,20,073,KS,Greenwood County,3162,3091,71,2.2
CN2007500000000,2022-12-01,20,075,KS,Hamilton County,1708,1683,25,1.5
CN2007700000000,2022-12-01,20,077,KS,Harper County,2812,2754,58,2.1
CN2007900000000,2022-12-01,20,079,KS,Harvey County,17158,16762,396,2.3
CN2008100000000,2022-12-01,20,081,KS,Haskell County,2297,2256,41,1.8
CN2008300000000,2022-12-01,20,083,KS,Hodgeman County,1088,1063,25,2.3
CN2008500000000,2022-12-01,20,085,KS,Jackson County,7274,7122,152,2.1
CN2008700000000,2022-12-01,20,087,KS,Jefferson County,10385,10132,253,2.4
CN2008900000000,2022-12-01,20,089,KS,Jewell County,1201,1171,30,2.5
CN2009100000000,2022-12-01,20,091,KS,Johnson County,349353,341830,7523,2.2
CN2009300000000,2022-12-01,20,093,KS,Kearny County,2061,2023,38,1.8
CN2009500000000,2022-12-01,20,095,KS,Kingman County,3342,3268,74,2.2
CN2009700000000,2022-12-01,20,097,KS,Kiowa County,1252,1227,25,2
CN2009900000000,2022-12-01,20,099,KS,Labette County,9412,9158,254,2.7
CN2010100000000,2022-12-01,20,101,KS,Lane County,812,791,21,2.6
CN2010300000000,2022-12-01,20,103,KS,Leavenworth County,37385,36422,963,2.6
CN2010500000000,2022-12-01,20,105,KS,Lincoln County,1749,1713,36,2.1
CN2010700000000,2022-12-01,20,107,KS,Linn County,4397,4247,150,3.4
CN2010900000000,2022-12-01,20,109,KS,Logan County,1674,1646,28,1.7
CN2011100000000,2022-12-01,20,111,KS,Lyon County,17019,16600,419,2.5
CN2011300000000,2022-12-01,20,113,KS,McPherson County,17449,17130,319,1.8
CN2011500000000,2022-12-01,20,115,KS,Marion County,5996,5870,126,2.1
CN2011700000000,2022-12-01,20,117,KS,Marshall County,5282,5182,100,1.9
CN2011900000000,2022-12-01,20,119,KS,Meade County,2179,2135,44,2
CN2012100000000,2022-12-01,20,121,KS,Miami County,18053,17611,442,2.4
CN2012300000000,2022-12-01,20,123,KS,Mitchell County,3370,3307,63,1.9
CN2012500000000,2022-12-01,20,125,KS,Montgomery County,14597,14183,414,2.8
CN2012700000000,2022-12-01,20,127,KS,Morris County,3040,2977,63,2.1
CN2012900000000,2022-12-01,20,129,KS,Morton County,1113,1085,28,2.5
CN2013100000000,2022-12-01,20,131,KS,Nemaha County,5710,5604,106,1.9
CN2013300000000,2022-12-01,20,133,KS,Neosho County,6019,5826,193,3.2
CN2013500000000,2022-12-01,20,135,KS,Ness County,1365,1337,28,2.1
CN2013700000000,2022-12-01,20,137,KS,Norton County,2643,2591,52,2
CN2013900000000,2022-12-01,20,139,KS,Osage County,8049,7842,207,2.6
CN2014100000000,2022-12-01,20,141,KS,Osborne County,1945,1906,39,2
CN2014300000000,2022-12-01,20,143,KS,Ottawa County,3090,3017,73,2.4
CN2014500000000,2022-12-01,20,145,KS,Pawnee County,2789,2724,65,2.3
CN2014700000000,2022-12-01,20,147,KS,Phillips County,2704,2649,55,2
CN2014900000000,2022-12-01,20,149,KS,Pottawatomie County,12649,12373,276,2.2
CN2015100000000,2022-12-01,20,151,KS,Pratt County,4963,4863,100,2
CN2015300000000,2022-12-01,20,153,KS,Rawlins County,1608,1583,25,1.6
CN2015500000000,2022-12-01,20,155,KS,Reno County,29210,28423,787,2.7
CN2015700000000,2022-12-01,20,157,KS,Republic County,2467,2421,46,1.9
CN2015900000000,2022-12-01,20,159,KS,Rice County,5372,5254,118,2.2
CN2016100000000,2022-12-01,20,161,KS,Riley County,34860,33966,894,2.6
CN2016300000000,2022-12-01,20,163,KS,Rooks County,2468,2410,58,2.4
CN2016500000000,2022-12-01,20,165,KS,Rush County,1668,1633,35,2.1
CN2016700000000,2022-12-01,20,167,KS,Russell County,3356,3287,69,2.1
CN2016900000000,2022-12-01,20,169,KS,Saline County,30161,29476,685,2.3
CN2017100000000,2022-12-01,20,171,KS,Scott County,2787,2738,49,1.8
CN2017300000000,2022-12-01,20,173,KS,Sedgwick County,254972,247896,7076,2.8
CN2017500000000,2022-12-01,20,175,KS,Seward County,9856,9618,238,2.4
CN2017700000000,2022-12-01,20,177,KS,Shawnee County,91408,89044,2364,2.6
CN2017900000000,2022-12-01,20,179,KS,Sheridan County,1532,1505,27,1.8
CN2018100000000,2022-12-01,20,181,KS,Sherman County,2832,2772,60,2.1
CN2018300000000,2022-12-01,20,183,KS,Smith County,2056,2017,39,1.9
CN2018500000000,2022-12-01,20,185,KS,Stafford County,2005,1962,43,2.1
CN2018700000000,2022-12-01,20,187,KS,Stanton County,1161,1140,21,1.8
CN2018900000000,2022-12-01,20,189,KS,Stevens County,3146,3086,60,1.9
CN2019100000000,2022-12-01,20,191,KS,Sumner County,10831,10544,287,2.6
CN2019300000000,2022-12-01,20,193,KS,Thomas County,4348,4267,81,1.9
CN2019500000000,2022-12-01,20,195,KS,Trego County,1349,1311,38,2.8
CN2019700000000,2022-12-01,20,197,KS,Wabaunsee County,3775,3693,82,2.2
CN2019900000000,2022-12-01,20,199,KS,Wallace County,886,869,17,1.9
CN2020100000000,2022-12-01,20,201,KS,Washington County,3112,3057,55,1.8
CN2020300000000,2022-12-01,20,203,KS,Wichita County,1209,1187,22,1.8
CN2020500000000,2022-12-01,20,205,KS,Wilson County,3719,3607,112,3
CN2020700000000,2022-12-01,20,207,KS,Woodson County,1596,1545,51,3.2
CN2020900000000,2022-12-01,20,209,KS,Wyandotte County,77910,75552,2358,3
CN2100100000000,2022-12-01,21,001,KY,Adair County,7130,6836,294,4.1
CN2100300000000,2022-12-01,21,003,KY,Allen County,9031,8743,288,3.2
CN2100500000000,2022-12-01,21,005,KY,Anderson County,11907,11606,301,2.5
CN2100700000000,2022-12-01,21,007,KY,Ballard County,3481,3347,134,3.8
CN2100900000000,2022-12-01,21,009,KY,Barren County,17634,17009,625,3.5
CN2101100000000,2022-12-01,21,011,KY,Bath County,4785,4569,216,4.5
CN2101300000000,2022-12-01,21,013,KY,Bell County,8160,7788,372,4.6
CN2101500000000,2022-12-01,21,015,KY,Boone County,71655,69702,1953,2.7
CN2101700000000,2022-12-01,21,017,KY,Bourbon County,9833,9562,271,2.8
CN2101900000000,2022-12-01,21,019,KY,Boyd County,17042,16193,849,5
CN2102100000000,2022-12-01,21,021,KY,Boyle County,12740,12310,430,3.4
CN2102300000000,2022-12-01,21,023,KY,Bracken County,3781,3634,147,3.9
CN2102500000000,2022-12-01,21,025,KY,Breathitt County,3169,2985,184,5.8
CN2102700000000,2022-12-01,21,027,KY,Breckinridge County,7937,7626,311,3.9
CN2102900000000,2022-12-01,21,029,KY,Bullitt County,42178,40959,1219,2.9
CN2103100000000,2022-12-01,21,031,KY,Butler County,4971,4803,168,3.4
CN2103300000000,2022-12-01,21,033,KY,Caldwell County,6301,6110,191,3
CN2103500000000,2022-12-01,21,035,KY,Calloway County,17276,16715,561,3.2
CN2103700000000,2022-12-01,21,037,KY,Campbell County,50257,48838,1419,2.8
CN2103900000000,2022-12-01,21,039,KY,Carlisle County,2242,2180,62,2.8
CN2104100000000,2022-12-01,21,041,KY,Carroll County,5902,5753,149,2.5
CN2104300000000,2022-12-01,21,043,KY,Carter County,9620,8939,681,7.1
CN2104500000000,2022-12-01,21,045,KY,Casey County,6638,6419,219,3.3
CN2104700000000,2022-12-01,21,047,KY,Christian County,24981,23903,1078,4.3
CN2104900000000,2022-12-01,21,049,KY,Clark County,17301,16765,536,3.1
CN2105100000000,2022-12-01,21,051,KY,Clay County,5006,4760,246,4.9
CN2105300000000,2022-12-01,21,053,KY,Clinton County,3565,3409,156,4.4
CN2105500000000,2022-12-01,21,055,KY,Crittenden County,3873,3735,138,3.6
CN2105700000000,2022-12-01,21,057,KY,Cumberland County,3395,3292,103,3
CN2105900000000,2022-12-01,21,059,KY,Daviess County,45280,43627,1653,3.7
CN2106100000000,2022-12-01,21,061,KY,Edmonson County,4726,4530,196,4.1
CN2106300000000,2022-12-01,21,063,KY,Elliott County,1912,1760,152,7.9
CN2106500000000,2022-12-01,21,065,KY,Estill County,5109,4902,207,4.1
CN2106700000000,2022-12-01,21,067,KY,Fayette County,175818,171394,4424,2.5
CN2106900000000,2022-12-01,21,069,KY,Fleming County,6220,5974,246,4
CN2107100000000,2022-12-01,21,071,KY,Floyd County,11049,10483,566,5.1
CN2107300000000,2022-12-01,21,073,KY,Franklin County,24960,24275,685,2.7
CN2107500000000,2022-12-01,21,075,KY,Fulton County,2102,2029,73,3.5
CN2107700000000,2022-12-01,21,077,KY,Gallatin County,4002,3878,124,3.1
CN2107900000000,2022-12-01,21,079,KY,Garrard County,7956,7701,255,3.2
CN2108100000000,2022-12-01,21,081,KY,Grant County,11623,11248,375,3.2
CN2108300000000,2022-12-01,21,083,KY,Graves County,15602,15052,550,3.5
CN2108500000000,2022-12-01,21,085,KY,Grayson County,10449,10047,402,3.8
CN2108700000000,2022-12-01,21,087,KY,Green County,5101,4936,165,3.2
CN2108900000000,2022-12-01,21,089,KY,Greenup County,12893,12127,766,5.9
CN2109100000000,2022-12-01,21,091,KY,Hancock County,3772,3627,145,3.8
CN2109300000000,2022-12-01,21,093,KY,Hardin County,46337,44752,1585,3.4
CN2109500000000,2022-12-01,21,095,KY,Harlan County,6370,6036,334,5.2
CN2109700000000,2022-12-01,21,097,KY,Harrison County,8821,8580,241,2.7
CN2109900000000,2022-12-01,21,099,KY,Hart County,7633,7361,272,3.6
CN2110100000000,2022-12-01,21,101,KY,Henderson County,20556,19896,660,3.2
CN2110300000000,2022-12-01,21,103,KY,Henry County,8066,7855,211,2.6
CN2110500000000,2022-12-01,21,105,KY,Hickman County,1668,1611,57,3.4
CN2110700000000,2022-12-01,21,107,KY,Hopkins County,18012,17356,656,3.6
CN2110900000000,2022-12-01,21,109,KY,Jackson County,4096,3908,188,4.6
CN2111100000000,2022-12-01,21,111,KY,Jefferson County,387610,376307,11303,2.9
CN2111300000000,2022-12-01,21,113,KY,Jessamine County,26579,25861,718,2.7
CN2111500000000,2022-12-01,21,115,KY,Johnson County,6645,6284,361,5.4
CN2111700000000,2022-12-01,21,117,KY,Kenton County,87086,84586,2500,2.9
CN2111900000000,2022-12-01,21,119,KY,Knott County,4300,4075,225,5.2
CN2112100000000,2022-12-01,21,121,KY,Knox County,9899,9432,467,4.7
CN2112300000000,2022-12-01,21,123,KY,Larue County,5691,5479,212,3.7
CN2112500000000,2022-12-01,21,125,KY,Laurel County,25027,24121,906,3.6
CN2112700000000,2022-12-01,21,127,KY,Lawrence County,5530,5254,276,5
CN2112900000000,2022-12-01,21,129,KY,Lee County,2050,1953,97,4.7
CN2113100000000,2022-12-01,21,131,KY,Leslie County,2536,2386,150,5.9
CN2113300000000,2022-12-01,21,133,KY,Letcher County,5817,5474,343,5.9
CN2113500000000,2022-12-01,21,135,KY,Lewis County,4613,4273,340,7.4
CN2113700000000,2022-12-01,21,137,KY,Lincoln County,9396,8973,423,4.5
CN2113900000000,2022-12-01,21,139,KY,Livingston County,3650,3496,154,4.2
CN2114100000000,2022-12-01,21,141,KY,Logan County,12497,12120,377,3
CN2114300000000,2022-12-01,21,143,KY,Lyon County,3133,3014,119,3.8
CN2114500000000,2022-12-01,21,145,KY,McCracken County,29839,28811,1028,3.4
CN2114700000000,2022-12-01,21,147,KY,McCreary County,4739,4527,212,4.5
CN2114900000000,2022-12-01,21,149,KY,McLean County,3965,3804,161,4.1
CN2115100000000,2022-12-01,21,151,KY,Madison County,46826,45472,1354,2.9
CN2115300000000,2022-12-01,21,153,KY,Magoffin County,3111,2835,276,8.9
CN2115500000000,2022-12-01,21,155,KY,Marion County,9470,9221,249,2.6
CN2115700000000,2022-12-01,21,157,KY,Marshall County,14270,13727,543,3.8
CN2115900000000,2022-12-01,21,159,KY,Martin County,2117,1983,134,6.3
CN2116100000000,2022-12-01,21,161,KY,Mason County,6631,6335,296,4.5
CN2116300000000,2022-12-01,21,163,KY,Meade County,11479,11049,430,3.7
CN2116500000000,2022-12-01,21,165,KY,Menifee County,2388,2269,119,5
CN2116700000000,2022-12-01,21,167,KY,Mercer County,10063,9737,326,3.2
CN2116900000000,2022-12-01,21,169,KY,Metcalfe County,3908,3747,161,4.1
CN2117100000000,2022-12-01,21,171,KY,Monroe County,4657,4519,138,3
CN2117300000000,2022-12-01,21,173,KY,Montgomery County,11982,11511,471,3.9
CN2117500000000,2022-12-01,21,175,KY,Morgan County,4151,3951,200,4.8
CN2117700000000,2022-12-01,21,177,KY,Muhlenberg County,9771,9261,510,5.2
CN2117900000000,2022-12-01,21,179,KY,Nelson County,23635,22952,683,2.9
CN2118100000000,2022-12-01,21,181,KY,Nicholas County,3268,3157,111,3.4
CN2118300000000,2022-12-01,21,183,KY,Ohio County,9091,8686,405,4.5
CN2118500000000,2022-12-01,21,185,KY,Oldham County,32809,32009,800,2.4
CN2118700000000,2022-12-01,21,187,KY,Owen County,5161,5004,157,3
CN2118900000000,2022-12-01,21,189,KY,Owsley County,1071,1006,65,6.1
CN2119100000000,2022-12-01,21,191,KY,Pendleton County,6890,6676,214,3.1
CN2119300000000,2022-12-01,21,193,KY,Perry County,8033,7686,347,4.3
CN2119500000000,2022-12-01,21,195,KY,Pike County,18958,18125,833,4.4
CN2119700000000,2022-12-01,21,197,KY,Powell County,5285,5092,193,3.7
CN2119900000000,2022-12-01,21,199,KY,Pulaski County,25100,24086,1014,4
CN2120100000000,2022-12-01,21,201,KY,Robertson County,820,790,30,3.7
CN2120300000000,2022-12-01,21,203,KY,Rockcastle County,6485,6237,248,3.8
CN2120500000000,2022-12-01,21,205,KY,Rowan County,10236,9847,389,3.8
CN2120700000000,2022-12-01,21,207,KY,Russell County,6225,5928,297,4.8
CN2120900000000,2022-12-01,21,209,KY,Scott County,30427,29657,770,2.5
CN2121100000000,2022-12-01,21,211,KY,Shelby County,25615,24953,662,2.6
CN2121300000000,2022-12-01,21,213,KY,Simpson County,8650,8381,269,3.1
CN2121500000000,2022-12-01,21,215,KY,Spencer County,10387,10107,280,2.7
CN2121700000000,2022-12-01,21,217,KY,Taylor County,12472,12093,379,3
CN2121900000000,2022-12-01,21,219,KY,Todd County,5837,5665,172,2.9
CN2122100000000,2022-12-01,21,221,KY,Trigg County,6170,5899,271,4.4
CN2122300000000,2022-12-01,21,223,KY,Trimble County,3785,3663,122,3.2
CN2122500000000,2022-12-01,21,225,KY,Union County,5887,5678,209,3.6
CN2122700000000,2022-12-01,21,227,KY,Warren County,65399,63440,1959,3
CN2122900000000,2022-12-01,21,229,KY,Washington County,6172,6002,170,2.8
CN2123100000000,2022-12-01,21,231,KY,Wayne County,7044,6731,313,4.4
CN2123300000000,2022-12-01,21,233,KY,Webster County,5222,5040,182,3.5
CN2123500000000,2022-12-01,21,235,KY,Whitley County,13844,13340,504,3.6
CN2123700000000,2022-12-01,21,237,KY,Wolfe County,2184,2058,126,5.8
CN2123900000000,2022-12-01,21,239,KY,Woodford County,15317,14949,368,2.4
CN2200100000000,2022-12-01,22,001,LA,Acadia Parish,23779,22979,800,3.4
CN2200300000000,2022-12-01,22,003,LA,Allen Parish,8070,7758,312,3.9
CN2200500000000,2022-12-01,22,005,LA,Ascension Parish,67715,65962,1753,2.6
CN2200700000000,2022-12-01,22,007,LA,Assumption Parish,8820,8474,346,3.9
CN2200900000000,2022-12-01,22,009,LA,Avoyelles Parish,14186,13648,538,3.8
CN2201100000000,2022-12-01,22,011,LA,Beauregard Parish,14606,14119,487,3.3
CN2201300000000,2022-12-01,22,013,LA,Bienville Parish,5205,5003,202,3.9
CN2201500000000,2022-12-01,22,015,LA,Bossier Parish,58080,56456,1624,2.8
CN2201700000000,2022-12-01,22,017,LA,Caddo Parish,101444,97876,3568,3.5
CN2201900000000,2022-12-01,22,019,LA,Calcasieu Parish,92315,89481,2834,3.1
CN2202100000000,2022-12-01,22,021,LA,Caldwell Parish,3668,3542,126,3.4
CN2202300000000,2022-12-01,22,023,LA,Cameron Parish,3441,3345,96,2.8
CN2202500000000,2022-12-01,22,025,LA,Catahoula Parish,3374,3236,138,4.1
CN2202700000000,2022-12-01,22,027,LA,Claiborne Parish,5416,5240,176,3.2
CN2202900000000,2022-12-01,22,029,LA,Concordia Parish,6841,6553,288,4.2
CN2203100000000,2022-12-01,22,031,LA,De Soto Parish,10904,10525,379,3.5
CN2203300000000,2022-12-01,22,033,LA,East Baton Rouge Parish,235844,229007,6837,2.9
CN2203500000000,2022-12-01,22,035,LA,East Carroll Parish,1615,1501,114,7.1
CN2203700000000,2022-12-01,22,037,LA,East Feliciana Parish,7977,7743,234,2.9
CN2203900000000,2022-12-01,22,039,LA,Evangeline Parish,11879,11465,414,3.5
CN2204100000000,2022-12-01,22,041,LA,Franklin Parish,7375,7032,343,4.7
CN2204300000000,2022-12-01,22,043,LA,Grant Parish,8375,8101,274,3.3
CN2204500000000,2022-12-01,22,045,LA,Iberia Parish,27373,26375,998,3.6
CN2204700000000,2022-12-01,22,047,LA,Iberville Parish,14030,13504,526,3.7
CN2204900000000,2022-12-01,22,049,LA,Jackson Parish,6923,6726,197,2.8
CN2205100000000,2022-12-01,22,051,LA,Jefferson Parish,210981,204617,6364,3
CN2205300000000,2022-12-01,22,053,LA,Jefferson Davis Parish,12301,11903,398,3.2
CN2205500000000,2022-12-01,22,055,LA,Lafayette Parish,115961,112699,3262,2.8
CN2205700000000,2022-12-01,22,057,LA,Lafourche Parish,40023,38840,1183,3
CN2205900000000,2022-12-01,22,059,LA,LaSalle Parish,6737,6570,167,2.5
CN2206100000000,2022-12-01,22,061,LA,Lincoln Parish,21598,20922,676,3.1
CN2206300000000,2022-12-01,22,063,LA,Livingston Parish,72593,70694,1899,2.6
CN2206500000000,2022-12-01,22,065,LA,Madison Parish,3461,3309,152,4.4
CN2206700000000,2022-12-01,22,067,LA,Morehouse Parish,9833,9364,469,4.8
CN2206900000000,2022-12-01,22,069,LA,Natchitoches Parish,16688,16095,593,3.6
CN2207100000000,2022-12-01,22,071,LA,Orleans Parish,176376,169920,6456,3.7
CN2207300000000,2022-12-01,22,073,LA,Ouachita Parish,70321,68063,2258,3.2
CN2207500000000,2022-12-01,22,075,LA,Plaquemines Parish,9829,9538,291,3
CN2207700000000,2022-12-01,22,077,LA,Pointe Coupee Parish,9854,9534,320,3.2
CN2207900000000,2022-12-01,22,079,LA,Rapides Parish,56520,54847,1673,3
CN2208100000000,2022-12-01,22,081,LA,Red River Parish,4005,3890,115,2.9
CN2208300000000,2022-12-01,22,083,LA,Richland Parish,8280,7987,293,3.5
CN2208500000000,2022-12-01,22,085,LA,Sabine Parish,9167,8870,297,3.2
CN2208700000000,2022-12-01,22,087,LA,St. Bernard Parish,19986,19305,681,3.4
CN2208900000000,2022-12-01,22,089,LA,St. Charles Parish,24887,24179,708,2.8
CN2209100000000,2022-12-01,22,091,LA,St. Helena Parish,4301,4106,195,4.5
CN2209300000000,2022-12-01,22,093,LA,St. James Parish,8930,8586,344,3.9
CN2209500000000,2022-12-01,22,095,LA,St. John the Baptist Parish,19083,18327,756,4
CN2209700000000,2022-12-01,22,097,LA,St. Landry Parish,31445,30196,1249,4
CN2209900000000,2022-12-01,22,099,LA,St. Martin Parish,21985,21286,699,3.2
CN2210100000000,2022-12-01,22,101,LA,St. Mary Parish,19040,18358,682,3.6
CN2210300000000,2022-12-01,22,103,LA,St. Tammany Parish,120219,116984,3235,2.7
CN2210500000000,2022-12-01,22,105,LA,Tangipahoa Parish,56601,54424,2177,3.8
CN2210700000000,2022-12-01,22,107,LA,Tensas Parish,1276,1217,59,4.6
CN2210900000000,2022-12-01,22,109,LA,Terrebonne Parish,43940,42529,1411,3.2
CN2211100000000,2022-12-01,22,111,LA,Union Parish,9174,8844,330,3.6
CN2211300000000,2022-12-01,22,113,LA,Vermilion Parish,23904,23142,762,3.2
CN2211500000000,2022-12-01,22,115,LA,Vernon Parish,16115,15346,769,4.8
CN2211700000000,2022-12-01,22,117,LA,Washington Parish,17321,16694,627,3.6
CN2211900000000,2022-12-01,22,119,LA,Webster Parish,14172,13623,549,3.9
CN2212100000000,2022-12-01,22,121,LA,West Baton Rouge Parish,14173,13770,403,2.8
CN2212300000000,2022-12-01,22,123,LA,West Carroll Parish,3438,3252,186,5.4
CN2212500000000,2022-12-01,22,125,LA,West Feliciana Parish,5500,5372,128,2.3
CN2212700000000,2022-12-01,22,127,LA,Winn Parish,4691,4514,177,3.8
CN2300100000000,2022-12-01,23,001,ME,Androscoggin County,52893,51430,1463,2.8
CN2300300000000,2022-12-01,23,003,ME,Aroostook County,27324,26269,1055,3.9
CN2300500000000,2022-12-01,23,005,ME,Cumberland County,160704,157226,3478,2.2
CN2300700000000,2022-12-01,23,007,ME,Franklin County,13727,13260,467,3.4
CN2300900000000,2022-12-01,23,009,ME,Hancock County,26583,25609,974,3.7
CN2301100000000,2022-12-01,23,011,ME,Kennebec County,60263,58755,1508,2.5
CN2301300000000,2022-12-01,23,013,ME,Knox County,19050,18522,528,2.8
CN2301500000000,2022-12-01,23,015,ME,Lincoln County,15703,15246,457,2.9
CN2301700000000,2022-12-01,23,017,ME,Oxford County,25456,24693,763,3
CN2301900000000,2022-12-01,23,019,ME,Penobscot County,74623,72565,2058,2.8
CN2302100000000,2022-12-01,23,021,ME,Piscataquis County,6971,6738,233,3.3
CN2302300000000,2022-12-01,23,023,ME,Sagadahoc County,18602,18192,410,2.2
CN2302500000000,2022-12-01,23,025,ME,Somerset County,21102,20296,806,3.8
CN2302700000000,2022-12-01,23,027,ME,Waldo County,19613,19038,575,2.9
CN2302900000000,2022-12-01,23,029,ME,Washington County,12913,12444,469,3.6
CN2303100000000,2022-12-01,23,031,ME,York County,110650,107892,2758,2.5
CN2400100000000,2022-12-01,24,001,MD,Allegany County,31105,30091,1014,3.3
CN2400300000000,2022-12-01,24,003,MD,Anne Arundel County,312241,305525,6716,2.2
CN2400500000000,2022-12-01,24,005,MD,Baltimore County,442012,430560,11452,2.6
CN2400900000000,2022-12-01,24,009,MD,Calvert County,49350,48263,1087,2.2
CN2401100000000,2022-12-01,24,011,MD,Caroline County,17167,16751,416,2.4
CN2401300000000,2022-12-01,24,013,MD,Carroll County,94669,92774,1895,2
CN2401500000000,2022-12-01,24,015,MD,Cecil County,54065,52683,1382,2.6
CN2401700000000,2022-12-01,24,017,MD,Charles County,86735,84513,2222,2.6
CN2401900000000,2022-12-01,24,019,MD,Dorchester County,15992,15534,458,2.9
CN2402100000000,2022-12-01,24,021,MD,Frederick County,136418,133319,3099,2.3
CN2402300000000,2022-12-01,24,023,MD,Garrett County,15200,14780,420,2.8
CN2402500000000,2022-12-01,24,025,MD,Harford County,139645,136502,3143,2.3
CN2402700000000,2022-12-01,24,027,MD,Howard County,186691,182927,3764,2
CN2402900000000,2022-12-01,24,029,MD,Kent County,9897,9604,293,3
CN2403100000000,2022-12-01,24,031,MD,Montgomery County,543466,531664,11802,2.2
CN2403300000000,2022-12-01,24,033,MD,Prince George's County,496567,483215,13352,2.7
CN2403500000000,2022-12-01,24,035,MD,Queen Anne's County,28179,27579,600,2.1
CN2403700000000,2022-12-01,24,037,MD,St. Mary's County,57373,56020,1353,2.4
CN2403900000000,2022-12-01,24,039,MD,Somerset County,9040,8681,359,4
CN2404100000000,2022-12-01,24,041,MD,Talbot County,17443,16970,473,2.7
CN2404300000000,2022-12-01,24,043,MD,Washington County,72438,70556,1882,2.6
CN2404500000000,2022-12-01,24,045,MD,Wicomico County,50134,48408,1726,3.4
CN2404700000000,2022-12-01,24,047,MD,Worcester County,24955,23601,1354,5.4
CN2451000000000,2022-12-01,24,510,MD,Baltimore city,272426,263157,9269,3.4
CN2500100000000,2022-12-01,25,001,MA,Barnstable County,106623,101264,5359,5
CN2500300000000,2022-12-01,25,003,MA,Berkshire County,60805,58226,2579,4.2
CN2500500000000,2022-12-01,25,005,MA,Bristol County,296006,283719,12287,4.2
CN2500700000000,2022-12-01,25,007,MA,Dukes County,8505,7982,523,6.1
CN2500900000000,2022-12-01,25,009,MA,Essex County,419114,404754,14360,3.4
CN2501100000000,2022-12-01,25,011,MA,Franklin County,39667,38485,1182,3
CN2501300000000,2022-12-01,25,013,MA,Hampden County,222290,212766,9524,4.3
CN2501500000000,2022-12-01,25,015,MA,Hampshire County,88980,86327,2653,3
CN2501700000000,2022-12-01,25,017,MA,Middlesex County,904584,880378,24206,2.7
CN2501900000000,2022-12-01,25,019,MA,Nantucket County/town,6894,6332,562,8.2
CN2502100000000,2022-12-01,25,021,MA,Norfolk County,390018,378798,11220,2.9
CN2502300000000,2022-12-01,25,023,MA,Plymouth County,281390,271688,9702,3.4
CN2502500000000,2022-12-01,25,025,MA,Suffolk County,449761,436021,13740,3.1
CN2502700000000,2022-12-01,25,027,MA,Worcester County,440867,425675,15192,3.4
CN2600100000000,2022-12-01,26,001,MI,Alcona County,3714,3436,278,7.5
CN2600300000000,2022-12-01,26,003,MI,Alger County,3122,2820,302,9.7
CN2600500000000,2022-12-01,26,005,MI,Allegan County,61038,58886,2152,3.5
CN2600700000000,2022-12-01,26,007,MI,Alpena County,13034,12378,656,5
CN2600900000000,2022-12-01,26,009,MI,Antrim County,9682,9077,605,6.2
CN2601100000000,2022-12-01,26,011,MI,Arenac County,5683,5223,460,8.1
CN2601300000000,2022-12-01,26,013,MI,Baraga County,3018,2789,229,7.6
CN2601500000000,2022-12-01,26,015,MI,Barry County,31764,30595,1169,3.7
CN2601700000000,2022-12-01,26,017,MI,Bay County,48806,46397,2409,4.9
CN2601900000000,2022-12-01,26,019,MI,Benzie County,8562,8072,490,5.7
CN2602100000000,2022-12-01,26,021,MI,Berrien County,71565,68425,3140,4.4
CN2602300000000,2022-12-01,26,023,MI,Branch County,19491,18721,770,4
CN2602500000000,2022-12-01,26,025,MI,Calhoun County,59458,56915,2543,4.3
CN2602700000000,2022-12-01,26,027,MI,Cass County,23378,22341,1037,4.4
CN2602900000000,2022-12-01,26,029,MI,Charlevoix County,12315,11648,667,5.4
CN2603100000000,2022-12-01,26,031,MI,Cheboygan County,9652,8579,1073,11.1
CN2603300000000,2022-12-01,26,033,MI,Chippewa County,15794,14704,1090,6.9
CN2603500000000,2022-12-01,26,035,MI,Clare County,10907,10149,758,6.9
CN2603700000000,2022-12-01,26,037,MI,Clinton County,40230,38893,1337,3.3
CN2603900000000,2022-12-01,26,039,MI,Crawford County,5305,4925,380,7.2
CN2604100000000,2022-12-01,26,041,MI,Delta County,16313,15379,934,5.7
CN2604300000000,2022-12-01,26,043,MI,Dickinson County,11922,11446,476,4
CN2604500000000,2022-12-01,26,045,MI,Eaton County,56116,54109,2007,3.6
CN2604700000000,2022-12-01,26,047,MI,Emmet County,16123,15042,1081,6.7
CN2604900000000,2022-12-01,26,049,MI,Genesee County,177892,169109,8783,4.9
CN2605100000000,2022-12-01,26,051,MI,Gladwin County,9673,9067,606,6.3
CN2605300000000,2022-12-01,26,053,MI,Gogebic County,5712,5415,297,5.2
CN2605500000000,2022-12-01,26,055,MI,Grand Traverse County,48203,46443,1760,3.7
CN2605700000000,2022-12-01,26,057,MI,Gratiot County,17131,16407,724,4.2
CN2605900000000,2022-12-01,26,059,MI,Hillsdale County,19867,19013,854,4.3
CN2606100000000,2022-12-01,26,061,MI,Houghton County,16381,15650,731,4.5
CN2606300000000,2022-12-01,26,063,MI,Huron County,14633,13959,674,4.6
CN2606500000000,2022-12-01,26,065,MI,Ingham County,146657,141461,5196,3.5
CN2606700000000,2022-12-01,26,067,MI,Ionia County,29951,28930,1021,3.4
CN2606900000000,2022-12-01,26,069,MI,Iosco County,10023,9346,677,6.8
CN2607100000000,2022-12-01,26,071,MI,Iron County,4580,4280,300,6.6
CN2607300000000,2022-12-01,26,073,MI,Isabella County,30940,29596,1344,4.3
CN2607500000000,2022-12-01,26,075,MI,Jackson County,73452,70520,2932,4
CN2607700000000,2022-12-01,26,077,MI,Kalamazoo County,130889,126317,4572,3.5
CN2607900000000,2022-12-01,26,079,MI,Kalkaska County,7720,7232,488,6.3
CN2608100000000,2022-12-01,26,081,MI,Kent County,360053,349102,10951,3
CN2608300000000,2022-12-01,26,083,MI,Keweenaw County,924,853,71,7.7
CN2608500000000,2022-12-01,26,085,MI,Lake County,3867,3566,301,7.8
CN2608700000000,2022-12-01,26,087,MI,Lapeer County,40110,38452,1658,4.1
CN2608900000000,2022-12-01,26,089,MI,Leelanau County,9990,9570,420,4.2
CN2609100000000,2022-12-01,26,091,MI,Lenawee County,44447,42628,1819,4.1
CN2609300000000,2022-12-01,26,093,MI,Livingston County,102500,99901,2599,2.5
CN2609500000000,2022-12-01,26,095,MI,Luce County,2054,1897,157,7.6
CN2609700000000,2022-12-01,26,097,MI,Mackinac County,4223,3525,698,16.5
CN2609900000000,2022-12-01,26,099,MI,Macomb County,439744,425602,14142,3.2
CN2610100000000,2022-12-01,26,101,MI,Manistee County,9397,8766,631,6.7
CN2610300000000,2022-12-01,26,103,MI,Marquette County,31963,30428,1535,4.8
CN2610500000000,2022-12-01,26,105,MI,Mason County,12670,11946,724,5.7
CN2610700000000,2022-12-01,26,107,MI,Mecosta County,18385,17411,974,5.3
CN2610900000000,2022-12-01,26,109,MI,Menominee County,10504,10051,453,4.3
CN2611100000000,2022-12-01,26,111,MI,Midland County,39477,37896,1581,4
CN2611300000000,2022-12-01,26,113,MI,Missaukee County,6622,6292,330,5
CN2611500000000,2022-12-01,26,115,MI,Monroe County,73887,70852,3035,4.1
CN2611700000000,2022-12-01,26,117,MI,Montcalm County,27775,26591,1184,4.3
CN2611900000000,2022-12-01,26,119,MI,Montmorency County,2995,2725,270,9
CN2612100000000,2022-12-01,26,121,MI,Muskegon County,75788,72341,3447,4.5
CN2612300000000,2022-12-01,26,123,MI,Newaygo County,22919,21906,1013,4.4
CN2612500000000,2022-12-01,26,125,MI,Oakland County,663202,645963,17239,2.6
CN2612700000000,2022-12-01,26,127,MI,Oceana County,10808,10074,734,6.8
CN2612900000000,2022-12-01,26,129,MI,Ogemaw County,8030,7389,641,8
CN2613100000000,2022-12-01,26,131,MI,Ontonagon County,1979,1828,151,7.6
CN2613300000000,2022-12-01,26,133,MI,Osceola County,11336,10826,510,4.5
CN2613500000000,2022-12-01,26,135,MI,Oscoda County,2599,2370,229,8.8
CN2613700000000,2022-12-01,26,137,MI,Otsego County,11281,10686,595,5.3
CN2613900000000,2022-12-01,26,139,MI,Ottawa County,161694,156988,4706,2.9
CN2614100000000,2022-12-01,26,141,MI,Presque Isle County,4821,4401,420,8.7
CN2614300000000,2022-12-01,26,143,MI,Roscommon County,7629,6933,696,9.1
CN2614500000000,2022-12-01,26,145,MI,Saginaw County,82522,78261,4261,5.2
CN2614700000000,2022-12-01,26,147,MI,St. Clair County,74135,71476,2659,3.6
CN2614900000000,2022-12-01,26,149,MI,St. Joseph County,27953,26803,1150,4.1
CN2615100000000,2022-12-01,26,151,MI,Sanilac County,18482,17579,903,4.9
CN2615300000000,2022-12-01,26,153,MI,Schoolcraft County,3073,2807,266,8.7
CN2615500000000,2022-12-01,26,155,MI,Shiawassee County,32100,30714,1386,4.3
CN2615700000000,2022-12-01,26,157,MI,Tuscola County,22722,21541,1181,5.2
CN2615900000000,2022-12-01,26,159,MI,Van Buren County,34006,32213,1793,5.3
CN2616100000000,2022-12-01,26,161,MI,Washtenaw County,195674,189789,5885,3
CN2616300000000,2022-12-01,26,163,MI,Wayne County,791297,761210,30087,3.8
CN2616500000000,2022-12-01,26,165,MI,Wexford County,14544,13862,682,4.7
CN2700100000000,2022-12-01,27,001,MN,Aitkin County,7533,7027,506,6.7
CN2700300000000,2022-12-01,27,003,MN,Anoka County,198513,192631,5882,3
CN2700500000000,2022-12-01,27,005,MN,Becker County,19699,18897,802,4.1
CN2700700000000,2022-12-01,27,007,MN,Beltrami County,25178,24156,1022,4.1
CN2700900000000,2022-12-01,27,009,MN,Benton County,21922,20898,1024,4.7
CN2701100000000,2022-12-01,27,011,MN,Big Stone County,2386,2274,112,4.7
CN2701300000000,2022-12-01,27,013,MN,Blue Earth County,41104,40003,1101,2.7
CN2701500000000,2022-12-01,27,015,MN,Brown County,13615,13178,437,3.2
CN2701700000000,2022-12-01,27,017,MN,Carlton County,17706,16862,844,4.8
CN2701900000000,2022-12-01,27,019,MN,Carver County,59356,57876,1480,2.5
CN2702100000000,2022-12-01,27,021,MN,Cass County,14342,13432,910,6.3
CN2702300000000,2022-12-01,27,023,MN,Chippewa County,6539,6333,206,3.2
CN2702500000000,2022-12-01,27,025,MN,Chisago County,30188,28937,1251,4.1
CN2702700000000,2022-12-01,27,027,MN,Clay County,37810,36902,908,2.4
CN2702900000000,2022-12-01,27,029,MN,Clearwater County,4609,4228,381,8.3
CN2703100000000,2022-12-01,27,031,MN,Cook County,2704,2559,145,5.4
CN2703300000000,2022-12-01,27,033,MN,Cottonwood County,6900,6705,195,2.8
CN2703500000000,2022-12-01,27,035,MN,Crow Wing County,33064,31492,1572,4.8
CN2703700000000,2022-12-01,27,037,MN,Dakota County,241966,235446,6520,2.7
CN2703900000000,2022-12-01,27,039,MN,Dodge County,12005,11624,381,3.2
CN2704100000000,2022-12-01,27,041,MN,Douglas County,21393,20705,688,3.2
CN2704300000000,2022-12-01,27,043,MN,Faribault County,7187,6876,311,4.3
CN2704500000000,2022-12-01,27,045,MN,Fillmore County,11604,11213,391,3.4
CN2704700000000,2022-12-01,27,047,MN,Freeborn County,15953,15452,501,3.1
CN2704900000000,2022-12-01,27,049,MN,Goodhue County,26758,25931,827,3.1
CN2705100000000,2022-12-01,27,051,MN,Grant County,3341,3209,132,4
CN2705300000000,2022-12-01,27,053,MN,Hennepin County,701740,683796,17944,2.6
CN2705500000000,2022-12-01,27,055,MN,Houston County,10720,10396,324,3
CN2705700000000,2022-12-01,27,057,MN,Hubbard County,10041,9436,605,6
CN2705900000000,2022-12-01,27,059,MN,Isanti County,22003,20935,1068,4.9
CN2706100000000,2022-12-01,27,061,MN,Itasca County,21590,20298,1292,6
CN2706300000000,2022-12-01,27,063,MN,Jackson County,5455,5307,148,2.7
CN2706500000000,2022-12-01,27,065,MN,Kanabec County,9460,8746,714,7.5
CN2706700000000,2022-12-01,27,067,MN,Kandiyohi County,23462,22587,875,3.7
CN2706900000000,2022-12-01,27,069,MN,Kittson County,2268,2188,80,3.5
CN2707100000000,2022-12-01,27,071,MN,Koochiching County,5719,5465,254,4.4
CN2707300000000,2022-12-01,27,073,MN,Lac qui Parle County,3498,3372,126,3.6
CN2707500000000,2022-12-01,27,075,MN,Lake County,5079,4773,306,6
CN2707700000000,2022-12-01,27,077,MN,Lake of the Woods County,2457,2359,98,4
CN2707900000000,2022-12-01,27,079,MN,Le Sueur County,16280,15341,939,5.8
CN2708100000000,2022-12-01,27,081,MN,Lincoln County,3096,2977,119,3.8
CN2708300000000,2022-12-01,27,083,MN,Lyon County,14529,14102,427,2.9
CN2708500000000,2022-12-01,27,085,MN,McLeod County,19396,18642,754,3.9
CN2708700000000,2022-12-01,27,087,MN,Mahnomen County,2321,2173,148,6.4
CN2708900000000,2022-12-01,27,089,MN,Marshall County,5481,5159,322,5.9
CN2709100000000,2022-12-01,27,091,MN,Martin County,9656,9364,292,3
CN2709300000000,2022-12-01,27,093,MN,Meeker County,13856,13251,605,4.4
CN2709500000000,2022-12-01,27,095,MN,Mille Lacs County,12977,12080,897,6.9
CN2709700000000,2022-12-01,27,097,MN,Morrison County,17610,16399,1211,6.9
CN2709900000000,2022-12-01,27,099,MN,Mower County,20866,20242,624,3
CN2710100000000,2022-12-01,27,101,MN,Murray County,4821,4578,243,5
CN2710300000000,2022-12-01,27,103,MN,Nicollet County,21090,20578,512,2.4
CN2710500000000,2022-12-01,27,105,MN,Nobles County,11093,10789,304,2.7
CN2710700000000,2022-12-01,27,107,MN,Norman County,3299,3155,144,4.4
CN2710900000000,2022-12-01,27,109,MN,Olmsted County,91033,88837,2196,2.4
CN2711100000000,2022-12-01,27,111,MN,Otter Tail County,31276,29944,1332,4.3
CN2711300000000,2022-12-01,27,113,MN,Pennington County,8922,8488,434,4.9
CN2711500000000,2022-12-01,27,115,MN,Pine County,14567,13574,993,6.8
CN2711700000000,2022-12-01,27,117,MN,Pipestone County,4736,4595,141,3
CN2711900000000,2022-12-01,27,119,MN,Polk County,16352,15824,528,3.2
CN2712100000000,2022-12-01,27,121,MN,Pope County,6547,6306,241,3.7
CN2712300000000,2022-12-01,27,123,MN,Ramsey County,284389,276527,7862,2.8
CN2712500000000,2022-12-01,27,125,MN,Red Lake County,2184,2095,89,4.1
CN2712700000000,2022-12-01,27,127,MN,Redwood County,7784,7541,243,3.1
CN2712900000000,2022-12-01,27,129,MN,Renville County,8212,7870,342,4.2
CN2713100000000,2022-12-01,27,131,MN,Rice County,37550,36319,1231,3.3
CN2713300000000,2022-12-01,27,133,MN,Rock County,6100,5978,122,2
CN2713500000000,2022-12-01,27,135,MN,Roseau County,7975,7725,250,3.1
CN2713700000000,2022-12-01,27,137,MN,St. Louis County,100251,96442,3809,3.8
CN2713900000000,2022-12-01,27,139,MN,Scott County,84300,82094,2206,2.6
CN2714100000000,2022-12-01,27,141,MN,Sherburne County,53463,51440,2023,3.8
CN2714300000000,2022-12-01,27,143,MN,Sibley County,8267,7901,366,4.4
CN2714500000000,2022-12-01,27,145,MN,Stearns County,90227,87218,3009,3.3
CN2714700000000,2022-12-01,27,147,MN,Steele County,19551,18900,651,3.3
CN2714900000000,2022-12-01,27,149,MN,Stevens County,5436,5266,170,3.1
CN2715100000000,2022-12-01,27,151,MN,Swift County,4874,4689,185,3.8
CN2715300000000,2022-12-01,27,153,MN,Todd County,13824,13195,629,4.6
CN2715500000000,2022-12-01,27,155,MN,Traverse County,1686,1630,56,3.3
CN2715700000000,2022-12-01,27,157,MN,Wabasha County,12320,11921,399,3.2
CN2715900000000,2022-12-01,27,159,MN,Wadena County,6245,5878,367,5.9
CN2716100000000,2022-12-01,27,161,MN,Waseca County,8558,8174,384,4.5
CN2716300000000,2022-12-01,27,163,MN,Washington County,144658,140988,3670,2.5
CN2716500000000,2022-12-01,27,165,MN,Watonwan County,6731,6530,201,3
CN2716700000000,2022-12-01,27,167,MN,Wilkin County,3443,3351,92,2.7
CN2716900000000,2022-12-01,27,169,MN,Winona County,28427,27699,728,2.6
CN2717100000000,2022-12-01,27,171,MN,Wright County,77123,74385,2738,3.6
CN2717300000000,2022-12-01,27,173,MN,Yellow Medicine County,5171,4989,182,3.5
CN2800100000000,2022-12-01,28,001,MS,Adams County,10548,10094,454,4.3
CN2800300000000,2022-12-01,28,003,MS,Alcorn County,15149,14686,463,3.1
CN2800500000000,2022-12-01,28,005,MS,Amite County,4225,4018,207,4.9
CN2800700000000,2022-12-01,28,007,MS,Attala County,6877,6631,246,3.6
CN2800900000000,2022-12-01,28,009,MS,Benton County,3033,2898,135,4.5
CN2801100000000,2022-12-01,28,011,MS,Bolivar County,10897,10461,436,4
CN2801300000000,2022-12-01,28,013,MS,Calhoun County,5265,5046,219,4.2
CN2801500000000,2022-12-01,28,015,MS,Carroll County,3213,3080,133,4.1
CN2801700000000,2022-12-01,28,017,MS,Chickasaw County,6471,6139,332,5.1
CN2801900000000,2022-12-01,28,019,MS,Choctaw County,3486,3379,107,3.1
CN2802100000000,2022-12-01,28,021,MS,Claiborne County,2820,2634,186,6.6
CN2802300000000,2022-12-01,28,023,MS,Clarke County,5531,5311,220,4
CN2802500000000,2022-12-01,28,025,MS,Clay County,8842,8526,316,3.6
CN2802700000000,2022-12-01,28,027,MS,Coahoma County,7383,7002,381,5.2
CN2802900000000,2022-12-01,28,029,MS,Copiah County,10723,10321,402,3.7
CN2803100000000,2022-12-01,28,031,MS,Covington County,8023,7785,238,3
CN2803300000000,2022-12-01,28,033,MS,DeSoto County,93064,90524,2540,2.7
CN2803500000000,2022-12-01,28,035,MS,Forrest County,32928,31902,1026,3.1
CN2803700000000,2022-12-01,28,037,MS,Franklin County,2604,2469,135,5.2
CN2803900000000,2022-12-01,28,039,MS,George County,8596,8203,393,4.6
CN2804100000000,2022-12-01,28,041,MS,Greene County,4152,3939,213,5.1
CN2804300000000,2022-12-01,28,043,MS,Grenada County,8448,8161,287,3.4
CN2804500000000,2022-12-01,28,045,MS,Hancock County,18633,17990,643,3.5
CN2804700000000,2022-12-01,28,047,MS,Harrison County,85691,82965,2726,3.2
CN2804900000000,2022-12-01,28,049,MS,Hinds County,101453,98279,3174,3.1
CN2805100000000,2022-12-01,28,051,MS,Holmes County,4936,4656,280,5.7
CN2805300000000,2022-12-01,28,053,MS,Humphreys County,1922,1804,118,6.1
CN2805500000000,2022-12-01,28,055,MS,Issaquena County,307,286,21,6.8
CN2805700000000,2022-12-01,28,057,MS,Itawamba County,10140,9814,326,3.2
CN2805900000000,2022-12-01,28,059,MS,Jackson County,57367,55317,2050,3.6
CN2806100000000,2022-12-01,28,061,MS,Jasper County,5798,5549,249,4.3
CN2806300000000,2022-12-01,28,063,MS,Jefferson County,1813,1609,204,11.3
CN2806500000000,2022-12-01,28,065,MS,Jefferson Davis County,3855,3685,170,4.4
CN2806700000000,2022-12-01,28,067,MS,Jones County,24732,23916,816,3.3
CN2806900000000,2022-12-01,28,069,MS,Kemper County,3188,3023,165,5.2
CN2807100000000,2022-12-01,28,071,MS,Lafayette County,27567,26875,692,2.5
CN2807300000000,2022-12-01,28,073,MS,Lamar County,31357,30577,780,2.5
CN2807500000000,2022-12-01,28,075,MS,Lauderdale County,28518,27544,974,3.4
CN2807700000000,2022-12-01,28,077,MS,Lawrence County,4743,4536,207,4.4
CN2807900000000,2022-12-01,28,079,MS,Leake County,7890,7616,274,3.5
CN2808100000000,2022-12-01,28,081,MS,Lee County,40339,39117,1222,3
CN2808300000000,2022-12-01,28,083,MS,Leflore County,9041,8588,453,5
CN2808500000000,2022-12-01,28,085,MS,Lincoln County,14350,13862,488,3.4
CN2808700000000,2022-12-01,28,087,MS,Lowndes County,24336,23507,829,3.4
CN2808900000000,2022-12-01,28,089,MS,Madison County,53293,51946,1347,2.5
CN2809100000000,2022-12-01,28,091,MS,Marion County,9777,9451,326,3.3
CN2809300000000,2022-12-01,28,093,MS,Marshall County,14124,13630,494,3.5
CN2809500000000,2022-12-01,28,095,MS,Monroe County,15233,14556,677,4.4
CN2809700000000,2022-12-01,28,097,MS,Montgomery County,3839,3696,143,3.7
CN2809900000000,2022-12-01,28,099,MS,Neshoba County,9608,9257,351,3.7
CN2810100000000,2022-12-01,28,101,MS,Newton County,7804,7539,265,3.4
CN2810300000000,2022-12-01,28,103,MS,Noxubee County,3258,3100,158,4.8
CN2810500000000,2022-12-01,28,105,MS,Oktibbeha County,21696,20980,716,3.3
CN2810700000000,2022-12-01,28,107,MS,Panola County,12205,11735,470,3.9
CN2810900000000,2022-12-01,28,109,MS,Pearl River County,23206,22451,755,3.3
CN2811100000000,2022-12-01,28,111,MS,Perry County,4201,4021,180,4.3
CN2811300000000,2022-12-01,28,113,MS,Pike County,13789,13235,554,4
CN2811500000000,2022-12-01,28,115,MS,Pontotoc County,14699,14263,436,3
CN2811700000000,2022-12-01,28,117,MS,Prentiss County,11206,10887,319,2.8
CN2811900000000,2022-12-01,28,119,MS,Quitman County,2250,2131,119,5.3
CN2812100000000,2022-12-01,28,121,MS,Rankin County,76576,74712,1864,2.4
CN2812300000000,2022-12-01,28,123,MS,Scott County,12112,11783,329,2.7
CN2812500000000,2022-12-01,28,125,MS,Sharkey County,1282,1222,60,4.7
CN2812700000000,2022-12-01,28,127,MS,Simpson County,10549,10218,331,3.1
CN2812900000000,2022-12-01,28,129,MS,Smith County,6555,6350,205,3.1
CN2813100000000,2022-12-01,28,131,MS,Stone County,6945,6693,252,3.6
CN2813300000000,2022-12-01,28,133,MS,Sunflower County,7095,6718,377,5.3
CN2813500000000,2022-12-01,28,135,MS,Tallahatchie County,4457,4304,153,3.4
CN2813700000000,2022-12-01,28,137,MS,Tate County,12001,11611,390,3.2
CN2813900000000,2022-12-01,28,139,MS,Tippah County,9792,9508,284,2.9
CN2814100000000,2022-12-01,28,141,MS,Tishomingo County,8499,8201,298,3.5
CN2814300000000,2022-12-01,28,143,MS,Tunica County,4099,3946,153,3.7
CN2814500000000,2022-12-01,28,145,MS,Union County,14605,14243,362,2.5
CN2814700000000,2022-12-01,28,147,MS,Walthall County,4834,4626,208,4.3
CN2814900000000,2022-12-01,28,149,MS,Warren County,18911,18266,645,3.4
CN2815100000000,2022-12-01,28,151,MS,Washington County,14435,13735,700,4.8
CN2815300000000,2022-12-01,28,153,MS,Wayne County,6896,6627,269,3.9
CN2815500000000,2022-12-01,28,155,MS,Webster County,3775,3648,127,3.4
CN2815700000000,2022-12-01,28,157,MS,Wilkinson County,2549,2408,141,5.5
CN2815900000000,2022-12-01,28,159,MS,Winston County,7068,6828,240,3.4
CN2816100000000,2022-12-01,28,161,MS,Yalobusha County,4580,4412,168,3.7
CN2816300000000,2022-12-01,28,163,MS,Yazoo County,8768,8463,305,3.5
CN2900100000000,2022-12-01,29,001,MO,Adair County,9743,9504,239,2.5
CN2900300000000,2022-12-01,29,003,MO,Andrew County,9394,9226,168,1.8
CN2900500000000,2022-12-01,29,005,MO,Atchison County,2533,2483,50,2
CN2900700000000,2022-12-01,29,007,MO,Audrain County,9956,9695,261,2.6
CN2900900000000,2022-12-01,29,009,MO,Barry County,14011,13665,346,2.5
CN2901100000000,2022-12-01,29,011,MO,Barton County,5193,5089,104,2
CN2901300000000,2022-12-01,29,013,MO,Bates County,7682,7489,193,2.5
CN2901500000000,2022-12-01,29,015,MO,Benton County,7228,6968,260,3.6
CN2901700000000,2022-12-01,29,017,MO,Bollinger County,5322,5195,127,2.4
CN2901900000000,2022-12-01,29,019,MO,Boone County,100039,98337,1702,1.7
CN2902100000000,2022-12-01,29,021,MO,Buchanan County,42089,41204,885,2.1
CN2902300000000,2022-12-01,29,023,MO,Butler County,18102,17498,604,3.3
CN2902500000000,2022-12-01,29,025,MO,Caldwell County,4256,4159,97,2.3
CN2902700000000,2022-12-01,29,027,MO,Callaway County,21681,21244,437,2
CN2902900000000,2022-12-01,29,029,MO,Camden County,18059,17427,632,3.5
CN2903100000000,2022-12-01,29,031,MO,Cape Girardeau County,40722,39921,801,2
CN2903300000000,2022-12-01,29,033,MO,Carroll County,4450,4349,101,2.3
CN2903500000000,2022-12-01,29,035,MO,Carter County,2456,2366,90,3.7
CN2903700000000,2022-12-01,29,037,MO,Cass County,55356,54170,1186,2.1
CN2903900000000,2022-12-01,29,039,MO,Cedar County,5597,5446,151,2.7
CN2904100000000,2022-12-01,29,041,MO,Chariton County,3723,3666,57,1.5
CN2904300000000,2022-12-01,29,043,MO,Christian County,47750,46896,854,1.8
CN2904500000000,2022-12-01,29,045,MO,Clark County,2984,2883,101,3.4
CN2904700000000,2022-12-01,29,047,MO,Clay County,139382,136637,2745,2
CN2904900000000,2022-12-01,29,049,MO,Clinton County,10631,10404,227,2.1
CN2905100000000,2022-12-01,29,051,MO,Cole County,39416,38727,689,1.7
CN2905300000000,2022-12-01,29,053,MO,Cooper County,7045,6895,150,2.1
CN2905500000000,2022-12-01,29,055,MO,Crawford County,10637,10367,270,2.5
CN2905700000000,2022-12-01,29,057,MO,Dade County,3452,3379,73,2.1
CN2905900000000,2022-12-01,29,059,MO,Dallas County,7248,7067,181,2.5
CN2906100000000,2022-12-01,29,061,MO,Daviess County,3970,3893,77,1.9
CN2906300000000,2022-12-01,29,063,MO,DeKalb County,4001,3924,77,1.9
CN2906500000000,2022-12-01,29,065,MO,Dent County,6027,5860,167,2.8
CN2906700000000,2022-12-01,29,067,MO,Douglas County,5219,5086,133,2.5
CN2906900000000,2022-12-01,29,069,MO,Dunklin County,10917,10491,426,3.9
CN2907100000000,2022-12-01,29,071,MO,Franklin County,52965,51841,1124,2.1
CN2907300000000,2022-12-01,29,073,MO,Gasconade County,7648,7478,170,2.2
CN2907500000000,2022-12-01,29,075,MO,Gentry County,3164,3109,55,1.7
CN2907700000000,2022-12-01,29,077,MO,Greene County,156020,153131,2889,1.9
CN2907900000000,2022-12-01,29,079,MO,Grundy County,4020,3927,93,2.3
CN2908100000000,2022-12-01,29,081,MO,Harrison County,3681,3597,84,2.3
CN2908300000000,2022-12-01,29,083,MO,Henry County,10240,9992,248,2.4
CN2908500000000,2022-12-01,29,085,MO,Hickory County,3911,3795,116,3
CN2908700000000,2022-12-01,29,087,MO,Holt County,2414,2379,35,1.4
CN2908900000000,2022-12-01,29,089,MO,Howard County,4724,4625,99,2.1
CN2909100000000,2022-12-01,29,091,MO,Howell County,15926,15487,439,2.8
CN2909300000000,2022-12-01,29,093,MO,Iron County,3477,3346,131,3.8
CN2909500000000,2022-12-01,29,095,MO,Jackson County,362493,353455,9038,2.5
CN2909700000000,2022-12-01,29,097,MO,Jasper County,57077,55853,1224,2.1
CN2909900000000,2022-12-01,29,099,MO,Jefferson County,118260,115736,2524,2.1
CN2910100000000,2022-12-01,29,101,MO,Johnson County,22792,22275,517,2.3
CN2910300000000,2022-12-01,29,103,MO,Knox County,1728,1674,54,3.1
CN2910500000000,2022-12-01,29,105,MO,Laclede County,16714,16304,410,2.5
CN2910700000000,2022-12-01,29,107,MO,Lafayette County,16794,16429,365,2.2
CN2910900000000,2022-12-01,29,109,MO,Lawrence County,17079,16708,371,2.2
CN2911100000000,2022-12-01,29,111,MO,Lewis County,4747,4645,102,2.1
CN2911300000000,2022-12-01,29,113,MO,Lincoln County,29209,28577,632,2.2
CN2911500000000,2022-12-01,29,115,MO,Linn County,5135,4997,138,2.7
CN2911700000000,2022-12-01,29,117,MO,Livingston County,7203,7088,115,1.6
CN2911900000000,2022-12-01,29,119,MO,McDonald County,11166,10936,230,2.1
CN2912100000000,2022-12-01,29,121,MO,Macon County,7162,6978,184,2.6
CN2912300000000,2022-12-01,29,123,MO,Madison County,5370,5223,147,2.7
CN2912500000000,2022-12-01,29,125,MO,Maries County,3843,3758,85,2.2
CN2912700000000,2022-12-01,29,127,MO,Marion County,13789,13487,302,2.2
CN2912900000000,2022-12-01,29,129,MO,Mercer County,1673,1638,35,2.1
CN2913100000000,2022-12-01,29,131,MO,Miller County,12584,12256,328,2.6
CN2913300000000,2022-12-01,29,133,MO,Mississippi County,5145,5000,145,2.8
CN2913500000000,2022-12-01,29,135,MO,Moniteau County,7067,6939,128,1.8
CN2913700000000,2022-12-01,29,137,MO,Monroe County,3711,3624,87,2.3
CN2913900000000,2022-12-01,29,139,MO,Montgomery County,5817,5686,131,2.3
CN2914100000000,2022-12-01,29,141,MO,Morgan County,7990,7755,235,2.9
CN2914300000000,2022-12-01,29,143,MO,New Madrid County,8105,7891,214,2.6
CN2914500000000,2022-12-01,29,145,MO,Newton County,26983,26407,576,2.1
CN2914700000000,2022-12-01,29,147,MO,Nodaway County,10953,10760,193,1.8
CN2914900000000,2022-12-01,29,149,MO,Oregon County,3773,3666,107,2.8
CN2915100000000,2022-12-01,29,151,MO,Osage County,7081,6958,123,1.7
CN2915300000000,2022-12-01,29,153,MO,Ozark County,3316,3178,138,4.2
CN2915500000000,2022-12-01,29,155,MO,Pemiscot County,5688,5486,202,3.6
CN2915700000000,2022-12-01,29,157,MO,Perry County,9500,9339,161,1.7
CN2915900000000,2022-12-01,29,159,MO,Pettis County,20096,19670,426,2.1
CN2916100000000,2022-12-01,29,161,MO,Phelps County,20057,19603,454,2.3
CN2916300000000,2022-12-01,29,163,MO,Pike County,7231,7077,154,2.1
CN2916500000000,2022-12-01,29,165,MO,Platte County,60357,59233,1124,1.9
CN2916700000000,2022-12-01,29,167,MO,Polk County,14826,14506,320,2.2
CN2916900000000,2022-12-01,29,169,MO,Pulaski County,14505,14113,392,2.7
CN2917100000000,2022-12-01,29,171,MO,Putnam County,2137,2093,44,2.1
CN2917300000000,2022-12-01,29,173,MO,Ralls County,5427,5307,120,2.2
CN2917500000000,2022-12-01,29,175,MO,Randolph County,10212,9990,222,2.2
CN2917700000000,2022-12-01,29,177,MO,Ray County,10867,10631,236,2.2
CN2917900000000,2022-12-01,29,179,MO,Reynolds County,2721,2640,81,3
CN2918100000000,2022-12-01,29,181,MO,Ripley County,5134,4979,155,3
CN2918300000000,2022-12-01,29,183,MO,St. Charles County,229067,224958,4109,1.8
CN2918500000000,2022-12-01,29,185,MO,St. Clair County,3831,3733,98,2.6
CN2918600000000,2022-12-01,29,186,MO,Ste. Genevieve County,9207,9023,184,2
CN2918700000000,2022-12-01,29,187,MO,St. Francois County,25557,24776,781,3.1
CN2918900000000,2022-12-01,29,189,MO,St. Louis County,526685,515371,11314,2.1
CN2919500000000,2022-12-01,29,195,MO,Saline County,10271,10036,235,2.3
CN2919700000000,2022-12-01,29,197,MO,Schuyler County,1794,1737,57,3.2
CN2919900000000,2022-12-01,29,199,MO,Scotland County,2202,2164,38,1.7
CN2920100000000,2022-12-01,29,201,MO,Scott County,20040,19622,418,2.1
CN2920300000000,2022-12-01,29,203,MO,Shannon County,3221,3092,129,4
CN2920500000000,2022-12-01,29,205,MO,Shelby County,2941,2877,64,2.2
CN2920700000000,2022-12-01,29,207,MO,Stoddard County,13014,12652,362,2.8
CN2920900000000,2022-12-01,29,209,MO,Stone County,13070,12642,428,3.3
CN2921100000000,2022-12-01,29,211,MO,Sullivan County,2546,2486,60,2.4
CN2921300000000,2022-12-01,29,213,MO,Taney County,24902,24171,731,2.9
CN2921500000000,2022-12-01,29,215,MO,Texas County,9072,8823,249,2.7
CN2921700000000,2022-12-01,29,217,MO,Vernon County,9138,8917,221,2.4
CN2921900000000,2022-12-01,29,219,MO,Warren County,18753,18350,403,2.1
CN2922100000000,2022-12-01,29,221,MO,Washington County,10006,9686,320,3.2
CN2922300000000,2022-12-01,29,223,MO,Wayne County,4725,4547,178,3.8
CN2922500000000,2022-12-01,29,225,MO,Webster County,17680,17358,322,1.8
CN2922700000000,2022-12-01,29,227,MO,Worth County,1134,1113,21,1.9
CN2922900000000,2022-12-01,29,229,MO,Wright County,7544,7360,184,2.4
CN2951000000000,2022-12-01,29,510,MO,St. Louis city,148811,144613,4198,2.8
CN3000100000000,2022-12-01,30,001,MT,Beaverhead County,5531,5419,112,2
CN3000300000000,2022-12-01,30,003,MT,Big Horn County,4638,4457,181,3.9
CN3000500000000,2022-12-01,30,005,MT,Blaine County,2227,2155,72,3.2
CN3000700000000,2022-12-01,30,007,MT,Broadwater County,2805,2707,98,3.5
CN3000900000000,2022-12-01,30,009,MT,Carbon County,5740,5601,139,2.4
CN3001100000000,2022-12-01,30,011,MT,Carter County,713,699,14,2
CN3001300000000,2022-12-01,30,013,MT,Cascade County,39370,38376,994,2.5
CN3001500000000,2022-12-01,30,015,MT,Chouteau County,2559,2508,51,2
CN3001700000000,2022-12-01,30,017,MT,Custer County,6358,6199,159,2.5
CN3001900000000,2022-12-01,30,019,MT,Daniels County,885,868,17,1.9
CN3002100000000,2022-12-01,30,021,MT,Dawson County,4568,4478,90,2
CN3002300000000,2022-12-01,30,023,MT,Deer Lodge County,5350,5206,144,2.7
CN3002500000000,2022-12-01,30,025,MT,Fallon County,1658,1632,26,1.6
CN3002700000000,2022-12-01,30,027,MT,Fergus County,5857,5671,186,3.2
CN3002900000000,2022-12-01,30,029,MT,Flathead County,51996,50375,1621,3.1
CN3003100000000,2022-12-01,30,031,MT,Gallatin County,77511,76119,1392,1.8
CN3003300000000,2022-12-01,30,033,MT,Garfield County,782,754,28,3.6
CN3003500000000,2022-12-01,30,035,MT,Glacier County,5645,5377,268,4.7
CN3003700000000,2022-12-01,30,037,MT,Golden Valley County,374,366,8,2.1
CN3003900000000,2022-12-01,30,039,MT,Granite County,1640,1578,62,3.8
CN3004100000000,2022-12-01,30,041,MT,Hill County,7492,7338,154,2.1
CN3004300000000,2022-12-01,30,043,MT,Jefferson County,6098,5951,147,2.4
CN3004500000000,2022-12-01,30,045,MT,Judith Basin County,1038,1013,25,2.4
CN3004700000000,2022-12-01,30,047,MT,Lake County,14299,13878,421,2.9
CN3004900000000,2022-12-01,30,049,MT,Lewis and Clark County,38496,37634,862,2.2
CN3005100000000,2022-12-01,30,051,MT,Liberty County,1019,997,22,2.2
CN3005300000000,2022-12-01,30,053,MT,Lincoln County,8522,8099,423,5
CN3005500000000,2022-12-01,30,055,MT,McCone County,1004,989,15,1.5
CN3005700000000,2022-12-01,30,057,MT,Madison County,6035,5920,115,1.9
CN3005900000000,2022-12-01,30,059,MT,Meagher County,1060,1038,22,2.1
CN3006100000000,2022-12-01,30,061,MT,Mineral County,1798,1707,91,5.1
CN3006300000000,2022-12-01,30,063,MT,Missoula County,67330,65563,1767,2.6
CN3006500000000,2022-12-01,30,065,MT,Musselshell County,2360,2297,63,2.7
CN3006700000000,2022-12-01,30,067,MT,Park County,9789,9500,289,3
CN3006900000000,2022-12-01,30,069,MT,Petroleum County,280,271,9,3.2
CN3007100000000,2022-12-01,30,071,MT,Phillips County,1862,1788,74,4
CN3007300000000,2022-12-01,30,073,MT,Pondera County,2642,2581,61,2.3
CN3007500000000,2022-12-01,30,075,MT,Powder River County,1031,1008,23,2.2
CN3007700000000,2022-12-01,30,077,MT,Powell County,2939,2863,76,2.6
CN3007900000000,2022-12-01,30,079,MT,Prairie County,499,482,17,3.4
CN3008100000000,2022-12-01,30,081,MT,Ravalli County,21838,21190,648,3
CN3008300000000,2022-12-01,30,083,MT,Richland County,5883,5767,116,2
CN3008500000000,2022-12-01,30,085,MT,Roosevelt County,4391,4248,143,3.3
CN3008700000000,2022-12-01,30,087,MT,Rosebud County,3553,3443,110,3.1
CN3008900000000,2022-12-01,30,089,MT,Sanders County,5364,5105,259,4.8
CN3009100000000,2022-12-01,30,091,MT,Sheridan County,1774,1745,29,1.6
CN3009300000000,2022-12-01,30,093,MT,Silver Bow County,17560,17072,488,2.8
CN3009500000000,2022-12-01,30,095,MT,Stillwater County,5390,5280,110,2
CN3009700000000,2022-12-01,30,097,MT,Sweet Grass County,1902,1863,39,2.1
CN3009900000000,2022-12-01,30,099,MT,Teton County,2836,2753,83,2.9
CN3010100000000,2022-12-01,30,101,MT,Toole County,2112,2075,37,1.8
CN3010300000000,2022-12-01,30,103,MT,Treasure County,360,351,9,2.5
CN3010500000000,2022-12-01,30,105,MT,Valley County,3977,3888,89,2.2
CN3010700000000,2022-12-01,30,107,MT,Wheatland County,789,757,32,4.1
CN3010900000000,2022-12-01,30,109,MT,Wibaux County,451,441,10,2.2
CN3011100000000,2022-12-01,30,111,MT,Yellowstone County,85486,83572,1914,2.2
CN3100100000000,2022-12-01,31,001,NE,Adams County,17160,16780,380,2.2
CN3100300000000,2022-12-01,31,003,NE,Antelope County,3686,3618,68,1.8
CN3100500000000,2022-12-01,31,005,NE,Arthur County,233,229,4,1.7
CN3100700000000,2022-12-01,31,007,NE,Banner County,397,381,16,4
CN3100900000000,2022-12-01,31,009,NE,Blaine County,250,240,10,4
CN3101100000000,2022-12-01,31,011,NE,Boone County,3044,2992,52,1.7
CN3101300000000,2022-12-01,31,013,NE,Box Butte County,5291,5165,126,2.4
CN3101500000000,2022-12-01,31,015,NE,Boyd County,1035,1017,18,1.7
CN3101700000000,2022-12-01,31,017,NE,Brown County,1424,1384,40,2.8
CN3101900000000,2022-12-01,31,019,NE,Buffalo County,28557,28045,512,1.8
CN3102100000000,2022-12-01,31,021,NE,Burt County,3550,3472,78,2.2
CN3102300000000,2022-12-01,31,023,NE,Butler County,4749,4663,86,1.8
CN3102500000000,2022-12-01,31,025,NE,Cass County,13670,13358,312,2.3
CN3102700000000,2022-12-01,31,027,NE,Cedar County,4698,4612,86,1.8
CN3102900000000,2022-12-01,31,029,NE,Chase County,2263,2223,40,1.8
CN3103100000000,2022-12-01,31,031,NE,Cherry County,3347,3285,62,1.9
CN3103300000000,2022-12-01,31,033,NE,Cheyenne County,4230,4132,98,2.3
CN3103500000000,2022-12-01,31,035,NE,Clay County,3097,3017,80,2.6
CN3103700000000,2022-12-01,31,037,NE,Colfax County,5776,5666,110,1.9
CN3103900000000,2022-12-01,31,039,NE,Cuming County,4876,4782,94,1.9
CN3104100000000,2022-12-01,31,041,NE,Custer County,6347,6247,100,1.6
CN3104300000000,2022-12-01,31,043,NE,Dakota County,11188,10826,362,3.2
CN3104500000000,2022-12-01,31,045,NE,Dawes County,4988,4886,102,2
CN3104700000000,2022-12-01,31,047,NE,Dawson County,13673,13329,344,2.5
CN3104900000000,2022-12-01,31,049,NE,Deuel County,1035,1013,22,2.1
CN3105100000000,2022-12-01,31,051,NE,Dixon County,3085,3011,74,2.4
CN3105300000000,2022-12-01,31,053,NE,Dodge County,20883,20433,450,2.2
CN3105500000000,2022-12-01,31,055,NE,Douglas County,306311,298223,8088,2.6
CN3105700000000,2022-12-01,31,057,NE,Dundy County,1205,1187,18,1.5
CN3105900000000,2022-12-01,31,059,NE,Fillmore County,3377,3315,62,1.8
CN3106100000000,2022-12-01,31,061,NE,Franklin County,1563,1527,36,2.3
CN3106300000000,2022-12-01,31,063,NE,Frontier County,1538,1504,34,2.2
CN3106500000000,2022-12-01,31,065,NE,Furnas County,2510,2464,46,1.8
CN3106700000000,2022-12-01,31,067,NE,Gage County,10806,10548,258,2.4
CN3106900000000,2022-12-01,31,069,NE,Garden County,1100,1080,20,1.8
CN3107100000000,2022-12-01,31,071,NE,Garfield County,1128,1108,20,1.8
CN3107300000000,2022-12-01,31,073,NE,Gosper County,1182,1156,26,2.2
CN3107500000000,2022-12-01,31,075,NE,Grant County,434,428,6,1.4
CN3107700000000,2022-12-01,31,077,NE,Greeley County,1245,1217,28,2.2
CN3107900000000,2022-12-01,31,079,NE,Hall County,32932,32106,826,2.5
CN3108100000000,2022-12-01,31,081,NE,Hamilton County,4933,4837,96,1.9
CN3108300000000,2022-12-01,31,083,NE,Harlan County,1808,1774,34,1.9
CN3108500000000,2022-12-01,31,085,NE,Hayes County,597,587,10,1.7
CN3108700000000,2022-12-01,31,087,NE,Hitchcock County,1308,1278,30,2.3
CN3108900000000,2022-12-01,31,089,NE,Holt County,5656,5542,114,2
CN3109100000000,2022-12-01,31,091,NE,Hooker County,347,335,12,3.5
CN3109300000000,2022-12-01,31,093,NE,Howard County,3516,3430,86,2.4
CN3109500000000,2022-12-01,31,095,NE,Jefferson County,4212,4132,80,1.9
CN3109700000000,2022-12-01,31,097,NE,Johnson County,2025,1967,58,2.9
CN3109900000000,2022-12-01,31,099,NE,Kearney County,3761,3693,68,1.8
CN3110100000000,2022-12-01,31,101,NE,Keith County,4639,4555,84,1.8
CN3110300000000,2022-12-01,31,103,NE,Keya Paha County,568,554,14,2.5
CN3110500000000,2022-12-01,31,105,NE,Kimball County,1946,1914,32,1.6
CN3110700000000,2022-12-01,31,107,NE,Knox County,4616,4510,106,2.3
CN3110900000000,2022-12-01,31,109,NE,Lancaster County,181035,177155,3880,2.1
CN3111100000000,2022-12-01,31,111,NE,Lincoln County,18242,17850,392,2.1
CN3111300000000,2022-12-01,31,113,NE,Logan County,489,475,14,2.9
CN3111500000000,2022-12-01,31,115,NE,Loup County,434,422,12,2.8
CN3111700000000,2022-12-01,31,117,NE,McPherson County,438,428,10,2.3
CN3111900000000,2022-12-01,31,119,NE,Madison County,19747,19351,396,2
CN3112100000000,2022-12-01,31,121,NE,Merrick County,4209,4127,82,1.9
CN3112300000000,2022-12-01,31,123,NE,Morrill County,2644,2588,56,2.1
CN3112500000000,2022-12-01,31,125,NE,Nance County,1964,1920,44,2.2
CN3112700000000,2022-12-01,31,127,NE,Nemaha County,3702,3614,88,2.4
CN3112900000000,2022-12-01,31,129,NE,Nuckolls County,2508,2444,64,2.6
CN3113100000000,2022-12-01,31,131,NE,Otoe County,8610,8428,182,2.1
CN3113300000000,2022-12-01,31,133,NE,Pawnee County,1500,1468,32,2.1
CN3113500000000,2022-12-01,31,135,NE,Perkins County,1857,1823,34,1.8
CN3113700000000,2022-12-01,31,137,NE,Phelps County,5037,4939,98,1.9
CN3113900000000,2022-12-01,31,139,NE,Pierce County,4189,4111,78,1.9
CN3114100000000,2022-12-01,31,141,NE,Platte County,18610,18242,368,2
CN3114300000000,2022-12-01,31,143,NE,Polk County,2922,2858,64,2.2
CN3114500000000,2022-12-01,31,145,NE,Red Willow County,5910,5806,104,1.8
CN3114700000000,2022-12-01,31,147,NE,Richardson County,4186,4092,94,2.2
CN3114900000000,2022-12-01,31,149,NE,Rock County,918,906,12,1.3
CN3115100000000,2022-12-01,31,151,NE,Saline County,7211,7017,194,2.7
CN3115300000000,2022-12-01,31,153,NE,Sarpy County,99853,97607,2246,2.2
CN3115500000000,2022-12-01,31,155,NE,Saunders County,11546,11318,228,2
CN3115700000000,2022-12-01,31,157,NE,Scotts Bluff County,17913,17397,516,2.9
CN3115900000000,2022-12-01,31,159,NE,Seward County,8934,8748,186,2.1
CN3116100000000,2022-12-01,31,161,NE,Sheridan County,2789,2737,52,1.9
CN3116300000000,2022-12-01,31,163,NE,Sherman County,1666,1636,30,1.8
CN3116500000000,2022-12-01,31,165,NE,Sioux County,783,769,14,1.8
CN3116700000000,2022-12-01,31,167,NE,Stanton County,3541,3467,74,2.1
CN3116900000000,2022-12-01,31,169,NE,Thayer County,2749,2699,50,1.8
CN3117100000000,2022-12-01,31,171,NE,Thomas County,454,438,16,3.5
CN3117300000000,2022-12-01,31,173,NE,Thurston County,3283,3185,98,3
CN3117500000000,2022-12-01,31,175,NE,Valley County,2129,2077,52,2.4
CN3117700000000,2022-12-01,31,177,NE,Washington County,11496,11268,228,2
CN3117900000000,2022-12-01,31,179,NE,Wayne County,6000,5886,114,1.9
CN3118100000000,2022-12-01,31,181,NE,Webster County,1689,1641,48,2.8
CN3118300000000,2022-12-01,31,183,NE,Wheeler County,590,578,12,2
CN3118500000000,2022-12-01,31,185,NE,York County,7391,7237,154,2.1
CN3200100000000,2022-12-01,32,001,NV,Churchill County,10543,10141,402,3.8
CN3200300000000,2022-12-01,32,003,NV,Clark County,1155570,1090810,64760,5.6
CN3200500000000,2022-12-01,32,005,NV,Douglas County,21982,21085,897,4.1
CN3200700000000,2022-12-01,32,007,NV,Elko County,24716,23910,806,3.3
CN3200900000000,2022-12-01,32,009,NV,Esmeralda County,374,358,16,4.3
CN3201100000000,2022-12-01,32,011,NV,Eureka County,884,849,35,4
CN3201300000000,2022-12-01,32,013,NV,Humboldt County,7304,7064,240,3.3
CN3201500000000,2022-12-01,32,015,NV,Lander County,2895,2810,85,2.9
CN3201700000000,2022-12-01,32,017,NV,Lincoln County,1922,1837,85,4.4
CN3201900000000,2022-12-01,32,019,NV,Lyon County,23313,22061,1252,5.4
CN3202100000000,2022-12-01,32,021,NV,Mineral County,1961,1874,87,4.4
CN3202300000000,2022-12-01,32,023,NV,Nye County,17476,16458,1018,5.8
CN3202700000000,2022-12-01,32,027,NV,Pershing County,2237,2142,95,4.2
CN3202900000000,2022-12-01,32,029,NV,Storey County,2106,2033,73,3.5
CN3203100000000,2022-12-01,32,031,NV,Washoe County,259215,250161,9054,3.5
CN3203300000000,2022-12-01,32,033,NV,White Pine County,4374,4225,149,3.4
CN3251000000000,2022-12-01,32,510,NV,Carson City,25402,24362,1040,4.1
CN3300100000000,2022-12-01,33,001,NH,Belknap County,30498,29705,793,2.6
CN3300300000000,2022-12-01,33,003,NH,Carroll County,22495,21863,632,2.8
CN3300500000000,2022-12-01,33,005,NH,Cheshire County,39205,38185,1020,2.6
CN3300700000000,2022-12-01,33,007,NH,Coos County,14391,13916,475,3.3
CN3300900000000,2022-12-01,33,009,NH,Grafton County,48729,47637,1092,2.2
CN3301100000000,2022-12-01,33,011,NH,Hillsborough County,243372,237091,6281,2.6
CN3301300000000,2022-12-01,33,013,NH,Merrimack County,82708,80888,1820,2.2
CN3301500000000,2022-12-01,33,015,NH,Rockingham County,189364,184441,4923,2.6
CN3301700000000,2022-12-01,33,017,NH,Strafford County,74459,72821,1638,2.2
CN3301900000000,2022-12-01,33,019,NH,Sullivan County,22762,22226,536,2.4
CN3400100000000,2022-12-01,34,001,NJ,Atlantic County,123302,117742,5560,4.5
CN3400300000000,2022-12-01,34,003,NJ,Bergen County,512172,498824,13348,2.6
CN3400500000000,2022-12-01,34,005,NJ,Burlington County,249370,242384,6986,2.8
CN3400700000000,2022-12-01,34,007,NJ,Camden County,272628,263028,9600,3.5
CN3400900000000,2022-12-01,34,009,NJ,Cape May County,43597,40046,3551,8.1
CN3401100000000,2022-12-01,34,011,NJ,Cumberland County,69063,65654,3409,4.9
CN3401300000000,2022-12-01,34,013,NJ,Essex County,390410,375311,15099,3.9
CN3401500000000,2022-12-01,34,015,NJ,Gloucester County,162325,157214,5111,3.1
CN3401700000000,2022-12-01,34,017,NJ,Hudson County,383123,371846,11277,2.9
CN3401900000000,2022-12-01,34,019,NJ,Hunterdon County,68475,66834,1641,2.4
CN3402100000000,2022-12-01,34,021,NJ,Mercer County,218908,213162,5746,2.6
CN3402300000000,2022-12-01,34,023,NJ,Middlesex County,464676,452054,12622,2.7
CN3402500000000,2022-12-01,34,025,NJ,Monmouth County,350447,341062,9385,2.7
CN3402700000000,2022-12-01,34,027,NJ,Morris County,270431,263837,6594,2.4
CN3402900000000,2022-12-01,34,029,NJ,Ocean County,300784,291399,9385,3.1
CN3403100000000,2022-12-01,34,031,NJ,Passaic County,256441,246649,9792,3.8
CN3403300000000,2022-12-01,34,033,NJ,Salem County,30449,29175,1274,4.2
CN3403500000000,2022-12-01,34,035,NJ,Somerset County,180218,175675,4543,2.5
CN3403700000000,2022-12-01,34,037,NJ,Sussex County,78068,75659,2409,3.1
CN3403900000000,2022-12-01,34,039,NJ,Union County,290857,281401,9456,3.3
CN3404100000000,2022-12-01,34,041,NJ,Warren County,59329,57662,1667,2.8
CN3500100000000,2022-12-01,35,001,NM,Bernalillo County,338005,329106,8899,2.6
CN3500300000000,2022-12-01,35,003,NM,Catron County,1078,1033,45,4.2
CN3500500000000,2022-12-01,35,005,NM,Chaves County,27488,26646,842,3.1
CN3500600000000,2022-12-01,35,006,NM,Cibola County,8040,7707,333,4.1
CN3500700000000,2022-12-01,35,007,NM,Colfax County,5133,4986,147,2.9
CN3500900000000,2022-12-01,35,009,NM,Curry County,21908,21407,501,2.3
CN3501100000000,2022-12-01,35,011,NM,De Baca County,706,689,17,2.4
CN3501300000000,2022-12-01,35,013,NM,Dona Ana County,100689,97340,3349,3.3
CN3501500000000,2022-12-01,35,015,NM,Eddy County,32355,31660,695,2.1
CN3501700000000,2022-12-01,35,017,NM,Grant County,11674,11328,346,3
CN3501900000000,2022-12-01,35,019,NM,Guadalupe County,1468,1411,57,3.9
CN3502100000000,2022-12-01,35,021,NM,Harding County,296,289,7,2.4
CN3502300000000,2022-12-01,35,023,NM,Hidalgo County,1793,1746,47,2.6
CN3502500000000,2022-12-01,35,025,NM,Lea County,29198,28366,832,2.8
CN3502700000000,2022-12-01,35,027,NM,Lincoln County,8597,8344,253,2.9
CN3502800000000,2022-12-01,35,028,NM,Los Alamos County,10862,10708,154,1.4
CN3502900000000,2022-12-01,35,029,NM,Luna County,9532,8554,978,10.3
CN3503100000000,2022-12-01,35,031,NM,McKinley County,22972,22044,928,4
CN3503300000000,2022-12-01,35,033,NM,Mora County,1957,1870,87,4.4
CN3503500000000,2022-12-01,35,035,NM,Otero County,25896,25089,807,3.1
CN3503700000000,2022-12-01,35,037,NM,Quay County,2848,2763,85,3
CN3503900000000,2022-12-01,35,039,NM,Rio Arriba County,16374,15895,479,2.9
CN3504100000000,2022-12-01,35,041,NM,Roosevelt County,8089,7879,210,2.6
CN3504300000000,2022-12-01,35,043,NM,Sandoval County,68235,66375,1860,2.7
CN3504500000000,2022-12-01,35,045,NM,San Juan County,49820,48119,1701,3.4
CN3504700000000,2022-12-01,35,047,NM,San Miguel County,10397,10009,388,3.7
CN3504900000000,2022-12-01,35,049,NM,Santa Fe County,72305,70451,1854,2.6
CN3505100000000,2022-12-01,35,051,NM,Sierra County,3917,3738,179,4.6
CN3505300000000,2022-12-01,35,053,NM,Socorro County,6135,5932,203,3.3
CN3505500000000,2022-12-01,35,055,NM,Taos County,14536,14008,528,3.6
CN3505700000000,2022-12-01,35,057,NM,Torrance County,5476,5248,228,4.2
CN3505900000000,2022-12-01,35,059,NM,Union County,1564,1532,32,2
CN3506100000000,2022-12-01,35,061,NM,Valencia County,31114,30133,981,3.2
CN3600100000000,2022-12-01,36,001,NY,Albany County,158376,154155,4221,2.7
CN3600300000000,2022-12-01,36,003,NY,Allegany County,19077,18294,783,4.1
CN3600500000000,2022-12-01,36,005,NY,Bronx County,604080,562368,41712,6.9
CN3600700000000,2022-12-01,36,007,NY,Broome County,81729,78889,2840,3.5
CN3600900000000,2022-12-01,36,009,NY,Cattaraugus County,32591,31273,1318,4
CN3601100000000,2022-12-01,36,011,NY,Cayuga County,35225,34117,1108,3.1
CN3601300000000,2022-12-01,36,013,NY,Chautauqua County,52843,50778,2065,3.9
CN3601500000000,2022-12-01,36,015,NY,Chemung County,34255,33067,1188,3.5
CN3601700000000,2022-12-01,36,017,NY,Chenango County,21550,20859,691,3.2
CN3601900000000,2022-12-01,36,019,NY,Clinton County,35008,33930,1078,3.1
CN3602100000000,2022-12-01,36,021,NY,Columbia County,29981,29249,732,2.4
CN3602300000000,2022-12-01,36,023,NY,Cortland County,22796,21910,886,3.9
CN3602500000000,2022-12-01,36,025,NY,Delaware County,18176,17517,659,3.6
CN3602700000000,2022-12-01,36,027,NY,Dutchess County,141952,138134,3818,2.7
CN3602900000000,2022-12-01,36,029,NY,Erie County,440107,425504,14603,3.3
CN3603100000000,2022-12-01,36,031,NY,Essex County,16227,15627,600,3.7
CN3603300000000,2022-12-01,36,033,NY,Franklin County,18677,18008,669,3.6
CN3603500000000,2022-12-01,36,035,NY,Fulton County,22316,21453,863,3.9
CN3603700000000,2022-12-01,36,037,NY,Genesee County,29440,28517,923,3.1
CN3603900000000,2022-12-01,36,039,NY,Greene County,20162,19515,647,3.2
CN3604100000000,2022-12-01,36,041,NY,Hamilton County,2058,1937,121,5.9
CN3604300000000,2022-12-01,36,043,NY,Herkimer County,27001,25923,1078,4
CN3604500000000,2022-12-01,36,045,NY,Jefferson County,43272,41425,1847,4.3
CN3604700000000,2022-12-01,36,047,NY,Kings County,1213023,1149827,63196,5.2
CN3604900000000,2022-12-01,36,049,NY,Lewis County,11553,11041,512,4.4
CN3605100000000,2022-12-01,36,051,NY,Livingston County,29904,28973,931,3.1
CN3605300000000,2022-12-01,36,053,NY,Madison County,32913,31809,1104,3.4
CN3605500000000,2022-12-01,36,055,NY,Monroe County,359938,348812,11126,3.1
CN3605700000000,2022-12-01,36,057,NY,Montgomery County,22283,21366,917,4.1
CN3605900000000,2022-12-01,36,059,NY,Nassau County,722616,704784,17832,2.5
CN3606100000000,2022-12-01,36,061,NY,New York County,924404,886229,38175,4.1
CN3606300000000,2022-12-01,36,063,NY,Niagara County,97268,93677,3591,3.7
CN3606500000000,2022-12-01,36,065,NY,Oneida County,98578,95262,3316,3.4
CN3606700000000,2022-12-01,36,067,NY,Onondaga County,223893,217332,6561,2.9
CN3606900000000,2022-12-01,36,069,NY,Ontario County,55185,53581,1604,2.9
CN3607100000000,2022-12-01,36,071,NY,Orange County,188760,183474,5286,2.8
CN3607300000000,2022-12-01,36,073,NY,Orleans County,16916,16305,611,3.6
CN3607500000000,2022-12-01,36,075,NY,Oswego County,53017,50864,2153,4.1
CN3607700000000,2022-12-01,36,077,NY,Otsego County,26271,25325,946,3.6
CN3607900000000,2022-12-01,36,079,NY,Putnam County,50409,49104,1305,2.6
CN3608100000000,2022-12-01,36,081,NY,Queens County,1144063,1092752,51311,4.5
CN3608300000000,2022-12-01,36,083,NY,Rensselaer County,81708,79497,2211,2.7
CN3608500000000,2022-12-01,36,085,NY,Richmond County,227688,216799,10889,4.8
CN3608700000000,2022-12-01,36,087,NY,Rockland County,158064,154206,3858,2.4
CN3608900000000,2022-12-01,36,089,NY,St. Lawrence County,42829,41135,1694,4
CN3609100000000,2022-12-01,36,091,NY,Saratoga County,121073,118118,2955,2.4
CN3609300000000,2022-12-01,36,093,NY,Schenectady County,77416,75150,2266,2.9
CN3609500000000,2022-12-01,36,095,NY,Schoharie County,14769,14188,581,3.9
CN3609700000000,2022-12-01,36,097,NY,Schuyler County,7767,7464,303,3.9
CN3609900000000,2022-12-01,36,099,NY,Seneca County,14431,13982,449,3.1
CN3610100000000,2022-12-01,36,101,NY,Steuben County,40657,39194,1463,3.6
CN3610300000000,2022-12-01,36,103,NY,Suffolk County,793351,771547,21804,2.7
CN3610500000000,2022-12-01,36,105,NY,Sullivan County,36741,35649,1092,3
CN3610700000000,2022-12-01,36,107,NY,Tioga County,22112,21446,666,3
CN3610900000000,2022-12-01,36,109,NY,Tompkins County,50242,48963,1279,2.5
CN3611100000000,2022-12-01,36,111,NY,Ulster County,86461,84058,2403,2.8
CN3611300000000,2022-12-01,36,113,NY,Warren County,30731,29613,1118,3.6
CN3611500000000,2022-12-01,36,115,NY,Washington County,26932,26100,832,3.1
CN3611700000000,2022-12-01,36,117,NY,Wayne County,42868,41563,1305,3
CN3611900000000,2022-12-01,36,119,NY,Westchester County,492174,479125,13049,2.7
CN3612100000000,2022-12-01,36,121,NY,Wyoming County,17119,16487,632,3.7
CN3612300000000,2022-12-01,36,123,NY,Yates County,11533,11170,363,3.1
CN3700100000000,2022-12-01,37,001,NC,Alamance County,82268,79605,2663,3.2
CN3700300000000,2022-12-01,37,003,NC,Alexander County,17994,17483,511,2.8
CN3700500000000,2022-12-01,37,005,NC,Alleghany County,4626,4364,262,5.7
CN3700700000000,2022-12-01,37,007,NC,Anson County,10138,9763,375,3.7
CN3700900000000,2022-12-01,37,009,NC,Ashe County,12676,12307,369,2.9
CN3701100000000,2022-12-01,37,011,NC,Avery County,7617,7400,217,2.8
CN3701300000000,2022-12-01,37,013,NC,Beaufort County,19782,19089,693,3.5
CN3701500000000,2022-12-01,37,015,NC,Bertie County,7107,6816,291,4.1
CN3701700000000,2022-12-01,37,017,NC,Bladen County,14439,13868,571,4
CN3701900000000,2022-12-01,37,019,NC,Brunswick County,55757,53430,2327,4.2
CN3702100000000,2022-12-01,37,021,NC,Buncombe County,139915,136466,3449,2.5
CN3702300000000,2022-12-01,37,023,NC,Burke County,40712,39545,1167,2.9
CN3702500000000,2022-12-01,37,025,NC,Cabarrus County,115825,112331,3494,3
CN3702700000000,2022-12-01,37,027,NC,Caldwell County,36247,35172,1075,3
CN3702900000000,2022-12-01,37,029,NC,Camden County,4654,4501,153,3.3
CN3703100000000,2022-12-01,37,031,NC,Carteret County,31632,30654,978,3.1
CN3703300000000,2022-12-01,37,033,NC,Caswell County,9593,9261,332,3.5
CN3703500000000,2022-12-01,37,035,NC,Catawba County,79283,76958,2325,2.9
CN3703700000000,2022-12-01,37,037,NC,Chatham County,37114,36120,994,2.7
CN3703900000000,2022-12-01,37,039,NC,Cherokee County,11105,10693,412,3.7
CN3704100000000,2022-12-01,37,041,NC,Chowan County,6010,5795,215,3.6
CN3704300000000,2022-12-01,37,043,NC,Clay County,4192,4054,138,3.3
CN3704500000000,2022-12-01,37,045,NC,Cleveland County,49076,47453,1623,3.3
CN3704700000000,2022-12-01,37,047,NC,Columbus County,23695,22853,842,3.6
CN3704900000000,2022-12-01,37,049,NC,Craven County,41680,40312,1368,3.3
CN3705100000000,2022-12-01,37,051,NC,Cumberland County,125951,120133,5818,4.6
CN3705300000000,2022-12-01,37,053,NC,Currituck County,14494,14040,454,3.1
CN3705500000000,2022-12-01,37,055,NC,Dare County,17972,17182,790,4.4
CN3705700000000,2022-12-01,37,057,NC,Davidson County,81260,78657,2603,3.2
CN3705900000000,2022-12-01,37,059,NC,Davie County,20680,20084,596,2.9
CN3706100000000,2022-12-01,37,061,NC,Duplin County,24632,23877,755,3.1
CN3706300000000,2022-12-01,37,063,NC,Durham County,177723,172822,4901,2.8
CN3706500000000,2022-12-01,37,065,NC,Edgecombe County,19899,18750,1149,5.8
CN3706700000000,2022-12-01,37,067,NC,Forsyth County,187959,181862,6097,3.2
CN3706900000000,2022-12-01,37,069,NC,Franklin County,33896,32838,1058,3.1
CN3707100000000,2022-12-01,37,071,NC,Gaston County,114383,110652,3731,3.3
CN3707300000000,2022-12-01,37,073,NC,Gates County,5049,4901,148,2.9
CN3707500000000,2022-12-01,37,075,NC,Graham County,2789,2653,136,4.9
CN3707700000000,2022-12-01,37,077,NC,Granville County,30063,29259,804,2.7
CN3707900000000,2022-12-01,37,079,NC,Greene County,9468,9225,243,2.6
CN3708100000000,2022-12-01,37,081,NC,Guilford County,258457,249161,9296,3.6
CN3708300000000,2022-12-01,37,083,NC,Halifax County,19065,18133,932,4.9
CN3708500000000,2022-12-01,37,085,NC,Harnett County,54469,52512,1957,3.6
CN3708700000000,2022-12-01,37,087,NC,Haywood County,29768,28960,808,2.7
CN3708900000000,2022-12-01,37,089,NC,Henderson County,54716,53260,1456,2.7
CN3709100000000,2022-12-01,37,091,NC,Hertford County,8444,8069,375,4.4
CN3709300000000,2022-12-01,37,093,NC,Hoke County,19994,19117,877,4.4
CN3709500000000,2022-12-01,37,095,NC,Hyde County,1692,1576,116,6.9
CN3709700000000,2022-12-01,37,097,NC,Iredell County,94348,91547,2801,3
CN3709900000000,2022-12-01,37,099,NC,Jackson County,19544,18923,621,3.2
CN3710100000000,2022-12-01,37,101,NC,Johnston County,107760,104701,3059,2.8
CN3710300000000,2022-12-01,37,103,NC,Jones County,4280,4144,136,3.2
CN3710500000000,2022-12-01,37,105,NC,Lee County,26026,25073,953,3.7
CN3710700000000,2022-12-01,37,107,NC,Lenoir County,27520,26678,842,3.1
CN3710900000000,2022-12-01,37,109,NC,Lincoln County,46204,44966,1238,2.7
CN3711100000000,2022-12-01,37,111,NC,McDowell County,20047,19432,615,3.1
CN3711300000000,2022-12-01,37,113,NC,Macon County,15983,15517,466,2.9
CN3711500000000,2022-12-01,37,115,NC,Madison County,9942,9645,297,3
CN3711700000000,2022-12-01,37,117,NC,Martin County,8481,8165,316,3.7
CN3711900000000,2022-12-01,37,119,NC,Mecklenburg County,650720,630313,20407,3.1
CN3712100000000,2022-12-01,37,121,NC,Mitchell County,6017,5796,221,3.7
CN3712300000000,2022-12-01,37,123,NC,Montgomery County,10968,10615,353,3.2
CN3712500000000,2022-12-01,37,125,NC,Moore County,42068,40781,1287,3.1
CN3712700000000,2022-12-01,37,127,NC,Nash County,41642,39813,1829,4.4
CN3712900000000,2022-12-01,37,129,NC,New Hanover County,128897,125104,3793,2.9
CN3713100000000,2022-12-01,37,131,NC,Northampton County,7201,6883,318,4.4
CN3713300000000,2022-12-01,37,133,NC,Onslow County,68474,65927,2547,3.7
CN3713500000000,2022-12-01,37,135,NC,Orange County,80910,78773,2137,2.6
CN3713700000000,2022-12-01,37,137,NC,Pamlico County,5434,5273,161,3
CN3713900000000,2022-12-01,37,139,NC,Pasquotank County,16627,15965,662,4
CN3714100000000,2022-12-01,37,141,NC,Pender County,30598,29635,963,3.1
CN3714300000000,2022-12-01,37,143,NC,Perquimans County,4925,4735,190,3.9
CN3714500000000,2022-12-01,37,145,NC,Person County,18682,18061,621,3.3
CN3714700000000,2022-12-01,37,147,NC,Pitt County,87186,84092,3094,3.5
CN3714900000000,2022-12-01,37,149,NC,Polk County,9214,8931,283,3.1
CN3715100000000,2022-12-01,37,151,NC,Randolph County,65019,62862,2157,3.3
CN3715300000000,2022-12-01,37,153,NC,Richmond County,16966,16232,734,4.3
CN3715500000000,2022-12-01,37,155,NC,Robeson County,47685,45420,2265,4.7
CN3715700000000,2022-12-01,37,157,NC,Rockingham County,39237,37771,1466,3.7
CN3715900000000,2022-12-01,37,159,NC,Rowan County,67478,65358,2120,3.1
CN3716100000000,2022-12-01,37,161,NC,Rutherford County,24479,23472,1007,4.1
CN3716300000000,2022-12-01,37,163,NC,Sampson County,28645,27762,883,3.1
CN3716500000000,2022-12-01,37,165,NC,Scotland County,11161,10532,629,5.6
CN3716700000000,2022-12-01,37,167,NC,Stanly County,30655,29766,889,2.9
CN3716900000000,2022-12-01,37,169,NC,Stokes County,21530,20936,594,2.8
CN3717100000000,2022-12-01,37,171,NC,Surry County,32499,31554,945,2.9
CN3717300000000,2022-12-01,37,173,NC,Swain County,7017,6823,194,2.8
CN3717500000000,2022-12-01,37,175,NC,Transylvania County,14405,13984,421,2.9
CN3717700000000,2022-12-01,37,177,NC,Tyrrell County,1211,1129,82,6.8
CN3717900000000,2022-12-01,37,179,NC,Union County,129880,126347,3533,2.7
CN3718100000000,2022-12-01,37,181,NC,Vance County,16699,15800,899,5.4
CN3718300000000,2022-12-01,37,183,NC,Wake County,629997,613305,16692,2.6
CN3718500000000,2022-12-01,37,185,NC,Warren County,6206,5860,346,5.6
CN3718700000000,2022-12-01,37,187,NC,Washington County,4234,4026,208,4.9
CN3718900000000,2022-12-01,37,189,NC,Watauga County,29704,28924,780,2.6
CN3719100000000,2022-12-01,37,191,NC,Wayne County,50007,48279,1728,3.5
CN3719300000000,2022-12-01,37,193,NC,Wilkes County,27044,26180,864,3.2
CN3719500000000,2022-12-01,37,195,NC,Wilson County,33882,32407,1475,4.4
CN3719700000000,2022-12-01,37,197,NC,Yadkin County,17551,17062,489,2.8
CN3719900000000,2022-12-01,37,199,NC,Yancey County,8031,7798,233,2.9
CN3800100000000,2022-12-01,38,001,ND,Adams County,960,943,17,1.8
CN3800300000000,2022-12-01,38,003,ND,Barnes County,5172,5061,111,2.1
CN3800500000000,2022-12-01,38,005,ND,Benson County,2385,2315,70,2.9
CN3800700000000,2022-12-01,38,007,ND,Billings County,388,382,6,1.5
CN3800900000000,2022-12-01,38,009,ND,Bottineau County,2897,2818,79,2.7
CN3801100000000,2022-12-01,38,011,ND,Bowman County,1521,1494,27,1.8
CN3801300000000,2022-12-01,38,013,ND,Burke County,1038,1019,19,1.8
CN3801500000000,2022-12-01,38,015,ND,Burleigh County,50866,49870,996,2
CN3801700000000,2022-12-01,38,017,ND,Cass County,108439,106602,1837,1.7
CN3801900000000,2022-12-01,38,019,ND,Cavalier County,1808,1759,49,2.7
CN3802100000000,2022-12-01,38,021,ND,Dickey County,2194,2150,44,2
CN3802300000000,2022-12-01,38,023,ND,Divide County,1443,1427,16,1.1
CN3802500000000,2022-12-01,38,025,ND,Dunn County,3237,3193,44,1.4
CN3802700000000,2022-12-01,38,027,ND,Eddy County,1234,1194,40,3.2
CN3802900000000,2022-12-01,38,029,ND,Emmons County,1475,1392,83,5.6
CN3803100000000,2022-12-01,38,031,ND,Foster County,1529,1488,41,2.7
CN3803300000000,2022-12-01,38,033,ND,Golden Valley County,857,840,17,2
CN3803500000000,2022-12-01,38,035,ND,Grand Forks County,37360,36680,680,1.8
CN3803700000000,2022-12-01,38,037,ND,Grant County,1232,1208,24,1.9
CN3803900000000,2022-12-01,38,039,ND,Griggs County,1011,986,25,2.5
CN3804100000000,2022-12-01,38,041,ND,Hettinger County,1392,1368,24,1.7
CN3804300000000,2022-12-01,38,043,ND,Kidder County,1342,1282,60,4.5
CN3804500000000,2022-12-01,38,045,ND,LaMoure County,2110,2070,40,1.9
CN3804700000000,2022-12-01,38,047,ND,Logan County,888,863,25,2.8
CN3804900000000,2022-12-01,38,049,ND,McHenry County,3159,3057,102,3.2
CN3805100000000,2022-12-01,38,051,ND,McIntosh County,1069,1045,24,2.2
CN3805300000000,2022-12-01,38,053,ND,McKenzie County,9566,9420,146,1.5
CN3805500000000,2022-12-01,38,055,ND,McLean County,4799,4637,162,3.4
CN3805700000000,2022-12-01,38,057,ND,Mercer County,3411,3290,121,3.5
CN3805900000000,2022-12-01,38,059,ND,Morton County,16850,16400,450,2.7
CN3806100000000,2022-12-01,38,061,ND,Mountrail County,6447,6369,78,1.2
CN3806300000000,2022-12-01,38,063,ND,Nelson County,1436,1395,41,2.9
CN3806500000000,2022-12-01,38,065,ND,Oliver County,876,844,32,3.7
CN3806700000000,2022-12-01,38,067,ND,Pembina County,3204,3094,110,3.4
CN3806900000000,2022-12-01,38,069,ND,Pierce County,1622,1582,40,2.5
CN3807100000000,2022-12-01,38,071,ND,Ramsey County,5487,5366,121,2.2
CN3807300000000,2022-12-01,38,073,ND,Ransom County,2620,2583,37,1.4
CN3807500000000,2022-12-01,38,075,ND,Renville County,1228,1204,24,2
CN3807700000000,2022-12-01,38,077,ND,Richland County,8725,8574,151,1.7
CN3807900000000,2022-12-01,38,079,ND,Rolette County,4606,4369,237,5.1
CN3808100000000,2022-12-01,38,081,ND,Sargent County,2272,2242,30,1.3
CN3808300000000,2022-12-01,38,083,ND,Sheridan County,674,653,21,3.1
CN3808500000000,2022-12-01,38,085,ND,Sioux County,1187,1168,19,1.6
CN3808700000000,2022-12-01,38,087,ND,Slope County,339,331,8,2.4
CN3808900000000,2022-12-01,38,089,ND,Stark County,18087,17776,311,1.7
CN3809100000000,2022-12-01,38,091,ND,Steele County,956,942,14,1.5
CN3809300000000,2022-12-01,38,093,ND,Stutsman County,10703,10492,211,2
CN3809500000000,2022-12-01,38,095,ND,Towner County,1105,1075,30,2.7
CN3809700000000,2022-12-01,38,097,ND,Traill County,4522,4443,79,1.7
CN3809900000000,2022-12-01,38,099,ND,Walsh County,5256,5065,191,3.6
CN3810100000000,2022-12-01,38,101,ND,Ward County,31860,31171,689,2.2
CN3810300000000,2022-12-01,38,103,ND,Wells County,1925,1852,73,3.8
CN3810500000000,2022-12-01,38,105,ND,Williams County,22241,21822,419,1.9
CN3900100000000,2022-12-01,39,001,OH,Adams County,10977,10296,681,6.2
CN3900300000000,2022-12-01,39,003,OH,Allen County,46097,44440,1657,3.6
CN3900500000000,2022-12-01,39,005,OH,Ashland County,25471,24492,979,3.8
CN3900700000000,2022-12-01,39,007,OH,Ashtabula County,42239,40471,1768,4.2
CN3900900000000,2022-12-01,39,009,OH,Athens County,25936,24811,1125,4.3
CN3901100000000,2022-12-01,39,011,OH,Auglaize County,23759,23194,565,2.4
CN3901300000000,2022-12-01,39,013,OH,Belmont County,26918,25617,1301,4.8
CN3901500000000,2022-12-01,39,015,OH,Brown County,19588,18735,853,4.4
CN3901700000000,2022-12-01,39,017,OH,Butler County,196499,190612,5887,3
CN3901900000000,2022-12-01,39,019,OH,Carroll County,12581,12071,510,4.1
CN3902100000000,2022-12-01,39,021,OH,Champaign County,18913,18331,582,3.1
CN3902300000000,2022-12-01,39,023,OH,Clark County,62335,60116,2219,3.6
CN3902500000000,2022-12-01,39,025,OH,Clermont County,107897,104598,3299,3.1
CN3902700000000,2022-12-01,39,027,OH,Clinton County,17815,17082,733,4.1
CN3902900000000,2022-12-01,39,029,OH,Columbiana County,44133,42272,1861,4.2
CN3903100000000,2022-12-01,39,031,OH,Coshocton County,13473,12876,597,4.4
CN3903300000000,2022-12-01,39,033,OH,Crawford County,17519,16773,746,4.3
CN3903500000000,2022-12-01,39,035,OH,Cuyahoga County,590742,569911,20831,3.5
CN3903700000000,2022-12-01,39,037,OH,Darke County,25316,24535,781,3.1
CN3903900000000,2022-12-01,39,039,OH,Defiance County,17186,16602,584,3.4
CN3904100000000,2022-12-01,39,041,OH,Delaware County,115103,112095,3008,2.6
CN3904300000000,2022-12-01,39,043,OH,Erie County,34579,32992,1587,4.6
CN3904500000000,2022-12-01,39,045,OH,Fairfield County,80028,77549,2479,3.1
CN3904700000000,2022-12-01,39,047,OH,Fayette County,13812,13288,524,3.8
CN3904900000000,2022-12-01,39,049,OH,Franklin County,705008,683763,21245,3
CN3905100000000,2022-12-01,39,051,OH,Fulton County,21730,20893,837,3.9
CN3905300000000,2022-12-01,39,053,OH,Gallia County,12057,11519,538,4.5
CN3905500000000,2022-12-01,39,055,OH,Geauga County,47974,46560,1414,2.9
CN3905700000000,2022-12-01,39,057,OH,Greene County,82019,79472,2547,3.1
CN3905900000000,2022-12-01,39,059,OH,Guernsey County,17442,16586,856,4.9
CN3906100000000,2022-12-01,39,061,OH,Hamilton County,416040,403629,12411,3
CN3906300000000,2022-12-01,39,063,OH,Hancock County,39739,38654,1085,2.7
CN3906500000000,2022-12-01,39,065,OH,Hardin County,12549,12109,440,3.5
CN3906700000000,2022-12-01,39,067,OH,Harrison County,6379,6052,327,5.1
CN3906900000000,2022-12-01,39,069,OH,Henry County,12622,12019,603,4.8
CN3907100000000,2022-12-01,39,071,OH,Highland County,17539,16454,1085,6.2
CN3907300000000,2022-12-01,39,073,OH,Hocking County,12929,12426,503,3.9
CN3907500000000,2022-12-01,39,075,OH,Holmes County,21925,21153,772,3.5
CN3907700000000,2022-12-01,39,077,OH,Huron County,27320,25834,1486,5.4
CN3907900000000,2022-12-01,39,079,OH,Jackson County,12252,11663,589,4.8
CN3908100000000,2022-12-01,39,081,OH,Jefferson County,26762,25425,1337,5
CN3908300000000,2022-12-01,39,083,OH,Knox County,30659,29693,966,3.2
CN3908500000000,2022-12-01,39,085,OH,Lake County,123306,119250,4056,3.3
CN3908700000000,2022-12-01,39,087,OH,Lawrence County,23238,22284,954,4.1
CN3908900000000,2022-12-01,39,089,OH,Licking County,91694,88960,2734,3
CN3909100000000,2022-12-01,39,091,OH,Logan County,22542,21832,710,3.1
CN3909300000000,2022-12-01,39,093,OH,Lorain County,151436,146157,5279,3.5
CN3909500000000,2022-12-01,39,095,OH,Lucas County,202429,194183,8246,4.1
CN3909700000000,2022-12-01,39,097,OH,Madison County,20973,20384,589,2.8
CN3909900000000,2022-12-01,39,099,OH,Mahoning County,97469,93330,4139,4.2
CN3910100000000,2022-12-01,39,101,OH,Marion County,26745,25838,907,3.4
CN3910300000000,2022-12-01,39,103,OH,Medina County,96684,93773,2911,3
CN3910500000000,2022-12-01,39,105,OH,Meigs County,8437,7946,491,5.8
CN3910700000000,2022-12-01,39,107,OH,Mercer County,22575,22096,479,2.1
CN3910900000000,2022-12-01,39,109,OH,Miami County,53331,51658,1673,3.1
CN3911100000000,2022-12-01,39,111,OH,Monroe County,5157,4832,325,6.3
CN3911300000000,2022-12-01,39,113,OH,Montgomery County,245067,236186,8881,3.6
CN3911500000000,2022-12-01,39,115,OH,Morgan County,6793,6408,385,5.7
CN3911700000000,2022-12-01,39,117,OH,Morrow County,17009,16393,616,3.6
CN3911900000000,2022-12-01,39,119,OH,Muskingum County,40597,38936,1661,4.1
CN3912100000000,2022-12-01,39,121,OH,Noble County,4521,4233,288,6.4
CN3912300000000,2022-12-01,39,123,OH,Ottawa County,19660,18395,1265,6.4
CN3912500000000,2022-12-01,39,125,OH,Paulding County,8580,8354,226,2.6
CN3912700000000,2022-12-01,39,127,OH,Perry County,15946,15280,666,4.2
CN3912900000000,2022-12-01,39,129,OH,Pickaway County,26766,25878,888,3.3
CN3913100000000,2022-12-01,39,131,OH,Pike County,10883,10321,562,5.2
CN3913300000000,2022-12-01,39,133,OH,Portage County,84208,81198,3010,3.6
CN3913500000000,2022-12-01,39,135,OH,Preble County,21647,21010,637,2.9
CN3913700000000,2022-12-01,39,137,OH,Putnam County,18679,18155,524,2.8
CN3913900000000,2022-12-01,39,139,OH,Richland County,50396,48189,2207,4.4
CN3914100000000,2022-12-01,39,141,OH,Ross County,35009,33790,1219,3.5
CN3914300000000,2022-12-01,39,143,OH,Sandusky County,29305,28143,1162,4
CN3914500000000,2022-12-01,39,145,OH,Scioto County,29178,27709,1469,5
CN3914700000000,2022-12-01,39,147,OH,Seneca County,25805,24843,962,3.7
CN3914900000000,2022-12-01,39,149,OH,Shelby County,23199,22533,666,2.9
CN3915100000000,2022-12-01,39,151,OH,Stark County,180041,173334,6707,3.7
CN3915300000000,2022-12-01,39,153,OH,Summit County,261892,251958,9934,3.8
CN3915500000000,2022-12-01,39,155,OH,Trumbull County,82419,78733,3686,4.5
CN3915700000000,2022-12-01,39,157,OH,Tuscarawas County,44258,42484,1774,4
CN3915900000000,2022-12-01,39,159,OH,Union County,30215,29422,793,2.6
CN3916100000000,2022-12-01,39,161,OH,Van Wert County,14138,13767,371,2.6
CN3916300000000,2022-12-01,39,163,OH,Vinton County,5362,5062,300,5.6
CN3916500000000,2022-12-01,39,165,OH,Warren County,122390,118930,3460,2.8
CN3916700000000,2022-12-01,39,167,OH,Washington County,26245,25042,1203,4.6
CN3916900000000,2022-12-01,39,169,OH,Wayne County,59741,58003,1738,2.9
CN3917100000000,2022-12-01,39,171,OH,Williams County,17952,17440,512,2.9
CN3917300000000,2022-12-01,39,173,OH,Wood County,69115,66965,2150,3.1
CN3917500000000,2022-12-01,39,175,OH,Wyandot County,13126,12811,315,2.4
CN4000100000000,2022-12-01,40,001,OK,Adair County,8604,8362,242,2.8
CN4000300000000,2022-12-01,40,003,OK,Alfalfa County,2697,2642,55,2
CN4000500000000,2022-12-01,40,005,OK,Atoka County,5121,4956,165,3.2
CN4000700000000,2022-12-01,40,007,OK,Beaver County,2580,2538,42,1.6
CN4000900000000,2022-12-01,40,009,OK,Beckham County,10333,10107,226,2.2
CN4001100000000,2022-12-01,40,011,OK,Blaine County,4385,4308,77,1.8
CN4001300000000,2022-12-01,40,013,OK,Bryan County,23259,22715,544,2.3
CN4001500000000,2022-12-01,40,015,OK,Caddo County,11671,11336,335,2.9
CN4001700000000,2022-12-01,40,017,OK,Canadian County,80999,79243,1756,2.2
CN4001900000000,2022-12-01,40,019,OK,Carter County,21348,20712,636,3
CN4002100000000,2022-12-01,40,021,OK,Cherokee County,19832,19243,589,3
CN4002300000000,2022-12-01,40,023,OK,Choctaw County,6037,5763,274,4.5
CN4002500000000,2022-12-01,40,025,OK,Cimarron County,1629,1611,18,1.1
CN4002700000000,2022-12-01,40,027,OK,Cleveland County,149096,145908,3188,2.1
CN4002900000000,2022-12-01,40,029,OK,Coal County,2388,2324,64,2.7
CN4003100000000,2022-12-01,40,031,OK,Comanche County,47226,45717,1509,3.2
CN4003300000000,2022-12-01,40,033,OK,Cotton County,2680,2600,80,3
CN4003500000000,2022-12-01,40,035,OK,Craig County,5913,5765,148,2.5
CN4003700000000,2022-12-01,40,037,OK,Creek County,31321,30400,921,2.9
CN4003900000000,2022-12-01,40,039,OK,Custer County,15090,14785,305,2
CN4004100000000,2022-12-01,40,041,OK,Delaware County,19961,19426,535,2.7
CN4004300000000,2022-12-01,40,043,OK,Dewey County,3043,2993,50,1.6
CN4004500000000,2022-12-01,40,045,OK,Ellis County,2072,2031,41,2
CN4004700000000,2022-12-01,40,047,OK,Garfield County,26077,25401,676,2.6
CN4004900000000,2022-12-01,40,049,OK,Garvin County,12811,12459,352,2.7
CN4005100000000,2022-12-01,40,051,OK,Grady County,27515,26842,673,2.4
CN4005300000000,2022-12-01,40,053,OK,Grant County,2731,2686,45,1.6
CN4005500000000,2022-12-01,40,055,OK,Greer County,1828,1773,55,3
CN4005700000000,2022-12-01,40,057,OK,Harmon County,1187,1157,30,2.5
CN4005900000000,2022-12-01,40,059,OK,Harper County,1800,1773,27,1.5
CN4006100000000,2022-12-01,40,061,OK,Haskell County,4145,3987,158,3.8
CN4006300000000,2022-12-01,40,063,OK,Hughes County,5199,5029,170,3.3
CN4006500000000,2022-12-01,40,065,OK,Jackson County,10764,10522,242,2.2
CN4006700000000,2022-12-01,40,067,OK,Jefferson County,2476,2403,73,2.9
CN4006900000000,2022-12-01,40,069,OK,Johnston County,3781,3655,126,3.3
CN4007100000000,2022-12-01,40,071,OK,Kay County,18503,17933,570,3.1
CN4007300000000,2022-12-01,40,073,OK,Kingfisher County,9018,8871,147,1.6
CN4007500000000,2022-12-01,40,075,OK,Kiowa County,3601,3498,103,2.9
CN4007700000000,2022-12-01,40,077,OK,Latimer County,3129,2967,162,5.2
CN4007900000000,2022-12-01,40,079,OK,Le Flore County,19596,18996,600,3.1
CN4008100000000,2022-12-01,40,081,OK,Lincoln County,16271,15835,436,2.7
CN4008300000000,2022-12-01,40,083,OK,Logan County,23507,22952,555,2.4
CN4008500000000,2022-12-01,40,085,OK,Love County,5817,5696,121,2.1
CN4008700000000,2022-12-01,40,087,OK,McClain County,21041,20550,491,2.3
CN4008900000000,2022-12-01,40,089,OK,McCurtain County,15725,15155,570,3.6
CN4009100000000,2022-12-01,40,091,OK,McIntosh County,7203,6873,330,4.6
CN4009300000000,2022-12-01,40,093,OK,Major County,3812,3727,85,2.2
CN4009500000000,2022-12-01,40,095,OK,Marshall County,7201,6999,202,2.8
CN4009700000000,2022-12-01,40,097,OK,Mayes County,19703,19117,586,3
CN4009900000000,2022-12-01,40,099,OK,Murray County,5994,5844,150,2.5
CN4010100000000,2022-12-01,40,101,OK,Muskogee County,28664,27779,885,3.1
CN4010300000000,2022-12-01,40,103,OK,Noble County,5821,5716,105,1.8
CN4010500000000,2022-12-01,40,105,OK,Nowata County,4739,4621,118,2.5
CN4010700000000,2022-12-01,40,107,OK,Okfuskee County,4420,4258,162,3.7
CN4010900000000,2022-12-01,40,109,OK,Oklahoma County,400311,389933,10378,2.6
CN4011100000000,2022-12-01,40,111,OK,Okmulgee County,15570,14985,585,3.8
CN4011300000000,2022-12-01,40,113,OK,Osage County,20514,19872,642,3.1
CN4011500000000,2022-12-01,40,115,OK,Ottawa County,15423,15052,371,2.4
CN4011700000000,2022-12-01,40,117,OK,Pawnee County,7354,7112,242,3.3
CN4011900000000,2022-12-01,40,119,OK,Payne County,39222,38330,892,2.3
CN4012100000000,2022-12-01,40,121,OK,Pittsburg County,16362,15748,614,3.8
CN4012300000000,2022-12-01,40,123,OK,Pontotoc County,19505,19069,436,2.2
CN4012500000000,2022-12-01,40,125,OK,Pottawatomie County,33269,32271,998,3
CN4012700000000,2022-12-01,40,127,OK,Pushmataha County,4582,4415,167,3.6
CN4012900000000,2022-12-01,40,129,OK,Roger Mills County,1814,1782,32,1.8
CN4013100000000,2022-12-01,40,131,OK,Rogers County,45447,44344,1103,2.4
CN4013300000000,2022-12-01,40,133,OK,Seminole County,9237,8905,332,3.6
CN4013500000000,2022-12-01,40,135,OK,Sequoyah County,16846,16354,492,2.9
CN4013700000000,2022-12-01,40,137,OK,Stephens County,19388,18833,555,2.9
CN4013900000000,2022-12-01,40,139,OK,Texas County,11906,11739,167,1.4
CN4014100000000,2022-12-01,40,141,OK,Tillman County,2979,2861,118,4
CN4014300000000,2022-12-01,40,143,OK,Tulsa County,325575,317060,8515,2.6
CN4014500000000,2022-12-01,40,145,OK,Wagoner County,39118,38079,1039,2.7
CN4014700000000,2022-12-01,40,147,OK,Washington County,22105,21466,639,2.9
CN4014900000000,2022-12-01,40,149,OK,Washita County,5362,5236,126,2.3
CN4015100000000,2022-12-01,40,151,OK,Woods County,4615,4550,65,1.4
CN4015300000000,2022-12-01,40,153,OK,Woodward County,8594,8383,211,2.5
CN4100100000000,2022-12-01,41,001,OR,Baker County,7337,6902,435,5.9
CN4100300000000,2022-12-01,41,003,OR,Benton County,49857,48034,1823,3.7
CN4100500000000,2022-12-01,41,005,OR,Clackamas County,227914,218759,9155,4
CN4100700000000,2022-12-01,41,007,OR,Clatsop County,19074,18126,948,5
CN4100900000000,2022-12-01,41,009,OR,Columbia County,25384,24043,1341,5.3
CN4101100000000,2022-12-01,41,011,OR,Coos County,26473,24910,1563,5.9
CN4101300000000,2022-12-01,41,013,OR,Crook County,11153,10391,762,6.8
CN4101500000000,2022-12-01,41,015,OR,Curry County,8871,8313,558,6.3
CN4101700000000,2022-12-01,41,017,OR,Deschutes County,103082,97988,5094,4.9
CN4101900000000,2022-12-01,41,019,OR,Douglas County,47351,44560,2791,5.9
CN4102100000000,2022-12-01,41,021,OR,Gilliam County,1026,987,39,3.8
CN4102300000000,2022-12-01,41,023,OR,Grant County,3162,2925,237,7.5
CN4102500000000,2022-12-01,41,025,OR,Harney County,3696,3459,237,6.4
CN4102700000000,2022-12-01,41,027,OR,Hood River County,14174,13644,530,3.7
CN4102900000000,2022-12-01,41,029,OR,Jackson County,106225,100734,5491,5.2
CN4103100000000,2022-12-01,41,031,OR,Jefferson County,10228,9572,656,6.4
CN4103300000000,2022-12-01,41,033,OR,Josephine County,36851,34437,2414,6.6
CN4103500000000,2022-12-01,41,035,OR,Klamath County,30210,28007,2203,7.3
CN4103700000000,2022-12-01,41,037,OR,Lake County,3630,3391,239,6.6
CN4103900000000,2022-12-01,41,039,OR,Lane County,182218,173156,9062,5
CN4104100000000,2022-12-01,41,041,OR,Lincoln County,20214,18952,1262,6.2
CN4104300000000,2022-12-01,41,043,OR,Linn County,61687,58602,3085,5
CN4104500000000,2022-12-01,41,045,OR,Malheur County,12458,11815,643,5.2
CN4104700000000,2022-12-01,41,047,OR,Marion County,170514,162761,7753,4.5
CN4104900000000,2022-12-01,41,049,OR,Morrow County,5819,5561,258,4.4
CN4105100000000,2022-12-01,41,051,OR,Multnomah County,471278,451627,19651,4.2
CN4105300000000,2022-12-01,41,053,OR,Polk County,42901,40995,1906,4.4
CN4105500000000,2022-12-01,41,055,OR,Sherman County,958,924,34,3.5
CN4105700000000,2022-12-01,41,057,OR,Tillamook County,11708,11109,599,5.1
CN4105900000000,2022-12-01,41,059,OR,Umatilla County,37588,35615,1973,5.2
CN4106100000000,2022-12-01,41,061,OR,Union County,12013,11370,643,5.4
CN4106300000000,2022-12-01,41,063,OR,Wallowa County,3479,3228,251,7.2
CN4106500000000,2022-12-01,41,065,OR,Wasco County,12933,12245,688,5.3
CN4106700000000,2022-12-01,41,067,OR,Washington County,337652,325225,12427,3.7
CN4106900000000,2022-12-01,41,069,OR,Wheeler County,727,701,26,3.6
CN4107100000000,2022-12-01,41,071,OR,Yamhill County,56508,54197,2311,4.1
CN4200100000000,2022-12-01,42,001,PA,Adams County,54765,53259,1506,2.7
CN4200300000000,2022-12-01,42,003,PA,Allegheny County,626424,602993,23431,3.7
CN4200500000000,2022-12-01,42,005,PA,Armstrong County,30985,29462,1523,4.9
CN4200700000000,2022-12-01,42,007,PA,Beaver County,81594,77281,4313,5.3
CN4200900000000,2022-12-01,42,009,PA,Bedford County,24339,23168,1171,4.8
CN4201100000000,2022-12-01,42,011,PA,Berks County,213661,205901,7760,3.6
CN4201300000000,2022-12-01,42,013,PA,Blair County,58471,56083,2388,4.1
CN4201500000000,2022-12-01,42,015,PA,Bradford County,27818,26752,1066,3.8
CN4201700000000,2022-12-01,42,017,PA,Bucks County,349620,338038,11582,3.3
CN4201900000000,2022-12-01,42,019,PA,Butler County,98082,94349,3733,3.8
CN4202100000000,2022-12-01,42,021,PA,Cambria County,55116,52380,2736,5
CN4202300000000,2022-12-01,42,023,PA,Cameron County,1920,1801,119,6.2
CN4202500000000,2022-12-01,42,025,PA,Carbon County,32499,31037,1462,4.5
CN4202700000000,2022-12-01,42,027,PA,Centre County,79725,77175,2550,3.2
CN4202900000000,2022-12-01,42,029,PA,Chester County,295158,287140,8018,2.7
CN4203100000000,2022-12-01,42,031,PA,Clarion County,15620,14862,758,4.9
CN4203300000000,2022-12-01,42,033,PA,Clearfield County,34849,32958,1891,5.4
CN4203500000000,2022-12-01,42,035,PA,Clinton County,16881,16000,881,5.2
CN4203700000000,2022-12-01,42,037,PA,Columbia County,33962,32530,1432,4.2
CN4203900000000,2022-12-01,42,039,PA,Crawford County,37421,35741,1680,4.5
CN4204100000000,2022-12-01,42,041,PA,Cumberland County,134968,131118,3850,2.9
CN4204300000000,2022-12-01,42,043,PA,Dauphin County,145947,140955,4992,3.4
CN4204500000000,2022-12-01,42,045,PA,Delaware County,301114,290539,10575,3.5
CN4204700000000,2022-12-01,42,047,PA,Elk County,14105,13514,591,4.2
CN4204900000000,2022-12-01,42,049,PA,Erie County,124734,119073,5661,4.5
CN4205100000000,2022-12-01,42,051,PA,Fayette County,54761,51612,3149,5.8
CN4205300000000,2022-12-01,42,053,PA,Forest County,1648,1533,115,7
CN4205500000000,2022-12-01,42,055,PA,Franklin County,77988,75460,2528,3.2
CN4205700000000,2022-12-01,42,057,PA,Fulton County,7198,6929,269,3.7
CN4205900000000,2022-12-01,42,059,PA,Greene County,15194,14498,696,4.6
CN4206100000000,2022-12-01,42,061,PA,Huntingdon County,19106,17945,1161,6.1
CN4206300000000,2022-12-01,42,063,PA,Indiana County,36063,34329,1734,4.8
CN4206500000000,2022-12-01,42,065,PA,Jefferson County,19173,18259,914,4.8
CN4206700000000,2022-12-01,42,067,PA,Juniata County,12276,11714,562,4.6
CN4206900000000,2022-12-01,42,069,PA,Lackawanna County,105345,101003,4342,4.1
CN4207100000000,2022-12-01,42,071,PA,Lancaster County,289123,280818,8305,2.9
CN4207300000000,2022-12-01,42,073,PA,Lawrence County,38700,36653,2047,5.3
CN4207500000000,2022-12-01,42,075,PA,Lebanon County,73680,71455,2225,3
CN4207700000000,2022-12-01,42,077,PA,Lehigh County,196787,189353,7434,3.8
CN4207900000000,2022-12-01,42,079,PA,Luzerne County,158638,151100,7538,4.8
CN4208100000000,2022-12-01,42,081,PA,Lycoming County,54990,52610,2380,4.3
CN4208300000000,2022-12-01,42,083,PA,McKean County,16594,15709,885,5.3
CN4208500000000,2022-12-01,42,085,PA,Mercer County,47223,45109,2114,4.5
CN4208700000000,2022-12-01,42,087,PA,Mifflin County,20871,19921,950,4.6
CN4208900000000,2022-12-01,42,089,PA,Monroe County,82029,77828,4201,5.1
CN4209100000000,2022-12-01,42,091,PA,Montgomery County,465058,451257,13801,3
CN4209300000000,2022-12-01,42,093,PA,Montour County,9231,8947,284,3.1
CN4209500000000,2022-12-01,42,095,PA,Northampton County,163993,157993,6000,3.7
CN4209700000000,2022-12-01,42,097,PA,Northumberland County,41257,39326,1931,4.7
CN4209900000000,2022-12-01,42,099,PA,Perry County,24782,23977,805,3.2
CN4210100000000,2022-12-01,42,101,PA,Philadelphia County/city,730604,697227,33377,4.6
CN4210300000000,2022-12-01,42,103,PA,Pike County,25674,24307,1367,5.3
CN4210500000000,2022-12-01,42,105,PA,Potter County,6780,6364,416,6.1
CN4210700000000,2022-12-01,42,107,PA,Schuylkill County,65315,62398,2917,4.5
CN4210900000000,2022-12-01,42,109,PA,Snyder County,19693,18874,819,4.2
CN4211100000000,2022-12-01,42,111,PA,Somerset County,32195,30454,1741,5.4
CN4211300000000,2022-12-01,42,113,PA,Sullivan County,2516,2403,113,4.5
CN4211500000000,2022-12-01,42,115,PA,Susquehanna County,20055,19282,773,3.9
CN4211700000000,2022-12-01,42,117,PA,Tioga County,18704,17820,884,4.7
CN4211900000000,2022-12-01,42,119,PA,Union County,19254,18626,628,3.3
CN4212100000000,2022-12-01,42,121,PA,Venango County,20868,19834,1034,5
CN4212300000000,2022-12-01,42,123,PA,Warren County,17330,16453,877,5.1
CN4212500000000,2022-12-01,42,125,PA,Washington County,103762,99616,4146,4
CN4212700000000,2022-12-01,42,127,PA,Wayne County,22090,21020,1070,4.8
CN4212900000000,2022-12-01,42,129,PA,Westmoreland County,174372,167159,7213,4.1
CN4213100000000,2022-12-01,42,131,PA,Wyoming County,13588,12996,592,4.4
CN4213300000000,2022-12-01,42,133,PA,York County,237742,230126,7616,3.2
CN4400100000000,2022-12-01,44,001,RI,Bristol County,26230,25734,496,1.9
CN4400300000000,2022-12-01,44,003,RI,Kent County,92469,90568,1901,2.1
CN4400500000000,2022-12-01,44,005,RI,Newport County,44597,43665,932,2.1
CN4400700000000,2022-12-01,44,007,RI,Providence County,329939,321508,8431,2.6
CN4400900000000,2022-12-01,44,009,RI,Washington County,69346,67994,1352,1.9
CN4500100000000,2022-12-01,45,001,SC,Abbeville County,9490,9161,329,3.5
CN4500300000000,2022-12-01,45,003,SC,Aiken County,71954,69814,2140,3
CN4500500000000,2022-12-01,45,005,SC,Allendale County,2201,2077,124,5.6
CN4500700000000,2022-12-01,45,007,SC,Anderson County,90821,88332,2489,2.7
CN4500900000000,2022-12-01,45,009,SC,Bamberg County,4462,4249,213,4.8
CN4501100000000,2022-12-01,45,011,SC,Barnwell County,7333,7024,309,4.2
CN4501300000000,2022-12-01,45,013,SC,Beaufort County,75873,73634,2239,3
CN4501500000000,2022-12-01,45,015,SC,Berkeley County,109916,106942,2974,2.7
CN4501700000000,2022-12-01,45,017,SC,Calhoun County,6295,6085,210,3.3
CN4501900000000,2022-12-01,45,019,SC,Charleston County,215648,210308,5340,2.5
CN4502100000000,2022-12-01,45,021,SC,Cherokee County,24053,23181,872,3.6
CN4502300000000,2022-12-01,45,023,SC,Chester County,13232,12710,522,3.9
CN4502500000000,2022-12-01,45,025,SC,Chesterfield County,20689,20000,689,3.3
CN4502700000000,2022-12-01,45,027,SC,Clarendon County,11640,11124,516,4.4
CN4502900000000,2022-12-01,45,029,SC,Colleton County,15625,15117,508,3.3
CN4503100000000,2022-12-01,45,031,SC,Darlington County,29441,28489,952,3.2
CN4503300000000,2022-12-01,45,033,SC,Dillon County,12651,12086,565,4.5
CN4503500000000,2022-12-01,45,035,SC,Dorchester County,79655,77628,2027,2.5
CN4503700000000,2022-12-01,45,037,SC,Edgefield County,10032,9712,320,3.2
CN4503900000000,2022-12-01,45,039,SC,Fairfield County,9044,8667,377,4.2
CN4504100000000,2022-12-01,45,041,SC,Florence County,65525,63636,1889,2.9
CN4504300000000,2022-12-01,45,043,SC,Georgetown County,25347,24443,904,3.6
CN4504500000000,2022-12-01,45,045,SC,Greenville County,258383,251722,6661,2.6
CN4504700000000,2022-12-01,45,047,SC,Greenwood County,29778,28779,999,3.4
CN4504900000000,2022-12-01,45,049,SC,Hampton County,7703,7493,210,2.7
CN4505100000000,2022-12-01,45,051,SC,Horry County,147297,141572,5725,3.9
CN4505300000000,2022-12-01,45,053,SC,Jasper County,13030,12674,356,2.7
CN4505500000000,2022-12-01,45,055,SC,Kershaw County,28898,28023,875,3
CN4505700000000,2022-12-01,45,057,SC,Lancaster County,43284,41839,1445,3.3
CN4505900000000,2022-12-01,45,059,SC,Laurens County,29806,28893,913,3.1
CN4506100000000,2022-12-01,45,061,SC,Lee County,6267,5982,285,4.5
CN4506300000000,2022-12-01,45,063,SC,Lexington County,149199,145450,3749,2.5
CN4506500000000,2022-12-01,45,065,SC,McCormick County,3535,3422,113,3.2
CN4506700000000,2022-12-01,45,067,SC,Marion County,12288,11729,559,4.5
CN4506900000000,2022-12-01,45,069,SC,Marlboro County,8162,7532,630,7.7
CN4507100000000,2022-12-01,45,071,SC,Newberry County,18748,18256,492,2.6
CN4507300000000,2022-12-01,45,073,SC,Oconee County,33564,32627,937,2.8
CN4507500000000,2022-12-01,45,075,SC,Orangeburg County,32408,31014,1394,4.3
CN4507700000000,2022-12-01,45,077,SC,Pickens County,57523,55960,1563,2.7
CN4507900000000,2022-12-01,45,079,SC,Richland County,194739,189038,5701,2.9
CN4508100000000,2022-12-01,45,081,SC,Saluda County,8124,7892,232,2.9
CN4508300000000,2022-12-01,45,083,SC,Spartanburg County,153390,148976,4414,2.9
CN4508500000000,2022-12-01,45,085,SC,Sumter County,41488,39835,1653,4
CN4508700000000,2022-12-01,45,087,SC,Union County,11123,10641,482,4.3
CN4508900000000,2022-12-01,45,089,SC,Williamsburg County,10434,9950,484,4.6
CN4509100000000,2022-12-01,45,091,SC,York County,147261,143130,4131,2.8
CN4600300000000,2022-12-01,46,003,SD,Aurora County,1497,1467,30,2
CN4600500000000,2022-12-01,46,005,SD,Beadle County,9272,9082,190,2
CN4600700000000,2022-12-01,46,007,SD,Bennett County,1084,1043,41,3.8
CN4600900000000,2022-12-01,46,009,SD,Bon Homme County,2812,2752,60,2.1
CN4601100000000,2022-12-01,46,011,SD,Brookings County,19282,18875,407,2.1
CN4601300000000,2022-12-01,46,013,SD,Brown County,19909,19456,453,2.3
CN4601500000000,2022-12-01,46,015,SD,Brule County,2640,2597,43,1.6
CN4601700000000,2022-12-01,46,017,SD,Buffalo County,728,687,41,5.6
CN4601900000000,2022-12-01,46,019,SD,Butte County,5014,4905,109,2.2
CN4602100000000,2022-12-01,46,021,SD,Campbell County,773,749,24,3.1
CN4602300000000,2022-12-01,46,023,SD,Charles Mix County,3751,3665,86,2.3
CN4602500000000,2022-12-01,46,025,SD,Clark County,1921,1876,45,2.3
CN4602700000000,2022-12-01,46,027,SD,Clay County,7397,7237,160,2.2
CN4602900000000,2022-12-01,46,029,SD,Codington County,15884,15565,319,2
CN4603100000000,2022-12-01,46,031,SD,Corson County,1285,1244,41,3.2
CN4603300000000,2022-12-01,46,033,SD,Custer County,4216,4083,133,3.2
CN4603500000000,2022-12-01,46,035,SD,Davison County,11033,10819,214,1.9
CN4603700000000,2022-12-01,46,037,SD,Day County,2597,2509,88,3.4
CN4603900000000,2022-12-01,46,039,SD,Deuel County,2272,2180,92,4
CN4604100000000,2022-12-01,46,041,SD,Dewey County,2295,2179,116,5.1
CN4604300000000,2022-12-01,46,043,SD,Douglas County,1513,1479,34,2.2
CN4604500000000,2022-12-01,46,045,SD,Edmunds County,1985,1946,39,2
CN4604700000000,2022-12-01,46,047,SD,Fall River County,2972,2897,75,2.5
CN4604900000000,2022-12-01,46,049,SD,Faulk County,1101,1080,21,1.9
CN4605100000000,2022-12-01,46,051,SD,Grant County,4407,4255,152,3.4
CN4605300000000,2022-12-01,46,053,SD,Gregory County,2168,2123,45,2.1
CN4605500000000,2022-12-01,46,055,SD,Haakon County,1089,1068,21,1.9
CN4605700000000,2022-12-01,46,057,SD,Hamlin County,3595,3514,81,2.3
CN4605900000000,2022-12-01,46,059,SD,Hand County,1795,1761,34,1.9
CN4606100000000,2022-12-01,46,061,SD,Hanson County,1783,1732,51,2.9
CN4606300000000,2022-12-01,46,063,SD,Harding County,759,746,13,1.7
CN4606500000000,2022-12-01,46,065,SD,Hughes County,9771,9602,169,1.7
CN4606700000000,2022-12-01,46,067,SD,Hutchinson County,3623,3531,92,2.5
CN4606900000000,2022-12-01,46,069,SD,Hyde County,649,636,13,2
CN4607100000000,2022-12-01,46,071,SD,Jackson County,1163,1112,51,4.4
CN4607300000000,2022-12-01,46,073,SD,Jerauld County,1268,1251,17,1.3
CN4607500000000,2022-12-01,46,075,SD,Jones County,494,479,15,3
CN4607700000000,2022-12-01,46,077,SD,Kingsbury County,2719,2665,54,2
CN4607900000000,2022-12-01,46,079,SD,Lake County,6727,6603,124,1.8
CN4608100000000,2022-12-01,46,081,SD,Lawrence County,13900,13611,289,2.1
CN4608300000000,2022-12-01,46,083,SD,Lincoln County,37380,36753,627,1.7
CN4608500000000,2022-12-01,46,085,SD,Lyman County,1672,1623,49,2.9
CN4608700000000,2022-12-01,46,087,SD,McCook County,3114,3056,58,1.9
CN4608900000000,2022-12-01,46,089,SD,McPherson County,968,944,24,2.5
CN4609100000000,2022-12-01,46,091,SD,Marshall County,2503,2428,75,3
CN4609300000000,2022-12-01,46,093,SD,Meade County,14372,14068,304,2.1
CN4609500000000,2022-12-01,46,095,SD,Mellette County,750,726,24,3.2
CN4609700000000,2022-12-01,46,097,SD,Miner County,1236,1213,23,1.9
CN4609900000000,2022-12-01,46,099,SD,Minnehaha County,116198,113883,2315,2
CN4610100000000,2022-12-01,46,101,SD,Moody County,3958,3883,75,1.9
CN4610200000000,2022-12-01,46,102,SD,Oglala Lakota County,3726,3551,175,4.7
CN4610300000000,2022-12-01,46,103,SD,Pennington County,59139,57918,1221,2.1
CN4610500000000,2022-12-01,46,105,SD,Perkins County,1429,1393,36,2.5
CN4610700000000,2022-12-01,46,107,SD,Potter County,1046,1022,24,2.3
CN4610900000000,2022-12-01,46,109,SD,Roberts County,4624,4412,212,4.6
CN4611100000000,2022-12-01,46,111,SD,Sanborn County,1217,1191,26,2.1
CN4611500000000,2022-12-01,46,115,SD,Spink County,3012,2946,66,2.2
CN4611700000000,2022-12-01,46,117,SD,Stanley County,1907,1871,36,1.9
CN4611900000000,2022-12-01,46,119,SD,Sully County,808,797,11,1.4
CN4612100000000,2022-12-01,46,121,SD,Todd County,2970,2861,109,3.7
CN4612300000000,2022-12-01,46,123,SD,Tripp County,3122,3066,56,1.8
CN4612500000000,2022-12-01,46,125,SD,Turner County,4774,4667,107,2.2
CN4612700000000,2022-12-01,46,127,SD,Union County,8712,8519,193,2.2
CN4612900000000,2022-12-01,46,129,SD,Walworth County,2101,2015,86,4.1
CN4613500000000,2022-12-01,46,135,SD,Yankton County,11642,11439,203,1.7
CN4613700000000,2022-12-01,46,137,SD,Ziebach County,958,922,36,3.8
CN4700100000000,2022-12-01,47,001,TN,Anderson County,34740,33722,1018,2.9
CN4700300000000,2022-12-01,47,003,TN,Bedford County,21033,20380,653,3.1
CN4700500000000,2022-12-01,47,005,TN,Benton County,6489,6245,244,3.8
CN4700700000000,2022-12-01,47,007,TN,Bledsoe County,4307,4082,225,5.2
CN4700900000000,2022-12-01,47,009,TN,Blount County,64521,62735,1786,2.8
CN4701100000000,2022-12-01,47,011,TN,Bradley County,49296,47761,1535,3.1
CN4701300000000,2022-12-01,47,013,TN,Campbell County,14705,14164,541,3.7
CN4701500000000,2022-12-01,47,015,TN,Cannon County,6791,6615,176,2.6
CN4701700000000,2022-12-01,47,017,TN,Carroll County,11444,11038,406,3.5
CN4701900000000,2022-12-01,47,019,TN,Carter County,23656,22887,769,3.3
CN4702100000000,2022-12-01,47,021,TN,Cheatham County,22321,21814,507,2.3
CN4702300000000,2022-12-01,47,023,TN,Chester County,8374,8143,231,2.8
CN4702500000000,2022-12-01,47,025,TN,Claiborne County,12478,12038,440,3.5
CN4702700000000,2022-12-01,47,027,TN,Clay County,2757,2648,109,4
CN4702900000000,2022-12-01,47,029,TN,Cocke County,14207,13639,568,4
CN4703100000000,2022-12-01,47,031,TN,Coffee County,24651,23917,734,3
CN4703300000000,2022-12-01,47,033,TN,Crockett County,6676,6489,187,2.8
CN4703500000000,2022-12-01,47,035,TN,Cumberland County,23094,22082,1012,4.4
CN4703700000000,2022-12-01,47,037,TN,Davidson County,408875,399221,9654,2.4
CN4703900000000,2022-12-01,47,039,TN,Decatur County,4321,4140,181,4.2
CN4704100000000,2022-12-01,47,041,TN,DeKalb County,7815,7562,253,3.2
CN4704300000000,2022-12-01,47,043,TN,Dickson County,27673,26952,721,2.6
CN4704500000000,2022-12-01,47,045,TN,Dyer County,16290,15771,519,3.2
CN4704700000000,2022-12-01,47,047,TN,Fayette County,18781,18190,591,3.1
CN4704900000000,2022-12-01,47,049,TN,Fentress County,7621,7350,271,3.6
CN4705100000000,2022-12-01,47,051,TN,Franklin County,18466,17886,580,3.1
CN4705300000000,2022-12-01,47,053,TN,Gibson County,21312,20644,668,3.1
CN4705500000000,2022-12-01,47,055,TN,Giles County,14526,14113,413,2.8
CN4705700000000,2022-12-01,47,057,TN,Grainger County,9528,9213,315,3.3
CN4705900000000,2022-12-01,47,059,TN,Greene County,28166,26971,1195,4.2
CN4706100000000,2022-12-01,47,061,TN,Grundy County,4864,4673,191,3.9
CN4706300000000,2022-12-01,47,063,TN,Hamblen County,27764,26909,855,3.1
CN4706500000000,2022-12-01,47,065,TN,Hamilton County,180374,175226,5148,2.9
CN4706700000000,2022-12-01,47,067,TN,Hancock County,2230,2150,80,3.6
CN4706900000000,2022-12-01,47,069,TN,Hardeman County,8696,8367,329,3.8
CN4707100000000,2022-12-01,47,071,TN,Hardin County,9764,9411,353,3.6
CN4707300000000,2022-12-01,47,073,TN,Hawkins County,22841,22051,790,3.5
CN4707500000000,2022-12-01,47,075,TN,Haywood County,7356,7048,308,4.2
CN4707700000000,2022-12-01,47,077,TN,Henderson County,11458,11083,375,3.3
CN4707900000000,2022-12-01,47,079,TN,Henry County,13296,12824,472,3.5
CN4708100000000,2022-12-01,47,081,TN,Hickman County,11599,11302,297,2.6
CN4708300000000,2022-12-01,47,083,TN,Houston County,3160,3035,125,4
CN4708500000000,2022-12-01,47,085,TN,Humphreys County,8423,8170,253,3
CN4708700000000,2022-12-01,47,087,TN,Jackson County,4686,4514,172,3.7
CN4708900000000,2022-12-01,47,089,TN,Jefferson County,24672,23908,764,3.1
CN4709100000000,2022-12-01,47,091,TN,Johnson County,7399,7176,223,3
CN4709300000000,2022-12-01,47,093,TN,Knox County,247206,241089,6117,2.5
CN4709500000000,2022-12-01,47,095,TN,Lake County,1561,1493,68,4.4
CN4709700000000,2022-12-01,47,097,TN,Lauderdale County,9226,8840,386,4.2
CN4709900000000,2022-12-01,47,099,TN,Lawrence County,18867,18299,568,3
CN4710100000000,2022-12-01,47,101,TN,Lewis County,5398,5226,172,3.2
CN4710300000000,2022-12-01,47,103,TN,Lincoln County,16350,15886,464,2.8
CN4710500000000,2022-12-01,47,105,TN,Loudon County,23973,23283,690,2.9
CN4710700000000,2022-12-01,47,107,TN,McMinn County,20726,19924,802,3.9
CN4710900000000,2022-12-01,47,109,TN,McNairy County,8267,7919,348,4.2
CN4711100000000,2022-12-01,47,111,TN,Macon County,11494,11182,312,2.7
CN4711300000000,2022-12-01,47,113,TN,Madison County,48063,46654,1409,2.9
CN4711500000000,2022-12-01,47,115,TN,Marion County,12130,11679,451,3.7
CN4711700000000,2022-12-01,47,117,TN,Marshall County,15479,15051,428,2.8
CN4711900000000,2022-12-01,47,119,TN,Maury County,52400,51078,1322,2.5
CN4712100000000,2022-12-01,47,121,TN,Meigs County,5086,4866,220,4.3
CN4712300000000,2022-12-01,47,123,TN,Monroe County,20325,19687,638,3.1
CN4712500000000,2022-12-01,47,125,TN,Montgomery County,87115,84251,2864,3.3
CN4712700000000,2022-12-01,47,127,TN,Moore County,3688,3607,81,2.2
CN4712900000000,2022-12-01,47,129,TN,Morgan County,7754,7468,286,3.7
CN4713100000000,2022-12-01,47,131,TN,Obion County,12460,12036,424,3.4
CN4713300000000,2022-12-01,47,133,TN,Overton County,9691,9380,311,3.2
CN4713500000000,2022-12-01,47,135,TN,Perry County,2647,2529,118,4.5
CN4713700000000,2022-12-01,47,137,TN,Pickett County,2070,1996,74,3.6
CN4713900000000,2022-12-01,47,139,TN,Polk County,6939,6680,259,3.7
CN4714100000000,2022-12-01,47,141,TN,Putnam County,34939,33858,1081,3.1
CN4714300000000,2022-12-01,47,143,TN,Rhea County,13549,12967,582,4.3
CN4714500000000,2022-12-01,47,145,TN,Roane County,23403,22637,766,3.3
CN4714700000000,2022-12-01,47,147,TN,Robertson County,38852,37872,980,2.5
CN4714900000000,2022-12-01,47,149,TN,Rutherford County,193965,189509,4456,2.3
CN4715100000000,2022-12-01,47,151,TN,Scott County,7941,7597,344,4.3
CN4715300000000,2022-12-01,47,153,TN,Sequatchie County,6049,5833,216,3.6
CN4715500000000,2022-12-01,47,155,TN,Sevier County,53409,52054,1355,2.5
CN4715700000000,2022-12-01,47,157,TN,Shelby County,427645,411746,15899,3.7
CN4715900000000,2022-12-01,47,159,TN,Smith County,9644,9394,250,2.6
CN4716100000000,2022-12-01,47,161,TN,Stewart County,5461,5274,187,3.4
CN4716300000000,2022-12-01,47,163,TN,Sullivan County,67842,65718,2124,3.1
CN4716500000000,2022-12-01,47,165,TN,Sumner County,107745,105155,2590,2.4
CN4716700000000,2022-12-01,47,167,TN,Tipton County,27021,26175,846,3.1
CN4716900000000,2022-12-01,47,169,TN,Trousdale County,5679,5519,160,2.8
CN4717100000000,2022-12-01,47,171,TN,Unicoi County,6939,6666,273,3.9
CN4717300000000,2022-12-01,47,173,TN,Union County,7710,7446,264,3.4
CN4717500000000,2022-12-01,47,175,TN,Van Buren County,2034,1960,74,3.6
CN4717700000000,2022-12-01,47,177,TN,Warren County,16122,15563,559,3.5
CN4717900000000,2022-12-01,47,179,TN,Washington County,60546,58751,1795,3
CN4718100000000,2022-12-01,47,181,TN,Wayne County,6336,6075,261,4.1
CN4718300000000,2022-12-01,47,183,TN,Weakley County,14964,14537,427,2.9
CN4718500000000,2022-12-01,47,185,TN,White County,11867,11481,386,3.3
CN4718700000000,2022-12-01,47,187,TN,Williamson County,136823,133853,2970,2.2
CN4718900000000,2022-12-01,47,189,TN,Wilson County,81241,79369,1872,2.3
CN4800100000000,2022-12-01,48,001,TX,Anderson County,22984,22287,697,3
CN4800300000000,2022-12-01,48,003,TX,Andrews County,9624,9379,245,2.5
CN4800500000000,2022-12-01,48,005,TX,Angelina County,35116,33684,1432,4.1
CN4800700000000,2022-12-01,48,007,TX,Aransas County,9219,8792,427,4.6
CN4800900000000,2022-12-01,48,009,TX,Archer County,3960,3846,114,2.9
CN4801100000000,2022-12-01,48,011,TX,Armstrong County,922,898,24,2.6
CN4801300000000,2022-12-01,48,013,TX,Atascosa County,22465,21678,787,3.5
CN4801500000000,2022-12-01,48,015,TX,Austin County,14100,13643,457,3.2
CN4801700000000,2022-12-01,48,017,TX,Bailey County,2241,2156,85,3.8
CN4801900000000,2022-12-01,48,019,TX,Bandera County,10614,10272,342,3.2
CN4802100000000,2022-12-01,48,021,TX,Bastrop County,48470,47079,1391,2.9
CN4802300000000,2022-12-01,48,023,TX,Baylor County,1935,1889,46,2.4
CN4802500000000,2022-12-01,48,025,TX,Bee County,8965,8526,439,4.9
CN4802700000000,2022-12-01,48,027,TX,Bell County,150044,144188,5856,3.9
CN4802900000000,2022-12-01,48,029,TX,Bexar County,983427,951409,32018,3.3
CN4803100000000,2022-12-01,48,031,TX,Blanco County,7166,6994,172,2.4
CN4803300000000,2022-12-01,48,033,TX,Borden County,763,751,12,1.6
CN4803500000000,2022-12-01,48,035,TX,Bosque County,8573,8298,275,3.2
CN4803700000000,2022-12-01,48,037,TX,Bowie County,38445,36920,1525,4
CN4803900000000,2022-12-01,48,039,TX,Brazoria County,185916,178354,7562,4.1
CN4804100000000,2022-12-01,48,041,TX,Brazos County,130905,127452,3453,2.6
CN4804300000000,2022-12-01,48,043,TX,Brewster County,4261,4143,118,2.8
CN4804500000000,2022-12-01,48,045,TX,Briscoe County,565,545,20,3.5
CN4804700000000,2022-12-01,48,047,TX,Brooks County,2340,2228,112,4.8
CN4804900000000,2022-12-01,48,049,TX,Brown County,15280,14548,732,4.8
CN4805100000000,2022-12-01,48,051,TX,Burleson County,8972,8686,286,3.2
CN4805300000000,2022-12-01,48,053,TX,Burnet County,25497,24821,676,2.7
CN4805500000000,2022-12-01,48,055,TX,Caldwell County,21436,20786,650,3
CN4805700000000,2022-12-01,48,057,TX,Calhoun County,12219,11829,390,3.2
CN4805900000000,2022-12-01,48,059,TX,Callahan County,6290,6088,202,3.2
CN4806100000000,2022-12-01,48,061,TX,Cameron County,178432,169109,9323,5.2
CN4806300000000,2022-12-01,48,063,TX,Camp County,5029,4832,197,3.9
CN4806500000000,2022-12-01,48,065,TX,Carson County,2963,2884,79,2.7
CN4806700000000,2022-12-01,48,067,TX,Cass County,11778,11295,483,4.1
CN4806900000000,2022-12-01,48,069,TX,Castro County,3152,3064,88,2.8
CN4807100000000,2022-12-01,48,071,TX,Chambers County,21230,20171,1059,5
CN4807300000000,2022-12-01,48,073,TX,Cherokee County,20239,19441,798,3.9
CN4807500000000,2022-12-01,48,075,TX,Childress County,3147,3076,71,2.3
CN4807700000000,2022-12-01,48,077,TX,Clay County,4789,4625,164,3.4
CN4807900000000,2022-12-01,48,079,TX,Cochran County,1030,989,41,4
CN4808100000000,2022-12-01,48,081,TX,Coke County,1543,1499,44,2.9
CN4808300000000,2022-12-01,48,083,TX,Coleman County,3001,2873,128,4.3
CN4808500000000,2022-12-01,48,085,TX,Collin County,634145,615855,18290,2.9
CN4808700000000,2022-12-01,48,087,TX,Collingsworth County,1050,1017,33,3.1
CN4808900000000,2022-12-01,48,089,TX,Colorado County,10093,9788,305,3
CN4809100000000,2022-12-01,48,091,TX,Comal County,82656,80121,2535,3.1
CN4809300000000,2022-12-01,48,093,TX,Comanche County,6327,6119,208,3.3
CN4809500000000,2022-12-01,48,095,TX,Concho County,1210,1175,35,2.9
CN4809700000000,2022-12-01,48,097,TX,Cooke County,19868,19300,568,2.9
CN4809900000000,2022-12-01,48,099,TX,Coryell County,24790,23800,990,4
CN4810100000000,2022-12-01,48,101,TX,Cottle County,957,937,20,2.1
CN4810300000000,2022-12-01,48,103,TX,Crane County,1672,1607,65,3.9
CN4810500000000,2022-12-01,48,105,TX,Crockett County,1426,1382,44,3.1
CN4810700000000,2022-12-01,48,107,TX,Crosby County,2317,2232,85,3.7
CN4810900000000,2022-12-01,48,109,TX,Culberson County,1167,1141,26,2.2
CN4811100000000,2022-12-01,48,111,TX,Dallam County,3704,3622,82,2.2
CN4811300000000,2022-12-01,48,113,TX,Dallas County,1439024,1391656,47368,3.3
CN4811500000000,2022-12-01,48,115,TX,Dawson County,4464,4311,153,3.4
CN4811700000000,2022-12-01,48,117,TX,Deaf Smith County,8714,8494,220,2.5
CN4811900000000,2022-12-01,48,119,TX,Delta County,2518,2413,105,4.2
CN4812100000000,2022-12-01,48,121,TX,Denton County,559206,542966,16240,2.9
CN4812300000000,2022-12-01,48,123,TX,DeWitt County,8996,8738,258,2.9
CN4812500000000,2022-12-01,48,125,TX,Dickens County,663,634,29,4.4
CN4812700000000,2022-12-01,48,127,TX,Dimmit County,6207,5987,220,3.5
CN4812900000000,2022-12-01,48,129,TX,Donley County,1475,1428,47,3.2
CN4813100000000,2022-12-01,48,131,TX,Duval County,4995,4825,170,3.4
CN4813300000000,2022-12-01,48,133,TX,Eastland County,6613,6347,266,4
CN4813500000000,2022-12-01,48,135,TX,Ector County,85044,82445,2599,3.1
CN4813700000000,2022-12-01,48,137,TX,Edwards County,1061,1035,26,2.5
CN4813900000000,2022-12-01,48,139,TX,Ellis County,104643,101333,3310,3.2
CN4814100000000,2022-12-01,48,141,TX,El Paso County,373291,359331,13960,3.7
CN4814300000000,2022-12-01,48,143,TX,Erath County,21080,20440,640,3
CN4814500000000,2022-12-01,48,145,TX,Falls County,6801,6553,248,3.6
CN4814700000000,2022-12-01,48,147,TX,Fannin County,17460,16802,658,3.8
CN4814900000000,2022-12-01,48,149,TX,Fayette County,11805,11440,365,3.1
CN4815100000000,2022-12-01,48,151,TX,Fisher County,1599,1546,53,3.3
CN4815300000000,2022-12-01,48,153,TX,Floyd County,2289,2204,85,3.7
CN4815500000000,2022-12-01,48,155,TX,Foard County,530,515,15,2.8
CN4815700000000,2022-12-01,48,157,TX,Fort Bend County,422236,407502,14734,3.5
CN4815900000000,2022-12-01,48,159,TX,Franklin County,5259,5099,160,3
CN4816100000000,2022-12-01,48,161,TX,Freestone County,6180,5897,283,4.6
CN4816300000000,2022-12-01,48,163,TX,Frio County,9083,8825,258,2.8
CN4816500000000,2022-12-01,48,165,TX,Gaines County,9970,9718,252,2.5
CN4816700000000,2022-12-01,48,167,TX,Galveston County,170274,163630,6644,3.9
CN4816900000000,2022-12-01,48,169,TX,Garza County,1940,1869,71,3.7
CN4817100000000,2022-12-01,48,171,TX,Gillespie County,14814,14495,319,2.2
CN4817300000000,2022-12-01,48,173,TX,Glasscock County,833,815,18,2.2
CN4817500000000,2022-12-01,48,175,TX,Goliad County,3193,3075,118,3.7
CN4817700000000,2022-12-01,48,177,TX,Gonzales County,9263,9002,261,2.8
CN4817900000000,2022-12-01,48,179,TX,Gray County,7584,7288,296,3.9
CN4818100000000,2022-12-01,48,181,TX,Grayson County,66559,64340,2219,3.3
CN4818300000000,2022-12-01,48,183,TX,Gregg County,56968,54837,2131,3.7
CN4818500000000,2022-12-01,48,185,TX,Grimes County,11396,10943,453,4
CN4818700000000,2022-12-01,48,187,TX,Guadalupe County,85982,83436,2546,3
CN4818900000000,2022-12-01,48,189,TX,Hale County,11223,10722,501,4.5
CN4819100000000,2022-12-01,48,191,TX,Hall County,1016,975,41,4
CN4819300000000,2022-12-01,48,193,TX,Hamilton County,3864,3742,122,3.2
CN4819500000000,2022-12-01,48,195,TX,Hansford County,2792,2733,59,2.1
CN4819700000000,2022-12-01,48,197,TX,Hardeman County,1755,1697,58,3.3
CN4819900000000,2022-12-01,48,199,TX,Hardin County,25018,23879,1139,4.6
CN4820100000000,2022-12-01,48,201,TX,Harris County,2359264,2270184,89080,3.8
CN4820300000000,2022-12-01,48,203,TX,Harrison County,28723,27597,1126,3.9
CN4820500000000,2022-12-01,48,205,TX,Hartley County,2510,2464,46,1.8
CN4820700000000,2022-12-01,48,207,TX,Haskell County,2705,2631,74,2.7
CN4820900000000,2022-12-01,48,209,TX,Hays County,140042,136253,3789,2.7
CN4821100000000,2022-12-01,48,211,TX,Hemphill County,1626,1579,47,2.9
CN4821300000000,2022-12-01,48,213,TX,Henderson County,39053,37554,1499,3.8
CN4821500000000,2022-12-01,48,215,TX,Hidalgo County,375941,352471,23470,6.2
CN4821700000000,2022-12-01,48,217,TX,Hill County,18248,17516,732,4
CN4821900000000,2022-12-01,48,219,TX,Hockley County,10622,10308,314,3
CN4822100000000,2022-12-01,48,221,TX,Hood County,30212,29209,1003,3.3
CN4822300000000,2022-12-01,48,223,TX,Hopkins County,18488,17759,729,3.9
CN4822500000000,2022-12-01,48,225,TX,Houston County,10578,10262,316,3
CN4822700000000,2022-12-01,48,227,TX,Howard County,12807,12303,504,3.9
CN4822900000000,2022-12-01,48,229,TX,Hudspeth County,1843,1776,67,3.6
CN4823100000000,2022-12-01,48,231,TX,Hunt County,47372,45663,1709,3.6
CN4823300000000,2022-12-01,48,233,TX,Hutchinson County,8370,8022,348,4.2
CN4823500000000,2022-12-01,48,235,TX,Irion County,775,755,20,2.6
CN4823700000000,2022-12-01,48,237,TX,Jack County,3444,3333,111,3.2
CN4823900000000,2022-12-01,48,239,TX,Jackson County,6905,6691,214,3.1
CN4824100000000,2022-12-01,48,241,TX,Jasper County,12736,11976,760,6
CN4824300000000,2022-12-01,48,243,TX,Jeff Davis County,949,917,32,3.4
CN4824500000000,2022-12-01,48,245,TX,Jefferson County,102038,95855,6183,6.1
CN4824700000000,2022-12-01,48,247,TX,Jim Hogg County,1761,1685,76,4.3
CN4824900000000,2022-12-01,48,249,TX,Jim Wells County,15331,14594,737,4.8
CN4825100000000,2022-12-01,48,251,TX,Johnson County,90156,87422,2734,3
CN4825300000000,2022-12-01,48,253,TX,Jones County,5763,5546,217,3.8
CN4825500000000,2022-12-01,48,255,TX,Karnes County,6569,6393,176,2.7
CN4825700000000,2022-12-01,48,257,TX,Kaufman County,76093,73501,2592,3.4
CN4825900000000,2022-12-01,48,259,TX,Kendall County,23737,23058,679,2.9
CN4826100000000,2022-12-01,48,261,TX,Kenedy County,116,107,9,7.8
CN4826300000000,2022-12-01,48,263,TX,Kent County,739,727,12,1.6
CN4826500000000,2022-12-01,48,265,TX,Kerr County,22355,21658,697,3.1
CN4826700000000,2022-12-01,48,267,TX,Kimble County,1717,1664,53,3.1
CN4826900000000,2022-12-01,48,269,TX,King County,517,514,3,0.6
CN4827100000000,2022-12-01,48,271,TX,Kinney County,1228,1181,47,3.8
CN4827300000000,2022-12-01,48,273,TX,Kleberg County,12948,12397,551,4.3
CN4827500000000,2022-12-01,48,275,TX,Knox County,1428,1384,44,3.1
CN4827700000000,2022-12-01,48,277,TX,Lamar County,24347,23313,1034,4.2
CN4827900000000,2022-12-01,48,279,TX,Lamb County,5037,4859,178,3.5
CN4828100000000,2022-12-01,48,281,TX,Lampasas County,9430,9126,304,3.2
CN4828300000000,2022-12-01,48,283,TX,La Salle County,4160,4064,96,2.3
CN4828500000000,2022-12-01,48,285,TX,Lavaca County,8970,8709,261,2.9
CN4828700000000,2022-12-01,48,287,TX,Lee County,8405,8142,263,3.1
CN4828900000000,2022-12-01,48,289,TX,Leon County,5981,5698,283,4.7
CN4829100000000,2022-12-01,48,291,TX,Liberty County,35406,33565,1841,5.2
CN4829300000000,2022-12-01,48,293,TX,Limestone County,8232,7899,333,4
CN4829500000000,2022-12-01,48,295,TX,Lipscomb County,1428,1389,39,2.7
CN4829700000000,2022-12-01,48,297,TX,Live Oak County,4747,4580,167,3.5
CN4829900000000,2022-12-01,48,299,TX,Llano County,9216,8914,302,3.3
CN4830100000000,2022-12-01,48,301,TX,Loving County,1413,1408,5,0.4
CN4830300000000,2022-12-01,48,303,TX,Lubbock County,163404,158728,4676,2.9
CN4830500000000,2022-12-01,48,305,TX,Lynn County,2765,2684,81,2.9
CN4830700000000,2022-12-01,48,307,TX,McCulloch County,3123,3012,111,3.6
CN4830900000000,2022-12-01,48,309,TX,McLennan County,127852,123839,4013,3.1
CN4831100000000,2022-12-01,48,311,TX,McMullen County,868,854,14,1.6
CN4831300000000,2022-12-01,48,313,TX,Madison County,4658,4477,181,3.9
CN4831500000000,2022-12-01,48,315,TX,Marion County,4138,3959,179,4.3
CN4831700000000,2022-12-01,48,317,TX,Martin County,2805,2740,65,2.3
CN4831900000000,2022-12-01,48,319,TX,Mason County,1768,1718,50,2.8
CN4832100000000,2022-12-01,48,321,TX,Matagorda County,16980,16029,951,5.6
CN4832300000000,2022-12-01,48,323,TX,Maverick County,23359,21589,1770,7.6
CN4832500000000,2022-12-01,48,325,TX,Medina County,22623,21871,752,3.3
CN4832700000000,2022-12-01,48,327,TX,Menard County,842,816,26,3.1
CN4832900000000,2022-12-01,48,329,TX,Midland County,108954,106473,2481,2.3
CN4833100000000,2022-12-01,48,331,TX,Milam County,10091,9682,409,4.1
CN4833300000000,2022-12-01,48,333,TX,Mills County,1820,1749,71,3.9
CN4833500000000,2022-12-01,48,335,TX,Mitchell County,2249,2170,79,3.5
CN4833700000000,2022-12-01,48,337,TX,Montague County,9153,8855,298,3.3
CN4833900000000,2022-12-01,48,339,TX,Montgomery County,304144,293693,10451,3.4
CN4834100000000,2022-12-01,48,341,TX,Moore County,11170,10903,267,2.4
CN4834300000000,2022-12-01,48,343,TX,Morris County,4449,4215,234,5.3
CN4834500000000,2022-12-01,48,345,TX,Motley County,495,478,17,3.4
CN4834700000000,2022-12-01,48,347,TX,Nacogdoches County,27636,26564,1072,3.9
CN4834900000000,2022-12-01,48,349,TX,Navarro County,23603,22805,798,3.4
CN4835100000000,2022-12-01,48,351,TX,Newton County,4903,4579,324,6.6
CN4835300000000,2022-12-01,48,353,TX,Nolan County,6672,6462,210,3.1
CN4835500000000,2022-12-01,48,355,TX,Nueces County,163417,156812,6605,4
CN4835700000000,2022-12-01,48,357,TX,Ochiltree County,3771,3657,114,3
CN4835900000000,2022-12-01,48,359,TX,Oldham County,916,892,24,2.6
CN4836100000000,2022-12-01,48,361,TX,Orange County,35120,33250,1870,5.3
CN4836300000000,2022-12-01,48,363,TX,Palo Pinto County,13069,12625,444,3.4
CN4836500000000,2022-12-01,48,365,TX,Panola County,9500,9137,363,3.8
CN4836700000000,2022-12-01,48,367,TX,Parker County,75471,73317,2154,2.9
CN4836900000000,2022-12-01,48,369,TX,Parmer County,4927,4818,109,2.2
CN4837100000000,2022-12-01,48,371,TX,Pecos County,6242,6031,211,3.4
CN4837300000000,2022-12-01,48,373,TX,Polk County,18730,17808,922,4.9
CN4837500000000,2022-12-01,48,375,TX,Potter County,55101,53620,1481,2.7
CN4837700000000,2022-12-01,48,377,TX,Presidio County,3010,2823,187,6.2
CN4837900000000,2022-12-01,48,379,TX,Rains County,6576,6365,211,3.2
CN4838100000000,2022-12-01,48,381,TX,Randall County,76093,74206,1887,2.5
CN4838300000000,2022-12-01,48,383,TX,Reagan County,1566,1522,44,2.8
CN4838500000000,2022-12-01,48,385,TX,Real County,1083,1033,50,4.6
CN4838700000000,2022-12-01,48,387,TX,Red River County,4937,4709,228,4.6
CN4838900000000,2022-12-01,48,389,TX,Reeves County,8312,8031,281,3.4
CN4839100000000,2022-12-01,48,391,TX,Refugio County,2857,2742,115,4
CN4839300000000,2022-12-01,48,393,TX,Roberts County,382,370,12,3.1
CN4839500000000,2022-12-01,48,395,TX,Robertson County,8023,7763,260,3.2
CN4839700000000,2022-12-01,48,397,TX,Rockwall County,60028,58228,1800,3
CN4839900000000,2022-12-01,48,399,TX,Runnels County,4612,4468,144,3.1
CN4840100000000,2022-12-01,48,401,TX,Rusk County,22389,21541,848,3.8
CN4840300000000,2022-12-01,48,403,TX,Sabine County,3919,3652,267,6.8
CN4840500000000,2022-12-01,48,405,TX,San Augustine County,3101,2938,163,5.3
CN4840700000000,2022-12-01,48,407,TX,San Jacinto County,11965,11452,513,4.3
CN4840900000000,2022-12-01,48,409,TX,San Patricio County,28954,27512,1442,5
CN4841100000000,2022-12-01,48,411,TX,San Saba County,2189,2121,68,3.1
CN4841300000000,2022-12-01,48,413,TX,Schleicher County,1227,1189,38,3.1
CN4841500000000,2022-12-01,48,415,TX,Scurry County,6263,6029,234,3.7
CN4841700000000,2022-12-01,48,417,TX,Shackelford County,1773,1732,41,2.3
CN4841900000000,2022-12-01,48,419,TX,Shelby County,10885,10492,393,3.6
CN4842100000000,2022-12-01,48,421,TX,Sherman County,1280,1245,35,2.7
CN4842300000000,2022-12-01,48,423,TX,Smith County,112357,108632,3725,3.3
CN4842500000000,2022-12-01,48,425,TX,Somervell County,4644,4474,170,3.7
CN4842700000000,2022-12-01,48,427,TX,Starr County,24070,21580,2490,10.3
CN4842900000000,2022-12-01,48,429,TX,Stephens County,4071,3925,146,3.6
CN4843100000000,2022-12-01,48,431,TX,Sterling County,462,445,17,3.7
CN4843300000000,2022-12-01,48,433,TX,Stonewall County,761,743,18,2.4
CN4843500000000,2022-12-01,48,435,TX,Sutton County,982,933,49,5
CN4843700000000,2022-12-01,48,437,TX,Swisher County,2509,2404,105,4.2
CN4843900000000,2022-12-01,48,439,TX,Tarrant County,1156971,1120314,36657,3.2
CN4844100000000,2022-12-01,48,441,TX,Taylor County,69255,67128,2127,3.1
CN4844300000000,2022-12-01,48,443,TX,Terrell County,408,396,12,2.9
CN4844500000000,2022-12-01,48,445,TX,Terry County,4407,4246,161,3.7
CN4844700000000,2022-12-01,48,447,TX,Throckmorton County,642,621,21,3.3
CN4844900000000,2022-12-01,48,449,TX,Titus County,13729,13219,510,3.7
CN4845100000000,2022-12-01,48,451,TX,Tom Green County,55717,54069,1648,3
CN4845300000000,2022-12-01,48,453,TX,Travis County,832439,810999,21440,2.6
CN4845500000000,2022-12-01,48,455,TX,Trinity County,5214,4969,245,4.7
CN4845700000000,2022-12-01,48,457,TX,Tyler County,6949,6542,407,5.9
CN4845900000000,2022-12-01,48,459,TX,Upshur County,17776,17108,668,3.8
CN4846100000000,2022-12-01,48,461,TX,Upton County,2304,2260,44,1.9
CN4846300000000,2022-12-01,48,463,TX,Uvalde County,10989,10541,448,4.1
CN4846500000000,2022-12-01,48,465,TX,Val Verde County,22381,21372,1009,4.5
CN4846700000000,2022-12-01,48,467,TX,Van Zandt County,27726,26865,861,3.1
CN4846900000000,2022-12-01,48,469,TX,Victoria County,41558,40094,1464,3.5
CN4847100000000,2022-12-01,48,471,TX,Walker County,23784,22801,983,4.1
CN4847300000000,2022-12-01,48,473,TX,Waller County,25526,24536,990,3.9
CN4847500000000,2022-12-01,48,475,TX,Ward County,6168,5986,182,3
CN4847700000000,2022-12-01,48,477,TX,Washington County,14965,14465,500,3.3
CN4847900000000,2022-12-01,48,479,TX,Webb County,117547,113388,4159,3.5
CN4848100000000,2022-12-01,48,481,TX,Wharton County,21034,20322,712,3.4
CN4848300000000,2022-12-01,48,483,TX,Wheeler County,1887,1823,64,3.4
CN4848500000000,2022-12-01,48,485,TX,Wichita County,55315,53447,1868,3.4
CN4848700000000,2022-12-01,48,487,TX,Wilbarger County,4626,4424,202,4.4
CN4848900000000,2022-12-01,48,489,TX,Willacy County,7176,6625,551,7.7
CN4849100000000,2022-12-01,48,491,TX,Williamson County,369028,359073,9955,2.7
CN4849300000000,2022-12-01,48,493,TX,Wilson County,26023,25303,720,2.8
CN4849500000000,2022-12-01,48,495,TX,Winkler County,4039,3907,132,3.3
CN4849700000000,2022-12-01,48,497,TX,Wise County,34629,33561,1068,3.1
CN4849900000000,2022-12-01,48,499,TX,Wood County,18200,17486,714,3.9
CN4850100000000,2022-12-01,48,501,TX,Yoakum County,3187,3085,102,3.2
CN4850300000000,2022-12-01,48,503,TX,Young County,7832,7604,228,2.9
CN4850500000000,2022-12-01,48,505,TX,Zapata County,4440,4173,267,6
CN4850700000000,2022-12-01,48,507,TX,Zavala County,3406,3146,260,7.6
CN4900100000000,2022-12-01,49,001,UT,Beaver County,2825,2754,71,2.5
CN4900300000000,2022-12-01,49,003,UT,Box Elder County,27737,27151,586,2.1
CN4900500000000,2022-12-01,49,005,UT,Cache County,72913,71567,1346,1.8
CN4900700000000,2022-12-01,49,007,UT,Carbon County,8364,8102,262,3.1
CN4900900000000,2022-12-01,49,009,UT,Daggett County,352,335,17,4.8
CN4901100000000,2022-12-01,49,011,UT,Davis County,185047,181390,3657,2
CN4901300000000,2022-12-01,49,013,UT,Duchesne County,8124,7901,223,2.7
CN4901500000000,2022-12-01,49,015,UT,Emery County,4389,4256,133,3
CN4901700000000,2022-12-01,49,017,UT,Garfield County,2528,2282,246,9.7
CN4901900000000,2022-12-01,49,019,UT,Grand County,6522,6205,317,4.9
CN4902100000000,2022-12-01,49,021,UT,Iron County,28647,28032,615,2.1
CN4902300000000,2022-12-01,49,023,UT,Juab County,6485,6381,104,1.6
CN4902500000000,2022-12-01,49,025,UT,Kane County,3982,3862,120,3
CN4902700000000,2022-12-01,49,027,UT,Millard County,6142,6005,137,2.2
CN4902900000000,2022-12-01,49,029,UT,Morgan County,5962,5859,103,1.7
CN4903100000000,2022-12-01,49,031,UT,Piute County,516,490,26,5
CN4903300000000,2022-12-01,49,033,UT,Rich County,1026,1000,26,2.5
CN4903500000000,2022-12-01,49,035,UT,Salt Lake County,687506,673356,14150,2.1
CN4903700000000,2022-12-01,49,037,UT,San Juan County,5406,5169,237,4.4
CN4903900000000,2022-12-01,49,039,UT,Sanpete County,13709,13362,347,2.5
CN4904100000000,2022-12-01,49,041,UT,Sevier County,10284,9992,292,2.8
CN4904300000000,2022-12-01,49,043,UT,Summit County,27303,26838,465,1.7
CN4904500000000,2022-12-01,49,045,UT,Tooele County,38869,37963,906,2.3
CN4904700000000,2022-12-01,49,047,UT,Uintah County,14157,13761,396,2.8
CN4904900000000,2022-12-01,49,049,UT,Utah County,349209,342247,6962,2
CN4905100000000,2022-12-01,49,051,UT,Wasatch County,18154,17795,359,2
CN4905300000000,2022-12-01,49,053,UT,Washington County,88154,86081,2073,2.4
CN4905500000000,2022-12-01,49,055,UT,Wayne County,1393,1303,90,6.5
CN4905700000000,2022-12-01,49,057,UT,Weber County,135944,132890,3054,2.2
CN5000100000000,2022-12-01,50,001,VT,Addison County,20779,20280,499,2.4
CN5000300000000,2022-12-01,50,003,VT,Bennington County,17700,17119,581,3.3
CN5000500000000,2022-12-01,50,005,VT,Caledonia County,14671,14192,479,3.3
CN5000700000000,2022-12-01,50,007,VT,Chittenden County,97424,95437,1987,2
CN5000900000000,2022-12-01,50,009,VT,Essex County,2652,2537,115,4.3
CN5001100000000,2022-12-01,50,011,VT,Franklin County,27846,27136,710,2.5
CN5001300000000,2022-12-01,50,013,VT,Grand Isle County,4156,4005,151,3.6
CN5001500000000,2022-12-01,50,015,VT,Lamoille County,14035,13573,462,3.3
CN5001700000000,2022-12-01,50,017,VT,Orange County,15708,15301,407,2.6
CN5001900000000,2022-12-01,50,019,VT,Orleans County,13505,12839,666,4.9
CN5002100000000,2022-12-01,50,021,VT,Rutland County,29761,28820,941,3.2
CN5002300000000,2022-12-01,50,023,VT,Washington County,34083,33224,859,2.5
CN5002500000000,2022-12-01,50,025,VT,Windham County,21348,20738,610,2.9
CN5002700000000,2022-12-01,50,027,VT,Windsor County,29253,28544,709,2.4
CN5100100000000,2022-12-01,51,001,VA,Accomack County,15870,15306,564,3.6
CN5100300000000,2022-12-01,51,003,VA,Albemarle County,58904,57513,1391,2.4
CN5100500000000,2022-12-01,51,005,VA,Alleghany County,6718,6515,203,3
CN5100700000000,2022-12-01,51,007,VA,Amelia County,6349,6182,167,2.6
CN5100900000000,2022-12-01,51,009,VA,Amherst County,14957,14534,423,2.8
CN5101100000000,2022-12-01,51,011,VA,Appomattox County,7219,6999,220,3
CN5101300000000,2022-12-01,51,013,VA,Arlington County,157450,154526,2924,1.9
CN5101500000000,2022-12-01,51,015,VA,Augusta County,38790,37899,891,2.3
CN5101700000000,2022-12-01,51,017,VA,Bath County,2608,2552,56,2.1
CN5101900000000,2022-12-01,51,019,VA,Bedford County,38811,37787,1024,2.6
CN5102100000000,2022-12-01,51,021,VA,Bland County,2835,2764,71,2.5
CN5102300000000,2022-12-01,51,023,VA,Botetourt County,17955,17540,415,2.3
CN5102500000000,2022-12-01,51,025,VA,Brunswick County,5930,5674,256,4.3
CN5102700000000,2022-12-01,51,027,VA,Buchanan County,6365,6091,274,4.3
CN5102900000000,2022-12-01,51,029,VA,Buckingham County,6581,6303,278,4.2
CN5103100000000,2022-12-01,51,031,VA,Campbell County,26039,25280,759,2.9
CN5103300000000,2022-12-01,51,033,VA,Caroline County,15509,15035,474,3.1
CN5103500000000,2022-12-01,51,035,VA,Carroll County,13121,12668,453,3.5
CN5103600000000,2022-12-01,51,036,VA,Charles City County,3657,3539,118,3.2
CN5103700000000,2022-12-01,51,037,VA,Charlotte County,5692,5530,162,2.8
CN5104100000000,2022-12-01,51,041,VA,Chesterfield County,195419,190264,5155,2.6
CN5104300000000,2022-12-01,51,043,VA,Clarke County,7732,7552,180,2.3
CN5104500000000,2022-12-01,51,045,VA,Craig County,2346,2282,64,2.7
CN5104700000000,2022-12-01,51,047,VA,Culpeper County,25664,25008,656,2.6
CN5104900000000,2022-12-01,51,049,VA,Cumberland County,4850,4694,156,3.2
CN5105100000000,2022-12-01,51,051,VA,Dickenson County,4594,4408,186,4
CN5105300000000,2022-12-01,51,053,VA,Dinwiddie County,13918,13497,421,3
CN5105700000000,2022-12-01,51,057,VA,Essex County,5596,5416,180,3.2
CN5105900000000,2022-12-01,51,059,VA,Fairfax County,640645,626551,14094,2.2
CN5106100000000,2022-12-01,51,061,VA,Fauquier County,37974,37115,859,2.3
CN5106300000000,2022-12-01,51,063,VA,Floyd County,8665,8453,212,2.4
CN5106500000000,2022-12-01,51,065,VA,Fluvanna County,14423,14077,346,2.4
CN5106700000000,2022-12-01,51,067,VA,Franklin County,26915,26191,724,2.7
CN5106900000000,2022-12-01,51,069,VA,Frederick County,52138,50941,1197,2.3
CN5107100000000,2022-12-01,51,071,VA,Giles County,8259,8018,241,2.9
CN5107300000000,2022-12-01,51,073,VA,Gloucester County,19554,19050,504,2.6
CN5107500000000,2022-12-01,51,075,VA,Goochland County,11933,11636,297,2.5
CN5107700000000,2022-12-01,51,077,VA,Grayson County,8353,8139,214,2.6
CN5107900000000,2022-12-01,51,079,VA,Greene County,10810,10560,250,2.3
CN5108100000000,2022-12-01,51,081,VA,Greensville County,4413,4233,180,4.1
CN5108300000000,2022-12-01,51,083,VA,Halifax County,15452,14873,579,3.7
CN5108500000000,2022-12-01,51,085,VA,Hanover County,60618,59261,1357,2.2
CN5108700000000,2022-12-01,51,087,VA,Henrico County,187003,182079,4924,2.6
CN5108900000000,2022-12-01,51,089,VA,Henry County,24060,23248,812,3.4
CN5109100000000,2022-12-01,51,091,VA,Highland County,1479,1451,28,1.9
CN5109300000000,2022-12-01,51,093,VA,Isle of Wight County,19741,19213,528,2.7
CN5109500000000,2022-12-01,51,095,VA,James City County,36979,36000,979,2.6
CN5109700000000,2022-12-01,51,097,VA,King and Queen County,4023,3931,92,2.3
CN5109900000000,2022-12-01,51,099,VA,King George County,14378,14040,338,2.4
CN5110100000000,2022-12-01,51,101,VA,King William County,9654,9417,237,2.5
CN5110300000000,2022-12-01,51,103,VA,Lancaster County,5532,5350,182,3.3
CN5110500000000,2022-12-01,51,105,VA,Lee County,8261,7945,316,3.8
CN5110700000000,2022-12-01,51,107,VA,Loudoun County,233290,228182,5108,2.2
CN5110900000000,2022-12-01,51,109,VA,Louisa County,20903,20379,524,2.5
CN5111100000000,2022-12-01,51,111,VA,Lunenburg County,5275,5100,175,3.3
CN5111300000000,2022-12-01,51,113,VA,Madison County,7647,7495,152,2
CN5111500000000,2022-12-01,51,115,VA,Mathews County,4087,3984,103,2.5
CN5111700000000,2022-12-01,51,117,VA,Mecklenburg County,13462,13007,455,3.4
CN5111900000000,2022-12-01,51,119,VA,Middlesex County,5380,5254,126,2.3
CN5112100000000,2022-12-01,51,121,VA,Montgomery County,52761,51483,1278,2.4
CN5112500000000,2022-12-01,51,125,VA,Nelson County,7481,7299,182,2.4
CN5112700000000,2022-12-01,51,127,VA,New Kent County,13371,13061,310,2.3
CN5113100000000,2022-12-01,51,131,VA,Northampton County,5627,5407,220,3.9
CN5113300000000,2022-12-01,51,133,VA,Northumberland County,5680,5479,201,3.5
CN5113500000000,2022-12-01,51,135,VA,Nottoway County,7266,7082,184,2.5
CN5113700000000,2022-12-01,51,137,VA,Orange County,17554,17050,504,2.9
CN5113900000000,2022-12-01,51,139,VA,Page County,12375,11890,485,3.9
CN5114100000000,2022-12-01,51,141,VA,Patrick County,7175,6951,224,3.1
CN5114300000000,2022-12-01,51,143,VA,Pittsylvania County,30487,29636,851,2.8
CN5114500000000,2022-12-01,51,145,VA,Powhatan County,14800,14447,353,2.4
CN5114700000000,2022-12-01,51,147,VA,Prince Edward County,10056,9708,348,3.5
CN5114900000000,2022-12-01,51,149,VA,Prince George County,15538,15040,498,3.2
CN5115300000000,2022-12-01,51,153,VA,Prince William County,251686,245555,6131,2.4
CN5115500000000,2022-12-01,51,155,VA,Pulaski County,16878,16427,451,2.7
CN5115700000000,2022-12-01,51,157,VA,Rappahannock County,3726,3645,81,2.2
CN5115900000000,2022-12-01,51,159,VA,Richmond County,4053,3935,118,2.9
CN5116100000000,2022-12-01,51,161,VA,Roanoke County,50593,49403,1190,2.4
CN5116300000000,2022-12-01,51,163,VA,Rockbridge County,11010,10719,291,2.6
CN5116500000000,2022-12-01,51,165,VA,Rockingham County,43691,42699,992,2.3
CN5116700000000,2022-12-01,51,167,VA,Russell County,10970,10609,361,3.3
CN5116900000000,2022-12-01,51,169,VA,Scott County,9389,9086,303,3.2
CN5117100000000,2022-12-01,51,171,VA,Shenandoah County,22197,21611,586,2.6
CN5117300000000,2022-12-01,51,173,VA,Smyth County,13478,13066,412,3.1
CN5117500000000,2022-12-01,51,175,VA,Southampton County,8956,8740,216,2.4
CN5117700000000,2022-12-01,51,177,VA,Spotsylvania County,69736,67808,1928,2.8
CN5117900000000,2022-12-01,51,179,VA,Stafford County,75978,73961,2017,2.7
CN5118100000000,2022-12-01,51,181,VA,Surry County,3652,3562,90,2.5
CN5118300000000,2022-12-01,51,183,VA,Sussex County,3764,3612,152,4
CN5118500000000,2022-12-01,51,185,VA,Tazewell County,15456,14821,635,4.1
CN5118700000000,2022-12-01,51,187,VA,Warren County,20817,20283,534,2.6
CN5119100000000,2022-12-01,51,191,VA,Washington County,26822,26102,720,2.7
CN5119300000000,2022-12-01,51,193,VA,Westmoreland County,9621,9326,295,3.1
CN5119500000000,2022-12-01,51,195,VA,Wise County,12926,12434,492,3.8
CN5119700000000,2022-12-01,51,197,VA,Wythe County,14345,13954,391,2.7
CN5119900000000,2022-12-01,51,199,VA,York County,33201,32353,848,2.6
CN5151000000000,2022-12-01,51,510,VA,Alexandria city,101141,99002,2139,2.1
CN5152000000000,2022-12-01,51,520,VA,Bristol city,7684,7438,246,3.2
CN5153000000000,2022-12-01,51,530,VA,Buena Vista city,3142,3059,83,2.6
CN5154000000000,2022-12-01,51,540,VA,Charlottesville city,26069,25481,588,2.3
CN5155000000000,2022-12-01,51,550,VA,Chesapeake city,124035,120658,3377,2.7
CN5157000000000,2022-12-01,51,570,VA,Colonial Heights city,8618,8349,269,3.1
CN5158000000000,2022-12-01,51,580,VA,Covington city,2310,2210,100,4.3
CN5159000000000,2022-12-01,51,590,VA,Danville city,18942,18111,831,4.4
CN5159500000000,2022-12-01,51,595,VA,Emporia city,2351,2259,92,3.9
CN5160000000000,2022-12-01,51,600,VA,Fairfax city,12955,12666,289,2.2
CN5161000000000,2022-12-01,51,610,VA,Falls Church city,8587,8418,169,2
CN5162000000000,2022-12-01,51,620,VA,Franklin city,3459,3324,135,3.9
CN5163000000000,2022-12-01,51,630,VA,Fredericksburg city,14423,13972,451,3.1
CN5164000000000,2022-12-01,51,640,VA,Galax city,2877,2787,90,3.1
CN5165000000000,2022-12-01,51,650,VA,Hampton city,64433,62125,2308,3.6
CN5166000000000,2022-12-01,51,660,VA,Harrisonburg city,25230,24510,720,2.9
CN5167000000000,2022-12-01,51,670,VA,Hopewell city,9721,9317,404,4.2
CN5167800000000,2022-12-01,51,678,VA,Lexington city,2294,2211,83,3.6
CN5168000000000,2022-12-01,51,680,VA,Lynchburg city,35931,34679,1252,3.5
CN5168300000000,2022-12-01,51,683,VA,Manassas city,21808,21299,509,2.3
CN5168500000000,2022-12-01,51,685,VA,Manassas Park city,9821,9601,220,2.2
CN5169000000000,2022-12-01,51,690,VA,Martinsville city,5660,5378,282,5
CN5170000000000,2022-12-01,51,700,VA,Newport News city,88410,85461,2949,3.3
CN5171000000000,2022-12-01,51,710,VA,Norfolk city,110206,106596,3610,3.3
CN5172000000000,2022-12-01,51,720,VA,Norton city,1603,1547,56,3.5
CN5173000000000,2022-12-01,51,730,VA,Petersburg city,12741,12042,699,5.5
CN5173500000000,2022-12-01,51,735,VA,Poquoson city,6385,6242,143,2.2
CN5174000000000,2022-12-01,51,740,VA,Portsmouth city,44085,42512,1573,3.6
CN5175000000000,2022-12-01,51,750,VA,Radford city,9110,8836,274,3
CN5176000000000,2022-12-01,51,760,VA,Richmond city,121766,117902,3864,3.2
CN5177000000000,2022-12-01,51,770,VA,Roanoke city,49747,48292,1455,2.9
CN5177500000000,2022-12-01,51,775,VA,Salem city,13060,12742,318,2.4
CN5179000000000,2022-12-01,51,790,VA,Staunton city,12566,12282,284,2.3
CN5180000000000,2022-12-01,51,800,VA,Suffolk city,45684,44338,1346,2.9
CN5181000000000,2022-12-01,51,810,VA,Virginia Beach city,232136,226013,6123,2.6
CN5182000000000,2022-12-01,51,820,VA,Waynesboro city,10930,10644,286,2.6
CN5183000000000,2022-12-01,51,830,VA,Williamsburg city,6789,6550,239,3.5
CN5184000000000,2022-12-01,51,840,VA,Winchester city,15286,14908,378,2.5
CN5300100000000,2022-12-01,53,001,WA,Adams County,9603,8821,782,8.1
CN5300300000000,2022-12-01,53,003,WA,Asotin County,10765,10302,463,4.3
CN5300500000000,2022-12-01,53,005,WA,Benton County,107253,100861,6392,6
CN5300700000000,2022-12-01,53,007,WA,Chelan County,44027,41353,2674,6.1
CN5300900000000,2022-12-01,53,009,WA,Clallam County,29005,27097,1908,6.6
CN5301100000000,2022-12-01,53,011,WA,Clark County,254747,242290,12457,4.9
CN5301300000000,2022-12-01,53,013,WA,Columbia County,1787,1689,98,5.5
CN5301500000000,2022-12-01,53,015,WA,Cowlitz County,50157,47166,2991,6
CN5301700000000,2022-12-01,53,017,WA,Douglas County,21759,20236,1523,7
CN5301900000000,2022-12-01,53,019,WA,Ferry County,2286,2014,272,11.9
CN5302100000000,2022-12-01,53,021,WA,Franklin County,43770,40248,3522,8
CN5302300000000,2022-12-01,53,023,WA,Garfield County,795,738,57,7.2
CN5302500000000,2022-12-01,53,025,WA,Grant County,47790,43756,4034,8.4
CN5302700000000,2022-12-01,53,027,WA,Grays Harbor County,29716,27466,2250,7.6
CN5302900000000,2022-12-01,53,029,WA,Island County,37287,35409,1878,5
CN5303100000000,2022-12-01,53,031,WA,Jefferson County,12796,12069,727,5.7
CN5303300000000,2022-12-01,53,033,WA,King County,1327262,1288288,38974,2.9
CN5303500000000,2022-12-01,53,035,WA,Kitsap County,131714,125678,6036,4.6
CN5303700000000,2022-12-01,53,037,WA,Kittitas County,22235,20703,1532,6.9
CN5303900000000,2022-12-01,53,039,WA,Klickitat County,9600,8953,647,6.7
CN5304100000000,2022-12-01,53,041,WA,Lewis County,35194,32915,2279,6.5
CN5304300000000,2022-12-01,53,043,WA,Lincoln County,4714,4407,307,6.5
CN5304500000000,2022-12-01,53,045,WA,Mason County,25646,23936,1710,6.7
CN5304700000000,2022-12-01,53,047,WA,Okanogan County,18902,17352,1550,8.2
CN5304900000000,2022-12-01,53,049,WA,Pacific County,8952,8313,639,7.1
CN5305100000000,2022-12-01,53,051,WA,Pend Oreille County,5302,4858,444,8.4
CN5305300000000,2022-12-01,53,053,WA,Pierce County,462390,437556,24834,5.4
CN5305500000000,2022-12-01,53,055,WA,San Juan County,9062,8710,352,3.9
CN5305700000000,2022-12-01,53,057,WA,Skagit County,62345,58829,3516,5.6
CN5305900000000,2022-12-01,53,059,WA,Skamania County,5706,5366,340,6
CN5306100000000,2022-12-01,53,061,WA,Snohomish County,451849,437207,14642,3.2
CN5306300000000,2022-12-01,53,063,WA,Spokane County,267580,252795,14785,5.5
CN5306500000000,2022-12-01,53,065,WA,Stevens County,19739,18087,1652,8.4
CN5306700000000,2022-12-01,53,067,WA,Thurston County,152708,145396,7312,4.8
CN5306900000000,2022-12-01,53,069,WA,Wahkiakum County,1432,1328,104,7.3
CN5307100000000,2022-12-01,53,071,WA,Walla Walla County,30528,28882,1646,5.4
CN5307300000000,2022-12-01,53,073,WA,Whatcom County,117120,111117,6003,5.1
CN5307500000000,2022-12-01,53,075,WA,Whitman County,24004,22841,1163,4.8
CN5307700000000,2022-12-01,53,077,WA,Yakima County,129713,118036,11677,9
CN5400100000000,2022-12-01,54,001,WV,Barbour County,7299,7011,288,3.9
CN5400300000000,2022-12-01,54,003,WV,Berkeley County,59239,57732,1507,2.5
CN5400500000000,2022-12-01,54,005,WV,Boone County,6890,6638,252,3.7
CN5400700000000,2022-12-01,54,007,WV,Braxton County,4975,4715,260,5.2
CN5400900000000,2022-12-01,54,009,WV,Brooke County,9688,9339,349,3.6
CN5401100000000,2022-12-01,54,011,WV,Cabell County,41046,39820,1226,3
CN5401300000000,2022-12-01,54,013,WV,Calhoun County,2484,2269,215,8.7
CN5401500000000,2022-12-01,54,015,WV,Clay County,2933,2766,167,5.7
CN5401700000000,2022-12-01,54,017,WV,Doddridge County,3890,3771,119,3.1
CN5401900000000,2022-12-01,54,019,WV,Fayette County,15558,14899,659,4.2
CN5402100000000,2022-12-01,54,021,WV,Gilmer County,2347,2228,119,5.1
CN5402300000000,2022-12-01,54,023,WV,Grant County,6030,5824,206,3.4
CN5402500000000,2022-12-01,54,025,WV,Greenbrier County,15458,14942,516,3.3
CN5402700000000,2022-12-01,54,027,WV,Hampshire County,11480,11210,270,2.4
CN5402900000000,2022-12-01,54,029,WV,Hancock County,12802,12217,585,4.6
CN5403100000000,2022-12-01,54,031,WV,Hardy County,5827,5611,216,3.7
CN5403300000000,2022-12-01,54,033,WV,Harrison County,32940,31920,1020,3.1
CN5403500000000,2022-12-01,54,035,WV,Jackson County,11454,11006,448,3.9
CN5403700000000,2022-12-01,54,037,WV,Jefferson County,30303,29649,654,2.2
CN5403900000000,2022-12-01,54,039,WV,Kanawha County,77961,75471,2490,3.2
CN5404100000000,2022-12-01,54,041,WV,Lewis County,6282,6017,265,4.2
CN5404300000000,2022-12-01,54,043,WV,Lincoln County,6952,6662,290,4.2
CN5404500000000,2022-12-01,54,045,WV,Logan County,10968,10567,401,3.7
CN5404700000000,2022-12-01,54,047,WV,McDowell County,4001,3786,215,5.4
CN5404900000000,2022-12-01,54,049,WV,Marion County,24859,23959,900,3.6
CN5405100000000,2022-12-01,54,051,WV,Marshall County,12775,12208,567,4.4
CN5405300000000,2022-12-01,54,053,WV,Mason County,10520,10146,374,3.6
CN5405500000000,2022-12-01,54,055,WV,Mercer County,20355,19590,765,3.8
CN5405700000000,2022-12-01,54,057,WV,Mineral County,12549,12142,407,3.2
CN5405900000000,2022-12-01,54,059,WV,Mingo County,6411,6130,281,4.4
CN5406100000000,2022-12-01,54,061,WV,Monongalia County,54705,53159,1546,2.8
CN5406300000000,2022-12-01,54,063,WV,Monroe County,6375,6227,148,2.3
CN5406500000000,2022-12-01,54,065,WV,Morgan County,8522,8312,210,2.5
CN5406700000000,2022-12-01,54,067,WV,Nicholas County,8756,8387,369,4.2
CN5406900000000,2022-12-01,54,069,WV,Ohio County,19435,18784,651,3.3
CN5407100000000,2022-12-01,54,071,WV,Pendleton County,3881,3792,89,2.3
CN5407300000000,2022-12-01,54,073,WV,Pleasants County,2706,2559,147,5.4
CN5407500000000,2022-12-01,54,075,WV,Pocahontas County,4887,4752,135,2.8
CN5407700000000,2022-12-01,54,077,WV,Preston County,15572,15055,517,3.3
CN5407900000000,2022-12-01,54,079,WV,Putnam County,26821,26047,774,2.9
CN5408100000000,2022-12-01,54,081,WV,Raleigh County,29229,28306,923,3.2
CN5408300000000,2022-12-01,54,083,WV,Randolph County,11843,11350,493,4.2
CN5408500000000,2022-12-01,54,085,WV,Ritchie County,4194,4022,172,4.1
CN5408700000000,2022-12-01,54,087,WV,Roane County,4857,4557,300,6.2
CN5408900000000,2022-12-01,54,089,WV,Summers County,4635,4498,137,3
CN5409100000000,2022-12-01,54,091,WV,Taylor County,7752,7509,243,3.1
CN5409300000000,2022-12-01,54,093,WV,Tucker County,3374,3267,107,3.2
CN5409500000000,2022-12-01,54,095,WV,Tyler County,2901,2748,153,5.3
CN5409700000000,2022-12-01,54,097,WV,Upshur County,9631,9234,397,4.1
CN5409900000000,2022-12-01,54,099,WV,Wayne County,15442,14899,543,3.5
CN5410100000000,2022-12-01,54,101,WV,Webster County,3174,3031,143,4.5
CN5410300000000,2022-12-01,54,103,WV,Wetzel County,6402,6055,347,5.4
CN5410500000000,2022-12-01,54,105,WV,Wirt County,2249,2133,116,5.2
CN5410700000000,2022-12-01,54,107,WV,Wood County,35841,34536,1305,3.6
CN5410900000000,2022-12-01,54,109,WV,Wyoming County,7038,6781,257,3.7
CN5500100000000,2022-12-01,55,001,WI,Adams County,7369,7018,351,4.8
CN5500300000000,2022-12-01,55,003,WI,Ashland County,7073,6857,216,3.1
CN5500500000000,2022-12-01,55,005,WI,Barron County,23104,22350,754,3.3
CN5500700000000,2022-12-01,55,007,WI,Bayfield County,7003,6680,323,4.6
CN5500900000000,2022-12-01,55,009,WI,Brown County,140780,138034,2746,2
CN5501100000000,2022-12-01,55,011,WI,Buffalo County,5859,5649,210,3.6
CN5501300000000,2022-12-01,55,013,WI,Burnett County,6964,6638,326,4.7
CN5501500000000,2022-12-01,55,015,WI,Calumet County,27281,26818,463,1.7
CN5501700000000,2022-12-01,55,017,WI,Chippewa County,33314,32216,1098,3.3
CN5501900000000,2022-12-01,55,019,WI,Clark County,16895,16516,379,2.2
CN5502100000000,2022-12-01,55,021,WI,Columbia County,31491,30877,614,1.9
CN5502300000000,2022-12-01,55,023,WI,Crawford County,6753,6512,241,3.6
CN5502500000000,2022-12-01,55,025,WI,Dane County,329255,324124,5131,1.6
CN5502700000000,2022-12-01,55,027,WI,Dodge County,46492,45591,901,1.9
CN5502900000000,2022-12-01,55,029,WI,Door County,13705,13311,394,2.9
CN5503100000000,2022-12-01,55,031,WI,Douglas County,22391,21664,727,3.2
CN5503300000000,2022-12-01,55,033,WI,Dunn County,23953,23304,649,2.7
CN5503500000000,2022-12-01,55,035,WI,Eau Claire County,59270,58081,1189,2
CN5503700000000,2022-12-01,55,037,WI,Florence County,2052,1992,60,2.9
CN5503900000000,2022-12-01,55,039,WI,Fond du Lac County,55562,54544,1018,1.8
CN5504100000000,2022-12-01,55,041,WI,Forest County,3737,3571,166,4.4
CN5504300000000,2022-12-01,55,043,WI,Grant County,26526,25959,567,2.1
CN5504500000000,2022-12-01,55,045,WI,Green County,20456,20097,359,1.8
CN5504700000000,2022-12-01,55,047,WI,Green Lake County,8741,8515,226,2.6
CN5504900000000,2022-12-01,55,049,WI,Iowa County,13274,13008,266,2
CN5505100000000,2022-12-01,55,051,WI,Iron County,2479,2336,143,5.8
CN5505300000000,2022-12-01,55,053,WI,Jackson County,8985,8662,323,3.6
CN5505500000000,2022-12-01,55,055,WI,Jefferson County,45501,44605,896,2
CN5505700000000,2022-12-01,55,057,WI,Juneau County,13065,12714,351,2.7
CN5505900000000,2022-12-01,55,059,WI,Kenosha County,89526,87396,2130,2.4
CN5506100000000,2022-12-01,55,061,WI,Kewaunee County,10569,10353,216,2
CN5506300000000,2022-12-01,55,063,WI,La Crosse County,66876,65654,1222,1.8
CN5506500000000,2022-12-01,55,065,WI,Lafayette County,9730,9540,190,2
CN5506700000000,2022-12-01,55,067,WI,Langlade County,8957,8687,270,3
CN5506900000000,2022-12-01,55,069,WI,Lincoln County,14478,14139,339,2.3
CN5507100000000,2022-12-01,55,071,WI,Manitowoc County,39302,38384,918,2.3
CN5507300000000,2022-12-01,55,073,WI,Marathon County,71746,70385,1361,1.9
CN5507500000000,2022-12-01,55,075,WI,Marinette County,18492,17891,601,3.3
CN5507700000000,2022-12-01,55,077,WI,Marquette County,7456,7205,251,3.4
CN5507800000000,2022-12-01,55,078,WI,Menominee County,1441,1385,56,3.9
CN5507900000000,2022-12-01,55,079,WI,Milwaukee County,453519,441691,11828,2.6
CN5508100000000,2022-12-01,55,081,WI,Monroe County,22583,22082,501,2.2
CN5508300000000,2022-12-01,55,083,WI,Oconto County,20377,19835,542,2.7
CN5508500000000,2022-12-01,55,085,WI,Oneida County,17226,16684,542,3.1
CN5508700000000,2022-12-01,55,087,WI,Outagamie County,103944,101972,1972,1.9
CN5508900000000,2022-12-01,55,089,WI,Ozaukee County,48237,47373,864,1.8
CN5509100000000,2022-12-01,55,091,WI,Pepin County,3834,3714,120,3.1
CN5509300000000,2022-12-01,55,093,WI,Pierce County,24118,23404,714,3
CN5509500000000,2022-12-01,55,095,WI,Polk County,24116,23140,976,4
CN5509700000000,2022-12-01,55,097,WI,Portage County,37518,36678,840,2.2
CN5509900000000,2022-12-01,55,099,WI,Price County,6007,5834,173,2.9
CN5510100000000,2022-12-01,55,101,WI,Racine County,97150,94737,2413,2.5
CN5510300000000,2022-12-01,55,103,WI,Richland County,8593,8405,188,2.2
CN5510500000000,2022-12-01,55,105,WI,Rock County,84892,82751,2141,2.5
CN5510700000000,2022-12-01,55,107,WI,Rusk County,6261,6069,192,3.1
CN5510900000000,2022-12-01,55,109,WI,St. Croix County,49230,47828,1402,2.8
CN5511100000000,2022-12-01,55,111,WI,Sauk County,33199,32483,716,2.2
CN5511300000000,2022-12-01,55,113,WI,Sawyer County,7511,7229,282,3.8
CN5511500000000,2022-12-01,55,115,WI,Shawano County,19796,19349,447,2.3
CN5511700000000,2022-12-01,55,117,WI,Sheboygan County,60526,59450,1076,1.8
CN5511900000000,2022-12-01,55,119,WI,Taylor County,10134,9768,366,3.6
CN5512100000000,2022-12-01,55,121,WI,Trempealeau County,14387,13967,420,2.9
CN5512300000000,2022-12-01,55,123,WI,Vernon County,14814,14497,317,2.1
CN5512500000000,2022-12-01,55,125,WI,Vilas County,9584,9201,383,4
CN5512700000000,2022-12-01,55,127,WI,Walworth County,56635,55417,1218,2.2
CN5512900000000,2022-12-01,55,129,WI,Washburn County,7350,7112,238,3.2
CN5513100000000,2022-12-01,55,131,WI,Washington County,75516,74207,1309,1.7
CN5513300000000,2022-12-01,55,133,WI,Waukesha County,221315,217327,3988,1.8
CN5513500000000,2022-12-01,55,135,WI,Waupaca County,24244,23708,536,2.2
CN5513700000000,2022-12-01,55,137,WI,Waushara County,10880,10561,319,2.9
CN5513900000000,2022-12-01,55,139,WI,Winnebago County,92062,90319,1743,1.9
CN5514100000000,2022-12-01,55,141,WI,Wood County,32321,31475,846,2.6
CN5600100000000,2022-12-01,56,001,WY,Albany County,21912,21225,687,3.1
CN5600300000000,2022-12-01,56,003,WY,Big Horn County,4971,4769,202,4.1
CN5600500000000,2022-12-01,56,005,WY,Campbell County,23041,22296,745,3.2
CN5600700000000,2022-12-01,56,007,WY,Carbon County,7010,6720,290,4.1
CN5600900000000,2022-12-01,56,009,WY,Converse County,7661,7450,211,2.8
CN5601100000000,2022-12-01,56,011,WY,Crook County,3720,3606,114,3.1
CN5601300000000,2022-12-01,56,013,WY,Fremont County,18754,18029,725,3.9
CN5601500000000,2022-12-01,56,015,WY,Goshen County,6382,6184,198,3.1
CN5601700000000,2022-12-01,56,017,WY,Hot Springs County,2280,2209,71,3.1
CN5601900000000,2022-12-01,56,019,WY,Johnson County,4125,3971,154,3.7
CN5602100000000,2022-12-01,56,021,WY,Laramie County,49825,48054,1771,3.6
CN5602300000000,2022-12-01,56,023,WY,Lincoln County,9604,9270,334,3.5
CN5602500000000,2022-12-01,56,025,WY,Natrona County,39831,38318,1513,3.8
CN5602700000000,2022-12-01,56,027,WY,Niobrara County,1156,1116,40,3.5
CN5602900000000,2022-12-01,56,029,WY,Park County,14571,13999,572,3.9
CN5603100000000,2022-12-01,56,031,WY,Platte County,4280,4114,166,3.9
CN5603300000000,2022-12-01,56,033,WY,Sheridan County,16150,15574,576,3.6
CN5603500000000,2022-12-01,56,035,WY,Sublette County,3741,3581,160,4.3
CN5603700000000,2022-12-01,56,037,WY,Sweetwater County,19815,18979,836,4.2
CN5603900000000,2022-12-01,56,039,WY,Teton County,16670,16253,417,2.5
CN5604100000000,2022-12-01,56,041,WY,Uinta County,9013,8666,347,3.8
CN5604300000000,2022-12-01,56,043,WY,Washakie County,3808,3659,149,3.9
CN5604500000000,2022-12-01,56,045,WY,Weston County,3808,3711,97,2.5
CN7200100000000,2022-12-01,72,001,PR,Adjuntas Municipio,4716,4301,415,8.8
CN7200300000000,2022-12-01,72,003,PR,Aguada Municipio,13838,12883,955,6.9
CN7200500000000,2022-12-01,72,005,PR,Aguadilla Municipio,16928,15511,1417,8.4
CN7200700000000,2022-12-01,72,007,PR,Aguas Buenas Municipio,7271,6845,426,5.9
CN7200900000000,2022-12-01,72,009,PR,Aibonito Municipio,7062,6574,488,6.9
CN7201100000000,2022-12-01,72,011,PR,Anasco Municipio,10435,9789,646,6.2
CN7201300000000,2022-12-01,72,013,PR,Arecibo Municipio,26819,25082,1737,6.5
CN7201500000000,2022-12-01,72,015,PR,Arroyo Municipio,5114,4666,448,8.8
CN7201700000000,2022-12-01,72,017,PR,Barceloneta Municipio,6576,6055,521,7.9
CN7201900000000,2022-12-01,72,019,PR,Barranquitas Municipio,8170,7566,604,7.4
CN7202100000000,2022-12-01,72,021,PR,Bayamon Municipio,72177,68762,3415,4.7
CN7202300000000,2022-12-01,72,023,PR,Cabo Rojo Municipio,15632,14591,1041,6.7
CN7202500000000,2022-12-01,72,025,PR,Caguas Municipio,53135,50642,2493,4.7
CN7202700000000,2022-12-01,72,027,PR,Camuy Municipio,10859,10123,736,6.8
CN7202900000000,2022-12-01,72,029,PR,Canovanas Municipio,18228,17317,911,5
CN7203100000000,2022-12-01,72,031,PR,Carolina Municipio,68124,65080,3044,4.5
CN7203300000000,2022-12-01,72,033,PR,Catano Municipio,8597,8188,409,4.8
CN7203500000000,2022-12-01,72,035,PR,Cayey Municipio,17992,17129,863,4.8
CN7203700000000,2022-12-01,72,037,PR,Ceiba Municipio,3972,3719,253,6.4
CN7203900000000,2022-12-01,72,039,PR,Ciales Municipio,4052,3742,310,7.7
CN7204100000000,2022-12-01,72,041,PR,Cidra Municipio,17226,16411,815,4.7
CN7204300000000,2022-12-01,72,043,PR,Coamo Municipio,11645,10775,870,7.5
CN7204500000000,2022-12-01,72,045,PR,Comerio Municipio,5491,5107,384,7
CN7204700000000,2022-12-01,72,047,PR,Corozal Municipio,9838,9133,705,7.2
CN7204900000000,2022-12-01,72,049,PR,Culebra Municipio,997,975,22,2.2
CN7205100000000,2022-12-01,72,051,PR,Dorado Municipio,15053,14425,628,4.2
CN7205300000000,2022-12-01,72,053,PR,Fajardo Municipio,11693,10953,740,6.3
CN7205400000000,2022-12-01,72,054,PR,Florida Municipio,3638,3350,288,7.9
CN7205500000000,2022-12-01,72,055,PR,Guanica Municipio,4225,3849,376,8.9
CN7205700000000,2022-12-01,72,057,PR,Guayama Municipio,11996,11159,837,7
CN7205900000000,2022-12-01,72,059,PR,Guayanilla Municipio,5413,4829,584,10.8
CN7206100000000,2022-12-01,72,061,PR,Guaynabo Municipio,42302,41063,1239,2.9
CN7206300000000,2022-12-01,72,063,PR,Gurabo Municipio,20992,20138,854,4.1
CN7206500000000,2022-12-01,72,065,PR,Hatillo Municipio,15903,14135,1768,11.1
CN7206700000000,2022-12-01,72,067,PR,Hormigueros Municipio,6176,5884,292,4.7
CN7206900000000,2022-12-01,72,069,PR,Humacao Municipio,19581,18327,1254,6.4
CN7207100000000,2022-12-01,72,071,PR,Isabela Municipio,13802,12873,929,6.7
CN7207300000000,2022-12-01,72,073,PR,Jayuya Municipio,4753,4312,441,9.3
CN7207500000000,2022-12-01,72,075,PR,Juana Diaz Municipio,17550,16270,1280,7.3
CN7207700000000,2022-12-01,72,077,PR,Juncos Municipio,13863,13006,857,6.2
CN7207900000000,2022-12-01,72,079,PR,Lajas Municipio,5869,5335,534,9.1
CN7208100000000,2022-12-01,72,081,PR,Lares Municipio,8262,7342,920,11.1
CN7208300000000,2022-12-01,72,083,PR,Las Marias Municipio,2880,2500,380,13.2
CN7208500000000,2022-12-01,72,085,PR,Las Piedras Municipio,12791,12035,756,5.9
CN7208700000000,2022-12-01,72,087,PR,Loiza Municipio,9192,8704,488,5.3
CN7208900000000,2022-12-01,72,089,PR,Luquillo Municipio,6816,6407,409,6
CN7209100000000,2022-12-01,72,091,PR,Manati Municipio,12524,11784,740,5.9
CN7209300000000,2022-12-01,72,093,PR,Maricao Municipio,2189,1980,209,9.5
CN7209500000000,2022-12-01,72,095,PR,Maunabo Municipio,3165,2816,349,11
CN7209700000000,2022-12-01,72,097,PR,Mayaguez Municipio,25087,23348,1739,6.9
CN7209900000000,2022-12-01,72,099,PR,Moca Municipio,12306,11274,1032,8.4
CN7210100000000,2022-12-01,72,101,PR,Morovis Municipio,8987,8368,619,6.9
CN7210300000000,2022-12-01,72,103,PR,Naguabo Municipio,9189,8653,536,5.8
CN7210500000000,2022-12-01,72,105,PR,Naranjito Municipio,7881,7330,551,7
CN7210700000000,2022-12-01,72,107,PR,Orocovis Municipio,5433,4956,477,8.8
CN7210900000000,2022-12-01,72,109,PR,Patillas Municipio,4568,4129,439,9.6
CN7211100000000,2022-12-01,72,111,PR,Penuelas Municipio,6360,5725,635,10
CN7211300000000,2022-12-01,72,113,PR,Ponce Municipio,50158,46655,3503,7
CN7211500000000,2022-12-01,72,115,PR,Quebradillas Municipio,6850,6292,558,8.1
CN7211700000000,2022-12-01,72,117,PR,Rincon Municipio,5654,4982,672,11.9
CN7211900000000,2022-12-01,72,119,PR,Rio Grande Municipio,18869,17907,962,5.1
CN7212100000000,2022-12-01,72,121,PR,Sabana Grande Municipio,6604,6090,514,7.8
CN7212300000000,2022-12-01,72,123,PR,Salinas Municipio,7776,7073,703,9
CN7212500000000,2022-12-01,72,125,PR,San German Municipio,10750,9977,773,7.2
CN7212700000000,2022-12-01,72,127,PR,San Juan Municipio,149038,142383,6655,4.5
CN7212900000000,2022-12-01,72,129,PR,San Lorenzo Municipio,12877,12095,782,6.1
CN7213100000000,2022-12-01,72,131,PR,San Sebastian Municipio,11844,10660,1184,10
CN7213300000000,2022-12-01,72,133,PR,Santa Isabel Municipio,8648,7925,723,8.4
CN7213500000000,2022-12-01,72,135,PR,Toa Alta Municipio,31060,29722,1338,4.3
CN7213700000000,2022-12-01,72,137,PR,Toa Baja Municipio,32315,30861,1454,4.5
CN7213900000000,2022-12-01,72,139,PR,Trujillo Alto Municipio,30109,29167,942,3.1
CN7214100000000,2022-12-01,72,141,PR,Utuado Municipio,7663,7055,608,7.9
CN7214300000000,2022-12-01,72,143,PR,Vega Alta Municipio,10944,10208,736,6.7
CN7214500000000,2022-12-01,72,145,PR,Vega Baja Municipio,14668,13616,1052,7.2
CN7214700000000,2022-12-01,72,147,PR,Vieques Municipio,2780,2642,138,5
CN7214900000000,2022-12-01,72,149,PR,Villalba Municipio,8120,7178,942,11.6
CN7215100000000,2022-12-01,72,151,PR,Yabucoa Municipio,9504,8733,771,8.1
CN7215300000000,2022-12-01,72,153,PR,Yauco Municipio,10834,9606,1228,11.3
CN0100100000000,2023-01-01,01,001,AL,Autauga County,26658,26045,613,2.3
CN0100300000000,2023-01-01,01,003,AL,Baldwin County,101860,99347,2513,2.5
CN0100500000000,2023-01-01,01,005,AL,Barbour County,8157,7785,372,4.6
CN0100700000000,2023-01-01,01,007,AL,Bibb County,8645,8426,219,2.5
CN0100900000000,2023-01-01,01,009,AL,Blount County,25479,24927,552,2.2
CN0101100000000,2023-01-01,01,011,AL,Bullock County,4473,4338,135,3
CN0101300000000,2023-01-01,01,013,AL,Butler County,8700,8421,279,3.2
CN0101500000000,2023-01-01,01,015,AL,Calhoun County,46031,44756,1275,2.8
CN0101700000000,2023-01-01,01,017,AL,Chambers County,15842,15438,404,2.6
CN0101900000000,2023-01-01,01,019,AL,Cherokee County,11573,11290,283,2.4
CN0102100000000,2023-01-01,01,021,AL,Chilton County,20032,19580,452,2.3
CN0102300000000,2023-01-01,01,023,AL,Choctaw County,4215,4027,188,4.5
CN0102500000000,2023-01-01,01,025,AL,Clarke County,7664,7215,449,5.9
CN0102700000000,2023-01-01,01,027,AL,Clay County,6037,5891,146,2.4
CN0102900000000,2023-01-01,01,029,AL,Cleburne County,6087,5932,155,2.5
CN0103100000000,2023-01-01,01,031,AL,Coffee County,21450,20877,573,2.7
CN0103300000000,2023-01-01,01,033,AL,Colbert County,23689,22910,779,3.3
CN0103500000000,2023-01-01,01,035,AL,Conecuh County,4167,4017,150,3.6
CN0103700000000,2023-01-01,01,037,AL,Coosa County,4456,4336,120,2.7
CN0103900000000,2023-01-01,01,039,AL,Covington County,14711,14296,415,2.8
CN0104100000000,2023-01-01,01,041,AL,Crenshaw County,5805,5640,165,2.8
CN0104300000000,2023-01-01,01,043,AL,Cullman County,38585,37781,804,2.1
CN0104500000000,2023-01-01,01,045,AL,Dale County,20840,20293,547,2.6
CN0104700000000,2023-01-01,01,047,AL,Dallas County,13416,12700,716,5.3
CN0104900000000,2023-01-01,01,049,AL,DeKalb County,30687,29949,738,2.4
CN0105100000000,2023-01-01,01,051,AL,Elmore County,38083,37230,853,2.2
CN0105300000000,2023-01-01,01,053,AL,Escambia County,14164,13662,502,3.5
CN0105500000000,2023-01-01,01,055,AL,Etowah County,38596,37468,1128,2.9
CN0105700000000,2023-01-01,01,057,AL,Fayette County,6484,6293,191,2.9
CN0105900000000,2023-01-01,01,059,AL,Franklin County,14488,14106,382,2.6
CN0106100000000,2023-01-01,01,061,AL,Geneva County,11221,10950,271,2.4
CN0106300000000,2023-01-01,01,063,AL,Greene County,2742,2616,126,4.6
CN0106500000000,2023-01-01,01,065,AL,Hale County,5943,5720,223,3.8
CN0106700000000,2023-01-01,01,067,AL,Henry County,7055,6859,196,2.8
CN0106900000000,2023-01-01,01,069,AL,Houston County,48284,46946,1338,2.8
CN0107100000000,2023-01-01,01,071,AL,Jackson County,22868,22248,620,2.7
CN0107300000000,2023-01-01,01,073,AL,Jefferson County,320417,312309,8108,2.5
CN0107500000000,2023-01-01,01,075,AL,Lamar County,5656,5503,153,2.7
CN0107700000000,2023-01-01,01,077,AL,Lauderdale County,42532,41377,1155,2.7
CN0107900000000,2023-01-01,01,079,AL,Lawrence County,14780,14426,354,2.4
CN0108100000000,2023-01-01,01,081,AL,Lee County,79572,77719,1853,2.3
CN0108300000000,2023-01-01,01,083,AL,Limestone County,48565,47525,1040,2.1
CN0108500000000,2023-01-01,01,085,AL,Lowndes County,3483,3302,181,5.2
CN0108700000000,2023-01-01,01,087,AL,Macon County,7764,7501,263,3.4
CN0108900000000,2023-01-01,01,089,AL,Madison County,200259,196069,4190,2.1
CN0109100000000,2023-01-01,01,091,AL,Marengo County,7596,7322,274,3.6
CN0109300000000,2023-01-01,01,093,AL,Marion County,13796,13312,484,3.5
CN0109500000000,2023-01-01,01,095,AL,Marshall County,45053,44127,926,2.1
CN0109700000000,2023-01-01,01,097,AL,Mobile County,192208,186081,6127,3.2
CN0109900000000,2023-01-01,01,099,AL,Monroe County,7150,6828,322,4.5
CN0110100000000,2023-01-01,01,101,AL,Montgomery County,106833,103527,3306,3.1
CN0110300000000,2023-01-01,01,103,AL,Morgan County,61137,59894,1243,2
CN0110500000000,2023-01-01,01,105,AL,Perry County,2967,2821,146,4.9
CN0110700000000,2023-01-01,01,107,AL,Pickens County,7700,7462,238,3.1
CN0110900000000,2023-01-01,01,109,AL,Pike County,16060,15628,432,2.7
CN0111100000000,2023-01-01,01,111,AL,Randolph County,9594,9348,246,2.6
CN0111300000000,2023-01-01,01,113,AL,Russell County,24050,23372,678,2.8
CN0111500000000,2023-01-01,01,115,AL,St. Clair County,41822,40900,922,2.2
CN0111700000000,2023-01-01,01,117,AL,Shelby County,120303,118103,2200,1.8
CN0111900000000,2023-01-01,01,119,AL,Sumter County,4523,4373,150,3.3
CN0112100000000,2023-01-01,01,121,AL,Talladega County,36733,35661,1072,2.9
CN0112300000000,2023-01-01,01,123,AL,Tallapoosa County,16953,16461,492,2.9
CN0112500000000,2023-01-01,01,125,AL,Tuscaloosa County,104218,101805,2413,2.3
CN0112700000000,2023-01-01,01,127,AL,Walker County,25338,24610,728,2.9
CN0112900000000,2023-01-01,01,129,AL,Washington County,6570,6309,261,4
CN0113100000000,2023-01-01,01,131,AL,Wilcox County,2526,2303,223,8.8
CN0113300000000,2023-01-01,01,133,AL,Winston County,10146,9873,273,2.7
CN0201300000000,2023-01-01,02,013,AK,Aleutians East Borough,2662,2610,52,2
CN0201600000000,2023-01-01,02,016,AK,Aleutians West Census Area,3665,3553,112,3.1
CN0202000000000,2023-01-01,02,020,AK,Anchorage Borough/municipality,153089,147972,5117,3.3
CN0205000000000,2023-01-01,02,050,AK,Bethel Census Area,6493,5903,590,9.1
CN0206000000000,2023-01-01,02,060,AK,Bristol Bay Borough,219,193,26,11.9
CN0206300000000,2023-01-01,02,063,AK,Chugach Census Area,2843,2677,166,5.8
CN0206600000000,2023-01-01,02,066,AK,Copper River Census Area,1163,1038,125,10.7
CN0206800000000,2023-01-01,02,068,AK,Denali Borough,579,496,83,14.3
CN0207000000000,2023-01-01,02,070,AK,Dillingham Census Area,1435,1347,88,6.1
CN0209000000000,2023-01-01,02,090,AK,Fairbanks North Star Borough,45576,43703,1873,4.1
CN0210000000000,2023-01-01,02,100,AK,Haines Borough,886,790,96,10.8
CN0210500000000,2023-01-01,02,105,AK,Hoonah-Angoon Census Area,998,888,110,11
CN0211000000000,2023-01-01,02,110,AK,Juneau Borough/city,17008,16456,552,3.2
CN0212200000000,2023-01-01,02,122,AK,Kenai Peninsula Borough,26770,25299,1471,5.5
CN0213000000000,2023-01-01,02,130,AK,Ketchikan Gateway Borough,6207,5916,291,4.7
CN0215000000000,2023-01-01,02,150,AK,Kodiak Island Borough,5723,5400,323,5.6
CN0215800000000,2023-01-01,02,158,AK,Kusilvak Census Area,2231,1932,299,13.4
CN0216400000000,2023-01-01,02,164,AK,Lake and Peninsula Borough,532,492,40,7.5
CN0217000000000,2023-01-01,02,170,AK,Matanuska-Susitna Borough,50570,48000,2570,5.1
CN0218000000000,2023-01-01,02,180,AK,Nome Census Area,4008,3732,276,6.9
CN0218500000000,2023-01-01,02,185,AK,North Slope Borough,3126,2978,148,4.7
CN0218800000000,2023-01-01,02,188,AK,Northwest Arctic Borough,2936,2653,283,9.6
CN0219500000000,2023-01-01,02,195,AK,Petersburg Borough,1336,1249,87,6.5
CN0219800000000,2023-01-01,02,198,AK,Prince of Wales-Hyder Census Area,2698,2497,201,7.4
CN0222000000000,2023-01-01,02,220,AK,Sitka Borough/city,4103,3959,144,3.5
CN0223000000000,2023-01-01,02,230,AK,Skagway Municipality,584,502,82,14
CN0224000000000,2023-01-01,02,240,AK,Southeast Fairbanks Census Area,3169,2979,190,6
CN0227500000000,2023-01-01,02,275,AK,Wrangell Borough/city,863,815,48,5.6
CN0228200000000,2023-01-01,02,282,AK,Yakutat Borough/city,300,280,20,6.7
CN0229000000000,2023-01-01,02,290,AK,Yukon-Koyukuk Census Area,2293,2089,204,8.9
CN0400100000000,2023-01-01,04,001,AZ,Apache County,18954,17604,1350,7.1
CN0400300000000,2023-01-01,04,003,AZ,Cochise County,48800,46865,1935,4
CN0400500000000,2023-01-01,04,005,AZ,Coconino County,75064,72174,2890,3.9
CN0400700000000,2023-01-01,04,007,AZ,Gila County,20468,19706,762,3.7
CN0400900000000,2023-01-01,04,009,AZ,Graham County,16125,15617,508,3.2
CN0401100000000,2023-01-01,04,011,AZ,Greenlee County,5029,4914,115,2.3
CN0401200000000,2023-01-01,04,012,AZ,La Paz County,9570,9182,388,4.1
CN0401300000000,2023-01-01,04,013,AZ,Maricopa County,2417302,2348562,68740,2.8
CN0401500000000,2023-01-01,04,015,AZ,Mohave County,89826,86219,3607,4
CN0401700000000,2023-01-01,04,017,AZ,Navajo County,39957,37972,1985,5
CN0401900000000,2023-01-01,04,019,AZ,Pima County,496155,480368,15787,3.2
CN0402100000000,2023-01-01,04,021,AZ,Pinal County,203893,196994,6899,3.4
CN0402300000000,2023-01-01,04,023,AZ,Santa Cruz County,19371,18136,1235,6.4
CN0402500000000,2023-01-01,04,025,AZ,Yavapai County,108649,105346,3303,3
CN0402700000000,2023-01-01,04,027,AZ,Yuma County,98610,88919,9691,9.8
CN0500100000000,2023-01-01,05,001,AR,Arkansas County,9052,8761,291,3.2
CN0500300000000,2023-01-01,05,003,AR,Ashley County,6595,6167,428,6.5
CN0500500000000,2023-01-01,05,005,AR,Baxter County,16230,15568,662,4.1
CN0500700000000,2023-01-01,05,007,AR,Benton County,152330,148314,4016,2.6
CN0500900000000,2023-01-01,05,009,AR,Boone County,15738,15184,554,3.5
CN0501100000000,2023-01-01,05,011,AR,Bradley County,3952,3706,246,6.2
CN0501300000000,2023-01-01,05,013,AR,Calhoun County,2313,2231,82,3.5
CN0501500000000,2023-01-01,05,015,AR,Carroll County,11888,11428,460,3.9
CN0501700000000,2023-01-01,05,017,AR,Chicot County,2852,2663,189,6.6
CN0501900000000,2023-01-01,05,019,AR,Clark County,8163,7712,451,5.5
CN0502100000000,2023-01-01,05,021,AR,Clay County,5231,4950,281,5.4
CN0502300000000,2023-01-01,05,023,AR,Cleburne County,8704,8286,418,4.8
CN0502500000000,2023-01-01,05,025,AR,Cleveland County,3013,2892,121,4
CN0502700000000,2023-01-01,05,027,AR,Columbia County,8780,8336,444,5.1
CN0502900000000,2023-01-01,05,029,AR,Conway County,8283,7928,355,4.3
CN0503100000000,2023-01-01,05,031,AR,Craighead County,57401,55672,1729,3
CN0503300000000,2023-01-01,05,033,AR,Crawford County,26054,25164,890,3.4
CN0503500000000,2023-01-01,05,035,AR,Crittenden County,20362,19438,924,4.5
CN0503700000000,2023-01-01,05,037,AR,Cross County,6690,6414,276,4.1
CN0503900000000,2023-01-01,05,039,AR,Dallas County,2683,2557,126,4.7
CN0504100000000,2023-01-01,05,041,AR,Desha County,4784,4517,267,5.6
CN0504300000000,2023-01-01,05,043,AR,Drew County,7373,7006,367,5
CN0504500000000,2023-01-01,05,045,AR,Faulkner County,62455,60400,2055,3.3
CN0504700000000,2023-01-01,05,047,AR,Franklin County,7342,7085,257,3.5
CN0504900000000,2023-01-01,05,049,AR,Fulton County,4929,4732,197,4
CN0505100000000,2023-01-01,05,051,AR,Garland County,41711,39987,1724,4.1
CN0505300000000,2023-01-01,05,053,AR,Grant County,8314,8051,263,3.2
CN0505500000000,2023-01-01,05,055,AR,Greene County,19554,18801,753,3.9
CN0505700000000,2023-01-01,05,057,AR,Hempstead County,9249,8927,322,3.5
CN0505900000000,2023-01-01,05,059,AR,Hot Spring County,13731,13198,533,3.9
CN0506100000000,2023-01-01,05,061,AR,Howard County,5173,4982,191,3.7
CN0506300000000,2023-01-01,05,063,AR,Independence County,16506,15911,595,3.6
CN0506500000000,2023-01-01,05,065,AR,Izard County,4428,4166,262,5.9
CN0506700000000,2023-01-01,05,067,AR,Jackson County,5361,5018,343,6.4
CN0506900000000,2023-01-01,05,069,AR,Jefferson County,25258,23923,1335,5.3
CN0507100000000,2023-01-01,05,071,AR,Johnson County,9952,9504,448,4.5
CN0507300000000,2023-01-01,05,073,AR,Lafayette County,2259,2139,120,5.3
CN0507500000000,2023-01-01,05,075,AR,Lawrence County,6763,6517,246,3.6
CN0507700000000,2023-01-01,05,077,AR,Lee County,2497,2342,155,6.2
CN0507900000000,2023-01-01,05,079,AR,Lincoln County,3602,3439,163,4.5
CN0508100000000,2023-01-01,05,081,AR,Little River County,5156,4944,212,4.1
CN0508300000000,2023-01-01,05,083,AR,Logan County,8069,7715,354,4.4
CN0508500000000,2023-01-01,05,085,AR,Lonoke County,33706,32682,1024,3
CN0508700000000,2023-01-01,05,087,AR,Madison County,7709,7497,212,2.8
CN0508900000000,2023-01-01,05,089,AR,Marion County,6205,5909,296,4.8
CN0509100000000,2023-01-01,05,091,AR,Miller County,18563,17815,748,4
CN0509300000000,2023-01-01,05,093,AR,Mississippi County,16015,15159,856,5.3
CN0509500000000,2023-01-01,05,095,AR,Monroe County,2484,2355,129,5.2
CN0509700000000,2023-01-01,05,097,AR,Montgomery County,2682,2514,168,6.3
CN0509900000000,2023-01-01,05,099,AR,Nevada County,3411,3282,129,3.8
CN0510100000000,2023-01-01,05,101,AR,Newton County,3150,3034,116,3.7
CN0510300000000,2023-01-01,05,103,AR,Ouachita County,9529,9114,415,4.4
CN0510500000000,2023-01-01,05,105,AR,Perry County,4168,3995,173,4.2
CN0510700000000,2023-01-01,05,107,AR,Phillips County,5478,5039,439,8
CN0510900000000,2023-01-01,05,109,AR,Pike County,3869,3716,153,4
CN0511100000000,2023-01-01,05,111,AR,Poinsett County,9878,9490,388,3.9
CN0511300000000,2023-01-01,05,113,AR,Polk County,7717,7410,307,4
CN0511500000000,2023-01-01,05,115,AR,Pope County,27207,26003,1204,4.4
CN0511700000000,2023-01-01,05,117,AR,Prairie County,3455,3332,123,3.6
CN0511900000000,2023-01-01,05,119,AR,Pulaski County,187218,180579,6639,3.5
CN0512100000000,2023-01-01,05,121,AR,Randolph County,7073,6803,270,3.8
CN0512300000000,2023-01-01,05,123,AR,St. Francis County,7350,6943,407,5.5
CN0512500000000,2023-01-01,05,125,AR,Saline County,59365,57593,1772,3
CN0512700000000,2023-01-01,05,127,AR,Scott County,4200,4074,126,3
CN0512900000000,2023-01-01,05,129,AR,Searcy County,2772,2610,162,5.8
CN0513100000000,2023-01-01,05,131,AR,Sebastian County,54913,53082,1831,3.3
CN0513300000000,2023-01-01,05,133,AR,Sevier County,5342,5129,213,4
CN0513500000000,2023-01-01,05,135,AR,Sharp County,5845,5561,284,4.9
CN0513700000000,2023-01-01,05,137,AR,Stone County,4413,4187,226,5.1
CN0513900000000,2023-01-01,05,139,AR,Union County,14594,13836,758,5.2
CN0514100000000,2023-01-01,05,141,AR,Van Buren County,5880,5599,281,4.8
CN0514300000000,2023-01-01,05,143,AR,Washington County,134522,131149,3373,2.5
CN0514500000000,2023-01-01,05,145,AR,White County,33884,32559,1325,3.9
CN0514700000000,2023-01-01,05,147,AR,Woodruff County,2774,2651,123,4.4
CN0514900000000,2023-01-01,05,149,AR,Yell County,7698,7368,330,4.3
CN0600100000000,2023-01-01,06,001,CA,Alameda County,823276,793170,30106,3.7
CN0600300000000,2023-01-01,06,003,CA,Alpine County,633,602,31,4.9
CN0600500000000,2023-01-01,06,005,CA,Amador County,14226,13426,800,5.6
CN0600700000000,2023-01-01,06,007,CA,Butte County,92345,87192,5153,5.6
CN0600900000000,2023-01-01,06,009,CA,Calaveras County,22164,21148,1016,4.6
CN0601100000000,2023-01-01,06,011,CA,Colusa County,10109,8323,1786,17.7
CN0601300000000,2023-01-01,06,013,CA,Contra Costa County,549838,528463,21375,3.9
CN0601500000000,2023-01-01,06,015,CA,Del Norte County,9199,8616,583,6.3
CN0601700000000,2023-01-01,06,017,CA,El Dorado County,93532,89862,3670,3.9
CN0601900000000,2023-01-01,06,019,CA,Fresno County,458484,423838,34646,7.6
CN0602100000000,2023-01-01,06,021,CA,Glenn County,12882,11961,921,7.1
CN0602300000000,2023-01-01,06,023,CA,Humboldt County,59404,56532,2872,4.8
CN0602500000000,2023-01-01,06,025,CA,Imperial County,72254,60520,11734,16.2
CN0602700000000,2023-01-01,06,027,CA,Inyo County,8231,7881,350,4.3
CN0602900000000,2023-01-01,06,029,CA,Kern County,393275,361336,31939,8.1
CN0603100000000,2023-01-01,06,031,CA,Kings County,57863,52853,5010,8.7
CN0603300000000,2023-01-01,06,033,CA,Lake County,28571,26642,1929,6.8
CN0603500000000,2023-01-01,06,035,CA,Lassen County,8952,8411,541,6
CN0603700000000,2023-01-01,06,037,CA,Los Angeles County,4982143,4736443,245700,4.9
CN0603900000000,2023-01-01,06,039,CA,Madera County,65803,60836,4967,7.5
CN0604100000000,2023-01-01,06,041,CA,Marin County,130593,126599,3994,3.1
CN0604300000000,2023-01-01,06,043,CA,Mariposa County,6953,6543,410,5.9
CN0604500000000,2023-01-01,06,045,CA,Mendocino County,36912,34902,2010,5.4
CN0604700000000,2023-01-01,06,047,CA,Merced County,115289,104060,11229,9.7
CN0604900000000,2023-01-01,06,049,CA,Modoc County,3121,2837,284,9.1
CN0605100000000,2023-01-01,06,051,CA,Mono County,8766,8411,355,4
CN0605300000000,2023-01-01,06,053,CA,Monterey County,216615,197356,19259,8.9
CN0605500000000,2023-01-01,06,055,CA,Napa County,70663,67896,2767,3.9
CN0605700000000,2023-01-01,06,057,CA,Nevada County,49027,47066,1961,4
CN0605900000000,2023-01-01,06,059,CA,Orange County,1593371,1539657,53714,3.4
CN0606100000000,2023-01-01,06,061,CA,Placer County,194185,187208,6977,3.6
CN0606300000000,2023-01-01,06,063,CA,Plumas County,6970,6261,709,10.2
CN0606500000000,2023-01-01,06,065,CA,Riverside County,1151958,1100113,51845,4.5
CN0606700000000,2023-01-01,06,067,CA,Sacramento County,729692,697153,32539,4.5
CN0606900000000,2023-01-01,06,069,CA,San Benito County,32593,30559,2034,6.2
CN0607100000000,2023-01-01,06,071,CA,San Bernardino County,1007405,963262,44143,4.4
CN0607300000000,2023-01-01,06,073,CA,San Diego County,1600536,1541801,58735,3.7
CN0607500000000,2023-01-01,06,075,CA,San Francisco County/city,576820,560605,16215,2.8
CN0607700000000,2023-01-01,06,077,CA,San Joaquin County,344698,322961,21737,6.3
CN0607900000000,2023-01-01,06,079,CA,San Luis Obispo County,137322,132573,4749,3.5
CN0608100000000,2023-01-01,06,081,CA,San Mateo County,456437,444411,12026,2.6
CN0608300000000,2023-01-01,06,083,CA,Santa Barbara County,220755,210793,9962,4.5
CN0608500000000,2023-01-01,06,085,CA,Santa Clara County,1043837,1012902,30935,3
CN0608700000000,2023-01-01,06,087,CA,Santa Cruz County,132456,124235,8221,6.2
CN0608900000000,2023-01-01,06,089,CA,Shasta County,74029,69791,4238,5.7
CN0609100000000,2023-01-01,06,091,CA,Sierra County,1264,1189,75,5.9
CN0609300000000,2023-01-01,06,093,CA,Siskiyou County,16362,15125,1237,7.6
CN0609500000000,2023-01-01,06,095,CA,Solano County,201242,191684,9558,4.7
CN0609700000000,2023-01-01,06,097,CA,Sonoma County,248585,239658,8927,3.6
CN0609900000000,2023-01-01,06,099,CA,Stanislaus County,242287,226487,15800,6.5
CN0610100000000,2023-01-01,06,101,CA,Sutter County,46127,42053,4074,8.8
CN0610300000000,2023-01-01,06,103,CA,Tehama County,25591,24009,1582,6.2
CN0610500000000,2023-01-01,06,105,CA,Trinity County,4449,4129,320,7.2
CN0610700000000,2023-01-01,06,107,CA,Tulare County,209430,188684,20746,9.9
CN0610900000000,2023-01-01,06,109,CA,Tuolumne County,19634,18573,1061,5.4
CN0611100000000,2023-01-01,06,111,CA,Ventura County,413374,395993,17381,4.2
CN0611300000000,2023-01-01,06,113,CA,Yolo County,109200,103727,5473,5
CN0611500000000,2023-01-01,06,115,CA,Yuba County,31906,29621,2285,7.2
CN0800100000000,2023-01-01,08,001,CO,Adams County,283332,273742,9590,3.4
CN0800300000000,2023-01-01,08,003,CO,Alamosa County,7939,7638,301,3.8
CN0800500000000,2023-01-01,08,005,CO,Arapahoe County,377249,366126,11123,2.9
CN0800700000000,2023-01-01,08,007,CO,Archuleta County,6841,6621,220,3.2
CN0800900000000,2023-01-01,08,009,CO,Baca County,1921,1884,37,1.9
CN0801100000000,2023-01-01,08,011,CO,Bent County,1676,1620,56,3.3
CN0801300000000,2023-01-01,08,013,CO,Boulder County,203090,198081,5009,2.5
CN0801400000000,2023-01-01,08,014,CO,Broomfield County/city,42758,41634,1124,2.6
CN0801500000000,2023-01-01,08,015,CO,Chaffee County,9749,9456,293,3
CN0801700000000,2023-01-01,08,017,CO,Cheyenne County,963,941,22,2.3
CN0801900000000,2023-01-01,08,019,CO,Clear Creek County,6182,6011,171,2.8
CN0802100000000,2023-01-01,08,021,CO,Conejos County,3777,3656,121,3.2
CN0802300000000,2023-01-01,08,023,CO,Costilla County,1724,1644,80,4.6
CN0802500000000,2023-01-01,08,025,CO,Crowley County,1342,1283,59,4.4
CN0802700000000,2023-01-01,08,027,CO,Custer County,2268,2192,76,3.4
CN0802900000000,2023-01-01,08,029,CO,Delta County,12544,12018,526,4.2
CN0803100000000,2023-01-01,08,031,CO,Denver County/city,439280,425559,13721,3.1
CN0803300000000,2023-01-01,08,033,CO,Dolores County,1101,1074,27,2.5
CN0803500000000,2023-01-01,08,035,CO,Douglas County,209060,203774,5286,2.5
CN0803700000000,2023-01-01,08,037,CO,Eagle County,36814,35996,818,2.2
CN0803900000000,2023-01-01,08,039,CO,Elbert County,15876,15497,379,2.4
CN0804100000000,2023-01-01,08,041,CO,El Paso County,363269,351687,11582,3.2
CN0804300000000,2023-01-01,08,043,CO,Fremont County,14113,13405,708,5
CN0804500000000,2023-01-01,08,045,CO,Garfield County,32226,31247,979,3
CN0804700000000,2023-01-01,08,047,CO,Gilpin County,3949,3847,102,2.6
CN0804900000000,2023-01-01,08,049,CO,Grand County,9989,9740,249,2.5
CN0805100000000,2023-01-01,08,051,CO,Gunnison County,11548,11278,270,2.3
CN0805300000000,2023-01-01,08,053,CO,Hinsdale County,387,373,14,3.6
CN0805500000000,2023-01-01,08,055,CO,Huerfano County,2372,2199,173,7.3
CN0805700000000,2023-01-01,08,057,CO,Jackson County,941,920,21,2.2
CN0805900000000,2023-01-01,08,059,CO,Jefferson County,344990,335576,9414,2.7
CN0806100000000,2023-01-01,08,061,CO,Kiowa County,819,800,19,2.3
CN0806300000000,2023-01-01,08,063,CO,Kit Carson County,3932,3858,74,1.9
CN0806500000000,2023-01-01,08,065,CO,Lake County,5182,5072,110,2.1
CN0806700000000,2023-01-01,08,067,CO,La Plata County,30942,29960,982,3.2
CN0806900000000,2023-01-01,08,069,CO,Larimer County,208630,202986,5644,2.7
CN0807100000000,2023-01-01,08,071,CO,Las Animas County,5779,5499,280,4.8
CN0807300000000,2023-01-01,08,073,CO,Lincoln County,2095,2032,63,3
CN0807500000000,2023-01-01,08,075,CO,Logan County,9808,9539,269,2.7
CN0807700000000,2023-01-01,08,077,CO,Mesa County,77369,74535,2834,3.7
CN0807900000000,2023-01-01,08,079,CO,Mineral County,534,524,10,1.9
CN0808100000000,2023-01-01,08,081,CO,Moffat County,6979,6718,261,3.7
CN0808300000000,2023-01-01,08,083,CO,Montezuma County,12105,11540,565,4.7
CN0808500000000,2023-01-01,08,085,CO,Montrose County,20907,20149,758,3.6
CN0808700000000,2023-01-01,08,087,CO,Morgan County,15216,14771,445,2.9
CN0808900000000,2023-01-01,08,089,CO,Otero County,7530,7220,310,4.1
CN0809100000000,2023-01-01,08,091,CO,Ouray County,2432,2352,80,3.3
CN0809300000000,2023-01-01,08,093,CO,Park County,11686,11360,326,2.8
CN0809500000000,2023-01-01,08,095,CO,Phillips County,2206,2158,48,2.2
CN0809700000000,2023-01-01,08,097,CO,Pitkin County,10980,10715,265,2.4
CN0809900000000,2023-01-01,08,099,CO,Prowers County,5894,5740,154,2.6
CN0810100000000,2023-01-01,08,101,CO,Pueblo County,76467,73130,3337,4.4
CN0810300000000,2023-01-01,08,103,CO,Rio Blanco County,2713,2618,95,3.5
CN0810500000000,2023-01-01,08,105,CO,Rio Grande County,4979,4750,229,4.6
CN0810700000000,2023-01-01,08,107,CO,Routt County,16718,16356,362,2.2
CN0810900000000,2023-01-01,08,109,CO,Saguache County,3162,3043,119,3.8
CN0811100000000,2023-01-01,08,111,CO,San Juan County,539,524,15,2.8
CN0811300000000,2023-01-01,08,113,CO,San Miguel County,6309,6185,124,2
CN0811500000000,2023-01-01,08,115,CO,Sedgwick County,913,881,32,3.5
CN0811700000000,2023-01-01,08,117,CO,Summit County,23951,23506,445,1.9
CN0811900000000,2023-01-01,08,119,CO,Teller County,13602,13206,396,2.9
CN0812100000000,2023-01-01,08,121,CO,Washington County,2582,2523,59,2.3
CN0812300000000,2023-01-01,08,123,CO,Weld County,168556,163175,5381,3.2
CN0812500000000,2023-01-01,08,125,CO,Yuma County,5034,4936,98,1.9
CN0900100000000,2023-01-01,09,001,CT,Fairfield County,479932,459723,20209,4.2
CN0900300000000,2023-01-01,09,003,CT,Hartford County,477449,457705,19744,4.1
CN0900500000000,2023-01-01,09,005,CT,Litchfield County,104582,100242,4340,4.1
CN0900700000000,2023-01-01,09,007,CT,Middlesex County,93948,90287,3661,3.9
CN0900900000000,2023-01-01,09,009,CT,New Haven County,465634,445598,20036,4.3
CN0901100000000,2023-01-01,09,011,CT,New London County,132620,127100,5520,4.2
CN0901300000000,2023-01-01,09,013,CT,Tolland County,86496,83127,3369,3.9
CN0901500000000,2023-01-01,09,015,CT,Windham County,63947,61051,2896,4.5
CN1000100000000,2023-01-01,10,001,DE,Kent County,80459,76299,4160,5.2
CN1000300000000,2023-01-01,10,003,DE,New Castle County,306077,292280,13797,4.5
CN1000500000000,2023-01-01,10,005,DE,Sussex County,111246,105653,5593,5
CN1100100000000,2023-01-01,11,001,DC,District of Columbia,392894,373602,19292,4.9
CN1200100000000,2023-01-01,12,001,FL,Alachua County,143540,139879,3661,2.6
CN1200300000000,2023-01-01,12,003,FL,Baker County,12858,12542,316,2.5
CN1200500000000,2023-01-01,12,005,FL,Bay County,87786,85432,2354,2.7
CN1200700000000,2023-01-01,12,007,FL,Bradford County,11097,10813,284,2.6
CN1200900000000,2023-01-01,12,009,FL,Brevard County,298829,290916,7913,2.6
CN1201100000000,2023-01-01,12,011,FL,Broward County,1064855,1038366,26489,2.5
CN1201300000000,2023-01-01,12,013,FL,Calhoun County,4868,4719,149,3.1
CN1201500000000,2023-01-01,12,015,FL,Charlotte County,77869,75323,2546,3.3
CN1201700000000,2023-01-01,12,017,FL,Citrus County,49394,47458,1936,3.9
CN1201900000000,2023-01-01,12,019,FL,Clay County,115098,112312,2786,2.4
CN1202100000000,2023-01-01,12,021,FL,Collier County,189373,184593,4780,2.5
CN1202300000000,2023-01-01,12,023,FL,Columbia County,29474,28654,820,2.8
CN1202700000000,2023-01-01,12,027,FL,DeSoto County,13920,13500,420,3
CN1202900000000,2023-01-01,12,029,FL,Dixie County,5858,5670,188,3.2
CN1203100000000,2023-01-01,12,031,FL,Duval County,520149,506446,13703,2.6
CN1203300000000,2023-01-01,12,033,FL,Escambia County,149205,145141,4064,2.7
CN1203500000000,2023-01-01,12,035,FL,Flagler County,51151,49503,1648,3.2
CN1203700000000,2023-01-01,12,037,FL,Franklin County,4743,4619,124,2.6
CN1203900000000,2023-01-01,12,039,FL,Gadsden County,19183,18523,660,3.4
CN1204100000000,2023-01-01,12,041,FL,Gilchrist County,7479,7269,210,2.8
CN1204300000000,2023-01-01,12,043,FL,Glades County,5327,5167,160,3
CN1204500000000,2023-01-01,12,045,FL,Gulf County,5401,5277,124,2.3
CN1204700000000,2023-01-01,12,047,FL,Hamilton County,4157,4007,150,3.6
CN1204900000000,2023-01-01,12,049,FL,Hardee County,8825,8537,288,3.3
CN1205100000000,2023-01-01,12,051,FL,Hendry County,15538,14981,557,3.6
CN1205300000000,2023-01-01,12,053,FL,Hernando County,77802,75264,2538,3.3
CN1205500000000,2023-01-01,12,055,FL,Highlands County,36094,34682,1412,3.9
CN1205700000000,2023-01-01,12,057,FL,Hillsborough County,816115,795747,20368,2.5
CN1205900000000,2023-01-01,12,059,FL,Holmes County,7060,6855,205,2.9
CN1206100000000,2023-01-01,12,061,FL,Indian River County,67863,65821,2042,3
CN1206300000000,2023-01-01,12,063,FL,Jackson County,16418,15919,499,3
CN1206500000000,2023-01-01,12,065,FL,Jefferson County,5762,5605,157,2.7
CN1206700000000,2023-01-01,12,067,FL,Lafayette County,2813,2739,74,2.6
CN1206900000000,2023-01-01,12,069,FL,Lake County,172776,168004,4772,2.8
CN1207100000000,2023-01-01,12,071,FL,Lee County,381816,370446,11370,3
CN1207300000000,2023-01-01,12,073,FL,Leon County,160735,156476,4259,2.6
CN1207500000000,2023-01-01,12,075,FL,Levy County,17178,16651,527,3.1
CN1207700000000,2023-01-01,12,077,FL,Liberty County,2650,2577,73,2.8
CN1207900000000,2023-01-01,12,079,FL,Madison County,7815,7587,228,2.9
CN1208100000000,2023-01-01,12,081,FL,Manatee County,189413,184392,5021,2.7
CN1208300000000,2023-01-01,12,083,FL,Marion County,149679,144940,4739,3.2
CN1208500000000,2023-01-01,12,085,FL,Martin County,76419,74491,1928,2.5
CN1208600000000,2023-01-01,12,086,FL,Miami-Dade County,1374365,1347436,26929,2
CN1208700000000,2023-01-01,12,087,FL,Monroe County,50740,49882,858,1.7
CN1208900000000,2023-01-01,12,089,FL,Nassau County,45467,44377,1090,2.4
CN1209100000000,2023-01-01,12,091,FL,Okaloosa County,102933,100539,2394,2.3
CN1209300000000,2023-01-01,12,093,FL,Okeechobee County,17799,17315,484,2.7
CN1209500000000,2023-01-01,12,095,FL,Orange County,799576,779520,20056,2.5
CN1209700000000,2023-01-01,12,097,FL,Osceola County,198957,193164,5793,2.9
CN1209900000000,2023-01-01,12,099,FL,Palm Beach County,765906,746255,19651,2.6
CN1210100000000,2023-01-01,12,101,FL,Pasco County,261567,254155,7412,2.8
CN1210300000000,2023-01-01,12,103,FL,Pinellas County,516995,504350,12645,2.4
CN1210500000000,2023-01-01,12,105,FL,Polk County,341350,330818,10532,3.1
CN1210700000000,2023-01-01,12,107,FL,Putnam County,27507,26500,1007,3.7
CN1210900000000,2023-01-01,12,109,FL,St. Johns County,152243,148830,3413,2.2
CN1211100000000,2023-01-01,12,111,FL,St. Lucie County,156474,151671,4803,3.1
CN1211300000000,2023-01-01,12,113,FL,Santa Rosa County,87635,85439,2196,2.5
CN1211500000000,2023-01-01,12,115,FL,Sarasota County,198597,193283,5314,2.7
CN1211700000000,2023-01-01,12,117,FL,Seminole County,266600,260099,6501,2.4
CN1211900000000,2023-01-01,12,119,FL,Sumter County,38227,36739,1488,3.9
CN1212100000000,2023-01-01,12,121,FL,Suwannee County,17691,17167,524,3
CN1212300000000,2023-01-01,12,123,FL,Taylor County,7935,7694,241,3
CN1212500000000,2023-01-01,12,125,FL,Union County,4552,4436,116,2.5
CN1212700000000,2023-01-01,12,127,FL,Volusia County,269344,261527,7817,2.9
CN1212900000000,2023-01-01,12,129,FL,Wakulla County,16115,15738,377,2.3
CN1213100000000,2023-01-01,12,131,FL,Walton County,34866,33998,868,2.5
CN1213300000000,2023-01-01,12,133,FL,Washington County,9845,9567,278,2.8
CN1300100000000,2023-01-01,13,001,GA,Appling County,9387,8995,392,4.2
CN1300300000000,2023-01-01,13,003,GA,Atkinson County,4302,4146,156,3.6
CN1300500000000,2023-01-01,13,005,GA,Bacon County,4850,4682,168,3.5
CN1300700000000,2023-01-01,13,007,GA,Baker County,1072,1028,44,4.1
CN1300900000000,2023-01-01,13,009,GA,Baldwin County,18233,17455,778,4.3
CN1301100000000,2023-01-01,13,011,GA,Banks County,10881,10603,278,2.6
CN1301300000000,2023-01-01,13,013,GA,Barrow County,43510,42241,1269,2.9
CN1301500000000,2023-01-01,13,015,GA,Bartow County,53002,51042,1960,3.7
CN1301700000000,2023-01-01,13,017,GA,Ben Hill County,5595,5293,302,5.4
CN1301900000000,2023-01-01,13,019,GA,Berrien County,7625,7350,275,3.6
CN1302100000000,2023-01-01,13,021,GA,Bibb County,65741,63129,2612,4
CN1302300000000,2023-01-01,13,023,GA,Bleckley County,4481,4265,216,4.8
CN1302500000000,2023-01-01,13,025,GA,Brantley County,7384,7101,283,3.8
CN1302700000000,2023-01-01,13,027,GA,Brooks County,6545,6314,231,3.5
CN1302900000000,2023-01-01,13,029,GA,Bryan County,20084,19511,573,2.9
CN1303100000000,2023-01-01,13,031,GA,Bulloch County,38835,37438,1397,3.6
CN1303300000000,2023-01-01,13,033,GA,Burke County,8886,8395,491,5.5
CN1303500000000,2023-01-01,13,035,GA,Butts County,11421,11074,347,3
CN1303700000000,2023-01-01,13,037,GA,Calhoun County,2128,2061,67,3.1
CN1303900000000,2023-01-01,13,039,GA,Camden County,22358,21617,741,3.3
CN1304300000000,2023-01-01,13,043,GA,Candler County,6102,5946,156,2.6
CN1304500000000,2023-01-01,13,045,GA,Carroll County,57624,55687,1937,3.4
CN1304700000000,2023-01-01,13,047,GA,Catoosa County,33749,32728,1021,3
CN1304900000000,2023-01-01,13,049,GA,Charlton County,5079,4900,179,3.5
CN1305100000000,2023-01-01,13,051,GA,Chatham County,143807,139265,4542,3.2
CN1305300000000,2023-01-01,13,053,GA,Chattahoochee County,1938,1837,101,5.2
CN1305500000000,2023-01-01,13,055,GA,Chattooga County,9097,8685,412,4.5
CN1305700000000,2023-01-01,13,057,GA,Cherokee County,143955,140070,3885,2.7
CN1305900000000,2023-01-01,13,059,GA,Clarke County,59202,57145,2057,3.5
CN1306100000000,2023-01-01,13,061,GA,Clay County,774,714,60,7.8
CN1306300000000,2023-01-01,13,063,GA,Clayton County,141486,135619,5867,4.1
CN1306500000000,2023-01-01,13,065,GA,Clinch County,2946,2849,97,3.3
CN1306700000000,2023-01-01,13,067,GA,Cobb County,435136,422626,12510,2.9
CN1306900000000,2023-01-01,13,069,GA,Coffee County,18979,18219,760,4
CN1307100000000,2023-01-01,13,071,GA,Colquitt County,21521,20832,689,3.2
CN1307300000000,2023-01-01,13,073,GA,Columbia County,75187,72754,2433,3.2
CN1307500000000,2023-01-01,13,075,GA,Cook County,8166,7886,280,3.4
CN1307700000000,2023-01-01,13,077,GA,Coweta County,78494,76096,2398,3.1
CN1307900000000,2023-01-01,13,079,GA,Crawford County,5364,5180,184,3.4
CN1308100000000,2023-01-01,13,081,GA,Crisp County,9670,9256,414,4.3
CN1308300000000,2023-01-01,13,083,GA,Dade County,8032,7794,238,3
CN1308500000000,2023-01-01,13,085,GA,Dawson County,13465,13086,379,2.8
CN1308700000000,2023-01-01,13,087,GA,Decatur County,11672,11258,414,3.5
CN1308900000000,2023-01-01,13,089,GA,DeKalb County,408726,395037,13689,3.3
CN1309100000000,2023-01-01,13,091,GA,Dodge County,6707,6425,282,4.2
CN1309300000000,2023-01-01,13,093,GA,Dooly County,4998,4792,206,4.1
CN1309500000000,2023-01-01,13,095,GA,Dougherty County,36419,34796,1623,4.5
CN1309700000000,2023-01-01,13,097,GA,Douglas County,75821,73127,2694,3.6
CN1309900000000,2023-01-01,13,099,GA,Early County,4375,4197,178,4.1
CN1310100000000,2023-01-01,13,101,GA,Echols County,1818,1764,54,3
CN1310300000000,2023-01-01,13,103,GA,Effingham County,33645,32694,951,2.8
CN1310500000000,2023-01-01,13,105,GA,Elbert County,8098,7800,298,3.7
CN1310700000000,2023-01-01,13,107,GA,Emanuel County,8958,8514,444,5
CN1310900000000,2023-01-01,13,109,GA,Evans County,4973,4810,163,3.3
CN1311100000000,2023-01-01,13,111,GA,Fannin County,12006,11620,386,3.2
CN1311300000000,2023-01-01,13,113,GA,Fayette County,60174,58398,1776,3
CN1311500000000,2023-01-01,13,115,GA,Floyd County,45042,43417,1625,3.6
CN1311700000000,2023-01-01,13,117,GA,Forsyth County,131292,127861,3431,2.6
CN1311900000000,2023-01-01,13,119,GA,Franklin County,9812,9475,337,3.4
CN1312100000000,2023-01-01,13,121,GA,Fulton County,580498,560579,19919,3.4
CN1312300000000,2023-01-01,13,123,GA,Gilmer County,12300,11849,451,3.7
CN1312500000000,2023-01-01,13,125,GA,Glascock County,1242,1188,54,4.3
CN1312700000000,2023-01-01,13,127,GA,Glynn County,40130,38879,1251,3.1
CN1312900000000,2023-01-01,13,129,GA,Gordon County,29091,28051,1040,3.6
CN1313100000000,2023-01-01,13,131,GA,Grady County,10894,10555,339,3.1
CN1313300000000,2023-01-01,13,133,GA,Greene County,7267,7000,267,3.7
CN1313500000000,2023-01-01,13,135,GA,Gwinnett County,505043,490075,14968,3
CN1313700000000,2023-01-01,13,137,GA,Habersham County,18848,18166,682,3.6
CN1313900000000,2023-01-01,13,139,GA,Hall County,108616,105720,2896,2.7
CN1314100000000,2023-01-01,13,141,GA,Hancock County,2542,2396,146,5.7
CN1314300000000,2023-01-01,13,143,GA,Haralson County,13135,12674,461,3.5
CN1314500000000,2023-01-01,13,145,GA,Harris County,17030,16507,523,3.1
CN1314700000000,2023-01-01,13,147,GA,Hart County,12272,11875,397,3.2
CN1314900000000,2023-01-01,13,149,GA,Heard County,5356,5178,178,3.3
CN1315100000000,2023-01-01,13,151,GA,Henry County,122053,117808,4245,3.5
CN1315300000000,2023-01-01,13,153,GA,Houston County,70977,68663,2314,3.3
CN1315500000000,2023-01-01,13,155,GA,Irwin County,3462,3299,163,4.7
CN1315700000000,2023-01-01,13,157,GA,Jackson County,46525,45454,1071,2.3
CN1315900000000,2023-01-01,13,159,GA,Jasper County,7229,7014,215,3
CN1316100000000,2023-01-01,13,161,GA,Jeff Davis County,6177,5880,297,4.8
CN1316300000000,2023-01-01,13,163,GA,Jefferson County,6637,6342,295,4.4
CN1316500000000,2023-01-01,13,165,GA,Jenkins County,3415,3261,154,4.5
CN1316700000000,2023-01-01,13,167,GA,Johnson County,3958,3824,134,3.4
CN1316900000000,2023-01-01,13,169,GA,Jones County,13330,12904,426,3.2
CN1317100000000,2023-01-01,13,171,GA,Lamar County,8438,8140,298,3.5
CN1317300000000,2023-01-01,13,173,GA,Lanier County,3780,3627,153,4
CN1317500000000,2023-01-01,13,175,GA,Laurens County,19035,18192,843,4.4
CN1317700000000,2023-01-01,13,177,GA,Lee County,15021,14560,461,3.1
CN1317900000000,2023-01-01,13,179,GA,Liberty County,26331,25412,919,3.5
CN1318100000000,2023-01-01,13,181,GA,Lincoln County,3443,3306,137,4
CN1318300000000,2023-01-01,13,183,GA,Long County,8455,8157,298,3.5
CN1318500000000,2023-01-01,13,185,GA,Lowndes County,50751,48897,1854,3.7
CN1318700000000,2023-01-01,13,187,GA,Lumpkin County,18799,18291,508,2.7
CN1318900000000,2023-01-01,13,189,GA,McDuffie County,8418,7933,485,5.8
CN1319100000000,2023-01-01,13,191,GA,McIntosh County,6221,6013,208,3.3
CN1319300000000,2023-01-01,13,193,GA,Macon County,4427,4233,194,4.4
CN1319500000000,2023-01-01,13,195,GA,Madison County,13621,13180,441,3.2
CN1319700000000,2023-01-01,13,197,GA,Marion County,3287,3148,139,4.2
CN1319900000000,2023-01-01,13,199,GA,Meriwether County,9024,8638,386,4.3
CN1320100000000,2023-01-01,13,201,GA,Miller County,2886,2799,87,3
CN1320500000000,2023-01-01,13,205,GA,Mitchell County,8129,7812,317,3.9
CN1320700000000,2023-01-01,13,207,GA,Monroe County,12788,12387,401,3.1
CN1320900000000,2023-01-01,13,209,GA,Montgomery County,3992,3834,158,4
CN1321100000000,2023-01-01,13,211,GA,Morgan County,9668,9375,293,3
CN1321300000000,2023-01-01,13,213,GA,Murray County,15465,14699,766,5
CN1321500000000,2023-01-01,13,215,GA,Muscogee County,76946,73358,3588,4.7
CN1321700000000,2023-01-01,13,217,GA,Newton County,54751,52720,2031,3.7
CN1321900000000,2023-01-01,13,219,GA,Oconee County,20378,19841,537,2.6
CN1322100000000,2023-01-01,13,221,GA,Oglethorpe County,7011,6796,215,3.1
CN1322300000000,2023-01-01,13,223,GA,Paulding County,92327,89589,2738,3
CN1322500000000,2023-01-01,13,225,GA,Peach County,11797,11312,485,4.1
CN1322700000000,2023-01-01,13,227,GA,Pickens County,16076,15601,475,3
CN1322900000000,2023-01-01,13,229,GA,Pierce County,8893,8618,275,3.1
CN1323100000000,2023-01-01,13,231,GA,Pike County,9241,8968,273,3
CN1323300000000,2023-01-01,13,233,GA,Polk County,18416,17710,706,3.8
CN1323500000000,2023-01-01,13,235,GA,Pulaski County,3974,3830,144,3.6
CN1323700000000,2023-01-01,13,237,GA,Putnam County,8654,8307,347,4
CN1323900000000,2023-01-01,13,239,GA,Quitman County,714,670,44,6.2
CN1324100000000,2023-01-01,13,241,GA,Rabun County,7600,7328,272,3.6
CN1324300000000,2023-01-01,13,243,GA,Randolph County,2405,2294,111,4.6
CN1324500000000,2023-01-01,13,245,GA,Richmond County,82207,78315,3892,4.7
CN1324700000000,2023-01-01,13,247,GA,Rockdale County,45659,43935,1724,3.8
CN1324900000000,2023-01-01,13,249,GA,Schley County,2179,2097,82,3.8
CN1325100000000,2023-01-01,13,251,GA,Screven County,5067,4789,278,5.5
CN1325300000000,2023-01-01,13,253,GA,Seminole County,2993,2862,131,4.4
CN1325500000000,2023-01-01,13,255,GA,Spalding County,29572,28511,1061,3.6
CN1325700000000,2023-01-01,13,257,GA,Stephens County,10588,10179,409,3.9
CN1325900000000,2023-01-01,13,259,GA,Stewart County,2661,2549,112,4.2
CN1326100000000,2023-01-01,13,261,GA,Sumter County,12423,11871,552,4.4
CN1326300000000,2023-01-01,13,263,GA,Talbot County,2790,2681,109,3.9
CN1326500000000,2023-01-01,13,265,GA,Taliaferro County,531,508,23,4.3
CN1326700000000,2023-01-01,13,267,GA,Tattnall County,8985,8650,335,3.7
CN1326900000000,2023-01-01,13,269,GA,Taylor County,2608,2476,132,5.1
CN1327100000000,2023-01-01,13,271,GA,Telfair County,3467,3215,252,7.3
CN1327300000000,2023-01-01,13,273,GA,Terrell County,3463,3304,159,4.6
CN1327500000000,2023-01-01,13,275,GA,Thomas County,16804,16172,632,3.8
CN1327700000000,2023-01-01,13,277,GA,Tift County,20749,20098,651,3.1
CN1327900000000,2023-01-01,13,279,GA,Toombs County,12538,12017,521,4.2
CN1328100000000,2023-01-01,13,281,GA,Towns County,4126,3940,186,4.5
CN1328300000000,2023-01-01,13,283,GA,Treutlen County,2711,2590,121,4.5
CN1328500000000,2023-01-01,13,285,GA,Troup County,36489,35275,1214,3.3
CN1328700000000,2023-01-01,13,287,GA,Turner County,3163,3022,141,4.5
CN1328900000000,2023-01-01,13,289,GA,Twiggs County,2746,2610,136,5
CN1329100000000,2023-01-01,13,291,GA,Union County,11359,10982,377,3.3
CN1329300000000,2023-01-01,13,293,GA,Upson County,11922,11503,419,3.5
CN1329500000000,2023-01-01,13,295,GA,Walker County,31556,30446,1110,3.5
CN1329700000000,2023-01-01,13,297,GA,Walton County,48418,46959,1459,3
CN1329900000000,2023-01-01,13,299,GA,Ware County,15930,15368,562,3.5
CN1330100000000,2023-01-01,13,301,GA,Warren County,2727,2596,131,4.8
CN1330300000000,2023-01-01,13,303,GA,Washington County,7058,6755,303,4.3
CN1330500000000,2023-01-01,13,305,GA,Wayne County,12239,11813,426,3.5
CN1330700000000,2023-01-01,13,307,GA,Webster County,965,925,40,4.1
CN1330900000000,2023-01-01,13,309,GA,Wheeler County,1687,1590,97,5.7
CN1331100000000,2023-01-01,13,311,GA,White County,17079,16628,451,2.6
CN1331300000000,2023-01-01,13,313,GA,Whitfield County,43656,41458,2198,5
CN1331500000000,2023-01-01,13,315,GA,Wilcox County,2672,2576,96,3.6
CN1331700000000,2023-01-01,13,317,GA,Wilkes County,3627,3471,156,4.3
CN1331900000000,2023-01-01,13,319,GA,Wilkinson County,3962,3821,141,3.6
CN1332100000000,2023-01-01,13,321,GA,Worth County,8719,8397,322,3.7
CN1500100000000,2023-01-01,15,001,HI,Hawaii County,95220,92007,3213,3.4
CN1500300000000,2023-01-01,15,003,HI,Honolulu County/city,458068,443991,14077,3.1
CN1500700000000,2023-01-01,15,007,HI,Kauai County,36824,35716,1108,3
CN1500900000000,2023-01-01,15,009,HI,Maui County,88130,85416,2714,3.1
CN1600100000000,2023-01-01,16,001,ID,Ada County,278944,272025,6919,2.5
CN1600300000000,2023-01-01,16,003,ID,Adams County,1683,1589,94,5.6
CN1600500000000,2023-01-01,16,005,ID,Bannock County,44659,43390,1269,2.8
CN1600700000000,2023-01-01,16,007,ID,Bear Lake County,3051,2958,93,3
CN1600900000000,2023-01-01,16,009,ID,Benewah County,3947,3720,227,5.8
CN1601100000000,2023-01-01,16,011,ID,Bingham County,24154,23390,764,3.2
CN1601300000000,2023-01-01,16,013,ID,Blaine County,13195,12868,327,2.5
CN1601500000000,2023-01-01,16,015,ID,Boise County,3904,3735,169,4.3
CN1601700000000,2023-01-01,16,017,ID,Bonner County,21645,20551,1094,5.1
CN1601900000000,2023-01-01,16,019,ID,Bonneville County,63469,61738,1731,2.7
CN1602100000000,2023-01-01,16,021,ID,Boundary County,5518,5221,297,5.4
CN1602300000000,2023-01-01,16,023,ID,Butte County,1430,1374,56,3.9
CN1602500000000,2023-01-01,16,025,ID,Camas County,709,682,27,3.8
CN1602700000000,2023-01-01,16,027,ID,Canyon County,116666,112758,3908,3.3
CN1602900000000,2023-01-01,16,029,ID,Caribou County,3915,3790,125,3.2
CN1603100000000,2023-01-01,16,031,ID,Cassia County,14643,14310,333,2.3
CN1603300000000,2023-01-01,16,033,ID,Clark County,337,319,18,5.3
CN1603500000000,2023-01-01,16,035,ID,Clearwater County,2901,2705,196,6.8
CN1603700000000,2023-01-01,16,037,ID,Custer County,1856,1759,97,5.2
CN1603900000000,2023-01-01,16,039,ID,Elmore County,12598,12186,412,3.3
CN1604100000000,2023-01-01,16,041,ID,Franklin County,7488,7255,233,3.1
CN1604300000000,2023-01-01,16,043,ID,Fremont County,7783,7559,224,2.9
CN1604500000000,2023-01-01,16,045,ID,Gem County,8927,8610,317,3.6
CN1604700000000,2023-01-01,16,047,ID,Gooding County,10600,10300,300,2.8
CN1604900000000,2023-01-01,16,049,ID,Idaho County,6642,6332,310,4.7
CN1605100000000,2023-01-01,16,051,ID,Jefferson County,15768,15366,402,2.5
CN1605300000000,2023-01-01,16,053,ID,Jerome County,16033,15579,454,2.8
CN1605500000000,2023-01-01,16,055,ID,Kootenai County,85640,82003,3637,4.2
CN1605700000000,2023-01-01,16,057,ID,Latah County,20520,20029,491,2.4
CN1605900000000,2023-01-01,16,059,ID,Lemhi County,3475,3321,154,4.4
CN1606100000000,2023-01-01,16,061,ID,Lewis County,1623,1561,62,3.8
CN1606300000000,2023-01-01,16,063,ID,Lincoln County,3320,3179,141,4.2
CN1606500000000,2023-01-01,16,065,ID,Madison County,22841,22374,467,2
CN1606700000000,2023-01-01,16,067,ID,Minidoka County,12561,12218,343,2.7
CN1606900000000,2023-01-01,16,069,ID,Nez Perce County,21160,20516,644,3
CN1607100000000,2023-01-01,16,071,ID,Oneida County,2723,2619,104,3.8
CN1607300000000,2023-01-01,16,073,ID,Owyhee County,6089,5823,266,4.4
CN1607500000000,2023-01-01,16,075,ID,Payette County,11722,11286,436,3.7
CN1607700000000,2023-01-01,16,077,ID,Power County,4364,4193,171,3.9
CN1607900000000,2023-01-01,16,079,ID,Shoshone County,5499,5151,348,6.3
CN1608100000000,2023-01-01,16,081,ID,Teton County,7196,7031,165,2.3
CN1608300000000,2023-01-01,16,083,ID,Twin Falls County,45585,43998,1587,3.5
CN1608500000000,2023-01-01,16,085,ID,Valley County,5650,5405,245,4.3
CN1608700000000,2023-01-01,16,087,ID,Washington County,4926,4744,182,3.7
CN1700100000000,2023-01-01,17,001,IL,Adams County,29817,28763,1054,3.5
CN1700300000000,2023-01-01,17,003,IL,Alexander County,1771,1662,109,6.2
CN1700500000000,2023-01-01,17,005,IL,Bond County,7325,7006,319,4.4
CN1700700000000,2023-01-01,17,007,IL,Boone County,24850,23068,1782,7.2
CN1700900000000,2023-01-01,17,009,IL,Brown County,3070,3001,69,2.2
CN1701100000000,2023-01-01,17,011,IL,Bureau County,15414,14558,856,5.6
CN1701300000000,2023-01-01,17,013,IL,Calhoun County,2131,2032,99,4.6
CN1701500000000,2023-01-01,17,015,IL,Carroll County,6946,6594,352,5.1
CN1701700000000,2023-01-01,17,017,IL,Cass County,5586,5319,267,4.8
CN1701900000000,2023-01-01,17,019,IL,Champaign County,108425,104370,4055,3.7
CN1702100000000,2023-01-01,17,021,IL,Christian County,13010,12358,652,5
CN1702300000000,2023-01-01,17,023,IL,Clark County,7112,6789,323,4.5
CN1702500000000,2023-01-01,17,025,IL,Clay County,5527,5253,274,5
CN1702700000000,2023-01-01,17,027,IL,Clinton County,19478,18854,624,3.2
CN1702900000000,2023-01-01,17,029,IL,Coles County,22730,21757,973,4.3
CN1703100000000,2023-01-01,17,031,IL,Cook County,2680693,2551081,129612,4.8
CN1703300000000,2023-01-01,17,033,IL,Crawford County,8005,7673,332,4.1
CN1703500000000,2023-01-01,17,035,IL,Cumberland County,5925,5700,225,3.8
CN1703700000000,2023-01-01,17,037,IL,DeKalb County,52575,50181,2394,4.6
CN1703900000000,2023-01-01,17,039,IL,De Witt County,7209,6866,343,4.8
CN1704100000000,2023-01-01,17,041,IL,Douglas County,9887,9516,371,3.8
CN1704300000000,2023-01-01,17,043,IL,DuPage County,523544,504826,18718,3.6
CN1704500000000,2023-01-01,17,045,IL,Edgar County,9039,8710,329,3.6
CN1704700000000,2023-01-01,17,047,IL,Edwards County,2311,2208,103,4.5
CN1704900000000,2023-01-01,17,049,IL,Effingham County,19525,18874,651,3.3
CN1705100000000,2023-01-01,17,051,IL,Fayette County,9517,9001,516,5.4
CN1705300000000,2023-01-01,17,053,IL,Ford County,6233,5944,289,4.6
CN1705500000000,2023-01-01,17,055,IL,Franklin County,15319,14474,845,5.5
CN1705700000000,2023-01-01,17,057,IL,Fulton County,14278,13453,825,5.8
CN1705900000000,2023-01-01,17,059,IL,Gallatin County,1948,1848,100,5.1
CN1706100000000,2023-01-01,17,061,IL,Greene County,5733,5471,262,4.6
CN1706300000000,2023-01-01,17,063,IL,Grundy County,26860,25176,1684,6.3
CN1706500000000,2023-01-01,17,065,IL,Hamilton County,4257,4109,148,3.5
CN1706700000000,2023-01-01,17,067,IL,Hancock County,7593,7266,327,4.3
CN1706900000000,2023-01-01,17,069,IL,Hardin County,1412,1336,76,5.4
CN1707100000000,2023-01-01,17,071,IL,Henderson County,3441,3272,169,4.9
CN1707300000000,2023-01-01,17,073,IL,Henry County,23052,21913,1139,4.9
CN1707500000000,2023-01-01,17,075,IL,Iroquois County,11868,11208,660,5.6
CN1707700000000,2023-01-01,17,077,IL,Jackson County,26276,25177,1099,4.2
CN1707900000000,2023-01-01,17,079,IL,Jasper County,4822,4629,193,4
CN1708100000000,2023-01-01,17,081,IL,Jefferson County,16008,15290,718,4.5
CN1708300000000,2023-01-01,17,083,IL,Jersey County,10343,9965,378,3.7
CN1708500000000,2023-01-01,17,085,IL,Jo Daviess County,9931,9430,501,5
CN1708700000000,2023-01-01,17,087,IL,Johnson County,4040,3775,265,6.6
CN1708900000000,2023-01-01,17,089,IL,Kane County,259745,245744,14001,5.4
CN1709100000000,2023-01-01,17,091,IL,Kankakee County,51212,48110,3102,6.1
CN1709300000000,2023-01-01,17,093,IL,Kendall County,73597,70303,3294,4.5
CN1709500000000,2023-01-01,17,095,IL,Knox County,19167,18076,1091,5.7
CN1709700000000,2023-01-01,17,097,IL,Lake County,355921,337440,18481,5.2
CN1709900000000,2023-01-01,17,099,IL,LaSalle County,51013,47869,3144,6.2
CN1710100000000,2023-01-01,17,101,IL,Lawrence County,4949,4676,273,5.5
CN1710300000000,2023-01-01,17,103,IL,Lee County,16261,15500,761,4.7
CN1710500000000,2023-01-01,17,105,IL,Livingston County,14956,14296,660,4.4
CN1710700000000,2023-01-01,17,107,IL,Logan County,11094,10582,512,4.6
CN1710900000000,2023-01-01,17,109,IL,McDonough County,12475,11954,521,4.2
CN1711100000000,2023-01-01,17,111,IL,McHenry County,172025,164344,7681,4.5
CN1711300000000,2023-01-01,17,113,IL,McLean County,86747,83648,3099,3.6
CN1711500000000,2023-01-01,17,115,IL,Macon County,44717,42302,2415,5.4
CN1711700000000,2023-01-01,17,117,IL,Macoupin County,21651,20743,908,4.2
CN1711900000000,2023-01-01,17,119,IL,Madison County,128154,123298,4856,3.8
CN1712100000000,2023-01-01,17,121,IL,Marion County,16352,15558,794,4.9
CN1712300000000,2023-01-01,17,123,IL,Marshall County,5043,4761,282,5.6
CN1712500000000,2023-01-01,17,125,IL,Mason County,5804,5469,335,5.8
CN1712700000000,2023-01-01,17,127,IL,Massac County,5244,4994,250,4.8
CN1712900000000,2023-01-01,17,129,IL,Menard County,6127,5841,286,4.7
CN1713100000000,2023-01-01,17,131,IL,Mercer County,7426,6989,437,5.9
CN1713300000000,2023-01-01,17,133,IL,Monroe County,18246,17724,522,2.9
CN1713500000000,2023-01-01,17,135,IL,Montgomery County,10799,10211,588,5.4
CN1713700000000,2023-01-01,17,137,IL,Morgan County,15232,14569,663,4.4
CN1713900000000,2023-01-01,17,139,IL,Moultrie County,7245,6998,247,3.4
CN1714100000000,2023-01-01,17,141,IL,Ogle County,23379,22008,1371,5.9
CN1714300000000,2023-01-01,17,143,IL,Peoria County,80989,76616,4373,5.4
CN1714500000000,2023-01-01,17,145,IL,Perry County,7621,7200,421,5.5
CN1714700000000,2023-01-01,17,147,IL,Piatt County,8519,8209,310,3.6
CN1714900000000,2023-01-01,17,149,IL,Pike County,6482,6147,335,5.2
CN1715100000000,2023-01-01,17,151,IL,Pope County,1735,1659,76,4.4
CN1715300000000,2023-01-01,17,153,IL,Pulaski County,1607,1496,111,6.9
CN1715500000000,2023-01-01,17,155,IL,Putnam County,2944,2758,186,6.3
CN1715700000000,2023-01-01,17,157,IL,Randolph County,13188,12675,513,3.9
CN1715900000000,2023-01-01,17,159,IL,Richland County,7004,6749,255,3.6
CN1716100000000,2023-01-01,17,161,IL,Rock Island County,65726,62356,3370,5.1
CN1716300000000,2023-01-01,17,163,IL,St. Clair County,120290,115149,5141,4.3
CN1716500000000,2023-01-01,17,165,IL,Saline County,9133,8673,460,5
CN1716700000000,2023-01-01,17,167,IL,Sangamon County,95841,91769,4072,4.2
CN1716900000000,2023-01-01,17,169,IL,Schuyler County,2935,2780,155,5.3
CN1717100000000,2023-01-01,17,171,IL,Scott County,2269,2106,163,7.2
CN1717300000000,2023-01-01,17,173,IL,Shelby County,9621,9203,418,4.3
CN1717500000000,2023-01-01,17,175,IL,Stark County,2377,2212,165,6.9
CN1717700000000,2023-01-01,17,177,IL,Stephenson County,20001,18958,1043,5.2
CN1717900000000,2023-01-01,17,179,IL,Tazewell County,61012,58164,2848,4.7
CN1718100000000,2023-01-01,17,181,IL,Union County,6903,6470,433,6.3
CN1718300000000,2023-01-01,17,183,IL,Vermilion County,31390,29616,1774,5.7
CN1718500000000,2023-01-01,17,185,IL,Wabash County,5571,5396,175,3.1
CN1718700000000,2023-01-01,17,187,IL,Warren County,7670,7351,319,4.2
CN1718900000000,2023-01-01,17,189,IL,Washington County,9683,9417,266,2.7
CN1719100000000,2023-01-01,17,191,IL,Wayne County,6779,6505,274,4
CN1719300000000,2023-01-01,17,193,IL,White County,5905,5678,227,3.8
CN1719500000000,2023-01-01,17,195,IL,Whiteside County,26990,25736,1254,4.6
CN1719700000000,2023-01-01,17,197,IL,Will County,373359,354610,18749,5
CN1719900000000,2023-01-01,17,199,IL,Williamson County,30142,28806,1336,4.4
CN1720100000000,2023-01-01,17,201,IL,Winnebago County,130667,123404,7263,5.6
CN1720300000000,2023-01-01,17,203,IL,Woodford County,17954,17222,732,4.1
CN1800100000000,2023-01-01,18,001,IN,Adams County,16841,16418,423,2.5
CN1800300000000,2023-01-01,18,003,IN,Allen County,188665,183011,5654,3
CN1800500000000,2023-01-01,18,005,IN,Bartholomew County,44452,43248,1204,2.7
CN1800700000000,2023-01-01,18,007,IN,Benton County,4302,4181,121,2.8
CN1800900000000,2023-01-01,18,009,IN,Blackford County,4770,4590,180,3.8
CN1801100000000,2023-01-01,18,011,IN,Boone County,38477,37600,877,2.3
CN1801300000000,2023-01-01,18,013,IN,Brown County,7929,7633,296,3.7
CN1801500000000,2023-01-01,18,015,IN,Carroll County,9718,9406,312,3.2
CN1801700000000,2023-01-01,18,017,IN,Cass County,17232,16587,645,3.7
CN1801900000000,2023-01-01,18,019,IN,Clark County,62737,60956,1781,2.8
CN1802100000000,2023-01-01,18,021,IN,Clay County,11686,11264,422,3.6
CN1802300000000,2023-01-01,18,023,IN,Clinton County,17034,16560,474,2.8
CN1802500000000,2023-01-01,18,025,IN,Crawford County,4784,4579,205,4.3
CN1802700000000,2023-01-01,18,027,IN,Daviess County,16638,16237,401,2.4
CN1802900000000,2023-01-01,18,029,IN,Dearborn County,26126,25259,867,3.3
CN1803100000000,2023-01-01,18,031,IN,Decatur County,14540,14140,400,2.8
CN1803300000000,2023-01-01,18,033,IN,DeKalb County,22470,21801,669,3
CN1803500000000,2023-01-01,18,035,IN,Delaware County,51283,49392,1891,3.7
CN1803700000000,2023-01-01,18,037,IN,Dubois County,21843,21295,548,2.5
CN1803900000000,2023-01-01,18,039,IN,Elkhart County,118100,112323,5777,4.9
CN1804100000000,2023-01-01,18,041,IN,Fayette County,8290,7936,354,4.3
CN1804300000000,2023-01-01,18,043,IN,Floyd County,42281,41157,1124,2.7
CN1804500000000,2023-01-01,18,045,IN,Fountain County,7925,7658,267,3.4
CN1804700000000,2023-01-01,18,047,IN,Franklin County,11330,10935,395,3.5
CN1804900000000,2023-01-01,18,049,IN,Fulton County,9300,8942,358,3.8
CN1805100000000,2023-01-01,18,051,IN,Gibson County,20407,19933,474,2.3
CN1805300000000,2023-01-01,18,053,IN,Grant County,30609,29539,1070,3.5
CN1805500000000,2023-01-01,18,055,IN,Greene County,13631,13073,558,4.1
CN1805700000000,2023-01-01,18,057,IN,Hamilton County,196904,192310,4594,2.3
CN1805900000000,2023-01-01,18,059,IN,Hancock County,43063,41899,1164,2.7
CN1806100000000,2023-01-01,18,061,IN,Harrison County,20504,19918,586,2.9
CN1806300000000,2023-01-01,18,063,IN,Hendricks County,95914,93504,2410,2.5
CN1806500000000,2023-01-01,18,065,IN,Henry County,22222,21438,784,3.5
CN1806700000000,2023-01-01,18,067,IN,Howard County,32580,31038,1542,4.7
CN1806900000000,2023-01-01,18,069,IN,Huntington County,18188,17622,566,3.1
CN1807100000000,2023-01-01,18,071,IN,Jackson County,23778,23113,665,2.8
CN1807300000000,2023-01-01,18,073,IN,Jasper County,15979,15331,648,4.1
CN1807500000000,2023-01-01,18,075,IN,Jay County,8776,8501,275,3.1
CN1807700000000,2023-01-01,18,077,IN,Jefferson County,15110,14660,450,3
CN1807900000000,2023-01-01,18,079,IN,Jennings County,13549,13032,517,3.8
CN1808100000000,2023-01-01,18,081,IN,Johnson County,87624,85365,2259,2.6
CN1808300000000,2023-01-01,18,083,IN,Knox County,17995,17457,538,3
CN1808500000000,2023-01-01,18,085,IN,Kosciusko County,41287,39562,1725,4.2
CN1808700000000,2023-01-01,18,087,IN,LaGrange County,21567,20455,1112,5.2
CN1808900000000,2023-01-01,18,089,IN,Lake County,227759,216579,11180,4.9
CN1809100000000,2023-01-01,18,091,IN,LaPorte County,46961,44905,2056,4.4
CN1809300000000,2023-01-01,18,093,IN,Lawrence County,20442,19642,800,3.9
CN1809500000000,2023-01-01,18,095,IN,Madison County,60788,58582,2206,3.6
CN1809700000000,2023-01-01,18,097,IN,Marion County,510435,494793,15642,3.1
CN1809900000000,2023-01-01,18,099,IN,Marshall County,23255,22351,904,3.9
CN1810100000000,2023-01-01,18,101,IN,Martin County,5450,5299,151,2.8
CN1810300000000,2023-01-01,18,103,IN,Miami County,14065,13479,586,4.2
CN1810500000000,2023-01-01,18,105,IN,Monroe County,71676,69528,2148,3
CN1810700000000,2023-01-01,18,107,IN,Montgomery County,19028,18487,541,2.8
CN1810900000000,2023-01-01,18,109,IN,Morgan County,37683,36527,1156,3.1
CN1811100000000,2023-01-01,18,111,IN,Newton County,6797,6469,328,4.8
CN1811300000000,2023-01-01,18,113,IN,Noble County,22042,20893,1149,5.2
CN1811500000000,2023-01-01,18,115,IN,Ohio County,3236,3135,101,3.1
CN1811700000000,2023-01-01,18,117,IN,Orange County,8431,8129,302,3.6
CN1811900000000,2023-01-01,18,119,IN,Owen County,9468,9117,351,3.7
CN1812100000000,2023-01-01,18,121,IN,Parke County,6916,6666,250,3.6
CN1812300000000,2023-01-01,18,123,IN,Perry County,8742,8451,291,3.3
CN1812500000000,2023-01-01,18,125,IN,Pike County,5908,5711,197,3.3
CN1812700000000,2023-01-01,18,127,IN,Porter County,86000,82714,3286,3.8
CN1812900000000,2023-01-01,18,129,IN,Posey County,13056,12715,341,2.6
CN1813100000000,2023-01-01,18,131,IN,Pulaski County,6611,6384,227,3.4
CN1813300000000,2023-01-01,18,133,IN,Putnam County,17039,16488,551,3.2
CN1813500000000,2023-01-01,18,135,IN,Randolph County,11441,11043,398,3.5
CN1813700000000,2023-01-01,18,137,IN,Ripley County,12793,12318,475,3.7
CN1813900000000,2023-01-01,18,139,IN,Rush County,8898,8646,252,2.8
CN1814100000000,2023-01-01,18,141,IN,St. Joseph County,132131,126909,5222,4
CN1814300000000,2023-01-01,18,143,IN,Scott County,10544,10198,346,3.3
CN1814500000000,2023-01-01,18,145,IN,Shelby County,23883,23245,638,2.7
CN1814700000000,2023-01-01,18,147,IN,Spencer County,9958,9662,296,3
CN1814900000000,2023-01-01,18,149,IN,Starke County,9510,9031,479,5
CN1815100000000,2023-01-01,18,151,IN,Steuben County,20510,19920,590,2.9
CN1815300000000,2023-01-01,18,153,IN,Sullivan County,8008,7691,317,4
CN1815500000000,2023-01-01,18,155,IN,Switzerland County,4740,4591,149,3.1
CN1815700000000,2023-01-01,18,157,IN,Tippecanoe County,95150,92335,2815,3
CN1815900000000,2023-01-01,18,159,IN,Tipton County,8909,8632,277,3.1
CN1816100000000,2023-01-01,18,161,IN,Union County,3607,3496,111,3.1
CN1816300000000,2023-01-01,18,163,IN,Vanderburgh County,92694,89896,2798,3
CN1816500000000,2023-01-01,18,165,IN,Vermillion County,6623,6334,289,4.4
CN1816700000000,2023-01-01,18,167,IN,Vigo County,46109,44347,1762,3.8
CN1816900000000,2023-01-01,18,169,IN,Wabash County,14425,13956,469,3.3
CN1817100000000,2023-01-01,18,171,IN,Warren County,4066,3943,123,3
CN1817300000000,2023-01-01,18,173,IN,Warrick County,32535,31599,936,2.9
CN1817500000000,2023-01-01,18,175,IN,Washington County,13774,13354,420,3
CN1817700000000,2023-01-01,18,177,IN,Wayne County,29481,28487,994,3.4
CN1817900000000,2023-01-01,18,179,IN,Wells County,14316,13918,398,2.8
CN1818100000000,2023-01-01,18,181,IN,White County,13003,12625,378,2.9
CN1818300000000,2023-01-01,18,183,IN,Whitley County,17861,17347,514,2.9
CN1900100000000,2023-01-01,19,001,IA,Adair County,4353,4212,141,3.2
CN1900300000000,2023-01-01,19,003,IA,Adams County,2074,2026,48,2.3
CN1900500000000,2023-01-01,19,005,IA,Allamakee County,7021,6569,452,6.4
CN1900700000000,2023-01-01,19,007,IA,Appanoose County,6042,5837,205,3.4
CN1900900000000,2023-01-01,19,009,IA,Audubon County,3014,2935,79,2.6
CN1901100000000,2023-01-01,19,011,IA,Benton County,13155,12609,546,4.2
CN1901300000000,2023-01-01,19,013,IA,Black Hawk County,67622,65154,2468,3.6
CN1901500000000,2023-01-01,19,015,IA,Boone County,14731,14311,420,2.9
CN1901700000000,2023-01-01,19,017,IA,Bremer County,13873,13482,391,2.8
CN1901900000000,2023-01-01,19,019,IA,Buchanan County,11296,10864,432,3.8
CN1902100000000,2023-01-01,19,021,IA,Buena Vista County,11809,11523,286,2.4
CN1902300000000,2023-01-01,19,023,IA,Butler County,8252,7893,359,4.4
CN1902500000000,2023-01-01,19,025,IA,Calhoun County,4097,3988,109,2.7
CN1902700000000,2023-01-01,19,027,IA,Carroll County,10650,10409,241,2.3
CN1902900000000,2023-01-01,19,029,IA,Cass County,6868,6625,243,3.5
CN1903100000000,2023-01-01,19,031,IA,Cedar County,10508,10069,439,4.2
CN1903300000000,2023-01-01,19,033,IA,Cerro Gordo County,22227,21443,784,3.5
CN1903500000000,2023-01-01,19,035,IA,Cherokee County,6080,5912,168,2.8
CN1903700000000,2023-01-01,19,037,IA,Chickasaw County,6535,6328,207,3.2
CN1903900000000,2023-01-01,19,039,IA,Clarke County,5038,4824,214,4.2
CN1904100000000,2023-01-01,19,041,IA,Clay County,8558,8245,313,3.7
CN1904300000000,2023-01-01,19,043,IA,Clayton County,9541,8873,668,7
CN1904500000000,2023-01-01,19,045,IA,Clinton County,22201,21265,936,4.2
CN1904700000000,2023-01-01,19,047,IA,Crawford County,7946,7421,525,6.6
CN1904900000000,2023-01-01,19,049,IA,Dallas County,54476,53154,1322,2.4
CN1905100000000,2023-01-01,19,051,IA,Davis County,4299,4183,116,2.7
CN1905300000000,2023-01-01,19,053,IA,Decatur County,4274,4151,123,2.9
CN1905500000000,2023-01-01,19,055,IA,Delaware County,10480,10076,404,3.9
CN1905700000000,2023-01-01,19,057,IA,Des Moines County,18207,17355,852,4.7
CN1905900000000,2023-01-01,19,059,IA,Dickinson County,9951,9494,457,4.6
CN1906100000000,2023-01-01,19,061,IA,Dubuque County,56816,54725,2091,3.7
CN1906300000000,2023-01-01,19,063,IA,Emmet County,4807,4611,196,4.1
CN1906500000000,2023-01-01,19,065,IA,Fayette County,10399,9895,504,4.8
CN1906700000000,2023-01-01,19,067,IA,Floyd County,8343,8025,318,3.8
CN1906900000000,2023-01-01,19,069,IA,Franklin County,5576,5385,191,3.4
CN1907100000000,2023-01-01,19,071,IA,Fremont County,3683,3576,107,2.9
CN1907300000000,2023-01-01,19,073,IA,Greene County,5406,5277,129,2.4
CN1907500000000,2023-01-01,19,075,IA,Grundy County,6353,6133,220,3.5
CN1907700000000,2023-01-01,19,077,IA,Guthrie County,5716,5477,239,4.2
CN1907900000000,2023-01-01,19,079,IA,Hamilton County,6851,6644,207,3
CN1908100000000,2023-01-01,19,081,IA,Hancock County,5594,5442,152,2.7
CN1908300000000,2023-01-01,19,083,IA,Hardin County,7707,7393,314,4.1
CN1908500000000,2023-01-01,19,085,IA,Harrison County,7068,6850,218,3.1
CN1908700000000,2023-01-01,19,087,IA,Henry County,9241,8912,329,3.6
CN1908900000000,2023-01-01,19,089,IA,Howard County,5286,5020,266,5
CN1909100000000,2023-01-01,19,091,IA,Humboldt County,4847,4697,150,3.1
CN1909300000000,2023-01-01,19,093,IA,Ida County,3981,3868,113,2.8
CN1909500000000,2023-01-01,19,095,IA,Iowa County,9902,9531,371,3.7
CN1909700000000,2023-01-01,19,097,IA,Jackson County,10614,10116,498,4.7
CN1909900000000,2023-01-01,19,099,IA,Jasper County,18686,17939,747,4
CN1910100000000,2023-01-01,19,101,IA,Jefferson County,9920,9616,304,3.1
CN1910300000000,2023-01-01,19,103,IA,Johnson County,86802,84704,2098,2.4
CN1910500000000,2023-01-01,19,105,IA,Jones County,10496,9975,521,5
CN1910700000000,2023-01-01,19,107,IA,Keokuk County,5218,5000,218,4.2
CN1910900000000,2023-01-01,19,109,IA,Kossuth County,8123,7900,223,2.7
CN1911100000000,2023-01-01,19,111,IA,Lee County,14632,13921,711,4.9
CN1911300000000,2023-01-01,19,113,IA,Linn County,121389,116803,4586,3.8
CN1911500000000,2023-01-01,19,115,IA,Louisa County,5907,5621,286,4.8
CN1911700000000,2023-01-01,19,117,IA,Lucas County,4588,4459,129,2.8
CN1911900000000,2023-01-01,19,119,IA,Lyon County,6933,6753,180,2.6
CN1912100000000,2023-01-01,19,121,IA,Madison County,8998,8525,473,5.3
CN1912300000000,2023-01-01,19,123,IA,Mahaska County,12179,11833,346,2.8
CN1912500000000,2023-01-01,19,125,IA,Marion County,19198,18689,509,2.7
CN1912700000000,2023-01-01,19,127,IA,Marshall County,17915,16197,1718,9.6
CN1912900000000,2023-01-01,19,129,IA,Mills County,7065,6858,207,2.9
CN1913100000000,2023-01-01,19,131,IA,Mitchell County,5650,5516,134,2.4
CN1913300000000,2023-01-01,19,133,IA,Monona County,4357,4198,159,3.6
CN1913500000000,2023-01-01,19,135,IA,Monroe County,3974,3828,146,3.7
CN1913700000000,2023-01-01,19,137,IA,Montgomery County,4943,4798,145,2.9
CN1913900000000,2023-01-01,19,139,IA,Muscatine County,20759,19950,809,3.9
CN1914100000000,2023-01-01,19,141,IA,O'Brien County,8216,7975,241,2.9
CN1914300000000,2023-01-01,19,143,IA,Osceola County,3585,3521,64,1.8
CN1914500000000,2023-01-01,19,145,IA,Page County,6422,6236,186,2.9
CN1914700000000,2023-01-01,19,147,IA,Palo Alto County,4391,4255,136,3.1
CN1914900000000,2023-01-01,19,149,IA,Plymouth County,14778,14457,321,2.2
CN1915100000000,2023-01-01,19,151,IA,Pocahontas County,4038,3938,100,2.5
CN1915300000000,2023-01-01,19,153,IA,Polk County,280283,270643,9640,3.4
CN1915500000000,2023-01-01,19,155,IA,Pottawattamie County,47574,45995,1579,3.3
CN1915700000000,2023-01-01,19,157,IA,Poweshiek County,9272,8897,375,4
CN1915900000000,2023-01-01,19,159,IA,Ringgold County,2303,2257,46,2
CN1916100000000,2023-01-01,19,161,IA,Sac County,5200,5030,170,3.3
CN1916300000000,2023-01-01,19,163,IA,Scott County,88001,84635,3366,3.8
CN1916500000000,2023-01-01,19,165,IA,Shelby County,6403,6215,188,2.9
CN1916700000000,2023-01-01,19,167,IA,Sioux County,22467,21872,595,2.6
CN1916900000000,2023-01-01,19,169,IA,Story County,58789,57562,1227,2.1
CN1917100000000,2023-01-01,19,171,IA,Tama County,9317,8772,545,5.8
CN1917300000000,2023-01-01,19,173,IA,Taylor County,3150,3084,66,2.1
CN1917500000000,2023-01-01,19,175,IA,Union County,6129,5888,241,3.9
CN1917700000000,2023-01-01,19,177,IA,Van Buren County,3683,3540,143,3.9
CN1917900000000,2023-01-01,19,179,IA,Wapello County,16624,15961,663,4
CN1918100000000,2023-01-01,19,181,IA,Warren County,29793,28809,984,3.3
CN1918300000000,2023-01-01,19,183,IA,Washington County,11828,11405,423,3.6
CN1918500000000,2023-01-01,19,185,IA,Wayne County,2980,2869,111,3.7
CN1918700000000,2023-01-01,19,187,IA,Webster County,18664,18016,648,3.5
CN1918900000000,2023-01-01,19,189,IA,Winnebago County,5007,4834,173,3.5
CN1919100000000,2023-01-01,19,191,IA,Winneshiek County,10812,10199,613,5.7
CN1919300000000,2023-01-01,19,193,IA,Woodbury County,56372,54529,1843,3.3
CN1919500000000,2023-01-01,19,195,IA,Worth County,3955,3823,132,3.3
CN1919700000000,2023-01-01,19,197,IA,Wright County,6599,6397,202,3.1
CN2000100000000,2023-01-01,20,001,KS,Allen County,6242,6046,196,3.1
CN2000300000000,2023-01-01,20,003,KS,Anderson County,4259,4152,107,2.5
CN2000500000000,2023-01-01,20,005,KS,Atchison County,6704,6452,252,3.8
CN2000700000000,2023-01-01,20,007,KS,Barber County,2268,2207,61,2.7
CN2000900000000,2023-01-01,20,009,KS,Barton County,13000,12600,400,3.1
CN2001100000000,2023-01-01,20,011,KS,Bourbon County,6187,5932,255,4.1
CN2001300000000,2023-01-01,20,013,KS,Brown County,5057,4930,127,2.5
CN2001500000000,2023-01-01,20,015,KS,Butler County,32833,31819,1014,3.1
CN2001700000000,2023-01-01,20,017,KS,Chase County,1328,1299,29,2.2
CN2001900000000,2023-01-01,20,019,KS,Chautauqua County,1417,1372,45,3.2
CN2002100000000,2023-01-01,20,021,KS,Cherokee County,9783,9495,288,2.9
CN2002300000000,2023-01-01,20,023,KS,Cheyenne County,1279,1243,36,2.8
CN2002500000000,2023-01-01,20,025,KS,Clark County,1136,1115,21,1.8
CN2002700000000,2023-01-01,20,027,KS,Clay County,3743,3641,102,2.7
CN2002900000000,2023-01-01,20,029,KS,Cloud County,3848,3727,121,3.1
CN2003100000000,2023-01-01,20,031,KS,Coffey County,3814,3664,150,3.9
CN2003300000000,2023-01-01,20,033,KS,Comanche County,860,839,21,2.4
CN2003500000000,2023-01-01,20,035,KS,Cowley County,16129,15638,491,3
CN2003700000000,2023-01-01,20,037,KS,Crawford County,18985,18388,597,3.1
CN2003900000000,2023-01-01,20,039,KS,Decatur County,1160,1128,32,2.8
CN2004100000000,2023-01-01,20,041,KS,Dickinson County,8539,8282,257,3
CN2004300000000,2023-01-01,20,043,KS,Doniphan County,4044,3930,114,2.8
CN2004500000000,2023-01-01,20,045,KS,Douglas County,67809,65903,1906,2.8
CN2004700000000,2023-01-01,20,047,KS,Edwards County,1404,1368,36,2.6
CN2004900000000,2023-01-01,20,049,KS,Elk County,1206,1172,34,2.8
CN2005100000000,2023-01-01,20,051,KS,Ellis County,16900,16525,375,2.2
CN2005300000000,2023-01-01,20,053,KS,Ellsworth County,2629,2565,64,2.4
CN2005500000000,2023-01-01,20,055,KS,Finney County,20536,20086,450,2.2
CN2005700000000,2023-01-01,20,057,KS,Ford County,17865,17467,398,2.2
CN2005900000000,2023-01-01,20,059,KS,Franklin County,14942,14538,404,2.7
CN2006100000000,2023-01-01,20,061,KS,Geary County,11461,10998,463,4
CN2006300000000,2023-01-01,20,063,KS,Gove County,1378,1349,29,2.1
CN2006500000000,2023-01-01,20,065,KS,Graham County,1221,1192,29,2.4
CN2006700000000,2023-01-01,20,067,KS,Grant County,2791,2712,79,2.8
CN2006900000000,2023-01-01,20,069,KS,Gray County,3189,3123,66,2.1
CN2007100000000,2023-01-01,20,071,KS,Greeley County,812,798,14,1.7
CN2007300000000,2023-01-01,20,073,KS,Greenwood County,2983,2894,89,3
CN2007500000000,2023-01-01,20,075,KS,Hamilton County,1679,1647,32,1.9
CN2007700000000,2023-01-01,20,077,KS,Harper County,2815,2751,64,2.3
CN2007900000000,2023-01-01,20,079,KS,Harvey County,17154,16688,466,2.7
CN2008100000000,2023-01-01,20,081,KS,Haskell County,2266,2220,46,2
CN2008300000000,2023-01-01,20,083,KS,Hodgeman County,1055,1030,25,2.4
CN2008500000000,2023-01-01,20,085,KS,Jackson County,7260,7067,193,2.7
CN2008700000000,2023-01-01,20,087,KS,Jefferson County,10365,10051,314,3
CN2008900000000,2023-01-01,20,089,KS,Jewell County,1170,1138,32,2.7
CN2009100000000,2023-01-01,20,091,KS,Johnson County,350155,341354,8801,2.5
CN2009300000000,2023-01-01,20,093,KS,Kearny County,2001,1962,39,1.9
CN2009500000000,2023-01-01,20,095,KS,Kingman County,3317,3235,82,2.5
CN2009700000000,2023-01-01,20,097,KS,Kiowa County,1217,1185,32,2.6
CN2009900000000,2023-01-01,20,099,KS,Labette County,9290,8994,296,3.2
CN2010100000000,2023-01-01,20,101,KS,Lane County,747,729,18,2.4
CN2010300000000,2023-01-01,20,103,KS,Leavenworth County,37516,36352,1164,3.1
CN2010500000000,2023-01-01,20,105,KS,Lincoln County,1746,1705,41,2.3
CN2010700000000,2023-01-01,20,107,KS,Linn County,4432,4230,202,4.6
CN2010900000000,2023-01-01,20,109,KS,Logan County,1626,1596,30,1.8
CN2011100000000,2023-01-01,20,111,KS,Lyon County,16888,16395,493,2.9
CN2011300000000,2023-01-01,20,113,KS,McPherson County,17465,17106,359,2.1
CN2011500000000,2023-01-01,20,115,KS,Marion County,5981,5836,145,2.4
CN2011700000000,2023-01-01,20,117,KS,Marshall County,5216,5080,136,2.6
CN2011900000000,2023-01-01,20,119,KS,Meade County,2108,2058,50,2.4
CN2012100000000,2023-01-01,20,121,KS,Miami County,18113,17579,534,2.9
CN2012300000000,2023-01-01,20,123,KS,Mitchell County,3350,3284,66,2
CN2012500000000,2023-01-01,20,125,KS,Montgomery County,14529,14052,477,3.3
CN2012700000000,2023-01-01,20,127,KS,Morris County,3021,2946,75,2.5
CN2012900000000,2023-01-01,20,129,KS,Morton County,1105,1073,32,2.9
CN2013100000000,2023-01-01,20,131,KS,Nemaha County,5649,5536,113,2
CN2013300000000,2023-01-01,20,133,KS,Neosho County,6039,5809,230,3.8
CN2013500000000,2023-01-01,20,135,KS,Ness County,1330,1296,34,2.6
CN2013700000000,2023-01-01,20,137,KS,Norton County,2634,2582,52,2
CN2013900000000,2023-01-01,20,139,KS,Osage County,8060,7781,279,3.5
CN2014100000000,2023-01-01,20,141,KS,Osborne County,1905,1862,43,2.3
CN2014300000000,2023-01-01,20,143,KS,Ottawa County,3037,2958,79,2.6
CN2014500000000,2023-01-01,20,145,KS,Pawnee County,2739,2669,70,2.6
CN2014700000000,2023-01-01,20,147,KS,Phillips County,2677,2616,61,2.3
CN2014900000000,2023-01-01,20,149,KS,Pottawatomie County,12992,12654,338,2.6
CN2015100000000,2023-01-01,20,151,KS,Pratt County,4874,4770,104,2.1
CN2015300000000,2023-01-01,20,153,KS,Rawlins County,1569,1542,27,1.7
CN2015500000000,2023-01-01,20,155,KS,Reno County,29054,28136,918,3.2
CN2015700000000,2023-01-01,20,157,KS,Republic County,2403,2351,52,2.2
CN2015900000000,2023-01-01,20,159,KS,Rice County,5193,5064,129,2.5
CN2016100000000,2023-01-01,20,161,KS,Riley County,35829,34824,1005,2.8
CN2016300000000,2023-01-01,20,163,KS,Rooks County,2436,2373,63,2.6
CN2016500000000,2023-01-01,20,165,KS,Rush County,1633,1595,38,2.3
CN2016700000000,2023-01-01,20,167,KS,Russell County,3336,3254,82,2.5
CN2016900000000,2023-01-01,20,169,KS,Saline County,30069,29224,845,2.8
CN2017100000000,2023-01-01,20,171,KS,Scott County,2688,2634,54,2
CN2017300000000,2023-01-01,20,173,KS,Sedgwick County,255494,247152,8342,3.3
CN2017500000000,2023-01-01,20,175,KS,Seward County,9881,9604,277,2.8
CN2017700000000,2023-01-01,20,177,KS,Shawnee County,91314,88490,2824,3.1
CN2017900000000,2023-01-01,20,179,KS,Sheridan County,1500,1471,29,1.9
CN2018100000000,2023-01-01,20,181,KS,Sherman County,2787,2721,66,2.4
CN2018300000000,2023-01-01,20,183,KS,Smith County,2022,1977,45,2.2
CN2018500000000,2023-01-01,20,185,KS,Stafford County,1958,1908,50,2.6
CN2018700000000,2023-01-01,20,187,KS,Stanton County,1142,1121,21,1.8
CN2018900000000,2023-01-01,20,189,KS,Stevens County,3122,3063,59,1.9
CN2019100000000,2023-01-01,20,191,KS,Sumner County,10797,10477,320,3
CN2019300000000,2023-01-01,20,193,KS,Thomas County,4291,4209,82,1.9
CN2019500000000,2023-01-01,20,195,KS,Trego County,1334,1295,39,2.9
CN2019700000000,2023-01-01,20,197,KS,Wabaunsee County,3763,3647,116,3.1
CN2019900000000,2023-01-01,20,199,KS,Wallace County,883,858,25,2.8
CN2020100000000,2023-01-01,20,201,KS,Washington County,3024,2956,68,2.2
CN2020300000000,2023-01-01,20,203,KS,Wichita County,1187,1164,23,1.9
CN2020500000000,2023-01-01,20,205,KS,Wilson County,3666,3537,129,3.5
CN2020700000000,2023-01-01,20,207,KS,Woodson County,1571,1508,63,4
CN2020900000000,2023-01-01,20,209,KS,Wyandotte County,78372,75420,2952,3.8
CN2100100000000,2023-01-01,21,001,KY,Adair County,7120,6744,376,5.3
CN2100300000000,2023-01-01,21,003,KY,Allen County,8964,8604,360,4
CN2100500000000,2023-01-01,21,005,KY,Anderson County,11855,11475,380,3.2
CN2100700000000,2023-01-01,21,007,KY,Ballard County,3500,3323,177,5.1
CN2100900000000,2023-01-01,21,009,KY,Barren County,17810,17028,782,4.4
CN2101100000000,2023-01-01,21,011,KY,Bath County,4844,4524,320,6.6
CN2101300000000,2023-01-01,21,013,KY,Bell County,8248,7804,444,5.4
CN2101500000000,2023-01-01,21,015,KY,Boone County,71802,69321,2481,3.5
CN2101700000000,2023-01-01,21,017,KY,Bourbon County,9681,9357,324,3.3
CN2101900000000,2023-01-01,21,019,KY,Boyd County,17061,16092,969,5.7
CN2102100000000,2023-01-01,21,021,KY,Boyle County,12789,12285,504,3.9
CN2102300000000,2023-01-01,21,023,KY,Bracken County,3845,3622,223,5.8
CN2102500000000,2023-01-01,21,025,KY,Breathitt County,3246,2979,267,8.2
CN2102700000000,2023-01-01,21,027,KY,Breckinridge County,8003,7589,414,5.2
CN2102900000000,2023-01-01,21,029,KY,Bullitt County,42952,40751,2201,5.1
CN2103100000000,2023-01-01,21,031,KY,Butler County,5040,4803,237,4.7
CN2103300000000,2023-01-01,21,033,KY,Caldwell County,6321,6096,225,3.6
CN2103500000000,2023-01-01,21,035,KY,Calloway County,16923,16114,809,4.8
CN2103700000000,2023-01-01,21,037,KY,Campbell County,50446,48665,1781,3.5
CN2103900000000,2023-01-01,21,039,KY,Carlisle County,2232,2152,80,3.6
CN2104100000000,2023-01-01,21,041,KY,Carroll County,5879,5692,187,3.2
CN2104300000000,2023-01-01,21,043,KY,Carter County,9761,8893,868,8.9
CN2104500000000,2023-01-01,21,045,KY,Casey County,6649,6386,263,4
CN2104700000000,2023-01-01,21,047,KY,Christian County,25104,23868,1236,4.9
CN2104900000000,2023-01-01,21,049,KY,Clark County,17376,16726,650,3.7
CN2105100000000,2023-01-01,21,051,KY,Clay County,5047,4746,301,6
CN2105300000000,2023-01-01,21,053,KY,Clinton County,3599,3406,193,5.4
CN2105500000000,2023-01-01,21,055,KY,Crittenden County,3877,3715,162,4.2
CN2105700000000,2023-01-01,21,057,KY,Cumberland County,3447,3317,130,3.8
CN2105900000000,2023-01-01,21,059,KY,Daviess County,45197,43303,1894,4.2
CN2106100000000,2023-01-01,21,061,KY,Edmonson County,4728,4484,244,5.2
CN2106300000000,2023-01-01,21,063,KY,Elliott County,1939,1743,196,10.1
CN2106500000000,2023-01-01,21,065,KY,Estill County,5149,4901,248,4.8
CN2106700000000,2023-01-01,21,067,KY,Fayette County,176092,170681,5411,3.1
CN2106900000000,2023-01-01,21,069,KY,Fleming County,6179,5878,301,4.9
CN2107100000000,2023-01-01,21,071,KY,Floyd County,11056,10381,675,6.1
CN2107300000000,2023-01-01,21,073,KY,Franklin County,24890,24022,868,3.5
CN2107500000000,2023-01-01,21,075,KY,Fulton County,2110,2009,101,4.8
CN2107700000000,2023-01-01,21,077,KY,Gallatin County,4007,3845,162,4
CN2107900000000,2023-01-01,21,079,KY,Garrard County,7979,7685,294,3.7
CN2108100000000,2023-01-01,21,081,KY,Grant County,11679,11195,484,4.1
CN2108300000000,2023-01-01,21,083,KY,Graves County,15682,14982,700,4.5
CN2108500000000,2023-01-01,21,085,KY,Grayson County,10443,9947,496,4.7
CN2108700000000,2023-01-01,21,087,KY,Green County,5074,4883,191,3.8
CN2108900000000,2023-01-01,21,089,KY,Greenup County,12959,12030,929,7.2
CN2109100000000,2023-01-01,21,091,KY,Hancock County,3769,3595,174,4.6
CN2109300000000,2023-01-01,21,093,KY,Hardin County,46669,44659,2010,4.3
CN2109500000000,2023-01-01,21,095,KY,Harlan County,6337,5952,385,6.1
CN2109700000000,2023-01-01,21,097,KY,Harrison County,8845,8532,313,3.5
CN2109900000000,2023-01-01,21,099,KY,Hart County,7755,7414,341,4.4
CN2110100000000,2023-01-01,21,101,KY,Henderson County,20537,19757,780,3.8
CN2110300000000,2023-01-01,21,103,KY,Henry County,8071,7791,280,3.5
CN2110500000000,2023-01-01,21,105,KY,Hickman County,1656,1585,71,4.3
CN2110700000000,2023-01-01,21,107,KY,Hopkins County,18084,17298,786,4.3
CN2110900000000,2023-01-01,21,109,KY,Jackson County,4130,3899,231,5.6
CN2111100000000,2023-01-01,21,111,KY,Jefferson County,390951,375092,15859,4.1
CN2111300000000,2023-01-01,21,113,KY,Jessamine County,26731,25850,881,3.3
CN2111500000000,2023-01-01,21,115,KY,Johnson County,6657,6234,423,6.4
CN2111700000000,2023-01-01,21,117,KY,Kenton County,87246,84158,3088,3.5
CN2111900000000,2023-01-01,21,119,KY,Knott County,4336,4044,292,6.7
CN2112100000000,2023-01-01,21,121,KY,Knox County,10021,9493,528,5.3
CN2112300000000,2023-01-01,21,123,KY,Larue County,5778,5507,271,4.7
CN2112500000000,2023-01-01,21,125,KY,Laurel County,25358,24286,1072,4.2
CN2112700000000,2023-01-01,21,127,KY,Lawrence County,5537,5205,332,6
CN2112900000000,2023-01-01,21,129,KY,Lee County,2099,1990,109,5.2
CN2113100000000,2023-01-01,21,131,KY,Leslie County,2544,2376,168,6.6
CN2113300000000,2023-01-01,21,133,KY,Letcher County,5838,5464,374,6.4
CN2113500000000,2023-01-01,21,135,KY,Lewis County,4698,4263,435,9.3
CN2113700000000,2023-01-01,21,137,KY,Lincoln County,9446,8937,509,5.4
CN2113900000000,2023-01-01,21,139,KY,Livingston County,3668,3462,206,5.6
CN2114100000000,2023-01-01,21,141,KY,Logan County,12524,12078,446,3.6
CN2114300000000,2023-01-01,21,143,KY,Lyon County,3173,3013,160,5
CN2114500000000,2023-01-01,21,145,KY,McCracken County,29863,28675,1188,4
CN2114700000000,2023-01-01,21,147,KY,McCreary County,4796,4514,282,5.9
CN2114900000000,2023-01-01,21,149,KY,McLean County,3927,3752,175,4.5
CN2115100000000,2023-01-01,21,151,KY,Madison County,46731,45062,1669,3.6
CN2115300000000,2023-01-01,21,153,KY,Magoffin County,3235,2859,376,11.6
CN2115500000000,2023-01-01,21,155,KY,Marion County,9521,9193,328,3.4
CN2115700000000,2023-01-01,21,157,KY,Marshall County,14338,13684,654,4.6
CN2115900000000,2023-01-01,21,159,KY,Martin County,2153,1985,168,7.8
CN2116100000000,2023-01-01,21,161,KY,Mason County,6595,6240,355,5.4
CN2116300000000,2023-01-01,21,163,KY,Meade County,11594,10999,595,5.1
CN2116500000000,2023-01-01,21,165,KY,Menifee County,2420,2246,174,7.2
CN2116700000000,2023-01-01,21,167,KY,Mercer County,10057,9687,370,3.7
CN2116900000000,2023-01-01,21,169,KY,Metcalfe County,3934,3747,187,4.8
CN2117100000000,2023-01-01,21,171,KY,Monroe County,4658,4467,191,4.1
CN2117300000000,2023-01-01,21,173,KY,Montgomery County,12011,11420,591,4.9
CN2117500000000,2023-01-01,21,175,KY,Morgan County,4184,3892,292,7
CN2117700000000,2023-01-01,21,177,KY,Muhlenberg County,9897,9287,610,6.2
CN2117900000000,2023-01-01,21,179,KY,Nelson County,23829,22856,973,4.1
CN2118100000000,2023-01-01,21,181,KY,Nicholas County,3275,3134,141,4.3
CN2118300000000,2023-01-01,21,183,KY,Ohio County,9138,8636,502,5.5
CN2118500000000,2023-01-01,21,185,KY,Oldham County,32926,31881,1045,3.2
CN2118700000000,2023-01-01,21,187,KY,Owen County,5185,5006,179,3.5
CN2118900000000,2023-01-01,21,189,KY,Owsley County,1085,1016,69,6.4
CN2119100000000,2023-01-01,21,191,KY,Pendleton County,6956,6668,288,4.1
CN2119300000000,2023-01-01,21,193,KY,Perry County,8064,7658,406,5
CN2119500000000,2023-01-01,21,195,KY,Pike County,18982,18025,957,5
CN2119700000000,2023-01-01,21,197,KY,Powell County,5255,4998,257,4.9
CN2119900000000,2023-01-01,21,199,KY,Pulaski County,25254,24012,1242,4.9
CN2120100000000,2023-01-01,21,201,KY,Robertson County,818,776,42,5.1
CN2120300000000,2023-01-01,21,203,KY,Rockcastle County,6494,6179,315,4.9
CN2120500000000,2023-01-01,21,205,KY,Rowan County,10155,9640,515,5.1
CN2120700000000,2023-01-01,21,207,KY,Russell County,6240,5904,336,5.4
CN2120900000000,2023-01-01,21,209,KY,Scott County,30439,29508,931,3.1
CN2121100000000,2023-01-01,21,211,KY,Shelby County,25705,24772,933,3.6
CN2121300000000,2023-01-01,21,213,KY,Simpson County,8755,8427,328,3.7
CN2121500000000,2023-01-01,21,215,KY,Spencer County,10540,10078,462,4.4
CN2121700000000,2023-01-01,21,217,KY,Taylor County,12259,11809,450,3.7
CN2121900000000,2023-01-01,21,219,KY,Todd County,5849,5635,214,3.7
CN2122100000000,2023-01-01,21,221,KY,Trigg County,6166,5851,315,5.1
CN2122300000000,2023-01-01,21,223,KY,Trimble County,3783,3636,147,3.9
CN2122500000000,2023-01-01,21,225,KY,Union County,5897,5641,256,4.3
CN2122700000000,2023-01-01,21,227,KY,Warren County,65179,62736,2443,3.7
CN2122900000000,2023-01-01,21,229,KY,Washington County,6165,5951,214,3.5
CN2123100000000,2023-01-01,21,231,KY,Wayne County,7077,6696,381,5.4
CN2123300000000,2023-01-01,21,233,KY,Webster County,5186,4978,208,4
CN2123500000000,2023-01-01,21,235,KY,Whitley County,13988,13391,597,4.3
CN2123700000000,2023-01-01,21,237,KY,Wolfe County,2287,2123,164,7.2
CN2123900000000,2023-01-01,21,239,KY,Woodford County,15140,14703,437,2.9
CN2200100000000,2023-01-01,22,001,LA,Acadia Parish,23754,22895,859,3.6
CN2200300000000,2023-01-01,22,003,LA,Allen Parish,8206,7850,356,4.3
CN2200500000000,2023-01-01,22,005,LA,Ascension Parish,67609,65638,1971,2.9
CN2200700000000,2023-01-01,22,007,LA,Assumption Parish,8855,8464,391,4.4
CN2200900000000,2023-01-01,22,009,LA,Avoyelles Parish,14190,13593,597,4.2
CN2201100000000,2023-01-01,22,011,LA,Beauregard Parish,14856,14309,547,3.7
CN2201300000000,2023-01-01,22,013,LA,Bienville Parish,5293,5065,228,4.3
CN2201500000000,2023-01-01,22,015,LA,Bossier Parish,58003,56215,1788,3.1
CN2201700000000,2023-01-01,22,017,LA,Caddo Parish,101504,97456,4048,4
CN2201900000000,2023-01-01,22,019,LA,Calcasieu Parish,91979,88790,3189,3.5
CN2202100000000,2023-01-01,22,021,LA,Caldwell Parish,3652,3512,140,3.8
CN2202300000000,2023-01-01,22,023,LA,Cameron Parish,3432,3321,111,3.2
CN2202500000000,2023-01-01,22,025,LA,Catahoula Parish,3441,3274,167,4.9
CN2202700000000,2023-01-01,22,027,LA,Claiborne Parish,5424,5228,196,3.6
CN2202900000000,2023-01-01,22,029,LA,Concordia Parish,6858,6524,334,4.9
CN2203100000000,2023-01-01,22,031,LA,De Soto Parish,10927,10488,439,4
CN2203300000000,2023-01-01,22,033,LA,East Baton Rouge Parish,235724,227880,7844,3.3
CN2203500000000,2023-01-01,22,035,LA,East Carroll Parish,1635,1492,143,8.7
CN2203700000000,2023-01-01,22,037,LA,East Feliciana Parish,7981,7722,259,3.2
CN2203900000000,2023-01-01,22,039,LA,Evangeline Parish,11921,11438,483,4.1
CN2204100000000,2023-01-01,22,041,LA,Franklin Parish,7420,7041,379,5.1
CN2204300000000,2023-01-01,22,043,LA,Grant Parish,8347,8041,306,3.7
CN2204500000000,2023-01-01,22,045,LA,Iberia Parish,27453,26309,1144,4.2
CN2204700000000,2023-01-01,22,047,LA,Iberville Parish,14034,13454,580,4.1
CN2204900000000,2023-01-01,22,049,LA,Jackson Parish,6905,6675,230,3.3
CN2205100000000,2023-01-01,22,051,LA,Jefferson Parish,210678,203413,7265,3.4
CN2205300000000,2023-01-01,22,053,LA,Jefferson Davis Parish,12300,11843,457,3.7
CN2205500000000,2023-01-01,22,055,LA,Lafayette Parish,115645,112008,3637,3.1
CN2205700000000,2023-01-01,22,057,LA,Lafourche Parish,39792,38457,1335,3.4
CN2205900000000,2023-01-01,22,059,LA,LaSalle Parish,6770,6578,192,2.8
CN2206100000000,2023-01-01,22,061,LA,Lincoln Parish,21235,20513,722,3.4
CN2206300000000,2023-01-01,22,063,LA,Livingston Parish,72583,70436,2147,3
CN2206500000000,2023-01-01,22,065,LA,Madison Parish,3477,3293,184,5.3
CN2206700000000,2023-01-01,22,067,LA,Morehouse Parish,9865,9293,572,5.8
CN2206900000000,2023-01-01,22,069,LA,Natchitoches Parish,16608,15906,702,4.2
CN2207100000000,2023-01-01,22,071,LA,Orleans Parish,176598,169032,7566,4.3
CN2207300000000,2023-01-01,22,073,LA,Ouachita Parish,70229,67636,2593,3.7
CN2207500000000,2023-01-01,22,075,LA,Plaquemines Parish,9843,9521,322,3.3
CN2207700000000,2023-01-01,22,077,LA,Pointe Coupee Parish,9918,9540,378,3.8
CN2207900000000,2023-01-01,22,079,LA,Rapides Parish,56184,54327,1857,3.3
CN2208100000000,2023-01-01,22,081,LA,Red River Parish,4042,3906,136,3.4
CN2208300000000,2023-01-01,22,083,LA,Richland Parish,8310,7949,361,4.3
CN2208500000000,2023-01-01,22,085,LA,Sabine Parish,9209,8878,331,3.6
CN2208700000000,2023-01-01,22,087,LA,St. Bernard Parish,20048,19249,799,4
CN2208900000000,2023-01-01,22,089,LA,St. Charles Parish,24823,24034,789,3.2
CN2209100000000,2023-01-01,22,091,LA,St. Helena Parish,4316,4094,222,5.1
CN2209300000000,2023-01-01,22,093,LA,St. James Parish,8920,8529,391,4.4
CN2209500000000,2023-01-01,22,095,LA,St. John the Baptist Parish,19055,18197,858,4.5
CN2209700000000,2023-01-01,22,097,LA,St. Landry Parish,31480,30038,1442,4.6
CN2209900000000,2023-01-01,22,099,LA,St. Martin Parish,21929,21134,795,3.6
CN2210100000000,2023-01-01,22,101,LA,St. Mary Parish,18877,18101,776,4.1
CN2210300000000,2023-01-01,22,103,LA,St. Tammany Parish,120111,116457,3654,3
CN2210500000000,2023-01-01,22,105,LA,Tangipahoa Parish,56476,54028,2448,4.3
CN2210700000000,2023-01-01,22,107,LA,Tensas Parish,1306,1237,69,5.3
CN2210900000000,2023-01-01,22,109,LA,Terrebonne Parish,43667,42111,1556,3.6
CN2211100000000,2023-01-01,22,111,LA,Union Parish,9197,8827,370,4
CN2211300000000,2023-01-01,22,113,LA,Vermilion Parish,23940,23093,847,3.5
CN2211500000000,2023-01-01,22,115,LA,Vernon Parish,16507,15655,852,5.2
CN2211700000000,2023-01-01,22,117,LA,Washington Parish,17190,16508,682,4
CN2211900000000,2023-01-01,22,119,LA,Webster Parish,14190,13564,626,4.4
CN2212100000000,2023-01-01,22,121,LA,West Baton Rouge Parish,14157,13695,462,3.3
CN2212300000000,2023-01-01,22,123,LA,West Carroll Parish,3503,3250,253,7.2
CN2212500000000,2023-01-01,22,125,LA,West Feliciana Parish,5504,5361,143,2.6
CN2212700000000,2023-01-01,22,127,LA,Winn Parish,4742,4541,201,4.2
CN2300100000000,2023-01-01,23,001,ME,Androscoggin County,52791,51347,1444,2.7
CN2300300000000,2023-01-01,23,003,ME,Aroostook County,27861,26778,1083,3.9
CN2300500000000,2023-01-01,23,005,ME,Cumberland County,159710,156357,3353,2.1
CN2300700000000,2023-01-01,23,007,ME,Franklin County,13653,13204,449,3.3
CN2300900000000,2023-01-01,23,009,ME,Hancock County,26691,25552,1139,4.3
CN2301100000000,2023-01-01,23,011,ME,Kennebec County,60753,59225,1528,2.5
CN2301300000000,2023-01-01,23,013,ME,Knox County,19408,18801,607,3.1
CN2301500000000,2023-01-01,23,015,ME,Lincoln County,15771,15306,465,2.9
CN2301700000000,2023-01-01,23,017,ME,Oxford County,26069,25296,773,3
CN2301900000000,2023-01-01,23,019,ME,Penobscot County,74565,72459,2106,2.8
CN2302100000000,2023-01-01,23,021,ME,Piscataquis County,7129,6873,256,3.6
CN2302300000000,2023-01-01,23,023,ME,Sagadahoc County,18618,18231,387,2.1
CN2302500000000,2023-01-01,23,025,ME,Somerset County,21586,20705,881,4.1
CN2302700000000,2023-01-01,23,027,ME,Waldo County,19853,19244,609,3.1
CN2302900000000,2023-01-01,23,029,ME,Washington County,13002,12406,596,4.6
CN2303100000000,2023-01-01,23,031,ME,York County,110263,107234,3029,2.7
CN2400100000000,2023-01-01,24,001,MD,Allegany County,31099,29755,1344,4.3
CN2400300000000,2023-01-01,24,003,MD,Anne Arundel County,310047,302364,7683,2.5
CN2400500000000,2023-01-01,24,005,MD,Baltimore County,439905,426247,13658,3.1
CN2400900000000,2023-01-01,24,009,MD,Calvert County,49161,47914,1247,2.5
CN2401100000000,2023-01-01,24,011,MD,Caroline County,17220,16670,550,3.2
CN2401300000000,2023-01-01,24,013,MD,Carroll County,93389,91179,2210,2.4
CN2401500000000,2023-01-01,24,015,MD,Cecil County,53761,52030,1731,3.2
CN2401700000000,2023-01-01,24,017,MD,Charles County,86407,83805,2602,3
CN2401900000000,2023-01-01,24,019,MD,Dorchester County,15402,14860,542,3.5
CN2402100000000,2023-01-01,24,021,MD,Frederick County,136504,132912,3592,2.6
CN2402300000000,2023-01-01,24,023,MD,Garrett County,15042,14453,589,3.9
CN2402500000000,2023-01-01,24,025,MD,Harford County,138500,134777,3723,2.7
CN2402700000000,2023-01-01,24,027,MD,Howard County,185332,181202,4130,2.2
CN2402900000000,2023-01-01,24,029,MD,Kent County,9421,8998,423,4.5
CN2403100000000,2023-01-01,24,031,MD,Montgomery County,547548,534459,13089,2.4
CN2403300000000,2023-01-01,24,033,MD,Prince George's County,495160,479518,15642,3.2
CN2403500000000,2023-01-01,24,035,MD,Queen Anne's County,27584,26852,732,2.7
CN2403700000000,2023-01-01,24,037,MD,St. Mary's County,57126,55530,1596,2.8
CN2403900000000,2023-01-01,24,039,MD,Somerset County,8762,8292,470,5.4
CN2404100000000,2023-01-01,24,041,MD,Talbot County,17050,16450,600,3.5
CN2404300000000,2023-01-01,24,043,MD,Washington County,71488,69137,2351,3.3
CN2404500000000,2023-01-01,24,045,MD,Wicomico County,49928,47829,2099,4.2
CN2404700000000,2023-01-01,24,047,MD,Worcester County,25199,23249,1950,7.7
CN2451000000000,2023-01-01,24,510,MD,Baltimore city,272011,260503,11508,4.2
CN2500100000000,2023-01-01,25,001,MA,Barnstable County,108515,101282,7233,6.7
CN2500300000000,2023-01-01,25,003,MA,Berkshire County,61241,58163,3078,5
CN2500500000000,2023-01-01,25,005,MA,Bristol County,299672,283720,15952,5.3
CN2500700000000,2023-01-01,25,007,MA,Dukes County,8358,7662,696,8.3
CN2500900000000,2023-01-01,25,009,MA,Essex County,424920,407347,17573,4.1
CN2501100000000,2023-01-01,25,011,MA,Franklin County,39904,38398,1506,3.8
CN2501300000000,2023-01-01,25,013,MA,Hampden County,224172,212543,11629,5.2
CN2501500000000,2023-01-01,25,015,MA,Hampshire County,89585,86231,3354,3.7
CN2501700000000,2023-01-01,25,017,MA,Middlesex County,915261,885816,29445,3.2
CN2501900000000,2023-01-01,25,019,MA,Nantucket County/town,6715,5766,949,14.1
CN2502100000000,2023-01-01,25,021,MA,Norfolk County,395404,381211,14193,3.6
CN2502300000000,2023-01-01,25,023,MA,Plymouth County,285025,272836,12189,4.3
CN2502500000000,2023-01-01,25,025,MA,Suffolk County,455415,439005,16410,3.6
CN2502700000000,2023-01-01,25,027,MA,Worcester County,444964,426020,18944,4.3
CN2600100000000,2023-01-01,26,001,MI,Alcona County,3778,3433,345,9.1
CN2600300000000,2023-01-01,26,003,MI,Alger County,3190,2860,330,10.3
CN2600500000000,2023-01-01,26,005,MI,Allegan County,61533,58864,2669,4.3
CN2600700000000,2023-01-01,26,007,MI,Alpena County,13273,12487,786,5.9
CN2600900000000,2023-01-01,26,009,MI,Antrim County,9843,9063,780,7.9
CN2601100000000,2023-01-01,26,011,MI,Arenac County,5804,5197,607,10.5
CN2601300000000,2023-01-01,26,013,MI,Baraga County,3005,2740,265,8.8
CN2601500000000,2023-01-01,26,015,MI,Barry County,32050,30619,1431,4.5
CN2601700000000,2023-01-01,26,017,MI,Bay County,49494,46362,3132,6.3
CN2601900000000,2023-01-01,26,019,MI,Benzie County,8597,7956,641,7.5
CN2602100000000,2023-01-01,26,021,MI,Berrien County,72094,68275,3819,5.3
CN2602300000000,2023-01-01,26,023,MI,Branch County,19421,18464,957,4.9
CN2602500000000,2023-01-01,26,025,MI,Calhoun County,59841,56780,3061,5.1
CN2602700000000,2023-01-01,26,027,MI,Cass County,23578,22231,1347,5.7
CN2602900000000,2023-01-01,26,029,MI,Charlevoix County,12504,11698,806,6.4
CN2603100000000,2023-01-01,26,031,MI,Cheboygan County,9756,8266,1490,15.3
CN2603300000000,2023-01-01,26,033,MI,Chippewa County,16046,14686,1360,8.5
CN2603500000000,2023-01-01,26,035,MI,Clare County,10934,9941,993,9.1
CN2603700000000,2023-01-01,26,037,MI,Clinton County,39786,37972,1814,4.6
CN2603900000000,2023-01-01,26,039,MI,Crawford County,5393,4936,457,8.5
CN2604100000000,2023-01-01,26,041,MI,Delta County,16422,15290,1132,6.9
CN2604300000000,2023-01-01,26,043,MI,Dickinson County,11953,11387,566,4.7
CN2604500000000,2023-01-01,26,045,MI,Eaton County,55790,52848,2942,5.3
CN2604700000000,2023-01-01,26,047,MI,Emmet County,16185,14802,1383,8.5
CN2604900000000,2023-01-01,26,049,MI,Genesee County,178784,167859,10925,6.1
CN2605100000000,2023-01-01,26,051,MI,Gladwin County,9879,9124,755,7.6
CN2605300000000,2023-01-01,26,053,MI,Gogebic County,5733,5369,364,6.3
CN2605500000000,2023-01-01,26,055,MI,Grand Traverse County,47924,45794,2130,4.4
CN2605700000000,2023-01-01,26,057,MI,Gratiot County,17262,16322,940,5.4
CN2605900000000,2023-01-01,26,059,MI,Hillsdale County,19882,18883,999,5
CN2606100000000,2023-01-01,26,061,MI,Houghton County,16497,15565,932,5.6
CN2606300000000,2023-01-01,26,063,MI,Huron County,14568,13682,886,6.1
CN2606500000000,2023-01-01,26,065,MI,Ingham County,145432,138154,7278,5
CN2606700000000,2023-01-01,26,067,MI,Ionia County,30061,28662,1399,4.7
CN2606900000000,2023-01-01,26,069,MI,Iosco County,10152,9269,883,8.7
CN2607100000000,2023-01-01,26,071,MI,Iron County,4552,4188,364,8
CN2607300000000,2023-01-01,26,073,MI,Isabella County,30984,29265,1719,5.5
CN2607500000000,2023-01-01,26,075,MI,Jackson County,74104,70477,3627,4.9
CN2607700000000,2023-01-01,26,077,MI,Kalamazoo County,131796,126363,5433,4.1
CN2607900000000,2023-01-01,26,079,MI,Kalkaska County,7740,7130,610,7.9
CN2608100000000,2023-01-01,26,081,MI,Kent County,362497,349624,12873,3.6
CN2608300000000,2023-01-01,26,083,MI,Keweenaw County,926,849,77,8.3
CN2608500000000,2023-01-01,26,085,MI,Lake County,3930,3564,366,9.3
CN2608700000000,2023-01-01,26,087,MI,Lapeer County,39960,37594,2366,5.9
CN2608900000000,2023-01-01,26,089,MI,Leelanau County,9938,9428,510,5.1
CN2609100000000,2023-01-01,26,091,MI,Lenawee County,43921,41723,2198,5
CN2609300000000,2023-01-01,26,093,MI,Livingston County,101153,97720,3433,3.4
CN2609500000000,2023-01-01,26,095,MI,Luce County,2051,1873,178,8.7
CN2609700000000,2023-01-01,26,097,MI,Mackinac County,4421,3482,939,21.2
CN2609900000000,2023-01-01,26,099,MI,Macomb County,434800,416418,18382,4.2
CN2610100000000,2023-01-01,26,101,MI,Manistee County,9321,8556,765,8.2
CN2610300000000,2023-01-01,26,103,MI,Marquette County,32091,30178,1913,6
CN2610500000000,2023-01-01,26,105,MI,Mason County,12644,11736,908,7.2
CN2610700000000,2023-01-01,26,107,MI,Mecosta County,18436,17186,1250,6.8
CN2610900000000,2023-01-01,26,109,MI,Menominee County,10483,9960,523,5
CN2611100000000,2023-01-01,26,111,MI,Midland County,39889,37921,1968,4.9
CN2611300000000,2023-01-01,26,113,MI,Missaukee County,6620,6197,423,6.4
CN2611500000000,2023-01-01,26,115,MI,Monroe County,74631,70794,3837,5.1
CN2611700000000,2023-01-01,26,117,MI,Montcalm County,28127,26606,1521,5.4
CN2611900000000,2023-01-01,26,119,MI,Montmorency County,3010,2699,311,10.3
CN2612100000000,2023-01-01,26,121,MI,Muskegon County,76258,72252,4006,5.3
CN2612300000000,2023-01-01,26,123,MI,Newaygo County,23017,21770,1247,5.4
CN2612500000000,2023-01-01,26,125,MI,Oakland County,653971,632015,21956,3.4
CN2612700000000,2023-01-01,26,127,MI,Oceana County,10862,9916,946,8.7
CN2612900000000,2023-01-01,26,129,MI,Ogemaw County,8067,7264,803,10
CN2613100000000,2023-01-01,26,131,MI,Ontonagon County,2012,1848,164,8.2
CN2613300000000,2023-01-01,26,133,MI,Osceola County,11478,10827,651,5.7
CN2613500000000,2023-01-01,26,135,MI,Oscoda County,2632,2356,276,10.5
CN2613700000000,2023-01-01,26,137,MI,Otsego County,11373,10663,710,6.2
CN2613900000000,2023-01-01,26,139,MI,Ottawa County,162857,157131,5726,3.5
CN2614100000000,2023-01-01,26,141,MI,Presque Isle County,4942,4324,618,12.5
CN2614300000000,2023-01-01,26,143,MI,Roscommon County,7808,6902,906,11.6
CN2614500000000,2023-01-01,26,145,MI,Saginaw County,83378,78106,5272,6.3
CN2614700000000,2023-01-01,26,147,MI,St. Clair County,73627,69913,3714,5
CN2614900000000,2023-01-01,26,149,MI,St. Joseph County,28242,26574,1668,5.9
CN2615100000000,2023-01-01,26,151,MI,Sanilac County,18501,17248,1253,6.8
CN2615300000000,2023-01-01,26,153,MI,Schoolcraft County,3152,2776,376,11.9
CN2615500000000,2023-01-01,26,155,MI,Shiawassee County,32055,30199,1856,5.8
CN2615700000000,2023-01-01,26,157,MI,Tuscola County,22953,21410,1543,6.7
CN2615900000000,2023-01-01,26,159,MI,Van Buren County,34371,32147,2224,6.5
CN2616100000000,2023-01-01,26,161,MI,Washtenaw County,196720,189804,6916,3.5
CN2616300000000,2023-01-01,26,163,MI,Wayne County,785087,746249,38838,4.9
CN2616500000000,2023-01-01,26,165,MI,Wexford County,14544,13699,845,5.8
CN2700100000000,2023-01-01,27,001,MN,Aitkin County,7452,6918,534,7.2
CN2700300000000,2023-01-01,27,003,MN,Anoka County,197252,191172,6080,3.1
CN2700500000000,2023-01-01,27,005,MN,Becker County,19285,18435,850,4.4
CN2700700000000,2023-01-01,27,007,MN,Beltrami County,24991,23901,1090,4.4
CN2700900000000,2023-01-01,27,009,MN,Benton County,22023,20890,1133,5.1
CN2701100000000,2023-01-01,27,011,MN,Big Stone County,2355,2239,116,4.9
CN2701300000000,2023-01-01,27,013,MN,Blue Earth County,41100,39963,1137,2.8
CN2701500000000,2023-01-01,27,015,MN,Brown County,13504,13005,499,3.7
CN2701700000000,2023-01-01,27,017,MN,Carlton County,17667,16799,868,4.9
CN2701900000000,2023-01-01,27,019,MN,Carver County,58919,57404,1515,2.6
CN2702100000000,2023-01-01,27,021,MN,Cass County,14192,13195,997,7
CN2702300000000,2023-01-01,27,023,MN,Chippewa County,6456,6191,265,4.1
CN2702500000000,2023-01-01,27,025,MN,Chisago County,30085,28723,1362,4.5
CN2702700000000,2023-01-01,27,027,MN,Clay County,37561,36573,988,2.6
CN2702900000000,2023-01-01,27,029,MN,Clearwater County,4551,4116,435,9.6
CN2703100000000,2023-01-01,27,031,MN,Cook County,2618,2489,129,4.9
CN2703300000000,2023-01-01,27,033,MN,Cottonwood County,6716,6517,199,3
CN2703500000000,2023-01-01,27,035,MN,Crow Wing County,32870,31255,1615,4.9
CN2703700000000,2023-01-01,27,037,MN,Dakota County,240336,233651,6685,2.8
CN2703900000000,2023-01-01,27,039,MN,Dodge County,12081,11615,466,3.9
CN2704100000000,2023-01-01,27,041,MN,Douglas County,21250,20544,706,3.3
CN2704300000000,2023-01-01,27,043,MN,Faribault County,7028,6732,296,4.2
CN2704500000000,2023-01-01,27,045,MN,Fillmore County,11658,11168,490,4.2
CN2704700000000,2023-01-01,27,047,MN,Freeborn County,15828,15321,507,3.2
CN2704900000000,2023-01-01,27,049,MN,Goodhue County,26630,25736,894,3.4
CN2705100000000,2023-01-01,27,051,MN,Grant County,3248,3102,146,4.5
CN2705300000000,2023-01-01,27,053,MN,Hennepin County,696930,679149,17781,2.6
CN2705500000000,2023-01-01,27,055,MN,Houston County,10582,10192,390,3.7
CN2705700000000,2023-01-01,27,057,MN,Hubbard County,9970,9322,648,6.5
CN2705900000000,2023-01-01,27,059,MN,Isanti County,21951,20767,1184,5.4
CN2706100000000,2023-01-01,27,061,MN,Itasca County,21492,20162,1330,6.2
CN2706300000000,2023-01-01,27,063,MN,Jackson County,5364,5208,156,2.9
CN2706500000000,2023-01-01,27,065,MN,Kanabec County,9391,8599,792,8.4
CN2706700000000,2023-01-01,27,067,MN,Kandiyohi County,22955,22014,941,4.1
CN2706900000000,2023-01-01,27,069,MN,Kittson County,2214,2129,85,3.8
CN2707100000000,2023-01-01,27,071,MN,Koochiching County,5659,5399,260,4.6
CN2707300000000,2023-01-01,27,073,MN,Lac qui Parle County,3424,3282,142,4.1
CN2707500000000,2023-01-01,27,075,MN,Lake County,5024,4721,303,6
CN2707700000000,2023-01-01,27,077,MN,Lake of the Woods County,2507,2425,82,3.3
CN2707900000000,2023-01-01,27,079,MN,Le Sueur County,16227,15198,1029,6.3
CN2708100000000,2023-01-01,27,081,MN,Lincoln County,3015,2855,160,5.3
CN2708300000000,2023-01-01,27,083,MN,Lyon County,14269,13802,467,3.3
CN2708500000000,2023-01-01,27,085,MN,McLeod County,19249,18436,813,4.2
CN2708700000000,2023-01-01,27,087,MN,Mahnomen County,2291,2137,154,6.7
CN2708900000000,2023-01-01,27,089,MN,Marshall County,5386,5027,359,6.7
CN2709100000000,2023-01-01,27,091,MN,Martin County,9514,9203,311,3.3
CN2709300000000,2023-01-01,27,093,MN,Meeker County,13704,13067,637,4.6
CN2709500000000,2023-01-01,27,095,MN,Mille Lacs County,13023,11983,1040,8
CN2709700000000,2023-01-01,27,097,MN,Morrison County,17457,16149,1308,7.5
CN2709900000000,2023-01-01,27,099,MN,Mower County,20715,20042,673,3.2
CN2710100000000,2023-01-01,27,101,MN,Murray County,4643,4343,300,6.5
CN2710300000000,2023-01-01,27,103,MN,Nicollet County,21073,20552,521,2.5
CN2710500000000,2023-01-01,27,105,MN,Nobles County,10965,10640,325,3
CN2710700000000,2023-01-01,27,107,MN,Norman County,3208,3052,156,4.9
CN2710900000000,2023-01-01,27,109,MN,Olmsted County,91418,89154,2264,2.5
CN2711100000000,2023-01-01,27,111,MN,Otter Tail County,30664,29116,1548,5
CN2711300000000,2023-01-01,27,113,MN,Pennington County,8853,8393,460,5.2
CN2711500000000,2023-01-01,27,115,MN,Pine County,14406,13289,1117,7.8
CN2711700000000,2023-01-01,27,117,MN,Pipestone County,4591,4397,194,4.2
CN2711900000000,2023-01-01,27,119,MN,Polk County,16358,15797,561,3.4
CN2712100000000,2023-01-01,27,121,MN,Pope County,6427,6175,252,3.9
CN2712300000000,2023-01-01,27,123,MN,Ramsey County,282430,274556,7874,2.8
CN2712500000000,2023-01-01,27,125,MN,Red Lake County,2183,2061,122,5.6
CN2712700000000,2023-01-01,27,127,MN,Redwood County,7539,7267,272,3.6
CN2712900000000,2023-01-01,27,129,MN,Renville County,7971,7572,399,5
CN2713100000000,2023-01-01,27,131,MN,Rice County,37322,36089,1233,3.3
CN2713300000000,2023-01-01,27,133,MN,Rock County,5996,5857,139,2.3
CN2713500000000,2023-01-01,27,135,MN,Roseau County,7862,7598,264,3.4
CN2713700000000,2023-01-01,27,137,MN,St. Louis County,99966,96096,3870,3.9
CN2713900000000,2023-01-01,27,139,MN,Scott County,83777,81475,2302,2.7
CN2714100000000,2023-01-01,27,141,MN,Sherburne County,53289,51026,2263,4.2
CN2714300000000,2023-01-01,27,143,MN,Sibley County,8166,7775,391,4.8
CN2714500000000,2023-01-01,27,145,MN,Stearns County,90249,87091,3158,3.5
CN2714700000000,2023-01-01,27,147,MN,Steele County,18464,17791,673,3.6
CN2714900000000,2023-01-01,27,149,MN,Stevens County,5185,5016,169,3.3
CN2715100000000,2023-01-01,27,151,MN,Swift County,4780,4584,196,4.1
CN2715300000000,2023-01-01,27,153,MN,Todd County,13639,12948,691,5.1
CN2715500000000,2023-01-01,27,155,MN,Traverse County,1645,1576,69,4.2
CN2715700000000,2023-01-01,27,157,MN,Wabasha County,12367,11890,477,3.9
CN2715900000000,2023-01-01,27,159,MN,Wadena County,6198,5780,418,6.7
CN2716100000000,2023-01-01,27,161,MN,Waseca County,8443,7985,458,5.4
CN2716300000000,2023-01-01,27,163,MN,Washington County,143553,139870,3683,2.6
CN2716500000000,2023-01-01,27,165,MN,Watonwan County,6576,6357,219,3.3
CN2716700000000,2023-01-01,27,167,MN,Wilkin County,3381,3278,103,3
CN2716900000000,2023-01-01,27,169,MN,Winona County,28258,27515,743,2.6
CN2717100000000,2023-01-01,27,171,MN,Wright County,76839,73814,3025,3.9
CN2717300000000,2023-01-01,27,173,MN,Yellow Medicine County,4994,4795,199,4
CN2800100000000,2023-01-01,28,001,MS,Adams County,10369,9878,491,4.7
CN2800300000000,2023-01-01,28,003,MS,Alcorn County,15102,14602,500,3.3
CN2800500000000,2023-01-01,28,005,MS,Amite County,4251,4054,197,4.6
CN2800700000000,2023-01-01,28,007,MS,Attala County,6865,6597,268,3.9
CN2800900000000,2023-01-01,28,009,MS,Benton County,2998,2872,126,4.2
CN2801100000000,2023-01-01,28,011,MS,Bolivar County,10911,10457,454,4.2
CN2801300000000,2023-01-01,28,013,MS,Calhoun County,5371,5159,212,3.9
CN2801500000000,2023-01-01,28,015,MS,Carroll County,3213,3072,141,4.4
CN2801700000000,2023-01-01,28,017,MS,Chickasaw County,6380,6075,305,4.8
CN2801900000000,2023-01-01,28,019,MS,Choctaw County,3508,3395,113,3.2
CN2802100000000,2023-01-01,28,021,MS,Claiborne County,2827,2615,212,7.5
CN2802300000000,2023-01-01,28,023,MS,Clarke County,5546,5313,233,4.2
CN2802500000000,2023-01-01,28,025,MS,Clay County,8856,8518,338,3.8
CN2802700000000,2023-01-01,28,027,MS,Coahoma County,7426,7023,403,5.4
CN2802900000000,2023-01-01,28,029,MS,Copiah County,10757,10320,437,4.1
CN2803100000000,2023-01-01,28,031,MS,Covington County,8058,7810,248,3.1
CN2803300000000,2023-01-01,28,033,MS,DeSoto County,92248,89556,2692,2.9
CN2803500000000,2023-01-01,28,035,MS,Forrest County,32785,31687,1098,3.3
CN2803700000000,2023-01-01,28,037,MS,Franklin County,2626,2487,139,5.3
CN2803900000000,2023-01-01,28,039,MS,George County,8664,8258,406,4.7
CN2804100000000,2023-01-01,28,041,MS,Greene County,4176,3937,239,5.7
CN2804300000000,2023-01-01,28,043,MS,Grenada County,8404,8099,305,3.6
CN2804500000000,2023-01-01,28,045,MS,Hancock County,18634,17946,688,3.7
CN2804700000000,2023-01-01,28,047,MS,Harrison County,85802,82922,2880,3.4
CN2804900000000,2023-01-01,28,049,MS,Hinds County,101105,97743,3362,3.3
CN2805100000000,2023-01-01,28,051,MS,Holmes County,5016,4694,322,6.4
CN2805300000000,2023-01-01,28,053,MS,Humphreys County,1960,1825,135,6.9
CN2805500000000,2023-01-01,28,055,MS,Issaquena County,316,291,25,7.9
CN2805700000000,2023-01-01,28,057,MS,Itawamba County,10077,9739,338,3.4
CN2805900000000,2023-01-01,28,059,MS,Jackson County,57494,55327,2167,3.8
CN2806100000000,2023-01-01,28,061,MS,Jasper County,5853,5579,274,4.7
CN2806300000000,2023-01-01,28,063,MS,Jefferson County,1821,1608,213,11.7
CN2806500000000,2023-01-01,28,065,MS,Jefferson Davis County,3845,3682,163,4.2
CN2806700000000,2023-01-01,28,067,MS,Jones County,24812,23952,860,3.5
CN2806900000000,2023-01-01,28,069,MS,Kemper County,3220,3054,166,5.2
CN2807100000000,2023-01-01,28,071,MS,Lafayette County,27238,26457,781,2.9
CN2807300000000,2023-01-01,28,073,MS,Lamar County,31206,30343,863,2.8
CN2807500000000,2023-01-01,28,075,MS,Lauderdale County,28508,27490,1018,3.6
CN2807700000000,2023-01-01,28,077,MS,Lawrence County,4712,4500,212,4.5
CN2807900000000,2023-01-01,28,079,MS,Leake County,7919,7640,279,3.5
CN2808100000000,2023-01-01,28,081,MS,Lee County,39888,38653,1235,3.1
CN2808300000000,2023-01-01,28,083,MS,Leflore County,9029,8552,477,5.3
CN2808500000000,2023-01-01,28,085,MS,Lincoln County,14402,13894,508,3.5
CN2808700000000,2023-01-01,28,087,MS,Lowndes County,24111,23233,878,3.6
CN2808900000000,2023-01-01,28,089,MS,Madison County,53100,51650,1450,2.7
CN2809100000000,2023-01-01,28,091,MS,Marion County,9782,9431,351,3.6
CN2809300000000,2023-01-01,28,093,MS,Marshall County,14025,13496,529,3.8
CN2809500000000,2023-01-01,28,095,MS,Monroe County,15053,14433,620,4.1
CN2809700000000,2023-01-01,28,097,MS,Montgomery County,3834,3689,145,3.8
CN2809900000000,2023-01-01,28,099,MS,Neshoba County,9700,9319,381,3.9
CN2810100000000,2023-01-01,28,101,MS,Newton County,7755,7464,291,3.8
CN2810300000000,2023-01-01,28,103,MS,Noxubee County,3324,3149,175,5.3
CN2810500000000,2023-01-01,28,105,MS,Oktibbeha County,21719,20932,787,3.6
CN2810700000000,2023-01-01,28,107,MS,Panola County,12035,11530,505,4.2
CN2810900000000,2023-01-01,28,109,MS,Pearl River County,23162,22345,817,3.5
CN2811100000000,2023-01-01,28,111,MS,Perry County,4187,4005,182,4.3
CN2811300000000,2023-01-01,28,113,MS,Pike County,13823,13246,577,4.2
CN2811500000000,2023-01-01,28,115,MS,Pontotoc County,14558,14107,451,3.1
CN2811700000000,2023-01-01,28,117,MS,Prentiss County,11149,10820,329,3
CN2811900000000,2023-01-01,28,119,MS,Quitman County,2292,2150,142,6.2
CN2812100000000,2023-01-01,28,121,MS,Rankin County,76288,74318,1970,2.6
CN2812300000000,2023-01-01,28,123,MS,Scott County,12148,11803,345,2.8
CN2812500000000,2023-01-01,28,125,MS,Sharkey County,1311,1240,71,5.4
CN2812700000000,2023-01-01,28,127,MS,Simpson County,10560,10206,354,3.4
CN2812900000000,2023-01-01,28,129,MS,Smith County,6646,6437,209,3.1
CN2813100000000,2023-01-01,28,131,MS,Stone County,6972,6705,267,3.8
CN2813300000000,2023-01-01,28,133,MS,Sunflower County,7158,6768,390,5.4
CN2813500000000,2023-01-01,28,135,MS,Tallahatchie County,4519,4356,163,3.6
CN2813700000000,2023-01-01,28,137,MS,Tate County,11962,11541,421,3.5
CN2813900000000,2023-01-01,28,139,MS,Tippah County,9735,9437,298,3.1
CN2814100000000,2023-01-01,28,141,MS,Tishomingo County,8529,8210,319,3.7
CN2814300000000,2023-01-01,28,143,MS,Tunica County,4131,3952,179,4.3
CN2814500000000,2023-01-01,28,145,MS,Union County,14566,14182,384,2.6
CN2814700000000,2023-01-01,28,147,MS,Walthall County,4849,4631,218,4.5
CN2814900000000,2023-01-01,28,149,MS,Warren County,18762,18080,682,3.6
CN2815100000000,2023-01-01,28,151,MS,Washington County,14307,13548,759,5.3
CN2815300000000,2023-01-01,28,153,MS,Wayne County,6942,6662,280,4
CN2815500000000,2023-01-01,28,155,MS,Webster County,3800,3665,135,3.6
CN2815700000000,2023-01-01,28,157,MS,Wilkinson County,2566,2415,151,5.9
CN2815900000000,2023-01-01,28,159,MS,Winston County,7066,6802,264,3.7
CN2816100000000,2023-01-01,28,161,MS,Yalobusha County,4553,4369,184,4
CN2816300000000,2023-01-01,28,163,MS,Yazoo County,8818,8498,320,3.6
CN2900100000000,2023-01-01,29,001,MO,Adair County,9678,9334,344,3.6
CN2900300000000,2023-01-01,29,003,MO,Andrew County,9410,9184,226,2.4
CN2900500000000,2023-01-01,29,005,MO,Atchison County,2445,2383,62,2.5
CN2900700000000,2023-01-01,29,007,MO,Audrain County,9825,9522,303,3.1
CN2900900000000,2023-01-01,29,009,MO,Barry County,13914,13465,449,3.2
CN2901100000000,2023-01-01,29,011,MO,Barton County,5173,5041,132,2.6
CN2901300000000,2023-01-01,29,013,MO,Bates County,7681,7445,236,3.1
CN2901500000000,2023-01-01,29,015,MO,Benton County,7146,6825,321,4.5
CN2901700000000,2023-01-01,29,017,MO,Bollinger County,5272,5121,151,2.9
CN2901900000000,2023-01-01,29,019,MO,Boone County,98589,96348,2241,2.3
CN2902100000000,2023-01-01,29,021,MO,Buchanan County,42212,41111,1101,2.6
CN2902300000000,2023-01-01,29,023,MO,Butler County,17792,17153,639,3.6
CN2902500000000,2023-01-01,29,025,MO,Caldwell County,4251,4130,121,2.8
CN2902700000000,2023-01-01,29,027,MO,Callaway County,21868,21295,573,2.6
CN2902900000000,2023-01-01,29,029,MO,Camden County,17759,16982,777,4.4
CN2903100000000,2023-01-01,29,031,MO,Cape Girardeau County,40503,39496,1007,2.5
CN2903300000000,2023-01-01,29,033,MO,Carroll County,4373,4249,124,2.8
CN2903500000000,2023-01-01,29,035,MO,Carter County,2430,2331,99,4.1
CN2903700000000,2023-01-01,29,037,MO,Cass County,55596,54119,1477,2.7
CN2903900000000,2023-01-01,29,039,MO,Cedar County,5549,5371,178,3.2
CN2904100000000,2023-01-01,29,041,MO,Chariton County,3637,3559,78,2.1
CN2904300000000,2023-01-01,29,043,MO,Christian County,47440,46322,1118,2.4
CN2904500000000,2023-01-01,29,045,MO,Clark County,2956,2839,117,4
CN2904700000000,2023-01-01,29,047,MO,Clay County,139886,136636,3250,2.3
CN2904900000000,2023-01-01,29,049,MO,Clinton County,10670,10376,294,2.8
CN2905100000000,2023-01-01,29,051,MO,Cole County,39747,38861,886,2.2
CN2905300000000,2023-01-01,29,053,MO,Cooper County,6944,6749,195,2.8
CN2905500000000,2023-01-01,29,055,MO,Crawford County,10676,10338,338,3.2
CN2905700000000,2023-01-01,29,057,MO,Dade County,3420,3326,94,2.7
CN2905900000000,2023-01-01,29,059,MO,Dallas County,7180,6957,223,3.1
CN2906100000000,2023-01-01,29,061,MO,Daviess County,3882,3779,103,2.7
CN2906300000000,2023-01-01,29,063,MO,DeKalb County,3994,3893,101,2.5
CN2906500000000,2023-01-01,29,065,MO,Dent County,6055,5856,199,3.3
CN2906700000000,2023-01-01,29,067,MO,Douglas County,5201,5050,151,2.9
CN2906900000000,2023-01-01,29,069,MO,Dunklin County,10806,10315,491,4.5
CN2907100000000,2023-01-01,29,071,MO,Franklin County,52745,51315,1430,2.7
CN2907300000000,2023-01-01,29,073,MO,Gasconade County,7499,7309,190,2.5
CN2907500000000,2023-01-01,29,075,MO,Gentry County,3110,3032,78,2.5
CN2907700000000,2023-01-01,29,077,MO,Greene County,154868,151279,3589,2.3
CN2907900000000,2023-01-01,29,079,MO,Grundy County,3932,3818,114,2.9
CN2908100000000,2023-01-01,29,081,MO,Harrison County,3630,3518,112,3.1
CN2908300000000,2023-01-01,29,083,MO,Henry County,10258,9972,286,2.8
CN2908500000000,2023-01-01,29,085,MO,Hickory County,3876,3727,149,3.8
CN2908700000000,2023-01-01,29,087,MO,Holt County,2366,2316,50,2.1
CN2908900000000,2023-01-01,29,089,MO,Howard County,4686,4540,146,3.1
CN2909100000000,2023-01-01,29,091,MO,Howell County,15912,15390,522,3.3
CN2909300000000,2023-01-01,29,093,MO,Iron County,3497,3337,160,4.6
CN2909500000000,2023-01-01,29,095,MO,Jackson County,364013,353511,10502,2.9
CN2909700000000,2023-01-01,29,097,MO,Jasper County,57119,55671,1448,2.5
CN2909900000000,2023-01-01,29,099,MO,Jefferson County,117767,114654,3113,2.6
CN2910100000000,2023-01-01,29,101,MO,Johnson County,22844,22180,664,2.9
CN2910300000000,2023-01-01,29,103,MO,Knox County,1683,1629,54,3.2
CN2910500000000,2023-01-01,29,105,MO,Laclede County,16783,16286,497,3
CN2910700000000,2023-01-01,29,107,MO,Lafayette County,16823,16374,449,2.7
CN2910900000000,2023-01-01,29,109,MO,Lawrence County,17003,16529,474,2.8
CN2911100000000,2023-01-01,29,111,MO,Lewis County,4665,4525,140,3
CN2911300000000,2023-01-01,29,113,MO,Lincoln County,29442,28275,1167,4
CN2911500000000,2023-01-01,29,115,MO,Linn County,5151,4970,181,3.5
CN2911700000000,2023-01-01,29,117,MO,Livingston County,7116,6976,140,2
CN2911900000000,2023-01-01,29,119,MO,McDonald County,11240,10949,291,2.6
CN2912100000000,2023-01-01,29,121,MO,Macon County,7106,6870,236,3.3
CN2912300000000,2023-01-01,29,123,MO,Madison County,5341,5176,165,3.1
CN2912500000000,2023-01-01,29,125,MO,Maries County,3823,3719,104,2.7
CN2912700000000,2023-01-01,29,127,MO,Marion County,13473,13091,382,2.8
CN2912900000000,2023-01-01,29,129,MO,Mercer County,1617,1571,46,2.8
CN2913100000000,2023-01-01,29,131,MO,Miller County,12530,12097,433,3.5
CN2913300000000,2023-01-01,29,133,MO,Mississippi County,5089,4917,172,3.4
CN2913500000000,2023-01-01,29,135,MO,Moniteau County,7095,6923,172,2.4
CN2913700000000,2023-01-01,29,137,MO,Monroe County,3691,3573,118,3.2
CN2913900000000,2023-01-01,29,139,MO,Montgomery County,5810,5609,201,3.5
CN2914100000000,2023-01-01,29,141,MO,Morgan County,8024,7700,324,4
CN2914300000000,2023-01-01,29,143,MO,New Madrid County,8041,7785,256,3.2
CN2914500000000,2023-01-01,29,145,MO,Newton County,26982,26282,700,2.6
CN2914700000000,2023-01-01,29,147,MO,Nodaway County,10856,10584,272,2.5
CN2914900000000,2023-01-01,29,149,MO,Oregon County,3729,3606,123,3.3
CN2915100000000,2023-01-01,29,151,MO,Osage County,7105,6950,155,2.2
CN2915300000000,2023-01-01,29,153,MO,Ozark County,3292,3136,156,4.7
CN2915500000000,2023-01-01,29,155,MO,Pemiscot County,5641,5409,232,4.1
CN2915700000000,2023-01-01,29,157,MO,Perry County,9446,9234,212,2.2
CN2915900000000,2023-01-01,29,159,MO,Pettis County,19891,19349,542,2.7
CN2916100000000,2023-01-01,29,161,MO,Phelps County,19957,19358,599,3
CN2916300000000,2023-01-01,29,163,MO,Pike County,7083,6877,206,2.9
CN2916500000000,2023-01-01,29,165,MO,Platte County,60522,59226,1296,2.1
CN2916700000000,2023-01-01,29,167,MO,Polk County,14693,14292,401,2.7
CN2916900000000,2023-01-01,29,169,MO,Pulaski County,14679,14208,471,3.2
CN2917100000000,2023-01-01,29,171,MO,Putnam County,2101,2037,64,3
CN2917300000000,2023-01-01,29,173,MO,Ralls County,5289,5144,145,2.7
CN2917500000000,2023-01-01,29,175,MO,Randolph County,10088,9808,280,2.8
CN2917700000000,2023-01-01,29,177,MO,Ray County,10923,10617,306,2.8
CN2917900000000,2023-01-01,29,179,MO,Reynolds County,2700,2609,91,3.4
CN2918100000000,2023-01-01,29,181,MO,Ripley County,5057,4892,165,3.3
CN2918300000000,2023-01-01,29,183,MO,St. Charles County,228695,222791,5904,2.6
CN2918500000000,2023-01-01,29,185,MO,St. Clair County,3790,3671,119,3.1
CN2918600000000,2023-01-01,29,186,MO,Ste. Genevieve County,9146,8902,244,2.7
CN2918700000000,2023-01-01,29,187,MO,St. Francois County,25424,24485,939,3.7
CN2918900000000,2023-01-01,29,189,MO,St. Louis County,524631,510509,14122,2.7
CN2919500000000,2023-01-01,29,195,MO,Saline County,10135,9854,281,2.8
CN2919700000000,2023-01-01,29,197,MO,Schuyler County,1760,1695,65,3.7
CN2919900000000,2023-01-01,29,199,MO,Scotland County,2183,2137,46,2.1
CN2920100000000,2023-01-01,29,201,MO,Scott County,19911,19417,494,2.5
CN2920300000000,2023-01-01,29,203,MO,Shannon County,3181,3026,155,4.9
CN2920500000000,2023-01-01,29,205,MO,Shelby County,2908,2816,92,3.2
CN2920700000000,2023-01-01,29,207,MO,Stoddard County,12922,12468,454,3.5
CN2920900000000,2023-01-01,29,209,MO,Stone County,12472,11576,896,7.2
CN2921100000000,2023-01-01,29,211,MO,Sullivan County,2534,2457,77,3
CN2921300000000,2023-01-01,29,213,MO,Taney County,24245,22065,2180,9
CN2921500000000,2023-01-01,29,215,MO,Texas County,9059,8753,306,3.4
CN2921700000000,2023-01-01,29,217,MO,Vernon County,9062,8802,260,2.9
CN2921900000000,2023-01-01,29,219,MO,Warren County,18813,18157,656,3.5
CN2922100000000,2023-01-01,29,221,MO,Washington County,10015,9601,414,4.1
CN2922300000000,2023-01-01,29,223,MO,Wayne County,4648,4451,197,4.2
CN2922500000000,2023-01-01,29,225,MO,Webster County,17532,17104,428,2.4
CN2922700000000,2023-01-01,29,227,MO,Worth County,1108,1082,26,2.3
CN2922900000000,2023-01-01,29,229,MO,Wright County,7522,7292,230,3.1
CN2951000000000,2023-01-01,29,510,MO,St. Louis city,148140,143260,4880,3.3
CN3000100000000,2023-01-01,30,001,MT,Beaverhead County,5609,5480,129,2.3
CN3000300000000,2023-01-01,30,003,MT,Big Horn County,4642,4441,201,4.3
CN3000500000000,2023-01-01,30,005,MT,Blaine County,2245,2164,81,3.6
CN3000700000000,2023-01-01,30,007,MT,Broadwater County,2869,2746,123,4.3
CN3000900000000,2023-01-01,30,009,MT,Carbon County,5749,5591,158,2.7
CN3001100000000,2023-01-01,30,011,MT,Carter County,713,698,15,2.1
CN3001300000000,2023-01-01,30,013,MT,Cascade County,39539,38415,1124,2.8
CN3001500000000,2023-01-01,30,015,MT,Chouteau County,2549,2484,65,2.6
CN3001700000000,2023-01-01,30,017,MT,Custer County,6410,6208,202,3.2
CN3001900000000,2023-01-01,30,019,MT,Daniels County,896,881,15,1.7
CN3002100000000,2023-01-01,30,021,MT,Dawson County,4560,4462,98,2.1
CN3002300000000,2023-01-01,30,023,MT,Deer Lodge County,5463,5301,162,3
CN3002500000000,2023-01-01,30,025,MT,Fallon County,1671,1644,27,1.6
CN3002700000000,2023-01-01,30,027,MT,Fergus County,5873,5655,218,3.7
CN3002900000000,2023-01-01,30,029,MT,Flathead County,52417,50421,1996,3.8
CN3003100000000,2023-01-01,30,031,MT,Gallatin County,77906,76422,1484,1.9
CN3003300000000,2023-01-01,30,033,MT,Garfield County,779,747,32,4.1
CN3003500000000,2023-01-01,30,035,MT,Glacier County,5721,5406,315,5.5
CN3003700000000,2023-01-01,30,037,MT,Golden Valley County,377,366,11,2.9
CN3003900000000,2023-01-01,30,039,MT,Granite County,1706,1620,86,5
CN3004100000000,2023-01-01,30,041,MT,Hill County,7483,7317,166,2.2
CN3004300000000,2023-01-01,30,043,MT,Jefferson County,6180,6011,169,2.7
CN3004500000000,2023-01-01,30,045,MT,Judith Basin County,1032,1004,28,2.7
CN3004700000000,2023-01-01,30,047,MT,Lake County,14415,13869,546,3.8
CN3004900000000,2023-01-01,30,049,MT,Lewis and Clark County,39058,38032,1026,2.6
CN3005100000000,2023-01-01,30,051,MT,Liberty County,1025,1005,20,2
CN3005300000000,2023-01-01,30,053,MT,Lincoln County,8746,8218,528,6
CN3005500000000,2023-01-01,30,055,MT,McCone County,1012,992,20,2
CN3005700000000,2023-01-01,30,057,MT,Madison County,6109,5977,132,2.2
CN3005900000000,2023-01-01,30,059,MT,Meagher County,1094,1068,26,2.4
CN3006100000000,2023-01-01,30,061,MT,Mineral County,1817,1715,102,5.6
CN3006300000000,2023-01-01,30,063,MT,Missoula County,67478,65445,2033,3
CN3006500000000,2023-01-01,30,065,MT,Musselshell County,2364,2294,70,3
CN3006700000000,2023-01-01,30,067,MT,Park County,9912,9594,318,3.2
CN3006900000000,2023-01-01,30,069,MT,Petroleum County,280,271,9,3.2
CN3007100000000,2023-01-01,30,071,MT,Phillips County,1861,1769,92,4.9
CN3007300000000,2023-01-01,30,073,MT,Pondera County,2666,2596,70,2.6
CN3007500000000,2023-01-01,30,075,MT,Powder River County,1036,1005,31,3
CN3007700000000,2023-01-01,30,077,MT,Powell County,2849,2750,99,3.5
CN3007900000000,2023-01-01,30,079,MT,Prairie County,513,492,21,4.1
CN3008100000000,2023-01-01,30,081,MT,Ravalli County,22001,21224,777,3.5
CN3008300000000,2023-01-01,30,083,MT,Richland County,5953,5828,125,2.1
CN3008500000000,2023-01-01,30,085,MT,Roosevelt County,4406,4243,163,3.7
CN3008700000000,2023-01-01,30,087,MT,Rosebud County,3534,3418,116,3.3
CN3008900000000,2023-01-01,30,089,MT,Sanders County,5464,5132,332,6.1
CN3009100000000,2023-01-01,30,091,MT,Sheridan County,1787,1748,39,2.2
CN3009300000000,2023-01-01,30,093,MT,Silver Bow County,17735,17142,593,3.3
CN3009500000000,2023-01-01,30,095,MT,Stillwater County,5412,5283,129,2.4
CN3009700000000,2023-01-01,30,097,MT,Sweet Grass County,1929,1881,48,2.5
CN3009900000000,2023-01-01,30,099,MT,Teton County,2853,2759,94,3.3
CN3010100000000,2023-01-01,30,101,MT,Toole County,2125,2087,38,1.8
CN3010300000000,2023-01-01,30,103,MT,Treasure County,365,356,9,2.5
CN3010500000000,2023-01-01,30,105,MT,Valley County,3973,3853,120,3
CN3010700000000,2023-01-01,30,107,MT,Wheatland County,778,744,34,4.4
CN3010900000000,2023-01-01,30,109,MT,Wibaux County,442,434,8,1.8
CN3011100000000,2023-01-01,30,111,MT,Yellowstone County,85365,83194,2171,2.5
CN3100100000000,2023-01-01,31,001,NE,Adams County,17198,16852,346,2
CN3100300000000,2023-01-01,31,003,NE,Antelope County,3748,3672,76,2
CN3100500000000,2023-01-01,31,005,NE,Arthur County,243,235,8,3.3
CN3100700000000,2023-01-01,31,007,NE,Banner County,399,391,8,2
CN3100900000000,2023-01-01,31,009,NE,Blaine County,261,250,11,4.2
CN3101100000000,2023-01-01,31,011,NE,Boone County,3092,3042,50,1.6
CN3101300000000,2023-01-01,31,013,NE,Box Butte County,5337,5242,95,1.8
CN3101500000000,2023-01-01,31,015,NE,Boyd County,1064,1040,24,2.3
CN3101700000000,2023-01-01,31,017,NE,Brown County,1443,1411,32,2.2
CN3101900000000,2023-01-01,31,019,NE,Buffalo County,28254,27741,513,1.8
CN3102100000000,2023-01-01,31,021,NE,Burt County,3602,3508,94,2.6
CN3102300000000,2023-01-01,31,023,NE,Butler County,4787,4716,71,1.5
CN3102500000000,2023-01-01,31,025,NE,Cass County,13611,13296,315,2.3
CN3102700000000,2023-01-01,31,027,NE,Cedar County,4693,4609,84,1.8
CN3102900000000,2023-01-01,31,029,NE,Chase County,2310,2276,34,1.5
CN3103100000000,2023-01-01,31,031,NE,Cherry County,3389,3332,57,1.7
CN3103300000000,2023-01-01,31,033,NE,Cheyenne County,4274,4182,92,2.2
CN3103500000000,2023-01-01,31,035,NE,Clay County,3074,2998,76,2.5
CN3103700000000,2023-01-01,31,037,NE,Colfax County,5789,5698,91,1.6
CN3103900000000,2023-01-01,31,039,NE,Cuming County,4918,4823,95,1.9
CN3104100000000,2023-01-01,31,041,NE,Custer County,6435,6340,95,1.5
CN3104300000000,2023-01-01,31,043,NE,Dakota County,11143,10794,349,3.1
CN3104500000000,2023-01-01,31,045,NE,Dawes County,4922,4841,81,1.6
CN3104700000000,2023-01-01,31,047,NE,Dawson County,13832,13489,343,2.5
CN3104900000000,2023-01-01,31,049,NE,Deuel County,1050,1026,24,2.3
CN3105100000000,2023-01-01,31,051,NE,Dixon County,3095,3037,58,1.9
CN3105300000000,2023-01-01,31,053,NE,Dodge County,20893,20479,414,2
CN3105500000000,2023-01-01,31,055,NE,Douglas County,303530,295912,7618,2.5
CN3105700000000,2023-01-01,31,057,NE,Dundy County,1224,1208,16,1.3
CN3105900000000,2023-01-01,31,059,NE,Fillmore County,3411,3350,61,1.8
CN3106100000000,2023-01-01,31,061,NE,Franklin County,1588,1559,29,1.8
CN3106300000000,2023-01-01,31,063,NE,Frontier County,1537,1500,37,2.4
CN3106500000000,2023-01-01,31,065,NE,Furnas County,2554,2512,42,1.6
CN3106700000000,2023-01-01,31,067,NE,Gage County,10849,10593,256,2.4
CN3106900000000,2023-01-01,31,069,NE,Garden County,1120,1096,24,2.1
CN3107100000000,2023-01-01,31,071,NE,Garfield County,1155,1136,19,1.6
CN3107300000000,2023-01-01,31,073,NE,Gosper County,1189,1165,24,2
CN3107500000000,2023-01-01,31,075,NE,Grant County,445,439,6,1.3
CN3107700000000,2023-01-01,31,077,NE,Greeley County,1264,1240,24,1.9
CN3107900000000,2023-01-01,31,079,NE,Hall County,33147,32303,844,2.5
CN3108100000000,2023-01-01,31,081,NE,Hamilton County,4981,4900,81,1.6
CN3108300000000,2023-01-01,31,083,NE,Harlan County,1830,1799,31,1.7
CN3108500000000,2023-01-01,31,085,NE,Hayes County,610,604,6,1
CN3108700000000,2023-01-01,31,087,NE,Hitchcock County,1312,1288,24,1.8
CN3108900000000,2023-01-01,31,089,NE,Holt County,5768,5650,118,2
CN3109100000000,2023-01-01,31,091,NE,Hooker County,348,340,8,2.3
CN3109300000000,2023-01-01,31,093,NE,Howard County,3535,3472,63,1.8
CN3109500000000,2023-01-01,31,095,NE,Jefferson County,4260,4177,83,1.9
CN3109700000000,2023-01-01,31,097,NE,Johnson County,2064,1986,78,3.8
CN3109900000000,2023-01-01,31,099,NE,Kearney County,3775,3715,60,1.6
CN3110100000000,2023-01-01,31,101,NE,Keith County,4636,4566,70,1.5
CN3110300000000,2023-01-01,31,103,NE,Keya Paha County,584,574,10,1.7
CN3110500000000,2023-01-01,31,105,NE,Kimball County,1950,1921,29,1.5
CN3110700000000,2023-01-01,31,107,NE,Knox County,4690,4585,105,2.2
CN3110900000000,2023-01-01,31,109,NE,Lancaster County,177766,174163,3603,2
CN3111100000000,2023-01-01,31,111,NE,Lincoln County,18274,17899,375,2.1
CN3111300000000,2023-01-01,31,113,NE,Logan County,500,487,13,2.6
CN3111500000000,2023-01-01,31,115,NE,Loup County,434,423,11,2.5
CN3111700000000,2023-01-01,31,117,NE,McPherson County,447,437,10,2.2
CN3111900000000,2023-01-01,31,119,NE,Madison County,19751,19324,427,2.2
CN3112100000000,2023-01-01,31,121,NE,Merrick County,4263,4182,81,1.9
CN3112300000000,2023-01-01,31,123,NE,Morrill County,2669,2619,50,1.9
CN3112500000000,2023-01-01,31,125,NE,Nance County,2003,1956,47,2.3
CN3112700000000,2023-01-01,31,127,NE,Nemaha County,3641,3570,71,2
CN3112900000000,2023-01-01,31,129,NE,Nuckolls County,2548,2485,63,2.5
CN3113100000000,2023-01-01,31,131,NE,Otoe County,8599,8421,178,2.1
CN3113300000000,2023-01-01,31,133,NE,Pawnee County,1517,1485,32,2.1
CN3113500000000,2023-01-01,31,135,NE,Perkins County,1883,1857,26,1.4
CN3113700000000,2023-01-01,31,137,NE,Phelps County,5127,5044,83,1.6
CN3113900000000,2023-01-01,31,139,NE,Pierce County,4223,4144,79,1.9
CN3114100000000,2023-01-01,31,141,NE,Platte County,18670,18343,327,1.8
CN3114300000000,2023-01-01,31,143,NE,Polk County,2948,2891,57,1.9
CN3114500000000,2023-01-01,31,145,NE,Red Willow County,5910,5823,87,1.5
CN3114700000000,2023-01-01,31,147,NE,Richardson County,4180,4101,79,1.9
CN3114900000000,2023-01-01,31,149,NE,Rock County,948,937,11,1.2
CN3115100000000,2023-01-01,31,151,NE,Saline County,7273,7059,214,2.9
CN3115300000000,2023-01-01,31,153,NE,Sarpy County,98903,96818,2085,2.1
CN3115500000000,2023-01-01,31,155,NE,Saunders County,11520,11306,214,1.9
CN3115700000000,2023-01-01,31,157,NE,Scotts Bluff County,17814,17346,468,2.6
CN3115900000000,2023-01-01,31,159,NE,Seward County,8834,8685,149,1.7
CN3116100000000,2023-01-01,31,161,NE,Sheridan County,2849,2804,45,1.6
CN3116300000000,2023-01-01,31,163,NE,Sherman County,1698,1667,31,1.8
CN3116500000000,2023-01-01,31,165,NE,Sioux County,793,778,15,1.9
CN3116700000000,2023-01-01,31,167,NE,Stanton County,3535,3474,61,1.7
CN3116900000000,2023-01-01,31,169,NE,Thayer County,2779,2734,45,1.6
CN3117100000000,2023-01-01,31,171,NE,Thomas County,469,451,18,3.8
CN3117300000000,2023-01-01,31,173,NE,Thurston County,3300,3221,79,2.4
CN3117500000000,2023-01-01,31,175,NE,Valley County,2141,2094,47,2.2
CN3117700000000,2023-01-01,31,177,NE,Washington County,11433,11219,214,1.9
CN3117900000000,2023-01-01,31,179,NE,Wayne County,5797,5698,99,1.7
CN3118100000000,2023-01-01,31,181,NE,Webster County,1721,1677,44,2.6
CN3118300000000,2023-01-01,31,183,NE,Wheeler County,604,593,11,1.8
CN3118500000000,2023-01-01,31,185,NE,York County,7426,7280,146,2
CN3200100000000,2023-01-01,32,001,NV,Churchill County,10812,10303,509,4.7
CN3200300000000,2023-01-01,32,003,NV,Clark County,1158540,1089728,68812,5.9
CN3200500000000,2023-01-01,32,005,NV,Douglas County,22472,21325,1147,5.1
CN3200700000000,2023-01-01,32,007,NV,Elko County,25113,24112,1001,4
CN3200900000000,2023-01-01,32,009,NV,Esmeralda County,392,374,18,4.6
CN3201100000000,2023-01-01,32,011,NV,Eureka County,958,914,44,4.6
CN3201300000000,2023-01-01,32,013,NV,Humboldt County,7544,7226,318,4.2
CN3201500000000,2023-01-01,32,015,NV,Lander County,2963,2850,113,3.8
CN3201700000000,2023-01-01,32,017,NV,Lincoln County,1967,1875,92,4.7
CN3201900000000,2023-01-01,32,019,NV,Lyon County,23773,22163,1610,6.8
CN3202100000000,2023-01-01,32,021,NV,Mineral County,2028,1919,109,5.4
CN3202300000000,2023-01-01,32,023,NV,Nye County,17911,16740,1171,6.5
CN3202700000000,2023-01-01,32,027,NV,Pershing County,2343,2222,121,5.2
CN3202900000000,2023-01-01,32,029,NV,Storey County,2136,2029,107,5
CN3203100000000,2023-01-01,32,031,NV,Washoe County,261989,250148,11841,4.5
CN3203300000000,2023-01-01,32,033,NV,White Pine County,4416,4244,172,3.9
CN3251000000000,2023-01-01,32,510,NV,Carson City,25803,24451,1352,5.2
CN3300100000000,2023-01-01,33,001,NH,Belknap County,30428,29441,987,3.2
CN3300300000000,2023-01-01,33,003,NH,Carroll County,22711,21972,739,3.3
CN3300500000000,2023-01-01,33,005,NH,Cheshire County,39260,37977,1283,3.3
CN3300700000000,2023-01-01,33,007,NH,Coos County,14378,13816,562,3.9
CN3300900000000,2023-01-01,33,009,NH,Grafton County,48959,47627,1332,2.7
CN3301100000000,2023-01-01,33,011,NH,Hillsborough County,246816,239079,7737,3.1
CN3301300000000,2023-01-01,33,013,NH,Merrimack County,83251,81032,2219,2.7
CN3301500000000,2023-01-01,33,015,NH,Rockingham County,191267,185103,6164,3.2
CN3301700000000,2023-01-01,33,017,NH,Strafford County,74274,72229,2045,2.8
CN3301900000000,2023-01-01,33,019,NH,Sullivan County,22833,22215,618,2.7
CN3400100000000,2023-01-01,34,001,NJ,Atlantic County,124445,117100,7345,5.9
CN3400300000000,2023-01-01,34,003,NJ,Bergen County,512819,495781,17038,3.3
CN3400500000000,2023-01-01,34,005,NJ,Burlington County,252433,243462,8971,3.6
CN3400700000000,2023-01-01,34,007,NJ,Camden County,276494,264328,12166,4.4
CN3400900000000,2023-01-01,34,009,NJ,Cape May County,43243,38231,5012,11.6
CN3401100000000,2023-01-01,34,011,NJ,Cumberland County,70637,66165,4472,6.3
CN3401300000000,2023-01-01,34,013,NJ,Essex County,395246,375959,19287,4.9
CN3401500000000,2023-01-01,34,015,NJ,Gloucester County,164716,158026,6690,4.1
CN3401700000000,2023-01-01,34,017,NJ,Hudson County,384307,370012,14295,3.7
CN3401900000000,2023-01-01,34,019,NJ,Hunterdon County,69027,66835,2192,3.2
CN3402100000000,2023-01-01,34,021,NJ,Mercer County,221547,214145,7402,3.3
CN3402300000000,2023-01-01,34,023,NJ,Middlesex County,466715,450498,16217,3.5
CN3402500000000,2023-01-01,34,025,NJ,Monmouth County,351068,338743,12325,3.5
CN3402700000000,2023-01-01,34,027,NJ,Morris County,272944,264235,8709,3.2
CN3402900000000,2023-01-01,34,029,NJ,Ocean County,302013,289364,12649,4.2
CN3403100000000,2023-01-01,34,031,NJ,Passaic County,258475,245511,12964,5
CN3403300000000,2023-01-01,34,033,NJ,Salem County,30938,29273,1665,5.4
CN3403500000000,2023-01-01,34,035,NJ,Somerset County,182035,176094,5941,3.3
CN3403700000000,2023-01-01,34,037,NJ,Sussex County,78960,75671,3289,4.2
CN3403900000000,2023-01-01,34,039,NJ,Union County,294649,282219,12430,4.2
CN3404100000000,2023-01-01,34,041,NJ,Warren County,59925,57579,2346,3.9
CN3500100000000,2023-01-01,35,001,NM,Bernalillo County,337122,325484,11638,3.5
CN3500300000000,2023-01-01,35,003,NM,Catron County,1106,1047,59,5.3
CN3500500000000,2023-01-01,35,005,NM,Chaves County,27879,26803,1076,3.9
CN3500600000000,2023-01-01,35,006,NM,Cibola County,8217,7770,447,5.4
CN3500700000000,2023-01-01,35,007,NM,Colfax County,5142,4954,188,3.7
CN3500900000000,2023-01-01,35,009,NM,Curry County,22203,21556,647,2.9
CN3501100000000,2023-01-01,35,011,NM,De Baca County,710,684,26,3.7
CN3501300000000,2023-01-01,35,013,NM,Dona Ana County,99805,95275,4530,4.5
CN3501500000000,2023-01-01,35,015,NM,Eddy County,31903,31043,860,2.7
CN3501700000000,2023-01-01,35,017,NM,Grant County,11572,11122,450,3.9
CN3501900000000,2023-01-01,35,019,NM,Guadalupe County,1470,1399,71,4.8
CN3502100000000,2023-01-01,35,021,NM,Harding County,284,272,12,4.2
CN3502300000000,2023-01-01,35,023,NM,Hidalgo County,1858,1803,55,3
CN3502500000000,2023-01-01,35,025,NM,Lea County,29039,27965,1074,3.7
CN3502700000000,2023-01-01,35,027,NM,Lincoln County,8726,8413,313,3.6
CN3502800000000,2023-01-01,35,028,NM,Los Alamos County,10865,10652,213,2
CN3502900000000,2023-01-01,35,029,NM,Luna County,9728,8553,1175,12.1
CN3503100000000,2023-01-01,35,031,NM,McKinley County,23116,21933,1183,5.1
CN3503300000000,2023-01-01,35,033,NM,Mora County,1965,1866,99,5
CN3503500000000,2023-01-01,35,035,NM,Otero County,25930,24884,1046,4
CN3503700000000,2023-01-01,35,037,NM,Quay County,2947,2825,122,4.1
CN3503900000000,2023-01-01,35,039,NM,Rio Arriba County,16461,15834,627,3.8
CN3504100000000,2023-01-01,35,041,NM,Roosevelt County,8205,7915,290,3.5
CN3504300000000,2023-01-01,35,043,NM,Sandoval County,67983,65552,2431,3.6
CN3504500000000,2023-01-01,35,045,NM,San Juan County,49529,47282,2247,4.5
CN3504700000000,2023-01-01,35,047,NM,San Miguel County,10538,10024,514,4.9
CN3504900000000,2023-01-01,35,049,NM,Santa Fe County,72173,69774,2399,3.3
CN3505100000000,2023-01-01,35,051,NM,Sierra County,4018,3762,256,6.4
CN3505300000000,2023-01-01,35,053,NM,Socorro County,6204,5940,264,4.3
CN3505500000000,2023-01-01,35,055,NM,Taos County,15149,14496,653,4.3
CN3505700000000,2023-01-01,35,057,NM,Torrance County,5342,5061,281,5.3
CN3505900000000,2023-01-01,35,059,NM,Union County,1550,1505,45,2.9
CN3506100000000,2023-01-01,35,061,NM,Valencia County,31002,29728,1274,4.1
CN3600100000000,2023-01-01,36,001,NY,Albany County,159191,153657,5534,3.5
CN3600300000000,2023-01-01,36,003,NY,Allegany County,18995,17905,1090,5.7
CN3600500000000,2023-01-01,36,005,NY,Bronx County,607382,561135,46247,7.6
CN3600700000000,2023-01-01,36,007,NY,Broome County,82167,78330,3837,4.7
CN3600900000000,2023-01-01,36,009,NY,Cattaraugus County,33196,31470,1726,5.2
CN3601100000000,2023-01-01,36,011,NY,Cayuga County,35249,33752,1497,4.2
CN3601300000000,2023-01-01,36,013,NY,Chautauqua County,53304,50586,2718,5.1
CN3601500000000,2023-01-01,36,015,NY,Chemung County,34732,33209,1523,4.4
CN3601700000000,2023-01-01,36,017,NY,Chenango County,21901,20962,939,4.3
CN3601900000000,2023-01-01,36,019,NY,Clinton County,34997,33498,1499,4.3
CN3602100000000,2023-01-01,36,021,NY,Columbia County,30007,29013,994,3.3
CN3602300000000,2023-01-01,36,023,NY,Cortland County,22721,21495,1226,5.4
CN3602500000000,2023-01-01,36,025,NY,Delaware County,18219,17289,930,5.1
CN3602700000000,2023-01-01,36,027,NY,Dutchess County,141367,136342,5025,3.6
CN3602900000000,2023-01-01,36,029,NY,Erie County,442105,423381,18724,4.2
CN3603100000000,2023-01-01,36,031,NY,Essex County,16669,15840,829,5
CN3603300000000,2023-01-01,36,033,NY,Franklin County,18814,17965,849,4.5
CN3603500000000,2023-01-01,36,035,NY,Fulton County,22551,21360,1191,5.3
CN3603700000000,2023-01-01,36,037,NY,Genesee County,29475,28232,1243,4.2
CN3603900000000,2023-01-01,36,039,NY,Greene County,20740,19884,856,4.1
CN3604100000000,2023-01-01,36,041,NY,Hamilton County,2086,1941,145,7
CN3604300000000,2023-01-01,36,043,NY,Herkimer County,27577,26092,1485,5.4
CN3604500000000,2023-01-01,36,045,NY,Jefferson County,43789,41420,2369,5.4
CN3604700000000,2023-01-01,36,047,NY,Kings County,1217277,1147238,70039,5.8
CN3604900000000,2023-01-01,36,049,NY,Lewis County,11770,11071,699,5.9
CN3605100000000,2023-01-01,36,051,NY,Livingston County,30123,28774,1349,4.5
CN3605300000000,2023-01-01,36,053,NY,Madison County,32975,31454,1521,4.6
CN3605500000000,2023-01-01,36,055,NY,Monroe County,359332,345221,14111,3.9
CN3605700000000,2023-01-01,36,057,NY,Montgomery County,22478,21257,1221,5.4
CN3605900000000,2023-01-01,36,059,NY,Nassau County,720893,698049,22844,3.2
CN3606100000000,2023-01-01,36,061,NY,New York County,927067,884235,42832,4.6
CN3606300000000,2023-01-01,36,063,NY,Niagara County,98060,93266,4794,4.9
CN3606500000000,2023-01-01,36,065,NY,Oneida County,100043,95787,4256,4.3
CN3606700000000,2023-01-01,36,067,NY,Onondaga County,222725,214280,8445,3.8
CN3606900000000,2023-01-01,36,069,NY,Ontario County,55277,53122,2155,3.9
CN3607100000000,2023-01-01,36,071,NY,Orange County,188083,181186,6897,3.7
CN3607300000000,2023-01-01,36,073,NY,Orleans County,17035,16217,818,4.8
CN3607500000000,2023-01-01,36,075,NY,Oswego County,53009,50189,2820,5.3
CN3607700000000,2023-01-01,36,077,NY,Otsego County,26334,25005,1329,5
CN3607900000000,2023-01-01,36,079,NY,Putnam County,50082,48434,1648,3.3
CN3608100000000,2023-01-01,36,081,NY,Queens County,1147070,1090323,56747,4.9
CN3608300000000,2023-01-01,36,083,NY,Rensselaer County,82238,79261,2977,3.6
CN3608500000000,2023-01-01,36,085,NY,Richmond County,228453,216257,12196,5.3
CN3608700000000,2023-01-01,36,087,NY,Rockland County,157179,152192,4987,3.2
CN3608900000000,2023-01-01,36,089,NY,St. Lawrence County,42477,40243,2234,5.3
CN3609100000000,2023-01-01,36,091,NY,Saratoga County,121721,117791,3930,3.2
CN3609300000000,2023-01-01,36,093,NY,Schenectady County,77829,74911,2918,3.7
CN3609500000000,2023-01-01,36,095,NY,Schoharie County,15046,14189,857,5.7
CN3609700000000,2023-01-01,36,097,NY,Schuyler County,7831,7400,431,5.5
CN3609900000000,2023-01-01,36,099,NY,Seneca County,14502,13878,624,4.3
CN3610100000000,2023-01-01,36,101,NY,Steuben County,41238,39247,1991,4.8
CN3610300000000,2023-01-01,36,103,NY,Suffolk County,793533,764313,29220,3.7
CN3610500000000,2023-01-01,36,105,NY,Sullivan County,36935,35488,1447,3.9
CN3610700000000,2023-01-01,36,107,NY,Tioga County,22232,21310,922,4.1
CN3610900000000,2023-01-01,36,109,NY,Tompkins County,49281,47579,1702,3.5
CN3611100000000,2023-01-01,36,111,NY,Ulster County,86935,83671,3264,3.8
CN3611300000000,2023-01-01,36,113,NY,Warren County,30982,29577,1405,4.5
CN3611500000000,2023-01-01,36,115,NY,Washington County,27275,26151,1124,4.1
CN3611700000000,2023-01-01,36,117,NY,Wayne County,43049,41274,1775,4.1
CN3611900000000,2023-01-01,36,119,NY,Westchester County,489880,472916,16964,3.5
CN3612100000000,2023-01-01,36,121,NY,Wyoming County,17305,16376,929,5.4
CN3612300000000,2023-01-01,36,123,NY,Yates County,11632,11158,474,4.1
CN3700100000000,2023-01-01,37,001,NC,Alamance County,82754,79737,3017,3.6
CN3700300000000,2023-01-01,37,003,NC,Alexander County,18107,17526,581,3.2
CN3700500000000,2023-01-01,37,005,NC,Alleghany County,4557,4368,189,4.1
CN3700700000000,2023-01-01,37,007,NC,Anson County,10282,9842,440,4.3
CN3700900000000,2023-01-01,37,009,NC,Ashe County,12710,12268,442,3.5
CN3701100000000,2023-01-01,37,011,NC,Avery County,7699,7427,272,3.5
CN3701300000000,2023-01-01,37,013,NC,Beaufort County,20026,19177,849,4.2
CN3701500000000,2023-01-01,37,015,NC,Bertie County,7201,6871,330,4.6
CN3701700000000,2023-01-01,37,017,NC,Bladen County,14731,14033,698,4.7
CN3701900000000,2023-01-01,37,019,NC,Brunswick County,56302,53466,2836,5
CN3702100000000,2023-01-01,37,021,NC,Buncombe County,141239,137049,4190,3
CN3702300000000,2023-01-01,37,023,NC,Burke County,40969,39632,1337,3.3
CN3702500000000,2023-01-01,37,025,NC,Cabarrus County,116217,112175,4042,3.5
CN3702700000000,2023-01-01,37,027,NC,Caldwell County,36494,35248,1246,3.4
CN3702900000000,2023-01-01,37,029,NC,Camden County,4650,4480,170,3.7
CN3703100000000,2023-01-01,37,031,NC,Carteret County,31591,30360,1231,3.9
CN3703300000000,2023-01-01,37,033,NC,Caswell County,9655,9267,388,4
CN3703500000000,2023-01-01,37,035,NC,Catawba County,79844,77110,2734,3.4
CN3703700000000,2023-01-01,37,037,NC,Chatham County,37449,36257,1192,3.2
CN3703900000000,2023-01-01,37,039,NC,Cherokee County,11141,10657,484,4.3
CN3704100000000,2023-01-01,37,041,NC,Chowan County,5885,5648,237,4
CN3704300000000,2023-01-01,37,043,NC,Clay County,4218,4058,160,3.8
CN3704500000000,2023-01-01,37,045,NC,Cleveland County,49317,47471,1846,3.7
CN3704700000000,2023-01-01,37,047,NC,Columbus County,23900,22893,1007,4.2
CN3704900000000,2023-01-01,37,049,NC,Craven County,42103,40486,1617,3.8
CN3705100000000,2023-01-01,37,051,NC,Cumberland County,126731,120199,6532,5.2
CN3705300000000,2023-01-01,37,053,NC,Currituck County,14614,14051,563,3.9
CN3705500000000,2023-01-01,37,055,NC,Dare County,18063,16743,1320,7.3
CN3705700000000,2023-01-01,37,057,NC,Davidson County,82054,79089,2965,3.6
CN3705900000000,2023-01-01,37,059,NC,Davie County,20898,20198,700,3.3
CN3706100000000,2023-01-01,37,061,NC,Duplin County,25069,24176,893,3.6
CN3706300000000,2023-01-01,37,063,NC,Durham County,179097,173390,5707,3.2
CN3706500000000,2023-01-01,37,065,NC,Edgecombe County,20057,18784,1273,6.3
CN3706700000000,2023-01-01,37,067,NC,Forsyth County,189783,182842,6941,3.7
CN3706900000000,2023-01-01,37,069,NC,Franklin County,34054,32806,1248,3.7
CN3707100000000,2023-01-01,37,071,NC,Gaston County,114754,110485,4269,3.7
CN3707300000000,2023-01-01,37,073,NC,Gates County,5083,4907,176,3.5
CN3707500000000,2023-01-01,37,075,NC,Graham County,2819,2661,158,5.6
CN3707700000000,2023-01-01,37,077,NC,Granville County,30318,29380,938,3.1
CN3707900000000,2023-01-01,37,079,NC,Greene County,9564,9280,284,3
CN3708100000000,2023-01-01,37,081,NC,Guilford County,260547,249963,10584,4.1
CN3708300000000,2023-01-01,37,083,NC,Halifax County,19073,18025,1048,5.5
CN3708500000000,2023-01-01,37,085,NC,Harnett County,54978,52719,2259,4.1
CN3708700000000,2023-01-01,37,087,NC,Haywood County,30044,29087,957,3.2
CN3708900000000,2023-01-01,37,089,NC,Henderson County,55256,53500,1756,3.2
CN3709100000000,2023-01-01,37,091,NC,Hertford County,8503,8096,407,4.8
CN3709300000000,2023-01-01,37,093,NC,Hoke County,20110,19134,976,4.9
CN3709500000000,2023-01-01,37,095,NC,Hyde County,1703,1531,172,10.1
CN3709700000000,2023-01-01,37,097,NC,Iredell County,94720,91427,3293,3.5
CN3709900000000,2023-01-01,37,099,NC,Jackson County,18250,17498,752,4.1
CN3710100000000,2023-01-01,37,101,NC,Johnston County,108239,104624,3615,3.3
CN3710300000000,2023-01-01,37,103,NC,Jones County,4325,4169,156,3.6
CN3710500000000,2023-01-01,37,105,NC,Lee County,26293,25209,1084,4.1
CN3710700000000,2023-01-01,37,107,NC,Lenoir County,27619,26618,1001,3.6
CN3710900000000,2023-01-01,37,109,NC,Lincoln County,46393,44913,1480,3.2
CN3711100000000,2023-01-01,37,111,NC,McDowell County,20280,19570,710,3.5
CN3711300000000,2023-01-01,37,113,NC,Macon County,15883,15273,610,3.8
CN3711500000000,2023-01-01,37,115,NC,Madison County,10042,9687,355,3.5
CN3711700000000,2023-01-01,37,117,NC,Martin County,8566,8190,376,4.4
CN3711900000000,2023-01-01,37,119,NC,Mecklenburg County,652879,629356,23523,3.6
CN3712100000000,2023-01-01,37,121,NC,Mitchell County,6045,5790,255,4.2
CN3712300000000,2023-01-01,37,123,NC,Montgomery County,11120,10707,413,3.7
CN3712500000000,2023-01-01,37,125,NC,Moore County,42249,40713,1536,3.6
CN3712700000000,2023-01-01,37,127,NC,Nash County,41962,39873,2089,5
CN3712900000000,2023-01-01,37,129,NC,New Hanover County,129945,125502,4443,3.4
CN3713100000000,2023-01-01,37,131,NC,Northampton County,7206,6847,359,5
CN3713300000000,2023-01-01,37,133,NC,Onslow County,69356,66410,2946,4.2
CN3713500000000,2023-01-01,37,135,NC,Orange County,81469,79036,2433,3
CN3713700000000,2023-01-01,37,137,NC,Pamlico County,5494,5299,195,3.5
CN3713900000000,2023-01-01,37,139,NC,Pasquotank County,16683,15882,801,4.8
CN3714100000000,2023-01-01,37,141,NC,Pender County,30837,29747,1090,3.5
CN3714300000000,2023-01-01,37,143,NC,Perquimans County,4947,4721,226,4.6
CN3714500000000,2023-01-01,37,145,NC,Person County,18823,18127,696,3.7
CN3714700000000,2023-01-01,37,147,NC,Pitt County,88244,84648,3596,4.1
CN3714900000000,2023-01-01,37,149,NC,Polk County,9292,8966,326,3.5
CN3715100000000,2023-01-01,37,151,NC,Randolph County,65550,63084,2466,3.8
CN3715300000000,2023-01-01,37,153,NC,Richmond County,17066,16236,830,4.9
CN3715500000000,2023-01-01,37,155,NC,Robeson County,48172,45500,2672,5.5
CN3715700000000,2023-01-01,37,157,NC,Rockingham County,39637,37901,1736,4.4
CN3715900000000,2023-01-01,37,159,NC,Rowan County,67735,65279,2456,3.6
CN3716100000000,2023-01-01,37,161,NC,Rutherford County,24699,23522,1177,4.8
CN3716300000000,2023-01-01,37,163,NC,Sampson County,29109,28056,1053,3.6
CN3716500000000,2023-01-01,37,165,NC,Scotland County,11331,10571,760,6.7
CN3716700000000,2023-01-01,37,167,NC,Stanly County,30870,29849,1021,3.3
CN3716900000000,2023-01-01,37,169,NC,Stokes County,21729,21052,677,3.1
CN3717100000000,2023-01-01,37,171,NC,Surry County,32714,31574,1140,3.5
CN3717300000000,2023-01-01,37,173,NC,Swain County,6866,6615,251,3.7
CN3717500000000,2023-01-01,37,175,NC,Transylvania County,14529,14029,500,3.4
CN3717700000000,2023-01-01,37,177,NC,Tyrrell County,1198,1107,91,7.6
CN3717900000000,2023-01-01,37,179,NC,Union County,130299,126203,4096,3.1
CN3718100000000,2023-01-01,37,181,NC,Vance County,16812,15788,1024,6.1
CN3718300000000,2023-01-01,37,183,NC,Wake County,632006,612556,19450,3.1
CN3718500000000,2023-01-01,37,185,NC,Warren County,6304,5928,376,6
CN3718700000000,2023-01-01,37,187,NC,Washington County,4282,4037,245,5.7
CN3718900000000,2023-01-01,37,189,NC,Watauga County,29361,28443,918,3.1
CN3719100000000,2023-01-01,37,191,NC,Wayne County,50337,48319,2018,4
CN3719300000000,2023-01-01,37,193,NC,Wilkes County,26950,25964,986,3.7
CN3719500000000,2023-01-01,37,195,NC,Wilson County,34041,32347,1694,5
CN3719700000000,2023-01-01,37,197,NC,Yadkin County,17774,17164,610,3.4
CN3719900000000,2023-01-01,37,199,NC,Yancey County,8138,7837,301,3.7
CN3800100000000,2023-01-01,38,001,ND,Adams County,925,905,20,2.2
CN3800300000000,2023-01-01,38,003,ND,Barnes County,5126,4974,152,3
CN3800500000000,2023-01-01,38,005,ND,Benson County,2280,2194,86,3.8
CN3800700000000,2023-01-01,38,007,ND,Billings County,368,359,9,2.4
CN3800900000000,2023-01-01,38,009,ND,Bottineau County,2835,2727,108,3.8
CN3801100000000,2023-01-01,38,011,ND,Bowman County,1477,1453,24,1.6
CN3801300000000,2023-01-01,38,013,ND,Burke County,1010,989,21,2.1
CN3801500000000,2023-01-01,38,015,ND,Burleigh County,51478,50198,1280,2.5
CN3801700000000,2023-01-01,38,017,ND,Cass County,109626,107176,2450,2.2
CN3801900000000,2023-01-01,38,019,ND,Cavalier County,1756,1691,65,3.7
CN3802100000000,2023-01-01,38,021,ND,Dickey County,2144,2089,55,2.6
CN3802300000000,2023-01-01,38,023,ND,Divide County,1402,1384,18,1.3
CN3802500000000,2023-01-01,38,025,ND,Dunn County,3183,3135,48,1.5
CN3802700000000,2023-01-01,38,027,ND,Eddy County,1170,1118,52,4.4
CN3802900000000,2023-01-01,38,029,ND,Emmons County,1452,1336,116,8
CN3803100000000,2023-01-01,38,031,ND,Foster County,1501,1454,47,3.1
CN3803300000000,2023-01-01,38,033,ND,Golden Valley County,841,823,18,2.1
CN3803500000000,2023-01-01,38,035,ND,Grand Forks County,38084,37250,834,2.2
CN3803700000000,2023-01-01,38,037,ND,Grant County,1196,1168,28,2.3
CN3803900000000,2023-01-01,38,039,ND,Griggs County,990,960,30,3
CN3804100000000,2023-01-01,38,041,ND,Hettinger County,1340,1309,31,2.3
CN3804300000000,2023-01-01,38,043,ND,Kidder County,1291,1217,74,5.7
CN3804500000000,2023-01-01,38,045,ND,LaMoure County,2026,1966,60,3
CN3804700000000,2023-01-01,38,047,ND,Logan County,872,837,35,4
CN3804900000000,2023-01-01,38,049,ND,McHenry County,3078,2932,146,4.7
CN3805100000000,2023-01-01,38,051,ND,McIntosh County,1031,1003,28,2.7
CN3805300000000,2023-01-01,38,053,ND,McKenzie County,9495,9346,149,1.6
CN3805500000000,2023-01-01,38,055,ND,McLean County,4699,4516,183,3.9
CN3805700000000,2023-01-01,38,057,ND,Mercer County,3394,3248,146,4.3
CN3805900000000,2023-01-01,38,059,ND,Morton County,17015,16431,584,3.4
CN3806100000000,2023-01-01,38,061,ND,Mountrail County,6333,6235,98,1.5
CN3806300000000,2023-01-01,38,063,ND,Nelson County,1391,1344,47,3.4
CN3806500000000,2023-01-01,38,065,ND,Oliver County,861,830,31,3.6
CN3806700000000,2023-01-01,38,067,ND,Pembina County,3156,3010,146,4.6
CN3806900000000,2023-01-01,38,069,ND,Pierce County,1607,1545,62,3.9
CN3807100000000,2023-01-01,38,071,ND,Ramsey County,5466,5309,157,2.9
CN3807300000000,2023-01-01,38,073,ND,Ransom County,2610,2553,57,2.2
CN3807500000000,2023-01-01,38,075,ND,Renville County,1202,1175,27,2.2
CN3807700000000,2023-01-01,38,077,ND,Richland County,8643,8442,201,2.3
CN3807900000000,2023-01-01,38,079,ND,Rolette County,4617,4336,281,6.1
CN3808100000000,2023-01-01,38,081,ND,Sargent County,2261,2220,41,1.8
CN3808300000000,2023-01-01,38,083,ND,Sheridan County,634,606,28,4.4
CN3808500000000,2023-01-01,38,085,ND,Sioux County,1182,1159,23,1.9
CN3808700000000,2023-01-01,38,087,ND,Slope County,321,311,10,3.1
CN3808900000000,2023-01-01,38,089,ND,Stark County,18067,17703,364,2
CN3809100000000,2023-01-01,38,091,ND,Steele County,919,895,24,2.6
CN3809300000000,2023-01-01,38,093,ND,Stutsman County,10640,10375,265,2.5
CN3809500000000,2023-01-01,38,095,ND,Towner County,1053,1019,34,3.2
CN3809700000000,2023-01-01,38,097,ND,Traill County,4472,4374,98,2.2
CN3809900000000,2023-01-01,38,099,ND,Walsh County,5124,4901,223,4.4
CN3810100000000,2023-01-01,38,101,ND,Ward County,31790,30870,920,2.9
CN3810300000000,2023-01-01,38,103,ND,Wells County,1894,1789,105,5.5
CN3810500000000,2023-01-01,38,105,ND,Williams County,22191,21729,462,2.1
CN3900100000000,2023-01-01,39,001,OH,Adams County,10996,10167,829,7.5
CN3900300000000,2023-01-01,39,003,OH,Allen County,46256,44304,1952,4.2
CN3900500000000,2023-01-01,39,005,OH,Ashland County,25187,24045,1142,4.5
CN3900700000000,2023-01-01,39,007,OH,Ashtabula County,42243,40127,2116,5
CN3900900000000,2023-01-01,39,009,OH,Athens County,25364,24025,1339,5.3
CN3901100000000,2023-01-01,39,011,OH,Auglaize County,23550,22885,665,2.8
CN3901300000000,2023-01-01,39,013,OH,Belmont County,26781,25192,1589,5.9
CN3901500000000,2023-01-01,39,015,OH,Brown County,19696,18625,1071,5.4
CN3901700000000,2023-01-01,39,017,OH,Butler County,197237,190463,6774,3.4
CN3901900000000,2023-01-01,39,019,OH,Carroll County,12569,11935,634,5
CN3902100000000,2023-01-01,39,021,OH,Champaign County,18760,18000,760,4.1
CN3902300000000,2023-01-01,39,023,OH,Clark County,62596,59909,2687,4.3
CN3902500000000,2023-01-01,39,025,OH,Clermont County,108368,104461,3907,3.6
CN3902700000000,2023-01-01,39,027,OH,Clinton County,17749,16866,883,5
CN3902900000000,2023-01-01,39,029,OH,Columbiana County,44188,41782,2406,5.4
CN3903100000000,2023-01-01,39,031,OH,Coshocton County,13327,12581,746,5.6
CN3903300000000,2023-01-01,39,033,OH,Crawford County,17436,16540,896,5.1
CN3903500000000,2023-01-01,39,035,OH,Cuyahoga County,595664,570344,25320,4.3
CN3903700000000,2023-01-01,39,037,OH,Darke County,25093,24079,1014,4
CN3903900000000,2023-01-01,39,039,OH,Defiance County,16982,16323,659,3.9
CN3904100000000,2023-01-01,39,041,OH,Delaware County,115143,111713,3430,3
CN3904300000000,2023-01-01,39,043,OH,Erie County,34411,32339,2072,6
CN3904500000000,2023-01-01,39,045,OH,Fairfield County,80133,77113,3020,3.8
CN3904700000000,2023-01-01,39,047,OH,Fayette County,13534,12930,604,4.5
CN3904900000000,2023-01-01,39,049,OH,Franklin County,706109,682257,23852,3.4
CN3905100000000,2023-01-01,39,051,OH,Fulton County,21569,20569,1000,4.6
CN3905300000000,2023-01-01,39,053,OH,Gallia County,12138,11480,658,5.4
CN3905500000000,2023-01-01,39,055,OH,Geauga County,48179,46371,1808,3.8
CN3905700000000,2023-01-01,39,057,OH,Greene County,82746,79878,2868,3.5
CN3905900000000,2023-01-01,39,059,OH,Guernsey County,17404,16341,1063,6.1
CN3906100000000,2023-01-01,39,061,OH,Hamilton County,417833,403561,14272,3.4
CN3906300000000,2023-01-01,39,063,OH,Hancock County,39235,37986,1249,3.2
CN3906500000000,2023-01-01,39,065,OH,Hardin County,12341,11805,536,4.3
CN3906700000000,2023-01-01,39,067,OH,Harrison County,6358,5986,372,5.9
CN3906900000000,2023-01-01,39,069,OH,Henry County,12432,11702,730,5.9
CN3907100000000,2023-01-01,39,071,OH,Highland County,17482,16366,1116,6.4
CN3907300000000,2023-01-01,39,073,OH,Hocking County,13041,12391,650,5
CN3907500000000,2023-01-01,39,075,OH,Holmes County,21492,20477,1015,4.7
CN3907700000000,2023-01-01,39,077,OH,Huron County,27018,25088,1930,7.1
CN3907900000000,2023-01-01,39,079,OH,Jackson County,12199,11475,724,5.9
CN3908100000000,2023-01-01,39,081,OH,Jefferson County,26784,25185,1599,6
CN3908300000000,2023-01-01,39,083,OH,Knox County,30039,28874,1165,3.9
CN3908500000000,2023-01-01,39,085,OH,Lake County,124303,119192,5111,4.1
CN3908700000000,2023-01-01,39,087,OH,Lawrence County,23210,22101,1109,4.8
CN3908900000000,2023-01-01,39,089,OH,Licking County,91705,88452,3253,3.5
CN3909100000000,2023-01-01,39,091,OH,Logan County,22337,21523,814,3.6
CN3909300000000,2023-01-01,39,093,OH,Lorain County,152812,145934,6878,4.5
CN3909500000000,2023-01-01,39,095,OH,Lucas County,202329,193021,9308,4.6
CN3909700000000,2023-01-01,39,097,OH,Madison County,20848,20123,725,3.5
CN3909900000000,2023-01-01,39,099,OH,Mahoning County,97861,92883,4978,5.1
CN3910100000000,2023-01-01,39,101,OH,Marion County,26574,25547,1027,3.9
CN3910300000000,2023-01-01,39,103,OH,Medina County,97092,93593,3499,3.6
CN3910500000000,2023-01-01,39,105,OH,Meigs County,8470,7811,659,7.8
CN3910700000000,2023-01-01,39,107,OH,Mercer County,22168,21592,576,2.6
CN3910900000000,2023-01-01,39,109,OH,Miami County,53916,51910,2006,3.7
CN3911100000000,2023-01-01,39,111,OH,Monroe County,5134,4700,434,8.5
CN3911300000000,2023-01-01,39,113,OH,Montgomery County,248204,238030,10174,4.1
CN3911500000000,2023-01-01,39,115,OH,Morgan County,6819,6311,508,7.4
CN3911700000000,2023-01-01,39,117,OH,Morrow County,17028,16281,747,4.4
CN3911900000000,2023-01-01,39,119,OH,Muskingum County,40128,38078,2050,5.1
CN3912100000000,2023-01-01,39,121,OH,Noble County,4556,4234,322,7.1
CN3912300000000,2023-01-01,39,123,OH,Ottawa County,19505,18057,1448,7.4
CN3912500000000,2023-01-01,39,125,OH,Paulding County,8435,8162,273,3.2
CN3912700000000,2023-01-01,39,127,OH,Perry County,16042,15173,869,5.4
CN3912900000000,2023-01-01,39,129,OH,Pickaway County,26735,25663,1072,4
CN3913100000000,2023-01-01,39,131,OH,Pike County,10865,10223,642,5.9
CN3913300000000,2023-01-01,39,133,OH,Portage County,84069,80540,3529,4.2
CN3913500000000,2023-01-01,39,135,OH,Preble County,21738,20939,799,3.7
CN3913700000000,2023-01-01,39,137,OH,Putnam County,18413,17800,613,3.3
CN3913900000000,2023-01-01,39,139,OH,Richland County,50608,48047,2561,5.1
CN3914100000000,2023-01-01,39,141,OH,Ross County,34746,33287,1459,4.2
CN3914300000000,2023-01-01,39,143,OH,Sandusky County,29150,27781,1369,4.7
CN3914500000000,2023-01-01,39,145,OH,Scioto County,29140,27377,1763,6.1
CN3914700000000,2023-01-01,39,147,OH,Seneca County,25603,24504,1099,4.3
CN3914900000000,2023-01-01,39,149,OH,Shelby County,23080,22287,793,3.4
CN3915100000000,2023-01-01,39,151,OH,Stark County,180297,172392,7905,4.4
CN3915300000000,2023-01-01,39,153,OH,Summit County,261568,250186,11382,4.4
CN3915500000000,2023-01-01,39,155,OH,Trumbull County,82729,78374,4355,5.3
CN3915700000000,2023-01-01,39,157,OH,Tuscarawas County,44151,41950,2201,5
CN3915900000000,2023-01-01,39,159,OH,Union County,29997,29081,916,3.1
CN3916100000000,2023-01-01,39,161,OH,Van Wert County,14023,13558,465,3.3
CN3916300000000,2023-01-01,39,163,OH,Vinton County,5357,5013,344,6.4
CN3916500000000,2023-01-01,39,165,OH,Warren County,122793,118796,3997,3.3
CN3916700000000,2023-01-01,39,167,OH,Washington County,26193,24747,1446,5.5
CN3916900000000,2023-01-01,39,169,OH,Wayne County,58995,56975,2020,3.4
CN3917100000000,2023-01-01,39,171,OH,Williams County,17890,17270,620,3.5
CN3917300000000,2023-01-01,39,173,OH,Wood County,68943,66444,2499,3.6
CN3917500000000,2023-01-01,39,175,OH,Wyandot County,12921,12530,391,3
CN4000100000000,2023-01-01,40,001,OK,Adair County,8496,8186,310,3.6
CN4000300000000,2023-01-01,40,003,OK,Alfalfa County,2604,2530,74,2.8
CN4000500000000,2023-01-01,40,005,OK,Atoka County,5153,4950,203,3.9
CN4000700000000,2023-01-01,40,007,OK,Beaver County,2511,2448,63,2.5
CN4000900000000,2023-01-01,40,009,OK,Beckham County,10496,10202,294,2.8
CN4001100000000,2023-01-01,40,011,OK,Blaine County,4323,4226,97,2.2
CN4001300000000,2023-01-01,40,013,OK,Bryan County,23428,22713,715,3.1
CN4001500000000,2023-01-01,40,015,OK,Caddo County,11599,11185,414,3.6
CN4001700000000,2023-01-01,40,017,OK,Canadian County,81289,79081,2208,2.7
CN4001900000000,2023-01-01,40,019,OK,Carter County,21269,20497,772,3.6
CN4002100000000,2023-01-01,40,021,OK,Cherokee County,19846,19105,741,3.7
CN4002300000000,2023-01-01,40,023,OK,Choctaw County,6068,5781,287,4.7
CN4002500000000,2023-01-01,40,025,OK,Cimarron County,1569,1543,26,1.7
CN4002700000000,2023-01-01,40,027,OK,Cleveland County,150322,146150,4172,2.8
CN4002900000000,2023-01-01,40,029,OK,Coal County,2403,2309,94,3.9
CN4003100000000,2023-01-01,40,031,OK,Comanche County,47522,45745,1777,3.7
CN4003300000000,2023-01-01,40,033,OK,Cotton County,2649,2563,86,3.2
CN4003500000000,2023-01-01,40,035,OK,Craig County,5825,5625,200,3.4
CN4003700000000,2023-01-01,40,037,OK,Creek County,31503,30390,1113,3.5
CN4003900000000,2023-01-01,40,039,OK,Custer County,15060,14653,407,2.7
CN4004100000000,2023-01-01,40,041,OK,Delaware County,19878,19225,653,3.3
CN4004300000000,2023-01-01,40,043,OK,Dewey County,2987,2923,64,2.1
CN4004500000000,2023-01-01,40,045,OK,Ellis County,2034,1984,50,2.5
CN4004700000000,2023-01-01,40,047,OK,Garfield County,26194,25360,834,3.2
CN4004900000000,2023-01-01,40,049,OK,Garvin County,12773,12361,412,3.2
CN4005100000000,2023-01-01,40,051,OK,Grady County,27550,26723,827,3
CN4005300000000,2023-01-01,40,053,OK,Grant County,2582,2524,58,2.2
CN4005500000000,2023-01-01,40,055,OK,Greer County,1759,1694,65,3.7
CN4005700000000,2023-01-01,40,057,OK,Harmon County,1134,1099,35,3.1
CN4005900000000,2023-01-01,40,059,OK,Harper County,1724,1681,43,2.5
CN4006100000000,2023-01-01,40,061,OK,Haskell County,4196,4001,195,4.6
CN4006300000000,2023-01-01,40,063,OK,Hughes County,5083,4890,193,3.8
CN4006500000000,2023-01-01,40,065,OK,Jackson County,10692,10367,325,3
CN4006700000000,2023-01-01,40,067,OK,Jefferson County,2439,2357,82,3.4
CN4006900000000,2023-01-01,40,069,OK,Johnston County,3723,3564,159,4.3
CN4007100000000,2023-01-01,40,071,OK,Kay County,18400,17715,685,3.7
CN4007300000000,2023-01-01,40,073,OK,Kingfisher County,8865,8670,195,2.2
CN4007500000000,2023-01-01,40,075,OK,Kiowa County,3587,3463,124,3.5
CN4007700000000,2023-01-01,40,077,OK,Latimer County,3092,2911,181,5.9
CN4007900000000,2023-01-01,40,079,OK,Le Flore County,19623,18860,763,3.9
CN4008100000000,2023-01-01,40,081,OK,Lincoln County,16343,15809,534,3.3
CN4008300000000,2023-01-01,40,083,OK,Logan County,23597,22881,716,3
CN4008500000000,2023-01-01,40,085,OK,Love County,5800,5639,161,2.8
CN4008700000000,2023-01-01,40,087,OK,McClain County,21055,20441,614,2.9
CN4008900000000,2023-01-01,40,089,OK,McCurtain County,15756,15152,604,3.8
CN4009100000000,2023-01-01,40,091,OK,McIntosh County,7259,6871,388,5.3
CN4009300000000,2023-01-01,40,093,OK,Major County,3766,3656,110,2.9
CN4009500000000,2023-01-01,40,095,OK,Marshall County,7234,6979,255,3.5
CN4009700000000,2023-01-01,40,097,OK,Mayes County,19733,19061,672,3.4
CN4009900000000,2023-01-01,40,099,OK,Murray County,6034,5823,211,3.5
CN4010100000000,2023-01-01,40,101,OK,Muskogee County,28830,27761,1069,3.7
CN4010300000000,2023-01-01,40,103,OK,Noble County,5833,5682,151,2.6
CN4010500000000,2023-01-01,40,105,OK,Nowata County,4720,4576,144,3.1
CN4010700000000,2023-01-01,40,107,OK,Okfuskee County,4436,4248,188,4.2
CN4010900000000,2023-01-01,40,109,OK,Oklahoma County,403202,390680,12522,3.1
CN4011100000000,2023-01-01,40,111,OK,Okmulgee County,15588,14909,679,4.4
CN4011300000000,2023-01-01,40,113,OK,Osage County,20516,19759,757,3.7
CN4011500000000,2023-01-01,40,115,OK,Ottawa County,15360,14891,469,3.1
CN4011700000000,2023-01-01,40,117,OK,Pawnee County,7358,7083,275,3.7
CN4011900000000,2023-01-01,40,119,OK,Payne County,39229,37973,1256,3.2
CN4012100000000,2023-01-01,40,121,OK,Pittsburg County,16387,15681,706,4.3
CN4012300000000,2023-01-01,40,123,OK,Pontotoc County,19650,19087,563,2.9
CN4012500000000,2023-01-01,40,125,OK,Pottawatomie County,33342,32157,1185,3.6
CN4012700000000,2023-01-01,40,127,OK,Pushmataha County,4552,4355,197,4.3
CN4012900000000,2023-01-01,40,129,OK,Roger Mills County,1757,1715,42,2.4
CN4013100000000,2023-01-01,40,131,OK,Rogers County,45607,44219,1388,3
CN4013300000000,2023-01-01,40,133,OK,Seminole County,9258,8853,405,4.4
CN4013500000000,2023-01-01,40,135,OK,Sequoyah County,16889,16271,618,3.7
CN4013700000000,2023-01-01,40,137,OK,Stephens County,19638,18973,665,3.4
CN4013900000000,2023-01-01,40,139,OK,Texas County,11534,11275,259,2.2
CN4014100000000,2023-01-01,40,141,OK,Tillman County,2908,2768,140,4.8
CN4014300000000,2023-01-01,40,143,OK,Tulsa County,327649,317361,10288,3.1
CN4014500000000,2023-01-01,40,145,OK,Wagoner County,39297,38044,1253,3.2
CN4014700000000,2023-01-01,40,147,OK,Washington County,22329,21542,787,3.5
CN4014900000000,2023-01-01,40,149,OK,Washita County,5313,5160,153,2.9
CN4015100000000,2023-01-01,40,151,OK,Woods County,4523,4425,98,2.2
CN4015300000000,2023-01-01,40,153,OK,Woodward County,8585,8322,263,3.1
CN4100100000000,2023-01-01,41,001,OR,Baker County,7218,6741,477,6.6
CN4100300000000,2023-01-01,41,003,OR,Benton County,49175,47385,1790,3.6
CN4100500000000,2023-01-01,41,005,OR,Clackamas County,226793,217034,9759,4.3
CN4100700000000,2023-01-01,41,007,OR,Clatsop County,18988,17940,1048,5.5
CN4100900000000,2023-01-01,41,009,OR,Columbia County,25249,23826,1423,5.6
CN4101100000000,2023-01-01,41,011,OR,Coos County,26470,24822,1648,6.2
CN4101300000000,2023-01-01,41,013,OR,Crook County,11183,10336,847,7.6
CN4101500000000,2023-01-01,41,015,OR,Curry County,8934,8269,665,7.4
CN4101700000000,2023-01-01,41,017,OR,Deschutes County,103345,97875,5470,5.3
CN4101900000000,2023-01-01,41,019,OR,Douglas County,47207,44120,3087,6.5
CN4102100000000,2023-01-01,41,021,OR,Gilliam County,1008,965,43,4.3
CN4102300000000,2023-01-01,41,023,OR,Grant County,3130,2834,296,9.5
CN4102500000000,2023-01-01,41,025,OR,Harney County,3667,3396,271,7.4
CN4102700000000,2023-01-01,41,027,OR,Hood River County,13673,13089,584,4.3
CN4102900000000,2023-01-01,41,029,OR,Jackson County,106568,100184,6384,6
CN4103100000000,2023-01-01,41,031,OR,Jefferson County,10218,9485,733,7.2
CN4103300000000,2023-01-01,41,033,OR,Josephine County,36975,34250,2725,7.4
CN4103500000000,2023-01-01,41,035,OR,Klamath County,29941,27413,2528,8.4
CN4103700000000,2023-01-01,41,037,OR,Lake County,3613,3323,290,8
CN4103900000000,2023-01-01,41,039,OR,Lane County,181418,171741,9677,5.3
CN4104100000000,2023-01-01,41,041,OR,Lincoln County,20632,19272,1360,6.6
CN4104300000000,2023-01-01,41,043,OR,Linn County,61192,57911,3281,5.4
CN4104500000000,2023-01-01,41,045,OR,Malheur County,12240,11534,706,5.8
CN4104700000000,2023-01-01,41,047,OR,Marion County,168140,159825,8315,4.9
CN4104900000000,2023-01-01,41,049,OR,Morrow County,5766,5447,319,5.5
CN4105100000000,2023-01-01,41,051,OR,Multnomah County,469565,448359,21206,4.5
CN4105300000000,2023-01-01,41,053,OR,Polk County,42341,40252,2089,4.9
CN4105500000000,2023-01-01,41,055,OR,Sherman County,944,899,45,4.8
CN4105700000000,2023-01-01,41,057,OR,Tillamook County,11886,11241,645,5.4
CN4105900000000,2023-01-01,41,059,OR,Umatilla County,37892,34966,2926,7.7
CN4106100000000,2023-01-01,41,061,OR,Union County,11932,11210,722,6.1
CN4106300000000,2023-01-01,41,063,OR,Wallowa County,3454,3167,287,8.3
CN4106500000000,2023-01-01,41,065,OR,Wasco County,12747,11935,812,6.4
CN4106700000000,2023-01-01,41,067,OR,Washington County,334172,321059,13113,3.9
CN4106900000000,2023-01-01,41,069,OR,Wheeler County,727,700,27,3.7
CN4107100000000,2023-01-01,41,071,OR,Yamhill County,56286,53828,2458,4.4
CN4200100000000,2023-01-01,42,001,PA,Adams County,54819,52986,1833,3.3
CN4200300000000,2023-01-01,42,003,PA,Allegheny County,627976,600327,27649,4.4
CN4200500000000,2023-01-01,42,005,PA,Armstrong County,31189,29275,1914,6.1
CN4200700000000,2023-01-01,42,007,PA,Beaver County,81831,76915,4916,6
CN4200900000000,2023-01-01,42,009,PA,Bedford County,24468,23065,1403,5.7
CN4201100000000,2023-01-01,42,011,PA,Berks County,214255,204904,9351,4.4
CN4201300000000,2023-01-01,42,013,PA,Blair County,58920,56221,2699,4.6
CN4201500000000,2023-01-01,42,015,PA,Bradford County,28030,26755,1275,4.5
CN4201700000000,2023-01-01,42,017,PA,Bucks County,352359,338763,13596,3.9
CN4201900000000,2023-01-01,42,019,PA,Butler County,98301,93833,4468,4.5
CN4202100000000,2023-01-01,42,021,PA,Cambria County,55585,52436,3149,5.7
CN4202300000000,2023-01-01,42,023,PA,Cameron County,1903,1767,136,7.1
CN4202500000000,2023-01-01,42,025,PA,Carbon County,32656,30883,1773,5.4
CN4202700000000,2023-01-01,42,027,PA,Centre County,77996,75035,2961,3.8
CN4202900000000,2023-01-01,42,029,PA,Chester County,296206,286784,9422,3.2
CN4203100000000,2023-01-01,42,031,PA,Clarion County,15604,14675,929,6
CN4203300000000,2023-01-01,42,033,PA,Clearfield County,35047,32869,2178,6.2
CN4203500000000,2023-01-01,42,035,PA,Clinton County,16914,15816,1098,6.5
CN4203700000000,2023-01-01,42,037,PA,Columbia County,33902,32088,1814,5.4
CN4203900000000,2023-01-01,42,039,PA,Crawford County,37490,35457,2033,5.4
CN4204100000000,2023-01-01,42,041,PA,Cumberland County,135801,131274,4527,3.3
CN4204300000000,2023-01-01,42,043,PA,Dauphin County,147130,141287,5843,4
CN4204500000000,2023-01-01,42,045,PA,Delaware County,301938,289933,12005,4
CN4204700000000,2023-01-01,42,047,PA,Elk County,14252,13608,644,4.5
CN4204900000000,2023-01-01,42,049,PA,Erie County,126439,119574,6865,5.4
CN4205100000000,2023-01-01,42,051,PA,Fayette County,55124,51328,3796,6.9
CN4205300000000,2023-01-01,42,053,PA,Forest County,1660,1521,139,8.4
CN4205500000000,2023-01-01,42,055,PA,Franklin County,77988,75064,2924,3.7
CN4205700000000,2023-01-01,42,057,PA,Fulton County,7194,6867,327,4.5
CN4205900000000,2023-01-01,42,059,PA,Greene County,15243,14434,809,5.3
CN4206100000000,2023-01-01,42,061,PA,Huntingdon County,19088,17683,1405,7.4
CN4206300000000,2023-01-01,42,063,PA,Indiana County,35276,33201,2075,5.9
CN4206500000000,2023-01-01,42,065,PA,Jefferson County,19368,18258,1110,5.7
CN4206700000000,2023-01-01,42,067,PA,Juniata County,12404,11710,694,5.6
CN4206900000000,2023-01-01,42,069,PA,Lackawanna County,105906,100542,5364,5.1
CN4207100000000,2023-01-01,42,071,PA,Lancaster County,289773,279914,9859,3.4
CN4207300000000,2023-01-01,42,073,PA,Lawrence County,38994,36379,2615,6.7
CN4207500000000,2023-01-01,42,075,PA,Lebanon County,73908,71263,2645,3.6
CN4207700000000,2023-01-01,42,077,PA,Lehigh County,197371,188484,8887,4.5
CN4207900000000,2023-01-01,42,079,PA,Luzerne County,159600,150397,9203,5.8
CN4208100000000,2023-01-01,42,081,PA,Lycoming County,55731,52891,2840,5.1
CN4208300000000,2023-01-01,42,083,PA,McKean County,16786,15740,1046,6.2
CN4208500000000,2023-01-01,42,085,PA,Mercer County,47652,45035,2617,5.5
CN4208700000000,2023-01-01,42,087,PA,Mifflin County,20969,19862,1107,5.3
CN4208900000000,2023-01-01,42,089,PA,Monroe County,82479,77553,4926,6
CN4209100000000,2023-01-01,42,091,PA,Montgomery County,468768,452429,16339,3.5
CN4209300000000,2023-01-01,42,093,PA,Montour County,9179,8826,353,3.8
CN4209500000000,2023-01-01,42,095,PA,Northampton County,164634,157268,7366,4.5
CN4209700000000,2023-01-01,42,097,PA,Northumberland County,41350,39052,2298,5.6
CN4209900000000,2023-01-01,42,099,PA,Perry County,24903,23925,978,3.9
CN4210100000000,2023-01-01,42,101,PA,Philadelphia County/city,735758,697630,38128,5.2
CN4210300000000,2023-01-01,42,103,PA,Pike County,25826,24184,1642,6.4
CN4210500000000,2023-01-01,42,105,PA,Potter County,6834,6296,538,7.9
CN4210700000000,2023-01-01,42,107,PA,Schuylkill County,65907,62412,3495,5.3
CN4210900000000,2023-01-01,42,109,PA,Snyder County,19380,18299,1081,5.6
CN4211100000000,2023-01-01,42,111,PA,Somerset County,32653,30622,2031,6.2
CN4211300000000,2023-01-01,42,113,PA,Sullivan County,2520,2376,144,5.7
CN4211500000000,2023-01-01,42,115,PA,Susquehanna County,20217,19221,996,4.9
CN4211700000000,2023-01-01,42,117,PA,Tioga County,18754,17691,1063,5.7
CN4211900000000,2023-01-01,42,119,PA,Union County,19100,18314,786,4.1
CN4212100000000,2023-01-01,42,121,PA,Venango County,20957,19726,1231,5.9
CN4212300000000,2023-01-01,42,123,PA,Warren County,17375,16388,987,5.7
CN4212500000000,2023-01-01,42,125,PA,Washington County,104239,99103,5136,4.9
CN4212700000000,2023-01-01,42,127,PA,Wayne County,22293,20910,1383,6.2
CN4212900000000,2023-01-01,42,129,PA,Westmoreland County,174981,166277,8704,5
CN4213100000000,2023-01-01,42,131,PA,Wyoming County,13666,12895,771,5.6
CN4213300000000,2023-01-01,42,133,PA,York County,238926,229993,8933,3.7
CN4400100000000,2023-01-01,44,001,RI,Bristol County,26522,25693,829,3.1
CN4400300000000,2023-01-01,44,003,RI,Kent County,93422,90425,2997,3.2
CN4400500000000,2023-01-01,44,005,RI,Newport County,45197,43597,1600,3.5
CN4400700000000,2023-01-01,44,007,RI,Providence County,333699,320995,12704,3.8
CN4400900000000,2023-01-01,44,009,RI,Washington County,70144,67905,2239,3.2
CN4500100000000,2023-01-01,45,001,SC,Abbeville County,9477,9074,403,4.3
CN4500300000000,2023-01-01,45,003,SC,Aiken County,72152,69657,2495,3.5
CN4500500000000,2023-01-01,45,005,SC,Allendale County,2207,2059,148,6.7
CN4500700000000,2023-01-01,45,007,SC,Anderson County,91628,88742,2886,3.1
CN4500900000000,2023-01-01,45,009,SC,Bamberg County,4523,4258,265,5.9
CN4501100000000,2023-01-01,45,011,SC,Barnwell County,7390,7024,366,5
CN4501300000000,2023-01-01,45,013,SC,Beaufort County,76146,73668,2478,3.3
CN4501500000000,2023-01-01,45,015,SC,Berkeley County,110833,107337,3496,3.2
CN4501700000000,2023-01-01,45,017,SC,Calhoun County,6357,6110,247,3.9
CN4501900000000,2023-01-01,45,019,SC,Charleston County,217231,211077,6154,2.8
CN4502100000000,2023-01-01,45,021,SC,Cherokee County,24119,23043,1076,4.5
CN4502300000000,2023-01-01,45,023,SC,Chester County,13360,12733,627,4.7
CN4502500000000,2023-01-01,45,025,SC,Chesterfield County,20855,20094,761,3.6
CN4502700000000,2023-01-01,45,027,SC,Clarendon County,11707,11130,577,4.9
CN4502900000000,2023-01-01,45,029,SC,Colleton County,15661,15049,612,3.9
CN4503100000000,2023-01-01,45,031,SC,Darlington County,29716,28588,1128,3.8
CN4503300000000,2023-01-01,45,033,SC,Dillon County,12823,12135,688,5.4
CN4503500000000,2023-01-01,45,035,SC,Dorchester County,80232,77908,2324,2.9
CN4503700000000,2023-01-01,45,037,SC,Edgefield County,10035,9678,357,3.6
CN4503900000000,2023-01-01,45,039,SC,Fairfield County,9163,8707,456,5
CN4504100000000,2023-01-01,45,041,SC,Florence County,66220,63915,2305,3.5
CN4504300000000,2023-01-01,45,043,SC,Georgetown County,25502,24457,1045,4.1
CN4504500000000,2023-01-01,45,045,SC,Greenville County,260683,252916,7767,3
CN4504700000000,2023-01-01,45,047,SC,Greenwood County,29706,28484,1222,4.1
CN4504900000000,2023-01-01,45,049,SC,Hampton County,7755,7488,267,3.4
CN4505100000000,2023-01-01,45,051,SC,Horry County,149570,142164,7406,5
CN4505300000000,2023-01-01,45,053,SC,Jasper County,13073,12680,393,3
CN4505500000000,2023-01-01,45,055,SC,Kershaw County,29203,28156,1047,3.6
CN4505700000000,2023-01-01,45,057,SC,Lancaster County,43581,41926,1655,3.8
CN4505900000000,2023-01-01,45,059,SC,Laurens County,30062,29017,1045,3.5
CN4506100000000,2023-01-01,45,061,SC,Lee County,6323,5984,339,5.4
CN4506300000000,2023-01-01,45,063,SC,Lexington County,150566,146207,4359,2.9
CN4506500000000,2023-01-01,45,065,SC,McCormick County,3531,3401,130,3.7
CN4506700000000,2023-01-01,45,067,SC,Marion County,12484,11788,696,5.6
CN4506900000000,2023-01-01,45,069,SC,Marlboro County,8217,7442,775,9.4
CN4507100000000,2023-01-01,45,071,SC,Newberry County,18905,18309,596,3.2
CN4507300000000,2023-01-01,45,073,SC,Oconee County,33856,32725,1131,3.3
CN4507500000000,2023-01-01,45,075,SC,Orangeburg County,32536,30831,1705,5.2
CN4507700000000,2023-01-01,45,077,SC,Pickens County,58143,56227,1916,3.3
CN4507900000000,2023-01-01,45,079,SC,Richland County,197051,190124,6927,3.5
CN4508100000000,2023-01-01,45,081,SC,Saluda County,8155,7896,259,3.2
CN4508300000000,2023-01-01,45,083,SC,Spartanburg County,154866,149782,5084,3.3
CN4508500000000,2023-01-01,45,085,SC,Sumter County,42112,40171,1941,4.6
CN4508700000000,2023-01-01,45,087,SC,Union County,11283,10698,585,5.2
CN4508900000000,2023-01-01,45,089,SC,Williamsburg County,10606,9996,610,5.8
CN4509100000000,2023-01-01,45,091,SC,York County,148431,143487,4944,3.3
CN4600300000000,2023-01-01,46,003,SD,Aurora County,1481,1456,25,1.7
CN4600500000000,2023-01-01,46,005,SD,Beadle County,9195,9024,171,1.9
CN4600700000000,2023-01-01,46,007,SD,Bennett County,1064,1032,32,3
CN4600900000000,2023-01-01,46,009,SD,Bon Homme County,2789,2727,62,2.2
CN4601100000000,2023-01-01,46,011,SD,Brookings County,18837,18458,379,2
CN4601300000000,2023-01-01,46,013,SD,Brown County,19646,19223,423,2.2
CN4601500000000,2023-01-01,46,015,SD,Brule County,2590,2546,44,1.7
CN4601700000000,2023-01-01,46,017,SD,Buffalo County,716,683,33,4.6
CN4601900000000,2023-01-01,46,019,SD,Butte County,4961,4870,91,1.8
CN4602100000000,2023-01-01,46,021,SD,Campbell County,755,736,19,2.5
CN4602300000000,2023-01-01,46,023,SD,Charles Mix County,3704,3621,83,2.2
CN4602500000000,2023-01-01,46,025,SD,Clark County,1931,1869,62,3.2
CN4602700000000,2023-01-01,46,027,SD,Clay County,7455,7314,141,1.9
CN4602900000000,2023-01-01,46,029,SD,Codington County,15829,15511,318,2
CN4603100000000,2023-01-01,46,031,SD,Corson County,1268,1240,28,2.2
CN4603300000000,2023-01-01,46,033,SD,Custer County,4190,4070,120,2.9
CN4603500000000,2023-01-01,46,035,SD,Davison County,10936,10731,205,1.9
CN4603700000000,2023-01-01,46,037,SD,Day County,2598,2499,99,3.8
CN4603900000000,2023-01-01,46,039,SD,Deuel County,2227,2125,102,4.6
CN4604100000000,2023-01-01,46,041,SD,Dewey County,2243,2156,87,3.9
CN4604300000000,2023-01-01,46,043,SD,Douglas County,1483,1450,33,2.2
CN4604500000000,2023-01-01,46,045,SD,Edmunds County,1969,1930,39,2
CN4604700000000,2023-01-01,46,047,SD,Fall River County,2951,2875,76,2.6
CN4604900000000,2023-01-01,46,049,SD,Faulk County,1061,1043,18,1.7
CN4605100000000,2023-01-01,46,051,SD,Grant County,4339,4185,154,3.5
CN4605300000000,2023-01-01,46,053,SD,Gregory County,2079,2038,41,2
CN4605500000000,2023-01-01,46,055,SD,Haakon County,1087,1065,22,2
CN4605700000000,2023-01-01,46,057,SD,Hamlin County,3546,3463,83,2.3
CN4605900000000,2023-01-01,46,059,SD,Hand County,1753,1723,30,1.7
CN4606100000000,2023-01-01,46,061,SD,Hanson County,1780,1725,55,3.1
CN4606300000000,2023-01-01,46,063,SD,Harding County,750,740,10,1.3
CN4606500000000,2023-01-01,46,065,SD,Hughes County,9699,9534,165,1.7
CN4606700000000,2023-01-01,46,067,SD,Hutchinson County,3624,3530,94,2.6
CN4606900000000,2023-01-01,46,069,SD,Hyde County,642,631,11,1.7
CN4607100000000,2023-01-01,46,071,SD,Jackson County,1131,1077,54,4.8
CN4607300000000,2023-01-01,46,073,SD,Jerauld County,1249,1232,17,1.4
CN4607500000000,2023-01-01,46,075,SD,Jones County,473,461,12,2.5
CN4607700000000,2023-01-01,46,077,SD,Kingsbury County,2680,2625,55,2.1
CN4607900000000,2023-01-01,46,079,SD,Lake County,6651,6531,120,1.8
CN4608100000000,2023-01-01,46,081,SD,Lawrence County,13790,13549,241,1.7
CN4608300000000,2023-01-01,46,083,SD,Lincoln County,37304,36714,590,1.6
CN4608500000000,2023-01-01,46,085,SD,Lyman County,1619,1565,54,3.3
CN4608700000000,2023-01-01,46,087,SD,McCook County,3107,3053,54,1.7
CN4608900000000,2023-01-01,46,089,SD,McPherson County,962,939,23,2.4
CN4609100000000,2023-01-01,46,091,SD,Marshall County,2442,2370,72,2.9
CN4609300000000,2023-01-01,46,093,SD,Meade County,14305,14011,294,2.1
CN4609500000000,2023-01-01,46,095,SD,Mellette County,738,720,18,2.4
CN4609700000000,2023-01-01,46,097,SD,Miner County,1239,1214,25,2
CN4609900000000,2023-01-01,46,099,SD,Minnehaha County,116053,113761,2292,2
CN4610100000000,2023-01-01,46,101,SD,Moody County,3899,3825,74,1.9
CN4610200000000,2023-01-01,46,102,SD,Oglala Lakota County,3692,3538,154,4.2
CN4610300000000,2023-01-01,46,103,SD,Pennington County,58811,57721,1090,1.9
CN4610500000000,2023-01-01,46,105,SD,Perkins County,1411,1379,32,2.3
CN4610700000000,2023-01-01,46,107,SD,Potter County,992,970,22,2.2
CN4610900000000,2023-01-01,46,109,SD,Roberts County,4517,4327,190,4.2
CN4611100000000,2023-01-01,46,111,SD,Sanborn County,1205,1179,26,2.2
CN4611500000000,2023-01-01,46,115,SD,Spink County,2955,2875,80,2.7
CN4611700000000,2023-01-01,46,117,SD,Stanley County,1905,1862,43,2.3
CN4611900000000,2023-01-01,46,119,SD,Sully County,805,795,10,1.2
CN4612100000000,2023-01-01,46,121,SD,Todd County,2958,2857,101,3.4
CN4612300000000,2023-01-01,46,123,SD,Tripp County,3054,3003,51,1.7
CN4612500000000,2023-01-01,46,125,SD,Turner County,4766,4657,109,2.3
CN4612700000000,2023-01-01,46,127,SD,Union County,8674,8509,165,1.9
CN4612900000000,2023-01-01,46,129,SD,Walworth County,2042,1962,80,3.9
CN4613500000000,2023-01-01,46,135,SD,Yankton County,11561,11371,190,1.6
CN4613700000000,2023-01-01,46,137,SD,Ziebach County,944,914,30,3.2
CN4700100000000,2023-01-01,47,001,TN,Anderson County,35001,33825,1176,3.4
CN4700300000000,2023-01-01,47,003,TN,Bedford County,21389,20669,720,3.4
CN4700500000000,2023-01-01,47,005,TN,Benton County,6669,6354,315,4.7
CN4700700000000,2023-01-01,47,007,TN,Bledsoe County,4415,4155,260,5.9
CN4700900000000,2023-01-01,47,009,TN,Blount County,65212,63024,2188,3.4
CN4701100000000,2023-01-01,47,011,TN,Bradley County,49834,48041,1793,3.6
CN4701300000000,2023-01-01,47,013,TN,Campbell County,14896,14230,666,4.5
CN4701500000000,2023-01-01,47,015,TN,Cannon County,6851,6658,193,2.8
CN4701700000000,2023-01-01,47,017,TN,Carroll County,11635,11102,533,4.6
CN4701900000000,2023-01-01,47,019,TN,Carter County,23823,22916,907,3.8
CN4702100000000,2023-01-01,47,021,TN,Cheatham County,22510,21912,598,2.7
CN4702300000000,2023-01-01,47,023,TN,Chester County,8476,8197,279,3.3
CN4702500000000,2023-01-01,47,025,TN,Claiborne County,12587,12039,548,4.4
CN4702700000000,2023-01-01,47,027,TN,Clay County,2789,2657,132,4.7
CN4702900000000,2023-01-01,47,029,TN,Cocke County,14601,13581,1020,7
CN4703100000000,2023-01-01,47,031,TN,Coffee County,24934,24103,831,3.3
CN4703300000000,2023-01-01,47,033,TN,Crockett County,6849,6591,258,3.8
CN4703500000000,2023-01-01,47,035,TN,Cumberland County,23384,22162,1222,5.2
CN4703700000000,2023-01-01,47,037,TN,Davidson County,411496,400265,11231,2.7
CN4703900000000,2023-01-01,47,039,TN,Decatur County,4482,4211,271,6
CN4704100000000,2023-01-01,47,041,TN,DeKalb County,7972,7657,315,4
CN4704300000000,2023-01-01,47,043,TN,Dickson County,27923,27060,863,3.1
CN4704500000000,2023-01-01,47,045,TN,Dyer County,16396,15770,626,3.8
CN4704700000000,2023-01-01,47,047,TN,Fayette County,19016,18352,664,3.5
CN4704900000000,2023-01-01,47,049,TN,Fentress County,7842,7504,338,4.3
CN4705100000000,2023-01-01,47,051,TN,Franklin County,18668,18002,666,3.6
CN4705300000000,2023-01-01,47,053,TN,Gibson County,21509,20688,821,3.8
CN4705500000000,2023-01-01,47,055,TN,Giles County,14719,14226,493,3.3
CN4705700000000,2023-01-01,47,057,TN,Grainger County,9704,9290,414,4.3
CN4705900000000,2023-01-01,47,059,TN,Greene County,28667,27229,1438,5
CN4706100000000,2023-01-01,47,061,TN,Grundy County,4989,4769,220,4.4
CN4706300000000,2023-01-01,47,063,TN,Hamblen County,28191,27074,1117,4
CN4706500000000,2023-01-01,47,065,TN,Hamilton County,182029,176030,5999,3.3
CN4706700000000,2023-01-01,47,067,TN,Hancock County,2295,2192,103,4.5
CN4706900000000,2023-01-01,47,069,TN,Hardeman County,8886,8477,409,4.6
CN4707100000000,2023-01-01,47,071,TN,Hardin County,9901,9492,409,4.1
CN4707300000000,2023-01-01,47,073,TN,Hawkins County,23263,22324,939,4
CN4707500000000,2023-01-01,47,075,TN,Haywood County,7528,7154,374,5
CN4707700000000,2023-01-01,47,077,TN,Henderson County,11615,11157,458,3.9
CN4707900000000,2023-01-01,47,079,TN,Henry County,13462,12853,609,4.5
CN4708100000000,2023-01-01,47,081,TN,Hickman County,11729,11372,357,3
CN4708300000000,2023-01-01,47,083,TN,Houston County,3257,3085,172,5.3
CN4708500000000,2023-01-01,47,085,TN,Humphreys County,8563,8240,323,3.8
CN4708700000000,2023-01-01,47,087,TN,Jackson County,4747,4539,208,4.4
CN4708900000000,2023-01-01,47,089,TN,Jefferson County,25248,24057,1191,4.7
CN4709100000000,2023-01-01,47,091,TN,Johnson County,7517,7252,265,3.5
CN4709300000000,2023-01-01,47,093,TN,Knox County,249331,241894,7437,3
CN4709500000000,2023-01-01,47,095,TN,Lake County,1598,1518,80,5
CN4709700000000,2023-01-01,47,097,TN,Lauderdale County,9377,8890,487,5.2
CN4709900000000,2023-01-01,47,099,TN,Lawrence County,19156,18448,708,3.7
CN4710100000000,2023-01-01,47,101,TN,Lewis County,5536,5318,218,3.9
CN4710300000000,2023-01-01,47,103,TN,Lincoln County,16598,16012,586,3.5
CN4710500000000,2023-01-01,47,105,TN,Loudon County,24256,23485,771,3.2
CN4710700000000,2023-01-01,47,107,TN,McMinn County,21187,20234,953,4.5
CN4710900000000,2023-01-01,47,109,TN,McNairy County,8433,8030,403,4.8
CN4711100000000,2023-01-01,47,111,TN,Macon County,11731,11359,372,3.2
CN4711300000000,2023-01-01,47,113,TN,Madison County,48496,46743,1753,3.6
CN4711500000000,2023-01-01,47,115,TN,Marion County,12248,11736,512,4.2
CN4711700000000,2023-01-01,47,117,TN,Marshall County,15654,15148,506,3.2
CN4711900000000,2023-01-01,47,119,TN,Maury County,52814,51283,1531,2.9
CN4712100000000,2023-01-01,47,121,TN,Meigs County,5144,4882,262,5.1
CN4712300000000,2023-01-01,47,123,TN,Monroe County,20708,19965,743,3.6
CN4712500000000,2023-01-01,47,125,TN,Montgomery County,88269,84886,3383,3.8
CN4712700000000,2023-01-01,47,127,TN,Moore County,3670,3578,92,2.5
CN4712900000000,2023-01-01,47,129,TN,Morgan County,7889,7517,372,4.7
CN4713100000000,2023-01-01,47,131,TN,Obion County,12740,12198,542,4.3
CN4713300000000,2023-01-01,47,133,TN,Overton County,9880,9458,422,4.3
CN4713500000000,2023-01-01,47,135,TN,Perry County,2819,2542,277,9.8
CN4713700000000,2023-01-01,47,137,TN,Pickett County,2080,1988,92,4.4
CN4713900000000,2023-01-01,47,139,TN,Polk County,7037,6733,304,4.3
CN4714100000000,2023-01-01,47,141,TN,Putnam County,35132,33845,1287,3.7
CN4714300000000,2023-01-01,47,143,TN,Rhea County,13721,13028,693,5.1
CN4714500000000,2023-01-01,47,145,TN,Roane County,23637,22743,894,3.8
CN4714700000000,2023-01-01,47,147,TN,Robertson County,39293,38149,1144,2.9
CN4714900000000,2023-01-01,47,149,TN,Rutherford County,195407,190051,5356,2.7
CN4715100000000,2023-01-01,47,151,TN,Scott County,8033,7607,426,5.3
CN4715300000000,2023-01-01,47,153,TN,Sequatchie County,6129,5873,256,4.2
CN4715500000000,2023-01-01,47,155,TN,Sevier County,53286,50212,3074,5.8
CN4715700000000,2023-01-01,47,157,TN,Shelby County,431666,412183,19483,4.5
CN4715900000000,2023-01-01,47,159,TN,Smith County,9781,9460,321,3.3
CN4716100000000,2023-01-01,47,161,TN,Stewart County,5567,5336,231,4.1
CN4716300000000,2023-01-01,47,163,TN,Sullivan County,68926,66476,2450,3.6
CN4716500000000,2023-01-01,47,165,TN,Sumner County,108516,105497,3019,2.8
CN4716700000000,2023-01-01,47,167,TN,Tipton County,27271,26278,993,3.6
CN4716900000000,2023-01-01,47,169,TN,Trousdale County,5740,5553,187,3.3
CN4717100000000,2023-01-01,47,171,TN,Unicoi County,7060,6728,332,4.7
CN4717300000000,2023-01-01,47,173,TN,Union County,7811,7483,328,4.2
CN4717500000000,2023-01-01,47,175,TN,Van Buren County,2053,1973,80,3.9
CN4717700000000,2023-01-01,47,177,TN,Warren County,16366,15694,672,4.1
CN4717900000000,2023-01-01,47,179,TN,Washington County,60892,58799,2093,3.4
CN4718100000000,2023-01-01,47,181,TN,Wayne County,6499,6167,332,5.1
CN4718300000000,2023-01-01,47,183,TN,Weakley County,15183,14660,523,3.4
CN4718500000000,2023-01-01,47,185,TN,White County,11954,11490,464,3.9
CN4718700000000,2023-01-01,47,187,TN,Williamson County,137833,134362,3471,2.5
CN4718900000000,2023-01-01,47,189,TN,Wilson County,81920,79707,2213,2.7
CN4800100000000,2023-01-01,48,001,TX,Anderson County,23397,22557,840,3.6
CN4800300000000,2023-01-01,48,003,TX,Andrews County,9659,9353,306,3.2
CN4800500000000,2023-01-01,48,005,TX,Angelina County,35815,34080,1735,4.8
CN4800700000000,2023-01-01,48,007,TX,Aransas County,9275,8762,513,5.5
CN4800900000000,2023-01-01,48,009,TX,Archer County,4023,3867,156,3.9
CN4801100000000,2023-01-01,48,011,TX,Armstrong County,938,907,31,3.3
CN4801300000000,2023-01-01,48,013,TX,Atascosa County,22676,21735,941,4.1
CN4801500000000,2023-01-01,48,015,TX,Austin County,14192,13622,570,4
CN4801700000000,2023-01-01,48,017,TX,Bailey County,2326,2216,110,4.7
CN4801900000000,2023-01-01,48,019,TX,Bandera County,10707,10288,419,3.9
CN4802100000000,2023-01-01,48,021,TX,Bastrop County,48746,47027,1719,3.5
CN4802300000000,2023-01-01,48,023,TX,Baylor County,1997,1948,49,2.5
CN4802500000000,2023-01-01,48,025,TX,Bee County,9048,8523,525,5.8
CN4802700000000,2023-01-01,48,027,TX,Bell County,151493,143919,7574,5
CN4802900000000,2023-01-01,48,029,TX,Bexar County,992004,952621,39383,4
CN4803100000000,2023-01-01,48,031,TX,Blanco County,7158,6943,215,3
CN4803300000000,2023-01-01,48,033,TX,Borden County,788,774,14,1.8
CN4803500000000,2023-01-01,48,035,TX,Bosque County,8698,8354,344,4
CN4803700000000,2023-01-01,48,037,TX,Bowie County,38684,36858,1826,4.7
CN4803900000000,2023-01-01,48,039,TX,Brazoria County,186762,177790,8972,4.8
CN4804100000000,2023-01-01,48,041,TX,Brazos County,130390,125896,4494,3.4
CN4804300000000,2023-01-01,48,043,TX,Brewster County,4268,4114,154,3.6
CN4804500000000,2023-01-01,48,045,TX,Briscoe County,597,572,25,4.2
CN4804700000000,2023-01-01,48,047,TX,Brooks County,2374,2235,139,5.9
CN4804900000000,2023-01-01,48,049,TX,Brown County,15531,14714,817,5.3
CN4805100000000,2023-01-01,48,051,TX,Burleson County,8936,8593,343,3.8
CN4805300000000,2023-01-01,48,053,TX,Burnet County,26008,25148,860,3.3
CN4805500000000,2023-01-01,48,055,TX,Caldwell County,21583,20761,822,3.8
CN4805700000000,2023-01-01,48,057,TX,Calhoun County,12477,12018,459,3.7
CN4805900000000,2023-01-01,48,059,TX,Callahan County,6363,6094,269,4.2
CN4806100000000,2023-01-01,48,061,TX,Cameron County,180290,169299,10991,6.1
CN4806300000000,2023-01-01,48,063,TX,Camp County,5121,4868,253,4.9
CN4806500000000,2023-01-01,48,065,TX,Carson County,3012,2910,102,3.4
CN4806700000000,2023-01-01,48,067,TX,Cass County,11850,11258,592,5
CN4806900000000,2023-01-01,48,069,TX,Castro County,3250,3136,114,3.5
CN4807100000000,2023-01-01,48,071,TX,Chambers County,21336,20099,1237,5.8
CN4807300000000,2023-01-01,48,073,TX,Cherokee County,20323,19333,990,4.9
CN4807500000000,2023-01-01,48,075,TX,Childress County,3268,3172,96,2.9
CN4807700000000,2023-01-01,48,077,TX,Clay County,4848,4658,190,3.9
CN4807900000000,2023-01-01,48,079,TX,Cochran County,1075,1024,51,4.7
CN4808100000000,2023-01-01,48,081,TX,Coke County,1592,1535,57,3.6
CN4808300000000,2023-01-01,48,083,TX,Coleman County,3048,2898,150,4.9
CN4808500000000,2023-01-01,48,085,TX,Collin County,639059,616695,22364,3.5
CN4808700000000,2023-01-01,48,087,TX,Collingsworth County,1046,1004,42,4
CN4808900000000,2023-01-01,48,089,TX,Colorado County,10189,9815,374,3.7
CN4809100000000,2023-01-01,48,091,TX,Comal County,83267,80140,3127,3.8
CN4809300000000,2023-01-01,48,093,TX,Comanche County,6484,6231,253,3.9
CN4809500000000,2023-01-01,48,095,TX,Concho County,1241,1199,42,3.4
CN4809700000000,2023-01-01,48,097,TX,Cooke County,20216,19501,715,3.5
CN4809900000000,2023-01-01,48,099,TX,Coryell County,24989,23759,1230,4.9
CN4810100000000,2023-01-01,48,101,TX,Cottle County,973,948,25,2.6
CN4810300000000,2023-01-01,48,103,TX,Crane County,1698,1613,85,5
CN4810500000000,2023-01-01,48,105,TX,Crockett County,1428,1375,53,3.7
CN4810700000000,2023-01-01,48,107,TX,Crosby County,2383,2273,110,4.6
CN4810900000000,2023-01-01,48,109,TX,Culberson County,1189,1149,40,3.4
CN4811100000000,2023-01-01,48,111,TX,Dallam County,3778,3671,107,2.8
CN4811300000000,2023-01-01,48,113,TX,Dallas County,1449812,1393027,56785,3.9
CN4811500000000,2023-01-01,48,115,TX,Dawson County,4543,4347,196,4.3
CN4811700000000,2023-01-01,48,117,TX,Deaf Smith County,8922,8633,289,3.2
CN4811900000000,2023-01-01,48,119,TX,Delta County,2555,2430,125,4.9
CN4812100000000,2023-01-01,48,121,TX,Denton County,563622,543855,19767,3.5
CN4812300000000,2023-01-01,48,123,TX,DeWitt County,9045,8727,318,3.5
CN4812500000000,2023-01-01,48,125,TX,Dickens County,693,656,37,5.3
CN4812700000000,2023-01-01,48,127,TX,Dimmit County,6105,5858,247,4
CN4812900000000,2023-01-01,48,129,TX,Donley County,1456,1396,60,4.1
CN4813100000000,2023-01-01,48,131,TX,Duval County,5057,4845,212,4.2
CN4813300000000,2023-01-01,48,133,TX,Eastland County,6576,6247,329,5
CN4813500000000,2023-01-01,48,135,TX,Ector County,85746,82612,3134,3.7
CN4813700000000,2023-01-01,48,137,TX,Edwards County,1088,1054,34,3.1
CN4813900000000,2023-01-01,48,139,TX,Ellis County,105507,101469,4038,3.8
CN4814100000000,2023-01-01,48,141,TX,El Paso County,376273,359242,17031,4.5
CN4814300000000,2023-01-01,48,143,TX,Erath County,21197,20361,836,3.9
CN4814500000000,2023-01-01,48,145,TX,Falls County,6903,6594,309,4.5
CN4814700000000,2023-01-01,48,147,TX,Fannin County,17709,16952,757,4.3
CN4814900000000,2023-01-01,48,149,TX,Fayette County,11911,11475,436,3.7
CN4815100000000,2023-01-01,48,151,TX,Fisher County,1620,1558,62,3.8
CN4815300000000,2023-01-01,48,153,TX,Floyd County,2359,2251,108,4.6
CN4815500000000,2023-01-01,48,155,TX,Foard County,538,518,20,3.7
CN4815700000000,2023-01-01,48,157,TX,Fort Bend County,423770,405948,17822,4.2
CN4815900000000,2023-01-01,48,159,TX,Franklin County,5370,5171,199,3.7
CN4816100000000,2023-01-01,48,161,TX,Freestone County,6301,5926,375,6
CN4816300000000,2023-01-01,48,163,TX,Frio County,9290,8969,321,3.5
CN4816500000000,2023-01-01,48,165,TX,Gaines County,10214,9876,338,3.3
CN4816700000000,2023-01-01,48,167,TX,Galveston County,170932,163060,7872,4.6
CN4816900000000,2023-01-01,48,169,TX,Garza County,1954,1874,80,4.1
CN4817100000000,2023-01-01,48,171,TX,Gillespie County,14828,14420,408,2.8
CN4817300000000,2023-01-01,48,173,TX,Glasscock County,885,863,22,2.5
CN4817500000000,2023-01-01,48,175,TX,Goliad County,3188,3051,137,4.3
CN4817700000000,2023-01-01,48,177,TX,Gonzales County,9413,9069,344,3.7
CN4817900000000,2023-01-01,48,179,TX,Gray County,7727,7378,349,4.5
CN4818100000000,2023-01-01,48,181,TX,Grayson County,67083,64350,2733,4.1
CN4818300000000,2023-01-01,48,183,TX,Gregg County,57701,55112,2589,4.5
CN4818500000000,2023-01-01,48,185,TX,Grimes County,11533,10986,547,4.7
CN4818700000000,2023-01-01,48,187,TX,Guadalupe County,86763,83609,3154,3.6
CN4818900000000,2023-01-01,48,189,TX,Hale County,11388,10784,604,5.3
CN4819100000000,2023-01-01,48,191,TX,Hall County,1055,1007,48,4.5
CN4819300000000,2023-01-01,48,193,TX,Hamilton County,3917,3769,148,3.8
CN4819500000000,2023-01-01,48,195,TX,Hansford County,2830,2751,79,2.8
CN4819700000000,2023-01-01,48,197,TX,Hardeman County,1787,1719,68,3.8
CN4819900000000,2023-01-01,48,199,TX,Hardin County,25258,23920,1338,5.3
CN4820100000000,2023-01-01,48,201,TX,Harris County,2367555,2260695,106860,4.5
CN4820300000000,2023-01-01,48,203,TX,Harrison County,29092,27705,1387,4.8
CN4820500000000,2023-01-01,48,205,TX,Hartley County,2535,2476,59,2.3
CN4820700000000,2023-01-01,48,207,TX,Haskell County,2754,2658,96,3.5
CN4820900000000,2023-01-01,48,209,TX,Hays County,140802,136013,4789,3.4
CN4821100000000,2023-01-01,48,211,TX,Hemphill County,1632,1570,62,3.8
CN4821300000000,2023-01-01,48,213,TX,Henderson County,39073,37460,1613,4.1
CN4821500000000,2023-01-01,48,215,TX,Hidalgo County,380179,353310,26869,7.1
CN4821700000000,2023-01-01,48,217,TX,Hill County,18297,17447,850,4.6
CN4821900000000,2023-01-01,48,219,TX,Hockley County,10691,10277,414,3.9
CN4822100000000,2023-01-01,48,221,TX,Hood County,30384,29173,1211,4
CN4822300000000,2023-01-01,48,223,TX,Hopkins County,18706,17830,876,4.7
CN4822500000000,2023-01-01,48,225,TX,Houston County,10510,10142,368,3.5
CN4822700000000,2023-01-01,48,227,TX,Howard County,12949,12337,612,4.7
CN4822900000000,2023-01-01,48,229,TX,Hudspeth County,1879,1797,82,4.4
CN4823100000000,2023-01-01,48,231,TX,Hunt County,47782,45731,2051,4.3
CN4823300000000,2023-01-01,48,233,TX,Hutchinson County,8421,8022,399,4.7
CN4823500000000,2023-01-01,48,235,TX,Irion County,784,759,25,3.2
CN4823700000000,2023-01-01,48,237,TX,Jack County,3474,3344,130,3.7
CN4823900000000,2023-01-01,48,239,TX,Jackson County,7032,6768,264,3.8
CN4824100000000,2023-01-01,48,241,TX,Jasper County,12775,11944,831,6.5
CN4824300000000,2023-01-01,48,243,TX,Jeff Davis County,946,912,34,3.6
CN4824500000000,2023-01-01,48,245,TX,Jefferson County,103327,96003,7324,7.1
CN4824700000000,2023-01-01,48,247,TX,Jim Hogg County,1772,1682,90,5.1
CN4824900000000,2023-01-01,48,249,TX,Jim Wells County,15620,14741,879,5.6
CN4825100000000,2023-01-01,48,251,TX,Johnson County,90720,87357,3363,3.7
CN4825300000000,2023-01-01,48,253,TX,Jones County,5884,5586,298,5.1
CN4825500000000,2023-01-01,48,255,TX,Karnes County,6676,6437,239,3.6
CN4825700000000,2023-01-01,48,257,TX,Kaufman County,76756,73637,3119,4.1
CN4825900000000,2023-01-01,48,259,TX,Kendall County,23941,23101,840,3.5
CN4826100000000,2023-01-01,48,261,TX,Kenedy County,122,113,9,7.4
CN4826300000000,2023-01-01,48,263,TX,Kent County,692,678,14,2
CN4826500000000,2023-01-01,48,265,TX,Kerr County,22261,21397,864,3.9
CN4826700000000,2023-01-01,48,267,TX,Kimble County,1756,1690,66,3.8
CN4826900000000,2023-01-01,48,269,TX,King County,539,533,6,1.1
CN4827100000000,2023-01-01,48,271,TX,Kinney County,1213,1151,62,5.1
CN4827300000000,2023-01-01,48,273,TX,Kleberg County,13019,12327,692,5.3
CN4827500000000,2023-01-01,48,275,TX,Knox County,1459,1402,57,3.9
CN4827700000000,2023-01-01,48,277,TX,Lamar County,24286,23089,1197,4.9
CN4827900000000,2023-01-01,48,279,TX,Lamb County,5123,4902,221,4.3
CN4828100000000,2023-01-01,48,281,TX,Lampasas County,9499,9116,383,4
CN4828300000000,2023-01-01,48,283,TX,La Salle County,4220,4107,113,2.7
CN4828500000000,2023-01-01,48,285,TX,Lavaca County,9131,8799,332,3.6
CN4828700000000,2023-01-01,48,287,TX,Lee County,8427,8113,314,3.7
CN4828900000000,2023-01-01,48,289,TX,Leon County,5987,5647,340,5.7
CN4829100000000,2023-01-01,48,291,TX,Liberty County,35579,33466,2113,5.9
CN4829300000000,2023-01-01,48,293,TX,Limestone County,8365,7948,417,5
CN4829500000000,2023-01-01,48,295,TX,Lipscomb County,1427,1376,51,3.6
CN4829700000000,2023-01-01,48,297,TX,Live Oak County,4852,4643,209,4.3
CN4829900000000,2023-01-01,48,299,TX,Llano County,9241,8869,372,4
CN4830100000000,2023-01-01,48,301,TX,Loving County,1429,1423,6,0.4
CN4830300000000,2023-01-01,48,303,TX,Lubbock County,164861,159012,5849,3.5
CN4830500000000,2023-01-01,48,305,TX,Lynn County,2831,2724,107,3.8
CN4830700000000,2023-01-01,48,307,TX,McCulloch County,3125,2992,133,4.3
CN4830900000000,2023-01-01,48,309,TX,McLennan County,129341,123953,5388,4.2
CN4831100000000,2023-01-01,48,311,TX,McMullen County,865,853,12,1.4
CN4831300000000,2023-01-01,48,313,TX,Madison County,4721,4494,227,4.8
CN4831500000000,2023-01-01,48,315,TX,Marion County,4190,3971,219,5.2
CN4831700000000,2023-01-01,48,317,TX,Martin County,2874,2789,85,3
CN4831900000000,2023-01-01,48,319,TX,Mason County,1775,1710,65,3.7
CN4832100000000,2023-01-01,48,321,TX,Matagorda County,17485,16377,1108,6.3
CN4832300000000,2023-01-01,48,323,TX,Maverick County,23889,21657,2232,9.3
CN4832500000000,2023-01-01,48,325,TX,Medina County,22883,21950,933,4.1
CN4832700000000,2023-01-01,48,327,TX,Menard County,843,811,32,3.8
CN4832900000000,2023-01-01,48,329,TX,Midland County,110695,107683,3012,2.7
CN4833100000000,2023-01-01,48,331,TX,Milam County,10187,9697,490,4.8
CN4833300000000,2023-01-01,48,333,TX,Mills County,1904,1814,90,4.7
CN4833500000000,2023-01-01,48,335,TX,Mitchell County,2277,2180,97,4.3
CN4833700000000,2023-01-01,48,337,TX,Montague County,9200,8832,368,4
CN4833900000000,2023-01-01,48,339,TX,Montgomery County,305287,292467,12820,4.2
CN4834100000000,2023-01-01,48,341,TX,Moore County,11327,10978,349,3.1
CN4834300000000,2023-01-01,48,343,TX,Morris County,4449,4160,289,6.5
CN4834500000000,2023-01-01,48,345,TX,Motley County,512,492,20,3.9
CN4834700000000,2023-01-01,48,347,TX,Nacogdoches County,28205,26887,1318,4.7
CN4834900000000,2023-01-01,48,349,TX,Navarro County,23493,22481,1012,4.3
CN4835100000000,2023-01-01,48,351,TX,Newton County,4980,4595,385,7.7
CN4835300000000,2023-01-01,48,353,TX,Nolan County,6780,6528,252,3.7
CN4835500000000,2023-01-01,48,355,TX,Nueces County,164212,156283,7929,4.8
CN4835700000000,2023-01-01,48,357,TX,Ochiltree County,3810,3663,147,3.9
CN4835900000000,2023-01-01,48,359,TX,Oldham County,936,904,32,3.4
CN4836100000000,2023-01-01,48,361,TX,Orange County,35444,33283,2161,6.1
CN4836300000000,2023-01-01,48,363,TX,Palo Pinto County,13128,12581,547,4.2
CN4836500000000,2023-01-01,48,365,TX,Panola County,9690,9242,448,4.6
CN4836700000000,2023-01-01,48,367,TX,Parker County,75955,73262,2693,3.5
CN4836900000000,2023-01-01,48,369,TX,Parmer County,5076,4926,150,3
CN4837100000000,2023-01-01,48,371,TX,Pecos County,6585,6338,247,3.8
CN4837300000000,2023-01-01,48,373,TX,Polk County,18931,17848,1083,5.7
CN4837500000000,2023-01-01,48,375,TX,Potter County,55576,53727,1849,3.3
CN4837700000000,2023-01-01,48,377,TX,Presidio County,3067,2860,207,6.7
CN4837900000000,2023-01-01,48,379,TX,Rains County,6603,6354,249,3.8
CN4838100000000,2023-01-01,48,381,TX,Randall County,76861,74499,2362,3.1
CN4838300000000,2023-01-01,48,383,TX,Reagan County,1589,1533,56,3.5
CN4838500000000,2023-01-01,48,385,TX,Real County,1073,1011,62,5.8
CN4838700000000,2023-01-01,48,387,TX,Red River County,4997,4737,260,5.2
CN4838900000000,2023-01-01,48,389,TX,Reeves County,8452,8132,320,3.8
CN4839100000000,2023-01-01,48,391,TX,Refugio County,2890,2746,144,5
CN4839300000000,2023-01-01,48,393,TX,Roberts County,390,375,15,3.8
CN4839500000000,2023-01-01,48,395,TX,Robertson County,8027,7695,332,4.1
CN4839700000000,2023-01-01,48,397,TX,Rockwall County,60521,58286,2235,3.7
CN4839900000000,2023-01-01,48,399,TX,Runnels County,4694,4518,176,3.7
CN4840100000000,2023-01-01,48,401,TX,Rusk County,22655,21660,995,4.4
CN4840300000000,2023-01-01,48,403,TX,Sabine County,3932,3648,284,7.2
CN4840500000000,2023-01-01,48,405,TX,San Augustine County,3205,3023,182,5.7
CN4840700000000,2023-01-01,48,407,TX,San Jacinto County,12068,11432,636,5.3
CN4840900000000,2023-01-01,48,409,TX,San Patricio County,29131,27472,1659,5.7
CN4841100000000,2023-01-01,48,411,TX,San Saba County,2214,2135,79,3.6
CN4841300000000,2023-01-01,48,413,TX,Schleicher County,1244,1198,46,3.7
CN4841500000000,2023-01-01,48,415,TX,Scurry County,6362,6087,275,4.3
CN4841700000000,2023-01-01,48,417,TX,Shackelford County,1788,1734,54,3
CN4841900000000,2023-01-01,48,419,TX,Shelby County,11107,10636,471,4.2
CN4842100000000,2023-01-01,48,421,TX,Sherman County,1342,1294,48,3.6
CN4842300000000,2023-01-01,48,423,TX,Smith County,112632,108164,4468,4
CN4842500000000,2023-01-01,48,425,TX,Somervell County,4674,4469,205,4.4
CN4842700000000,2023-01-01,48,427,TX,Starr County,24737,21825,2912,11.8
CN4842900000000,2023-01-01,48,429,TX,Stephens County,4143,3975,168,4.1
CN4843100000000,2023-01-01,48,431,TX,Sterling County,507,481,26,5.1
CN4843300000000,2023-01-01,48,433,TX,Stonewall County,770,747,23,3
CN4843500000000,2023-01-01,48,435,TX,Sutton County,960,898,62,6.5
CN4843700000000,2023-01-01,48,437,TX,Swisher County,2536,2411,125,4.9
CN4843900000000,2023-01-01,48,439,TX,Tarrant County,1163273,1118880,44393,3.8
CN4844100000000,2023-01-01,48,441,TX,Taylor County,70069,67288,2781,4
CN4844300000000,2023-01-01,48,443,TX,Terrell County,419,405,14,3.3
CN4844500000000,2023-01-01,48,445,TX,Terry County,4536,4334,202,4.5
CN4844700000000,2023-01-01,48,447,TX,Throckmorton County,638,613,25,3.9
CN4844900000000,2023-01-01,48,449,TX,Titus County,13869,13223,646,4.7
CN4845100000000,2023-01-01,48,451,TX,Tom Green County,56392,54344,2048,3.6
CN4845300000000,2023-01-01,48,453,TX,Travis County,835815,809099,26716,3.2
CN4845500000000,2023-01-01,48,455,TX,Trinity County,5336,5047,289,5.4
CN4845700000000,2023-01-01,48,457,TX,Tyler County,7094,6626,468,6.6
CN4845900000000,2023-01-01,48,459,TX,Upshur County,18007,17201,806,4.5
CN4846100000000,2023-01-01,48,461,TX,Upton County,2354,2295,59,2.5
CN4846300000000,2023-01-01,48,463,TX,Uvalde County,11111,10564,547,4.9
CN4846500000000,2023-01-01,48,465,TX,Val Verde County,22616,21116,1500,6.6
CN4846700000000,2023-01-01,48,467,TX,Van Zandt County,28043,26989,1054,3.8
CN4846900000000,2023-01-01,48,469,TX,Victoria County,41512,39734,1778,4.3
CN4847100000000,2023-01-01,48,471,TX,Walker County,24237,23003,1234,5.1
CN4847300000000,2023-01-01,48,473,TX,Waller County,25764,24494,1270,4.9
CN4847500000000,2023-01-01,48,475,TX,Ward County,6257,6035,222,3.5
CN4847700000000,2023-01-01,48,477,TX,Washington County,15105,14450,655,4.3
CN4847900000000,2023-01-01,48,479,TX,Webb County,118487,113182,5305,4.5
CN4848100000000,2023-01-01,48,481,TX,Wharton County,21411,20510,901,4.2
CN4848300000000,2023-01-01,48,483,TX,Wheeler County,1912,1830,82,4.3
CN4848500000000,2023-01-01,48,485,TX,Wichita County,55845,53519,2326,4.2
CN4848700000000,2023-01-01,48,487,TX,Wilbarger County,4750,4478,272,5.7
CN4848900000000,2023-01-01,48,489,TX,Willacy County,7419,6762,657,8.9
CN4849100000000,2023-01-01,48,491,TX,Williamson County,370939,358537,12402,3.3
CN4849300000000,2023-01-01,48,493,TX,Wilson County,26252,25353,899,3.4
CN4849500000000,2023-01-01,48,495,TX,Winkler County,4235,4082,153,3.6
CN4849700000000,2023-01-01,48,497,TX,Wise County,34863,33556,1307,3.7
CN4849900000000,2023-01-01,48,499,TX,Wood County,18468,17592,876,4.7
CN4850100000000,2023-01-01,48,501,TX,Yoakum County,3238,3110,128,4
CN4850300000000,2023-01-01,48,503,TX,Young County,7942,7652,290,3.7
CN4850500000000,2023-01-01,48,505,TX,Zapata County,4522,4198,324,7.2
CN4850700000000,2023-01-01,48,507,TX,Zavala County,3529,3215,314,8.9
CN4900100000000,2023-01-01,49,001,UT,Beaver County,2873,2788,85,3
CN4900300000000,2023-01-01,49,003,UT,Box Elder County,27930,27200,730,2.6
CN4900500000000,2023-01-01,49,005,UT,Cache County,72895,71287,1608,2.2
CN4900700000000,2023-01-01,49,007,UT,Carbon County,8450,8139,311,3.7
CN4900900000000,2023-01-01,49,009,UT,Daggett County,344,322,22,6.4
CN4901100000000,2023-01-01,49,011,UT,Davis County,185853,181557,4296,2.3
CN4901300000000,2023-01-01,49,013,UT,Duchesne County,8172,7890,282,3.5
CN4901500000000,2023-01-01,49,015,UT,Emery County,4451,4287,164,3.7
CN4901700000000,2023-01-01,49,017,UT,Garfield County,2545,2200,345,13.6
CN4901900000000,2023-01-01,49,019,UT,Grand County,6367,5838,529,8.3
CN4902100000000,2023-01-01,49,021,UT,Iron County,28671,27897,774,2.7
CN4902300000000,2023-01-01,49,023,UT,Juab County,6550,6394,156,2.4
CN4902500000000,2023-01-01,49,025,UT,Kane County,3940,3789,151,3.8
CN4902700000000,2023-01-01,49,027,UT,Millard County,6194,6031,163,2.6
CN4902900000000,2023-01-01,49,029,UT,Morgan County,5995,5870,125,2.1
CN4903100000000,2023-01-01,49,031,UT,Piute County,523,490,33,6.3
CN4903300000000,2023-01-01,49,033,UT,Rich County,1029,997,32,3.1
CN4903500000000,2023-01-01,49,035,UT,Salt Lake County,692033,674681,17352,2.5
CN4903700000000,2023-01-01,49,037,UT,San Juan County,5425,5119,306,5.6
CN4903900000000,2023-01-01,49,039,UT,Sanpete County,13982,13536,446,3.2
CN4904100000000,2023-01-01,49,041,UT,Sevier County,10458,10086,372,3.6
CN4904300000000,2023-01-01,49,043,UT,Summit County,28528,28007,521,1.8
CN4904500000000,2023-01-01,49,045,UT,Tooele County,39052,37957,1095,2.8
CN4904700000000,2023-01-01,49,047,UT,Uintah County,14347,13831,516,3.6
CN4904900000000,2023-01-01,49,049,UT,Utah County,351872,343400,8472,2.4
CN4905100000000,2023-01-01,49,051,UT,Wasatch County,18207,17785,422,2.3
CN4905300000000,2023-01-01,49,053,UT,Washington County,88602,85930,2672,3
CN4905500000000,2023-01-01,49,055,UT,Wayne County,1451,1336,115,7.9
CN4905700000000,2023-01-01,49,057,UT,Weber County,136596,132820,3776,2.8
CN5000100000000,2023-01-01,50,001,VT,Addison County,20655,20153,502,2.4
CN5000300000000,2023-01-01,50,003,VT,Bennington County,17558,16984,574,3.3
CN5000500000000,2023-01-01,50,005,VT,Caledonia County,14732,14165,567,3.8
CN5000700000000,2023-01-01,50,007,VT,Chittenden County,96441,94655,1786,1.9
CN5000900000000,2023-01-01,50,009,VT,Essex County,2678,2545,133,5
CN5001100000000,2023-01-01,50,011,VT,Franklin County,27761,27016,745,2.7
CN5001300000000,2023-01-01,50,013,VT,Grand Isle County,4119,3972,147,3.6
CN5001500000000,2023-01-01,50,015,VT,Lamoille County,14201,13653,548,3.9
CN5001700000000,2023-01-01,50,017,VT,Orange County,15835,15291,544,3.4
CN5001900000000,2023-01-01,50,019,VT,Orleans County,13807,12926,881,6.4
CN5002100000000,2023-01-01,50,021,VT,Rutland County,29847,28855,992,3.3
CN5002300000000,2023-01-01,50,023,VT,Washington County,34136,33250,886,2.6
CN5002500000000,2023-01-01,50,025,VT,Windham County,21304,20753,551,2.6
CN5002700000000,2023-01-01,50,027,VT,Windsor County,30050,29459,591,2
CN5100100000000,2023-01-01,51,001,VA,Accomack County,15930,15188,742,4.7
CN5100300000000,2023-01-01,51,003,VA,Albemarle County,59133,57408,1725,2.9
CN5100500000000,2023-01-01,51,005,VA,Alleghany County,6737,6483,254,3.8
CN5100700000000,2023-01-01,51,007,VA,Amelia County,6410,6181,229,3.6
CN5100900000000,2023-01-01,51,009,VA,Amherst County,15031,14478,553,3.7
CN5101100000000,2023-01-01,51,011,VA,Appomattox County,7264,6965,299,4.1
CN5101300000000,2023-01-01,51,013,VA,Arlington County,158543,154744,3799,2.4
CN5101500000000,2023-01-01,51,015,VA,Augusta County,38809,37683,1126,2.9
CN5101700000000,2023-01-01,51,017,VA,Bath County,2652,2557,95,3.6
CN5101900000000,2023-01-01,51,019,VA,Bedford County,39039,37714,1325,3.4
CN5102100000000,2023-01-01,51,021,VA,Bland County,2846,2751,95,3.3
CN5102300000000,2023-01-01,51,023,VA,Botetourt County,18010,17467,543,3
CN5102500000000,2023-01-01,51,025,VA,Brunswick County,6087,5752,335,5.5
CN5102700000000,2023-01-01,51,027,VA,Buchanan County,6470,6108,362,5.6
CN5102900000000,2023-01-01,51,029,VA,Buckingham County,6615,6286,329,5
CN5103100000000,2023-01-01,51,031,VA,Campbell County,26208,25203,1005,3.8
CN5103300000000,2023-01-01,51,033,VA,Caroline County,15637,15039,598,3.8
CN5103500000000,2023-01-01,51,035,VA,Carroll County,13189,12629,560,4.2
CN5103600000000,2023-01-01,51,036,VA,Charles City County,3675,3529,146,4
CN5103700000000,2023-01-01,51,037,VA,Charlotte County,5686,5489,197,3.5
CN5104100000000,2023-01-01,51,041,VA,Chesterfield County,196651,190360,6291,3.2
CN5104300000000,2023-01-01,51,043,VA,Clarke County,7780,7557,223,2.9
CN5104500000000,2023-01-01,51,045,VA,Craig County,2369,2278,91,3.8
CN5104700000000,2023-01-01,51,047,VA,Culpeper County,25940,25096,844,3.3
CN5104900000000,2023-01-01,51,049,VA,Cumberland County,4932,4712,220,4.5
CN5105100000000,2023-01-01,51,051,VA,Dickenson County,4619,4377,242,5.2
CN5105300000000,2023-01-01,51,053,VA,Dinwiddie County,14039,13524,515,3.7
CN5105700000000,2023-01-01,51,057,VA,Essex County,5653,5430,223,3.9
CN5105900000000,2023-01-01,51,059,VA,Fairfax County,645836,628100,17736,2.7
CN5106100000000,2023-01-01,51,061,VA,Fauquier County,38232,37132,1100,2.9
CN5106300000000,2023-01-01,51,063,VA,Floyd County,8376,8111,265,3.2
CN5106500000000,2023-01-01,51,065,VA,Fluvanna County,14504,14059,445,3.1
CN5106700000000,2023-01-01,51,067,VA,Franklin County,27037,26111,926,3.4
CN5106900000000,2023-01-01,51,069,VA,Frederick County,52084,50596,1488,2.9
CN5107100000000,2023-01-01,51,071,VA,Giles County,7959,7673,286,3.6
CN5107300000000,2023-01-01,51,073,VA,Gloucester County,19592,18982,610,3.1
CN5107500000000,2023-01-01,51,075,VA,Goochland County,12074,11671,403,3.3
CN5107700000000,2023-01-01,51,077,VA,Grayson County,8226,7980,246,3
CN5107900000000,2023-01-01,51,079,VA,Greene County,10870,10550,320,2.9
CN5108100000000,2023-01-01,51,081,VA,Greensville County,4396,4207,189,4.3
CN5108300000000,2023-01-01,51,083,VA,Halifax County,15706,14977,729,4.6
CN5108500000000,2023-01-01,51,085,VA,Hanover County,60936,59268,1668,2.7
CN5108700000000,2023-01-01,51,087,VA,Henrico County,188123,182126,5997,3.2
CN5108900000000,2023-01-01,51,089,VA,Henry County,24095,23152,943,3.9
CN5109100000000,2023-01-01,51,091,VA,Highland County,1512,1465,47,3.1
CN5109300000000,2023-01-01,51,093,VA,Isle of Wight County,19794,19152,642,3.2
CN5109500000000,2023-01-01,51,095,VA,James City County,37131,35908,1223,3.3
CN5109700000000,2023-01-01,51,097,VA,King and Queen County,4050,3931,119,2.9
CN5109900000000,2023-01-01,51,099,VA,King George County,14577,14125,452,3.1
CN5110100000000,2023-01-01,51,101,VA,King William County,9758,9444,314,3.2
CN5110300000000,2023-01-01,51,103,VA,Lancaster County,5596,5282,314,5.6
CN5110500000000,2023-01-01,51,105,VA,Lee County,8310,7909,401,4.8
CN5110700000000,2023-01-01,51,107,VA,Loudoun County,234709,228343,6366,2.7
CN5110900000000,2023-01-01,51,109,VA,Louisa County,21053,20396,657,3.1
CN5111100000000,2023-01-01,51,111,VA,Lunenburg County,5298,5105,193,3.6
CN5111300000000,2023-01-01,51,113,VA,Madison County,7673,7459,214,2.8
CN5111500000000,2023-01-01,51,115,VA,Mathews County,4106,3975,131,3.2
CN5111700000000,2023-01-01,51,117,VA,Mecklenburg County,13588,13018,570,4.2
CN5111900000000,2023-01-01,51,119,VA,Middlesex County,5391,5224,167,3.1
CN5112100000000,2023-01-01,51,121,VA,Montgomery County,50694,49136,1558,3.1
CN5112500000000,2023-01-01,51,125,VA,Nelson County,7564,7316,248,3.3
CN5112700000000,2023-01-01,51,127,VA,New Kent County,13447,13074,373,2.8
CN5113100000000,2023-01-01,51,131,VA,Northampton County,5630,5361,269,4.8
CN5113300000000,2023-01-01,51,133,VA,Northumberland County,5760,5364,396,6.9
CN5113500000000,2023-01-01,51,135,VA,Nottoway County,7350,7110,240,3.3
CN5113700000000,2023-01-01,51,137,VA,Orange County,17723,17089,634,3.6
CN5113900000000,2023-01-01,51,139,VA,Page County,12373,11763,610,4.9
CN5114100000000,2023-01-01,51,141,VA,Patrick County,7160,6867,293,4.1
CN5114300000000,2023-01-01,51,143,VA,Pittsylvania County,30595,29488,1107,3.6
CN5114500000000,2023-01-01,51,145,VA,Powhatan County,14954,14479,475,3.2
CN5114700000000,2023-01-01,51,147,VA,Prince Edward County,10162,9727,435,4.3
CN5114900000000,2023-01-01,51,149,VA,Prince George County,15612,15033,579,3.7
CN5115300000000,2023-01-01,51,153,VA,Prince William County,253456,245804,7652,3
CN5115500000000,2023-01-01,51,155,VA,Pulaski County,16279,15707,572,3.5
CN5115700000000,2023-01-01,51,157,VA,Rappahannock County,3789,3672,117,3.1
CN5115900000000,2023-01-01,51,159,VA,Richmond County,4067,3904,163,4
CN5116100000000,2023-01-01,51,161,VA,Roanoke County,50755,49248,1507,3
CN5116300000000,2023-01-01,51,163,VA,Rockbridge County,11229,10869,360,3.2
CN5116500000000,2023-01-01,51,165,VA,Rockingham County,43071,41810,1261,2.9
CN5116700000000,2023-01-01,51,167,VA,Russell County,11089,10601,488,4.4
CN5116900000000,2023-01-01,51,169,VA,Scott County,9481,9114,367,3.9
CN5117100000000,2023-01-01,51,171,VA,Shenandoah County,22198,21460,738,3.3
CN5117300000000,2023-01-01,51,173,VA,Smyth County,13489,12972,517,3.8
CN5117500000000,2023-01-01,51,175,VA,Southampton County,8946,8670,276,3.1
CN5117700000000,2023-01-01,51,177,VA,Spotsylvania County,70292,67886,2406,3.4
CN5117900000000,2023-01-01,51,179,VA,Stafford County,76395,73957,2438,3.2
CN5118100000000,2023-01-01,51,181,VA,Surry County,3648,3527,121,3.3
CN5118300000000,2023-01-01,51,183,VA,Sussex County,3775,3584,191,5.1
CN5118500000000,2023-01-01,51,185,VA,Tazewell County,15530,14784,746,4.8
CN5118700000000,2023-01-01,51,187,VA,Warren County,21063,20340,723,3.4
CN5119100000000,2023-01-01,51,191,VA,Washington County,27116,26185,931,3.4
CN5119300000000,2023-01-01,51,193,VA,Westmoreland County,9605,9238,367,3.8
CN5119500000000,2023-01-01,51,195,VA,Wise County,12913,12286,627,4.9
CN5119700000000,2023-01-01,51,197,VA,Wythe County,14259,13765,494,3.5
CN5119900000000,2023-01-01,51,199,VA,York County,33270,32225,1045,3.1
CN5151000000000,2023-01-01,51,510,VA,Alexandria city,101879,99155,2724,2.7
CN5152000000000,2023-01-01,51,520,VA,Bristol city,7800,7491,309,4
CN5153000000000,2023-01-01,51,530,VA,Buena Vista city,3091,2993,98,3.2
CN5154000000000,2023-01-01,51,540,VA,Charlottesville city,26190,25399,791,3
CN5155000000000,2023-01-01,51,550,VA,Chesapeake city,124211,120105,4106,3.3
CN5157000000000,2023-01-01,51,570,VA,Colonial Heights city,8665,8353,312,3.6
CN5158000000000,2023-01-01,51,580,VA,Covington city,2325,2202,123,5.3
CN5159000000000,2023-01-01,51,590,VA,Danville city,18850,17911,939,5
CN5159500000000,2023-01-01,51,595,VA,Emporia city,2358,2237,121,5.1
CN5160000000000,2023-01-01,51,600,VA,Fairfax city,13053,12701,352,2.7
CN5161000000000,2023-01-01,51,610,VA,Falls Church city,8661,8443,218,2.5
CN5162000000000,2023-01-01,51,620,VA,Franklin city,3480,3319,161,4.6
CN5163000000000,2023-01-01,51,630,VA,Fredericksburg city,14521,13980,541,3.7
CN5164000000000,2023-01-01,51,640,VA,Galax city,2917,2803,114,3.9
CN5165000000000,2023-01-01,51,650,VA,Hampton city,64582,61843,2739,4.2
CN5166000000000,2023-01-01,51,660,VA,Harrisonburg city,24863,23996,867,3.5
CN5167000000000,2023-01-01,51,670,VA,Hopewell city,9822,9307,515,5.2
CN5167800000000,2023-01-01,51,678,VA,Lexington city,2367,2265,102,4.3
CN5168000000000,2023-01-01,51,680,VA,Lynchburg city,36075,34538,1537,4.3
CN5168300000000,2023-01-01,51,683,VA,Manassas city,21965,21338,627,2.9
CN5168500000000,2023-01-01,51,685,VA,Manassas Park city,9912,9632,280,2.8
CN5169000000000,2023-01-01,51,690,VA,Martinsville city,5669,5364,305,5.4
CN5170000000000,2023-01-01,51,700,VA,Newport News city,88552,85059,3493,3.9
CN5171000000000,2023-01-01,51,710,VA,Norfolk city,110394,106099,4295,3.9
CN5172000000000,2023-01-01,51,720,VA,Norton city,1619,1543,76,4.7
CN5173000000000,2023-01-01,51,730,VA,Petersburg city,12866,12041,825,6.4
CN5173500000000,2023-01-01,51,735,VA,Poquoson city,6398,6216,182,2.8
CN5174000000000,2023-01-01,51,740,VA,Portsmouth city,44137,42331,1806,4.1
CN5175000000000,2023-01-01,51,750,VA,Radford city,8739,8413,326,3.7
CN5176000000000,2023-01-01,51,760,VA,Richmond city,122719,118013,4706,3.8
CN5177000000000,2023-01-01,51,770,VA,Roanoke city,49944,48146,1798,3.6
CN5177500000000,2023-01-01,51,775,VA,Salem city,13101,12690,411,3.1
CN5179000000000,2023-01-01,51,790,VA,Staunton city,12593,12220,373,3
CN5180000000000,2023-01-01,51,800,VA,Suffolk city,45727,44108,1619,3.5
CN5181000000000,2023-01-01,51,810,VA,Virginia Beach city,232696,225222,7474,3.2
CN5182000000000,2023-01-01,51,820,VA,Waynesboro city,10961,10590,371,3.4
CN5183000000000,2023-01-01,51,830,VA,Williamsburg city,6801,6530,271,4
CN5184000000000,2023-01-01,51,840,VA,Winchester city,15299,14799,500,3.3
CN5300100000000,2023-01-01,53,001,WA,Adams County,9484,8688,796,8.4
CN5300300000000,2023-01-01,53,003,WA,Asotin County,10648,10201,447,4.2
CN5300500000000,2023-01-01,53,005,WA,Benton County,107398,100519,6879,6.4
CN5300700000000,2023-01-01,53,007,WA,Chelan County,43880,40851,3029,6.9
CN5300900000000,2023-01-01,53,009,WA,Clallam County,29137,27002,2135,7.3
CN5301100000000,2023-01-01,53,011,WA,Clark County,254737,241295,13442,5.3
CN5301300000000,2023-01-01,53,013,WA,Columbia County,1785,1673,112,6.3
CN5301500000000,2023-01-01,53,015,WA,Cowlitz County,50146,46886,3260,6.5
CN5301700000000,2023-01-01,53,017,WA,Douglas County,21481,19856,1625,7.6
CN5301900000000,2023-01-01,53,019,WA,Ferry County,2428,2095,333,13.7
CN5302100000000,2023-01-01,53,021,WA,Franklin County,43721,39957,3764,8.6
CN5302300000000,2023-01-01,53,023,WA,Garfield County,775,710,65,8.4
CN5302500000000,2023-01-01,53,025,WA,Grant County,47126,42819,4307,9.1
CN5302700000000,2023-01-01,53,027,WA,Grays Harbor County,30158,27537,2621,8.7
CN5302900000000,2023-01-01,53,029,WA,Island County,37328,35274,2054,5.5
CN5303100000000,2023-01-01,53,031,WA,Jefferson County,12829,11978,851,6.6
CN5303300000000,2023-01-01,53,033,WA,King County,1328366,1283946,44420,3.3
CN5303500000000,2023-01-01,53,035,WA,Kitsap County,131520,124908,6612,5
CN5303700000000,2023-01-01,53,037,WA,Kittitas County,22596,20896,1700,7.5
CN5303900000000,2023-01-01,53,039,WA,Klickitat County,9953,9185,768,7.7
CN5304100000000,2023-01-01,53,041,WA,Lewis County,35293,32739,2554,7.2
CN5304300000000,2023-01-01,53,043,WA,Lincoln County,4778,4435,343,7.2
CN5304500000000,2023-01-01,53,045,WA,Mason County,25821,23925,1896,7.3
CN5304700000000,2023-01-01,53,047,WA,Okanogan County,19156,17335,1821,9.5
CN5304900000000,2023-01-01,53,049,WA,Pacific County,8896,8165,731,8.2
CN5305100000000,2023-01-01,53,051,WA,Pend Oreille County,5311,4831,480,9
CN5305300000000,2023-01-01,53,053,WA,Pierce County,461773,434701,27072,5.9
CN5305500000000,2023-01-01,53,055,WA,San Juan County,8776,8368,408,4.6
CN5305700000000,2023-01-01,53,057,WA,Skagit County,62163,58409,3754,6
CN5305900000000,2023-01-01,53,059,WA,Skamania County,5752,5350,402,7
CN5306100000000,2023-01-01,53,061,WA,Snohomish County,452485,435946,16539,3.7
CN5306300000000,2023-01-01,53,063,WA,Spokane County,268232,251936,16296,6.1
CN5306500000000,2023-01-01,53,065,WA,Stevens County,19890,17979,1911,9.6
CN5306700000000,2023-01-01,53,067,WA,Thurston County,152961,145020,7941,5.2
CN5306900000000,2023-01-01,53,069,WA,Wahkiakum County,1403,1301,102,7.3
CN5307100000000,2023-01-01,53,071,WA,Walla Walla County,30363,28607,1756,5.8
CN5307300000000,2023-01-01,53,073,WA,Whatcom County,117400,110892,6508,5.5
CN5307500000000,2023-01-01,53,075,WA,Whitman County,23784,22694,1090,4.6
CN5307700000000,2023-01-01,53,077,WA,Yakima County,129419,116883,12536,9.7
CN5400100000000,2023-01-01,54,001,WV,Barbour County,7385,7003,382,5.2
CN5400300000000,2023-01-01,54,003,WV,Berkeley County,58929,57063,1866,3.2
CN5400500000000,2023-01-01,54,005,WV,Boone County,6890,6598,292,4.2
CN5400700000000,2023-01-01,54,007,WV,Braxton County,4914,4592,322,6.6
CN5400900000000,2023-01-01,54,009,WV,Brooke County,9713,9236,477,4.9
CN5401100000000,2023-01-01,54,011,WV,Cabell County,41144,39708,1436,3.5
CN5401300000000,2023-01-01,54,013,WV,Calhoun County,2526,2260,266,10.5
CN5401500000000,2023-01-01,54,015,WV,Clay County,2926,2715,211,7.2
CN5401700000000,2023-01-01,54,017,WV,Doddridge County,3846,3698,148,3.8
CN5401900000000,2023-01-01,54,019,WV,Fayette County,15608,14827,781,5
CN5402100000000,2023-01-01,54,021,WV,Gilmer County,2191,2063,128,5.8
CN5402300000000,2023-01-01,54,023,WV,Grant County,5885,5633,252,4.3
CN5402500000000,2023-01-01,54,025,WV,Greenbrier County,14762,14107,655,4.4
CN5402700000000,2023-01-01,54,027,WV,Hampshire County,11108,10777,331,3
CN5402900000000,2023-01-01,54,029,WV,Hancock County,13011,12173,838,6.4
CN5403100000000,2023-01-01,54,031,WV,Hardy County,5632,5350,282,5
CN5403300000000,2023-01-01,54,033,WV,Harrison County,33405,32165,1240,3.7
CN5403500000000,2023-01-01,54,035,WV,Jackson County,11580,11015,565,4.9
CN5403700000000,2023-01-01,54,037,WV,Jefferson County,30070,29292,778,2.6
CN5403900000000,2023-01-01,54,039,WV,Kanawha County,78094,75056,3038,3.9
CN5404100000000,2023-01-01,54,041,WV,Lewis County,6407,6062,345,5.4
CN5404300000000,2023-01-01,54,043,WV,Lincoln County,7034,6652,382,5.4
CN5404500000000,2023-01-01,54,045,WV,Logan County,10819,10345,474,4.4
CN5404700000000,2023-01-01,54,047,WV,McDowell County,4114,3844,270,6.6
CN5404900000000,2023-01-01,54,049,WV,Marion County,25074,24008,1066,4.3
CN5405100000000,2023-01-01,54,051,WV,Marshall County,12875,12072,803,6.2
CN5405300000000,2023-01-01,54,053,WV,Mason County,10491,9979,512,4.9
CN5405500000000,2023-01-01,54,055,WV,Mercer County,20499,19584,915,4.5
CN5405700000000,2023-01-01,54,057,WV,Mineral County,12354,11845,509,4.1
CN5405900000000,2023-01-01,54,059,WV,Mingo County,6503,6152,351,5.4
CN5406100000000,2023-01-01,54,061,WV,Monongalia County,54328,52548,1780,3.3
CN5406300000000,2023-01-01,54,063,WV,Monroe County,5951,5768,183,3.1
CN5406500000000,2023-01-01,54,065,WV,Morgan County,8326,8065,261,3.1
CN5406700000000,2023-01-01,54,067,WV,Nicholas County,8743,8319,424,4.8
CN5406900000000,2023-01-01,54,069,WV,Ohio County,19412,18591,821,4.2
CN5407100000000,2023-01-01,54,071,WV,Pendleton County,3671,3562,109,3
CN5407300000000,2023-01-01,54,073,WV,Pleasants County,2714,2532,182,6.7
CN5407500000000,2023-01-01,54,075,WV,Pocahontas County,4257,4103,154,3.6
CN5407700000000,2023-01-01,54,077,WV,Preston County,15215,14526,689,4.5
CN5407900000000,2023-01-01,54,079,WV,Putnam County,26831,25903,928,3.5
CN5408100000000,2023-01-01,54,081,WV,Raleigh County,29366,28253,1113,3.8
CN5408300000000,2023-01-01,54,083,WV,Randolph County,11584,10958,626,5.4
CN5408500000000,2023-01-01,54,085,WV,Ritchie County,4213,4030,183,4.3
CN5408700000000,2023-01-01,54,087,WV,Roane County,4852,4461,391,8.1
CN5408900000000,2023-01-01,54,089,WV,Summers County,4665,4470,195,4.2
CN5409100000000,2023-01-01,54,091,WV,Taylor County,7836,7504,332,4.2
CN5409300000000,2023-01-01,54,093,WV,Tucker County,3440,3295,145,4.2
CN5409500000000,2023-01-01,54,095,WV,Tyler County,2924,2729,195,6.7
CN5409700000000,2023-01-01,54,097,WV,Upshur County,9565,9063,502,5.2
CN5409900000000,2023-01-01,54,099,WV,Wayne County,15548,14863,685,4.4
CN5410100000000,2023-01-01,54,101,WV,Webster County,2952,2807,145,4.9
CN5410300000000,2023-01-01,54,103,WV,Wetzel County,6476,5993,483,7.5
CN5410500000000,2023-01-01,54,105,WV,Wirt County,2254,2083,171,7.6
CN5410700000000,2023-01-01,54,107,WV,Wood County,36140,34469,1671,4.6
CN5410900000000,2023-01-01,54,109,WV,Wyoming County,7220,6913,307,4.3
CN5500100000000,2023-01-01,55,001,WI,Adams County,7432,6988,444,6
CN5500300000000,2023-01-01,55,003,WI,Ashland County,7076,6810,266,3.8
CN5500500000000,2023-01-01,55,005,WI,Barron County,23236,22376,860,3.7
CN5500700000000,2023-01-01,55,007,WI,Bayfield County,7006,6668,338,4.8
CN5500900000000,2023-01-01,55,009,WI,Brown County,141179,138006,3173,2.2
CN5501100000000,2023-01-01,55,011,WI,Buffalo County,6030,5750,280,4.6
CN5501300000000,2023-01-01,55,013,WI,Burnett County,6949,6581,368,5.3
CN5501500000000,2023-01-01,55,015,WI,Calumet County,27494,26959,535,1.9
CN5501700000000,2023-01-01,55,017,WI,Chippewa County,33457,32154,1303,3.9
CN5501900000000,2023-01-01,55,019,WI,Clark County,17224,16753,471,2.7
CN5502100000000,2023-01-01,55,021,WI,Columbia County,31368,30580,788,2.5
CN5502300000000,2023-01-01,55,023,WI,Crawford County,6792,6489,303,4.5
CN5502500000000,2023-01-01,55,025,WI,Dane County,325294,319162,6132,1.9
CN5502700000000,2023-01-01,55,027,WI,Dodge County,46685,45522,1163,2.5
CN5502900000000,2023-01-01,55,029,WI,Door County,13579,13065,514,3.8
CN5503100000000,2023-01-01,55,031,WI,Douglas County,22525,21656,869,3.9
CN5503300000000,2023-01-01,55,033,WI,Dunn County,23569,22824,745,3.2
CN5503500000000,2023-01-01,55,035,WI,Eau Claire County,59019,57607,1412,2.4
CN5503700000000,2023-01-01,55,037,WI,Florence County,2084,2009,75,3.6
CN5503900000000,2023-01-01,55,039,WI,Fond du Lac County,55963,54678,1285,2.3
CN5504100000000,2023-01-01,55,041,WI,Forest County,3833,3645,188,4.9
CN5504300000000,2023-01-01,55,043,WI,Grant County,26146,25427,719,2.7
CN5504500000000,2023-01-01,55,045,WI,Green County,20562,20051,511,2.5
CN5504700000000,2023-01-01,55,047,WI,Green Lake County,8790,8494,296,3.4
CN5504900000000,2023-01-01,55,049,WI,Iowa County,13456,13074,382,2.8
CN5505100000000,2023-01-01,55,051,WI,Iron County,2503,2367,136,5.4
CN5505300000000,2023-01-01,55,053,WI,Jackson County,9191,8785,406,4.4
CN5505500000000,2023-01-01,55,055,WI,Jefferson County,45485,44341,1144,2.5
CN5505700000000,2023-01-01,55,057,WI,Juneau County,13068,12656,412,3.2
CN5505900000000,2023-01-01,55,059,WI,Kenosha County,88477,85968,2509,2.8
CN5506100000000,2023-01-01,55,061,WI,Kewaunee County,10792,10542,250,2.3
CN5506300000000,2023-01-01,55,063,WI,La Crosse County,66204,64724,1480,2.2
CN5506500000000,2023-01-01,55,065,WI,Lafayette County,9967,9695,272,2.7
CN5506700000000,2023-01-01,55,067,WI,Langlade County,9127,8817,310,3.4
CN5506900000000,2023-01-01,55,069,WI,Lincoln County,14580,14145,435,3
CN5507100000000,2023-01-01,55,071,WI,Manitowoc County,39527,38394,1133,2.9
CN5507300000000,2023-01-01,55,073,WI,Marathon County,72492,70856,1636,2.3
CN5507500000000,2023-01-01,55,075,WI,Marinette County,18568,17926,642,3.5
CN5507700000000,2023-01-01,55,077,WI,Marquette County,7494,7174,320,4.3
CN5507800000000,2023-01-01,55,078,WI,Menominee County,1453,1398,55,3.8
CN5507900000000,2023-01-01,55,079,WI,Milwaukee County,449171,435805,13366,3
CN5508100000000,2023-01-01,55,081,WI,Monroe County,22846,22245,601,2.6
CN5508300000000,2023-01-01,55,083,WI,Oconto County,20645,20008,637,3.1
CN5508500000000,2023-01-01,55,085,WI,Oneida County,17237,16596,641,3.7
CN5508700000000,2023-01-01,55,087,WI,Outagamie County,104093,101841,2252,2.2
CN5508900000000,2023-01-01,55,089,WI,Ozaukee County,47954,46944,1010,2.1
CN5509100000000,2023-01-01,55,091,WI,Pepin County,3901,3743,158,4.1
CN5509300000000,2023-01-01,55,093,WI,Pierce County,24288,23484,804,3.3
CN5509500000000,2023-01-01,55,095,WI,Polk County,24348,23244,1104,4.5
CN5509700000000,2023-01-01,55,097,WI,Portage County,36710,35698,1012,2.8
CN5509900000000,2023-01-01,55,099,WI,Price County,6051,5849,202,3.3
CN5510100000000,2023-01-01,55,101,WI,Racine County,97376,94406,2970,3.1
CN5510300000000,2023-01-01,55,103,WI,Richland County,8672,8410,262,3
CN5510500000000,2023-01-01,55,105,WI,Rock County,84995,82459,2536,3
CN5510700000000,2023-01-01,55,107,WI,Rusk County,6449,6215,234,3.6
CN5510900000000,2023-01-01,55,109,WI,St. Croix County,49441,47789,1652,3.3
CN5511100000000,2023-01-01,55,111,WI,Sauk County,33283,32398,885,2.7
CN5511300000000,2023-01-01,55,113,WI,Sawyer County,7567,7241,326,4.3
CN5511500000000,2023-01-01,55,115,WI,Shawano County,20092,19546,546,2.7
CN5511700000000,2023-01-01,55,117,WI,Sheboygan County,60961,59710,1251,2.1
CN5511900000000,2023-01-01,55,119,WI,Taylor County,10435,9997,438,4.2
CN5512100000000,2023-01-01,55,121,WI,Trempealeau County,14564,14031,533,3.7
CN5512300000000,2023-01-01,55,123,WI,Vernon County,15030,14567,463,3.1
CN5512500000000,2023-01-01,55,125,WI,Vilas County,9638,9244,394,4.1
CN5512700000000,2023-01-01,55,127,WI,Walworth County,55918,54408,1510,2.7
CN5512900000000,2023-01-01,55,129,WI,Washburn County,7360,7080,280,3.8
CN5513100000000,2023-01-01,55,131,WI,Washington County,75026,73416,1610,2.1
CN5513300000000,2023-01-01,55,133,WI,Waukesha County,219262,214550,4712,2.1
CN5513500000000,2023-01-01,55,135,WI,Waupaca County,24589,23871,718,2.9
CN5513700000000,2023-01-01,55,137,WI,Waushara County,10971,10563,408,3.7
CN5513900000000,2023-01-01,55,139,WI,Winnebago County,91890,89913,1977,2.2
CN5514100000000,2023-01-01,55,141,WI,Wood County,32712,31663,1049,3.2
CN5600100000000,2023-01-01,56,001,WY,Albany County,21755,20922,833,3.8
CN5600300000000,2023-01-01,56,003,WY,Big Horn County,5021,4761,260,5.2
CN5600500000000,2023-01-01,56,005,WY,Campbell County,23467,22537,930,4
CN5600700000000,2023-01-01,56,007,WY,Carbon County,7111,6767,344,4.8
CN5600900000000,2023-01-01,56,009,WY,Converse County,7801,7543,258,3.3
CN5601100000000,2023-01-01,56,011,WY,Crook County,3785,3649,136,3.6
CN5601300000000,2023-01-01,56,013,WY,Fremont County,19165,18170,995,5.2
CN5601500000000,2023-01-01,56,015,WY,Goshen County,6429,6200,229,3.6
CN5601700000000,2023-01-01,56,017,WY,Hot Springs County,2317,2237,80,3.5
CN5601900000000,2023-01-01,56,019,WY,Johnson County,4156,3978,178,4.3
CN5602100000000,2023-01-01,56,021,WY,Laramie County,50644,48525,2119,4.2
CN5602300000000,2023-01-01,56,023,WY,Lincoln County,9829,9393,436,4.4
CN5602500000000,2023-01-01,56,025,WY,Natrona County,40488,38648,1840,4.5
CN5602700000000,2023-01-01,56,027,WY,Niobrara County,1192,1133,59,4.9
CN5602900000000,2023-01-01,56,029,WY,Park County,14739,14048,691,4.7
CN5603100000000,2023-01-01,56,031,WY,Platte County,4366,4171,195,4.5
CN5603300000000,2023-01-01,56,033,WY,Sheridan County,16349,15646,703,4.3
CN5603500000000,2023-01-01,56,035,WY,Sublette County,3776,3582,194,5.1
CN5603700000000,2023-01-01,56,037,WY,Sweetwater County,20108,19050,1058,5.3
CN5603900000000,2023-01-01,56,039,WY,Teton County,17163,16697,466,2.7
CN5604100000000,2023-01-01,56,041,WY,Uinta County,9084,8672,412,4.5
CN5604300000000,2023-01-01,56,043,WY,Washakie County,3856,3671,185,4.8
CN5604500000000,2023-01-01,56,045,WY,Weston County,3849,3737,112,2.9
CN7200100000000,2023-01-01,72,001,PR,Adjuntas Municipio,4754,4273,481,10.1
CN7200300000000,2023-01-01,72,003,PR,Aguada Municipio,13836,12905,931,6.7
CN7200500000000,2023-01-01,72,005,PR,Aguadilla Municipio,16941,15569,1372,8.1
CN7200700000000,2023-01-01,72,007,PR,Aguas Buenas Municipio,7197,6808,389,5.4
CN7200900000000,2023-01-01,72,009,PR,Aibonito Municipio,7130,6543,587,8.2
CN7201100000000,2023-01-01,72,011,PR,Anasco Municipio,10452,9809,643,6.2
CN7201300000000,2023-01-01,72,013,PR,Arecibo Municipio,26765,25134,1631,6.1
CN7201500000000,2023-01-01,72,015,PR,Arroyo Municipio,5102,4659,443,8.7
CN7201700000000,2023-01-01,72,017,PR,Barceloneta Municipio,6519,6045,474,7.3
CN7201900000000,2023-01-01,72,019,PR,Barranquitas Municipio,8118,7543,575,7.1
CN7202100000000,2023-01-01,72,021,PR,Bayamon Municipio,71596,68563,3033,4.2
CN7202300000000,2023-01-01,72,023,PR,Cabo Rojo Municipio,15552,14586,966,6.2
CN7202500000000,2023-01-01,72,025,PR,Caguas Municipio,52848,50647,2201,4.2
CN7202700000000,2023-01-01,72,027,PR,Camuy Municipio,10835,10137,698,6.4
CN7202900000000,2023-01-01,72,029,PR,Canovanas Municipio,18048,17270,778,4.3
CN7203100000000,2023-01-01,72,031,PR,Carolina Municipio,67621,64934,2687,4
CN7203300000000,2023-01-01,72,033,PR,Catano Municipio,8501,8166,335,3.9
CN7203500000000,2023-01-01,72,035,PR,Cayey Municipio,17896,17080,816,4.6
CN7203700000000,2023-01-01,72,037,PR,Ceiba Municipio,3966,3709,257,6.5
CN7203900000000,2023-01-01,72,039,PR,Ciales Municipio,4006,3733,273,6.8
CN7204100000000,2023-01-01,72,041,PR,Cidra Municipio,17131,16381,750,4.4
CN7204300000000,2023-01-01,72,043,PR,Coamo Municipio,11565,10707,858,7.4
CN7204500000000,2023-01-01,72,045,PR,Comerio Municipio,5443,5101,342,6.3
CN7204700000000,2023-01-01,72,047,PR,Corozal Municipio,9702,9094,608,6.3
CN7204900000000,2023-01-01,72,049,PR,Culebra Municipio,972,956,16,1.6
CN7205100000000,2023-01-01,72,051,PR,Dorado Municipio,14998,14371,627,4.2
CN7205300000000,2023-01-01,72,053,PR,Fajardo Municipio,11647,10923,724,6.2
CN7205400000000,2023-01-01,72,054,PR,Florida Municipio,3637,3345,292,8
CN7205500000000,2023-01-01,72,055,PR,Guanica Municipio,4360,3856,504,11.6
CN7205700000000,2023-01-01,72,057,PR,Guayama Municipio,11852,11140,712,6
CN7205900000000,2023-01-01,72,059,PR,Guayanilla Municipio,5413,4784,629,11.6
CN7206100000000,2023-01-01,72,061,PR,Guaynabo Municipio,42014,40932,1082,2.6
CN7206300000000,2023-01-01,72,063,PR,Gurabo Municipio,20833,20083,750,3.6
CN7206500000000,2023-01-01,72,065,PR,Hatillo Municipio,15894,14117,1777,11.2
CN7206700000000,2023-01-01,72,067,PR,Hormigueros Municipio,6176,5877,299,4.8
CN7206900000000,2023-01-01,72,069,PR,Humacao Municipio,19569,18299,1270,6.5
CN7207100000000,2023-01-01,72,071,PR,Isabela Municipio,13793,12914,879,6.4
CN7207300000000,2023-01-01,72,073,PR,Jayuya Municipio,4802,4385,417,8.7
CN7207500000000,2023-01-01,72,075,PR,Juana Diaz Municipio,17553,16382,1171,6.7
CN7207700000000,2023-01-01,72,077,PR,Juncos Municipio,13802,12986,816,5.9
CN7207900000000,2023-01-01,72,079,PR,Lajas Municipio,5882,5323,559,9.5
CN7208100000000,2023-01-01,72,081,PR,Lares Municipio,8247,7328,919,11.1
CN7208300000000,2023-01-01,72,083,PR,Las Marias Municipio,2837,2448,389,13.7
CN7208500000000,2023-01-01,72,085,PR,Las Piedras Municipio,12692,11990,702,5.5
CN7208700000000,2023-01-01,72,087,PR,Loiza Municipio,9131,8693,438,4.8
CN7208900000000,2023-01-01,72,089,PR,Luquillo Municipio,6770,6391,379,5.6
CN7209100000000,2023-01-01,72,091,PR,Manati Municipio,12412,11750,662,5.3
CN7209300000000,2023-01-01,72,093,PR,Maricao Municipio,2203,1960,243,11
CN7209500000000,2023-01-01,72,095,PR,Maunabo Municipio,3226,2809,417,12.9
CN7209700000000,2023-01-01,72,097,PR,Mayaguez Municipio,24813,23330,1483,6
CN7209900000000,2023-01-01,72,099,PR,Moca Municipio,12302,11321,981,8
CN7210100000000,2023-01-01,72,101,PR,Morovis Municipio,8887,8371,516,5.8
CN7210300000000,2023-01-01,72,103,PR,Naguabo Municipio,9108,8632,476,5.2
CN7210500000000,2023-01-01,72,105,PR,Naranjito Municipio,7806,7323,483,6.2
CN7210700000000,2023-01-01,72,107,PR,Orocovis Municipio,5431,4950,481,8.9
CN7210900000000,2023-01-01,72,109,PR,Patillas Municipio,4592,4128,464,10.1
CN7211100000000,2023-01-01,72,111,PR,Penuelas Municipio,6346,5698,648,10.2
CN7211300000000,2023-01-01,72,113,PR,Ponce Municipio,49978,46678,3300,6.6
CN7211500000000,2023-01-01,72,115,PR,Quebradillas Municipio,6796,6289,507,7.5
CN7211700000000,2023-01-01,72,117,PR,Rincon Municipio,5679,4977,702,12.4
CN7211900000000,2023-01-01,72,119,PR,Rio Grande Municipio,18687,17862,825,4.4
CN7212100000000,2023-01-01,72,121,PR,Sabana Grande Municipio,6599,6080,519,7.9
CN7212300000000,2023-01-01,72,123,PR,Salinas Municipio,7718,7042,676,8.8
CN7212500000000,2023-01-01,72,125,PR,San German Municipio,10809,9965,844,7.8
CN7212700000000,2023-01-01,72,127,PR,San Juan Municipio,147684,141874,5810,3.9
CN7212900000000,2023-01-01,72,129,PR,San Lorenzo Municipio,12819,12093,726,5.7
CN7213100000000,2023-01-01,72,131,PR,San Sebastian Municipio,11795,10605,1190,10.1
CN7213300000000,2023-01-01,72,133,PR,Santa Isabel Municipio,8708,8041,667,7.7
CN7213500000000,2023-01-01,72,135,PR,Toa Alta Municipio,30829,29658,1171,3.8
CN7213700000000,2023-01-01,72,137,PR,Toa Baja Municipio,32053,30790,1263,3.9
CN7213900000000,2023-01-01,72,139,PR,Trujillo Alto Municipio,29842,29092,750,2.5
CN7214100000000,2023-01-01,72,141,PR,Utuado Municipio,7678,7070,608,7.9
CN7214300000000,2023-01-01,72,143,PR,Vega Alta Municipio,10752,10182,570,5.3
CN7214500000000,2023-01-01,72,145,PR,Vega Baja Municipio,14548,13556,992,6.8
CN7214700000000,2023-01-01,72,147,PR,Vieques Municipio,2712,2606,106,3.9
CN7214900000000,2023-01-01,72,149,PR,Villalba Municipio,8082,7127,955,11.8
CN7215100000000,2023-01-01,72,151,PR,Yabucoa Municipio,9521,8717,804,8.4
CN7215300000000,2023-01-01,72,153,PR,Yauco Municipio,10988,9557,1431,13
CN0100100000000,2023-02-01,01,001,AL,Autauga County,26808,26254,554,2.1
CN0100300000000,2023-02-01,01,003,AL,Baldwin County,102717,100439,2278,2.2
CN0100500000000,2023-02-01,01,005,AL,Barbour County,8090,7750,340,4.2
CN0100700000000,2023-02-01,01,007,AL,Bibb County,8654,8454,200,2.3
CN0100900000000,2023-02-01,01,009,AL,Blount County,25369,24859,510,2
CN0101100000000,2023-02-01,01,011,AL,Bullock County,4270,4169,101,2.4
CN0101300000000,2023-02-01,01,013,AL,Butler County,8692,8429,263,3
CN0101500000000,2023-02-01,01,015,AL,Calhoun County,46224,45050,1174,2.5
CN0101700000000,2023-02-01,01,017,AL,Chambers County,15950,15590,360,2.3
CN0101900000000,2023-02-01,01,019,AL,Cherokee County,11544,11275,269,2.3
CN0102100000000,2023-02-01,01,021,AL,Chilton County,19931,19508,423,2.1
CN0102300000000,2023-02-01,01,023,AL,Choctaw County,4143,3986,157,3.8
CN0102500000000,2023-02-01,01,025,AL,Clarke County,7577,7204,373,4.9
CN0102700000000,2023-02-01,01,027,AL,Clay County,5997,5848,149,2.5
CN0102900000000,2023-02-01,01,029,AL,Cleburne County,5969,5838,131,2.2
CN0103100000000,2023-02-01,01,031,AL,Coffee County,21311,20785,526,2.5
CN0103300000000,2023-02-01,01,033,AL,Colbert County,23772,23102,670,2.8
CN0103500000000,2023-02-01,01,035,AL,Conecuh County,4110,3975,135,3.3
CN0103700000000,2023-02-01,01,037,AL,Coosa County,4470,4352,118,2.6
CN0103900000000,2023-02-01,01,039,AL,Covington County,14456,14059,397,2.7
CN0104100000000,2023-02-01,01,041,AL,Crenshaw County,5630,5488,142,2.5
CN0104300000000,2023-02-01,01,043,AL,Cullman County,38452,37686,766,2
CN0104500000000,2023-02-01,01,045,AL,Dale County,20808,20295,513,2.5
CN0104700000000,2023-02-01,01,047,AL,Dallas County,13292,12612,680,5.1
CN0104900000000,2023-02-01,01,049,AL,DeKalb County,30420,29748,672,2.2
CN0105100000000,2023-02-01,01,051,AL,Elmore County,38400,37627,773,2
CN0105300000000,2023-02-01,01,053,AL,Escambia County,14159,13720,439,3.1
CN0105500000000,2023-02-01,01,055,AL,Etowah County,38959,37903,1056,2.7
CN0105700000000,2023-02-01,01,057,AL,Fayette County,6489,6338,151,2.3
CN0105900000000,2023-02-01,01,059,AL,Franklin County,14499,14164,335,2.3
CN0106100000000,2023-02-01,01,061,AL,Geneva County,11015,10774,241,2.2
CN0106300000000,2023-02-01,01,063,AL,Greene County,2766,2615,151,5.5
CN0106500000000,2023-02-01,01,065,AL,Hale County,5793,5599,194,3.3
CN0106700000000,2023-02-01,01,067,AL,Henry County,7007,6839,168,2.4
CN0106900000000,2023-02-01,01,069,AL,Houston County,48481,47337,1144,2.4
CN0107100000000,2023-02-01,01,071,AL,Jackson County,22703,22151,552,2.4
CN0107300000000,2023-02-01,01,073,AL,Jefferson County,322195,314716,7479,2.3
CN0107500000000,2023-02-01,01,075,AL,Lamar County,5618,5481,137,2.4
CN0107700000000,2023-02-01,01,077,AL,Lauderdale County,42693,41688,1005,2.4
CN0107900000000,2023-02-01,01,079,AL,Lawrence County,14780,14442,338,2.3
CN0108100000000,2023-02-01,01,081,AL,Lee County,80460,78731,1729,2.1
CN0108300000000,2023-02-01,01,083,AL,Limestone County,48941,47962,979,2
CN0108500000000,2023-02-01,01,085,AL,Lowndes County,3450,3302,148,4.3
CN0108700000000,2023-02-01,01,087,AL,Macon County,7817,7568,249,3.2
CN0108900000000,2023-02-01,01,089,AL,Madison County,202558,198645,3913,1.9
CN0109100000000,2023-02-01,01,091,AL,Marengo County,7519,7261,258,3.4
CN0109300000000,2023-02-01,01,093,AL,Marion County,13685,13293,392,2.9
CN0109500000000,2023-02-01,01,095,AL,Marshall County,45045,44154,891,2
CN0109700000000,2023-02-01,01,097,AL,Mobile County,193254,187755,5499,2.8
CN0109900000000,2023-02-01,01,099,AL,Monroe County,7099,6798,301,4.2
CN0110100000000,2023-02-01,01,101,AL,Montgomery County,107846,104808,3038,2.8
CN0110300000000,2023-02-01,01,103,AL,Morgan County,61540,60385,1155,1.9
CN0110500000000,2023-02-01,01,105,AL,Perry County,2879,2747,132,4.6
CN0110700000000,2023-02-01,01,107,AL,Pickens County,7658,7449,209,2.7
CN0110900000000,2023-02-01,01,109,AL,Pike County,16065,15672,393,2.4
CN0111100000000,2023-02-01,01,111,AL,Randolph County,9490,9270,220,2.3
CN0111300000000,2023-02-01,01,113,AL,Russell County,24142,23583,559,2.3
CN0111500000000,2023-02-01,01,115,AL,St. Clair County,41932,41107,825,2
CN0111700000000,2023-02-01,01,117,AL,Shelby County,121019,118958,2061,1.7
CN0111900000000,2023-02-01,01,119,AL,Sumter County,4487,4356,131,2.9
CN0112100000000,2023-02-01,01,121,AL,Talladega County,36967,35982,985,2.7
CN0112300000000,2023-02-01,01,123,AL,Tallapoosa County,16998,16578,420,2.5
CN0112500000000,2023-02-01,01,125,AL,Tuscaloosa County,105551,103323,2228,2.1
CN0112700000000,2023-02-01,01,127,AL,Walker County,25353,24695,658,2.6
CN0112900000000,2023-02-01,01,129,AL,Washington County,6490,6273,217,3.3
CN0113100000000,2023-02-01,01,131,AL,Wilcox County,2461,2263,198,8
CN0113300000000,2023-02-01,01,133,AL,Winston County,10130,9870,260,2.6
CN0201300000000,2023-02-01,02,013,AK,Aleutians East Borough,2896,2852,44,1.5
CN0201600000000,2023-02-01,02,016,AK,Aleutians West Census Area,4615,4516,99,2.1
CN0202000000000,2023-02-01,02,020,AK,Anchorage Borough/municipality,152139,147058,5081,3.3
CN0205000000000,2023-02-01,02,050,AK,Bethel Census Area,6706,6077,629,9.4
CN0206000000000,2023-02-01,02,060,AK,Bristol Bay Borough,221,198,23,10.4
CN0206300000000,2023-02-01,02,063,AK,Chugach Census Area,2964,2771,193,6.5
CN0206600000000,2023-02-01,02,066,AK,Copper River Census Area,1197,1074,123,10.3
CN0206800000000,2023-02-01,02,068,AK,Denali Borough,583,506,77,13.2
CN0207000000000,2023-02-01,02,070,AK,Dillingham Census Area,1483,1394,89,6
CN0209000000000,2023-02-01,02,090,AK,Fairbanks North Star Borough,45533,43707,1826,4
CN0210000000000,2023-02-01,02,100,AK,Haines Borough,873,781,92,10.5
CN0210500000000,2023-02-01,02,105,AK,Hoonah-Angoon Census Area,1017,905,112,11
CN0211000000000,2023-02-01,02,110,AK,Juneau Borough/city,16851,16328,523,3.1
CN0212200000000,2023-02-01,02,122,AK,Kenai Peninsula Borough,26668,25167,1501,5.6
CN0213000000000,2023-02-01,02,130,AK,Ketchikan Gateway Borough,6216,5927,289,4.6
CN0215000000000,2023-02-01,02,150,AK,Kodiak Island Borough,5978,5766,212,3.5
CN0215800000000,2023-02-01,02,158,AK,Kusilvak Census Area,2343,2029,314,13.4
CN0216400000000,2023-02-01,02,164,AK,Lake and Peninsula Borough,565,523,42,7.4
CN0217000000000,2023-02-01,02,170,AK,Matanuska-Susitna Borough,50464,47711,2753,5.5
CN0218000000000,2023-02-01,02,180,AK,Nome Census Area,4192,3894,298,7.1
CN0218500000000,2023-02-01,02,185,AK,North Slope Borough,3081,2929,152,4.9
CN0218800000000,2023-02-01,02,188,AK,Northwest Arctic Borough,2880,2578,302,10.5
CN0219500000000,2023-02-01,02,195,AK,Petersburg Borough,1358,1285,73,5.4
CN0219800000000,2023-02-01,02,198,AK,Prince of Wales-Hyder Census Area,2698,2480,218,8.1
CN0222000000000,2023-02-01,02,220,AK,Sitka Borough/city,4221,4075,146,3.5
CN0223000000000,2023-02-01,02,230,AK,Skagway Municipality,571,487,84,14.7
CN0224000000000,2023-02-01,02,240,AK,Southeast Fairbanks Census Area,3152,2967,185,5.9
CN0227500000000,2023-02-01,02,275,AK,Wrangell Borough/city,864,810,54,6.3
CN0228200000000,2023-02-01,02,282,AK,Yakutat Borough/city,279,253,26,9.3
CN0229000000000,2023-02-01,02,290,AK,Yukon-Koyukuk Census Area,2396,2155,241,10.1
CN0400100000000,2023-02-01,04,001,AZ,Apache County,18812,17497,1315,7
CN0400300000000,2023-02-01,04,003,AZ,Cochise County,49178,47178,2000,4.1
CN0400500000000,2023-02-01,04,005,AZ,Coconino County,74827,72049,2778,3.7
CN0400700000000,2023-02-01,04,007,AZ,Gila County,20373,19623,750,3.7
CN0400900000000,2023-02-01,04,009,AZ,Graham County,16579,16073,506,3.1
CN0401100000000,2023-02-01,04,011,AZ,Greenlee County,5003,4889,114,2.3
CN0401200000000,2023-02-01,04,012,AZ,La Paz County,9407,9017,390,4.1
CN0401300000000,2023-02-01,04,013,AZ,Maricopa County,2415374,2346377,68997,2.9
CN0401500000000,2023-02-01,04,015,AZ,Mohave County,90117,86486,3631,4
CN0401700000000,2023-02-01,04,017,AZ,Navajo County,39763,37763,2000,5
CN0401900000000,2023-02-01,04,019,AZ,Pima County,496780,480995,15785,3.2
CN0402100000000,2023-02-01,04,021,AZ,Pinal County,203151,196232,6919,3.4
CN0402300000000,2023-02-01,04,023,AZ,Santa Cruz County,19296,18119,1177,6.1
CN0402500000000,2023-02-01,04,025,AZ,Yavapai County,108925,105596,3329,3.1
CN0402700000000,2023-02-01,04,027,AZ,Yuma County,96589,87804,8785,9.1
CN0500100000000,2023-02-01,05,001,AR,Arkansas County,9193,8963,230,2.5
CN0500300000000,2023-02-01,05,003,AR,Ashley County,6646,6301,345,5.2
CN0500500000000,2023-02-01,05,005,AR,Baxter County,16342,15803,539,3.3
CN0500700000000,2023-02-01,05,007,AR,Benton County,154717,151393,3324,2.1
CN0500900000000,2023-02-01,05,009,AR,Boone County,15922,15461,461,2.9
CN0501100000000,2023-02-01,05,011,AR,Bradley County,4006,3814,192,4.8
CN0501300000000,2023-02-01,05,013,AR,Calhoun County,2348,2281,67,2.9
CN0501500000000,2023-02-01,05,015,AR,Carroll County,12057,11694,363,3
CN0501700000000,2023-02-01,05,017,AR,Chicot County,2880,2736,144,5
CN0501900000000,2023-02-01,05,019,AR,Clark County,8289,7956,333,4
CN0502100000000,2023-02-01,05,021,AR,Clay County,5295,5081,214,4
CN0502300000000,2023-02-01,05,023,AR,Cleburne County,8806,8459,347,3.9
CN0502500000000,2023-02-01,05,025,AR,Cleveland County,3072,2971,101,3.3
CN0502700000000,2023-02-01,05,027,AR,Columbia County,8819,8480,339,3.8
CN0502900000000,2023-02-01,05,029,AR,Conway County,8294,8008,286,3.4
CN0503100000000,2023-02-01,05,031,AR,Craighead County,57993,56637,1356,2.3
CN0503300000000,2023-02-01,05,033,AR,Crawford County,26322,25603,719,2.7
CN0503500000000,2023-02-01,05,035,AR,Crittenden County,20649,19874,775,3.8
CN0503700000000,2023-02-01,05,037,AR,Cross County,6762,6542,220,3.3
CN0503900000000,2023-02-01,05,039,AR,Dallas County,2689,2586,103,3.8
CN0504100000000,2023-02-01,05,041,AR,Desha County,4842,4636,206,4.3
CN0504300000000,2023-02-01,05,043,AR,Drew County,7438,7148,290,3.9
CN0504500000000,2023-02-01,05,045,AR,Faulkner County,63164,61453,1711,2.7
CN0504700000000,2023-02-01,05,047,AR,Franklin County,7453,7236,217,2.9
CN0504900000000,2023-02-01,05,049,AR,Fulton County,4950,4799,151,3.1
CN0505100000000,2023-02-01,05,051,AR,Garland County,42081,40670,1411,3.4
CN0505300000000,2023-02-01,05,053,AR,Grant County,8435,8215,220,2.6
CN0505500000000,2023-02-01,05,055,AR,Greene County,19812,19246,566,2.9
CN0505700000000,2023-02-01,05,057,AR,Hempstead County,9343,9077,266,2.8
CN0505900000000,2023-02-01,05,059,AR,Hot Spring County,13844,13432,412,3
CN0506100000000,2023-02-01,05,061,AR,Howard County,5278,5121,157,3
CN0506300000000,2023-02-01,05,063,AR,Independence County,16632,16153,479,2.9
CN0506500000000,2023-02-01,05,065,AR,Izard County,4447,4258,189,4.3
CN0506700000000,2023-02-01,05,067,AR,Jackson County,5407,5158,249,4.6
CN0506900000000,2023-02-01,05,069,AR,Jefferson County,25454,24383,1071,4.2
CN0507100000000,2023-02-01,05,071,AR,Johnson County,10050,9683,367,3.7
CN0507300000000,2023-02-01,05,073,AR,Lafayette County,2299,2193,106,4.6
CN0507500000000,2023-02-01,05,075,AR,Lawrence County,6865,6672,193,2.8
CN0507700000000,2023-02-01,05,077,AR,Lee County,2542,2419,123,4.8
CN0507900000000,2023-02-01,05,079,AR,Lincoln County,3679,3540,139,3.8
CN0508100000000,2023-02-01,05,081,AR,Little River County,5177,5005,172,3.3
CN0508300000000,2023-02-01,05,083,AR,Logan County,8167,7879,288,3.5
CN0508500000000,2023-02-01,05,085,AR,Lonoke County,34185,33349,836,2.4
CN0508700000000,2023-02-01,05,087,AR,Madison County,7912,7731,181,2.3
CN0508900000000,2023-02-01,05,089,AR,Marion County,6221,5993,228,3.7
CN0509100000000,2023-02-01,05,091,AR,Miller County,18661,18039,622,3.3
CN0509300000000,2023-02-01,05,093,AR,Mississippi County,16118,15451,667,4.1
CN0509500000000,2023-02-01,05,095,AR,Monroe County,2523,2422,101,4
CN0509700000000,2023-02-01,05,097,AR,Montgomery County,2763,2635,128,4.6
CN0509900000000,2023-02-01,05,099,AR,Nevada County,3424,3325,99,2.9
CN0510100000000,2023-02-01,05,101,AR,Newton County,3201,3106,95,3
CN0510300000000,2023-02-01,05,103,AR,Ouachita County,9591,9242,349,3.6
CN0510500000000,2023-02-01,05,105,AR,Perry County,4210,4079,131,3.1
CN0510700000000,2023-02-01,05,107,AR,Phillips County,5514,5158,356,6.5
CN0510900000000,2023-02-01,05,109,AR,Pike County,3929,3806,123,3.1
CN0511100000000,2023-02-01,05,111,AR,Poinsett County,10009,9724,285,2.8
CN0511300000000,2023-02-01,05,113,AR,Polk County,7828,7571,257,3.3
CN0511500000000,2023-02-01,05,115,AR,Pope County,27492,26570,922,3.4
CN0511700000000,2023-02-01,05,117,AR,Prairie County,3508,3413,95,2.7
CN0511900000000,2023-02-01,05,119,AR,Pulaski County,189004,183556,5448,2.9
CN0512100000000,2023-02-01,05,121,AR,Randolph County,7201,6948,253,3.5
CN0512300000000,2023-02-01,05,123,AR,St. Francis County,7409,7070,339,4.6
CN0512500000000,2023-02-01,05,125,AR,Saline County,60029,58546,1483,2.5
CN0512700000000,2023-02-01,05,127,AR,Scott County,4269,4166,103,2.4
CN0512900000000,2023-02-01,05,129,AR,Searcy County,2787,2656,131,4.7
CN0513100000000,2023-02-01,05,131,AR,Sebastian County,55418,53915,1503,2.7
CN0513300000000,2023-02-01,05,133,AR,Sevier County,5435,5254,181,3.3
CN0513500000000,2023-02-01,05,135,AR,Sharp County,5839,5633,206,3.5
CN0513700000000,2023-02-01,05,137,AR,Stone County,4476,4293,183,4.1
CN0513900000000,2023-02-01,05,139,AR,Union County,14625,14030,595,4.1
CN0514100000000,2023-02-01,05,141,AR,Van Buren County,5917,5688,229,3.9
CN0514300000000,2023-02-01,05,143,AR,Washington County,136576,133866,2710,2
CN0514500000000,2023-02-01,05,145,AR,White County,34198,33126,1072,3.1
CN0514700000000,2023-02-01,05,147,AR,Woodruff County,2822,2720,102,3.6
CN0514900000000,2023-02-01,05,149,AR,Yell County,7865,7595,270,3.4
CN0600100000000,2023-02-01,06,001,CA,Alameda County,832479,801063,31416,3.8
CN0600300000000,2023-02-01,06,003,CA,Alpine County,636,601,35,5.5
CN0600500000000,2023-02-01,06,005,CA,Amador County,14450,13648,802,5.6
CN0600700000000,2023-02-01,06,007,CA,Butte County,93446,88164,5282,5.7
CN0600900000000,2023-02-01,06,009,CA,Calaveras County,22386,21399,987,4.4
CN0601100000000,2023-02-01,06,011,CA,Colusa County,10491,8525,1966,18.7
CN0601300000000,2023-02-01,06,013,CA,Contra Costa County,555880,533816,22064,4
CN0601500000000,2023-02-01,06,015,CA,Del Norte County,9221,8666,555,6
CN0601700000000,2023-02-01,06,017,CA,El Dorado County,94531,90697,3834,4.1
CN0601900000000,2023-02-01,06,019,CA,Fresno County,466142,427597,38545,8.3
CN0602100000000,2023-02-01,06,021,CA,Glenn County,13106,12190,916,7
CN0602300000000,2023-02-01,06,023,CA,Humboldt County,60061,57176,2885,4.8
CN0602500000000,2023-02-01,06,025,CA,Imperial County,71881,60568,11313,15.7
CN0602700000000,2023-02-01,06,027,CA,Inyo County,8337,7985,352,4.2
CN0602900000000,2023-02-01,06,029,CA,Kern County,399538,363519,36019,9
CN0603100000000,2023-02-01,06,031,CA,Kings County,58635,53127,5508,9.4
CN0603300000000,2023-02-01,06,033,CA,Lake County,28714,26889,1825,6.4
CN0603500000000,2023-02-01,06,035,CA,Lassen County,8947,8367,580,6.5
CN0603700000000,2023-02-01,06,037,CA,Los Angeles County,5041535,4777999,263536,5.2
CN0603900000000,2023-02-01,06,039,CA,Madera County,67230,61705,5525,8.2
CN0604100000000,2023-02-01,06,041,CA,Marin County,132048,127884,4164,3.2
CN0604300000000,2023-02-01,06,043,CA,Mariposa County,7224,6711,513,7.1
CN0604500000000,2023-02-01,06,045,CA,Mendocino County,37357,35366,1991,5.3
CN0604700000000,2023-02-01,06,047,CA,Merced County,117383,104662,12721,10.8
CN0604900000000,2023-02-01,06,049,CA,Modoc County,3159,2870,289,9.1
CN0605100000000,2023-02-01,06,051,CA,Mono County,8936,8589,347,3.9
CN0605300000000,2023-02-01,06,053,CA,Monterey County,222466,200926,21540,9.7
CN0605500000000,2023-02-01,06,055,CA,Napa County,71827,69093,2734,3.8
CN0605700000000,2023-02-01,06,057,CA,Nevada County,49048,47026,2022,4.1
CN0605900000000,2023-02-01,06,059,CA,Orange County,1607657,1552537,55120,3.4
CN0606100000000,2023-02-01,06,061,CA,Placer County,196105,188893,7212,3.7
CN0606300000000,2023-02-01,06,063,CA,Plumas County,7159,6360,799,11.2
CN0606500000000,2023-02-01,06,065,CA,Riverside County,1156856,1103989,52867,4.6
CN0606700000000,2023-02-01,06,067,CA,Sacramento County,736498,703373,33125,4.5
CN0606900000000,2023-02-01,06,069,CA,San Benito County,33075,30895,2180,6.6
CN0607100000000,2023-02-01,06,071,CA,San Bernardino County,1012408,966754,45654,4.5
CN0607300000000,2023-02-01,06,073,CA,San Diego County,1611438,1551477,59961,3.7
CN0607500000000,2023-02-01,06,075,CA,San Francisco County/city,579642,562555,17087,2.9
CN0607700000000,2023-02-01,06,077,CA,San Joaquin County,350156,327544,22612,6.5
CN0607900000000,2023-02-01,06,079,CA,San Luis Obispo County,139964,135174,4790,3.4
CN0608100000000,2023-02-01,06,081,CA,San Mateo County,458784,446034,12750,2.8
CN0608300000000,2023-02-01,06,083,CA,Santa Barbara County,224413,214042,10371,4.6
CN0608500000000,2023-02-01,06,085,CA,Santa Clara County,1052287,1019279,33008,3.1
CN0608700000000,2023-02-01,06,087,CA,Santa Cruz County,134943,125699,9244,6.9
CN0608900000000,2023-02-01,06,089,CA,Shasta County,74172,69832,4340,5.9
CN0609100000000,2023-02-01,06,091,CA,Sierra County,1279,1200,79,6.2
CN0609300000000,2023-02-01,06,093,CA,Siskiyou County,16533,15225,1308,7.9
CN0609500000000,2023-02-01,06,095,CA,Solano County,203263,193506,9757,4.8
CN0609700000000,2023-02-01,06,097,CA,Sonoma County,251325,242236,9089,3.6
CN0609900000000,2023-02-01,06,099,CA,Stanislaus County,244332,227777,16555,6.8
CN0610100000000,2023-02-01,06,101,CA,Sutter County,47008,42667,4341,9.2
CN0610300000000,2023-02-01,06,103,CA,Tehama County,25667,24015,1652,6.4
CN0610500000000,2023-02-01,06,105,CA,Trinity County,4442,4126,316,7.1
CN0610700000000,2023-02-01,06,107,CA,Tulare County,213153,190100,23053,10.8
CN0610900000000,2023-02-01,06,109,CA,Tuolumne County,19961,18838,1123,5.6
CN0611100000000,2023-02-01,06,111,CA,Ventura County,418229,400965,17264,4.1
CN0611300000000,2023-02-01,06,113,CA,Yolo County,110374,104744,5630,5.1
CN0611500000000,2023-02-01,06,115,CA,Yuba County,32362,29967,2395,7.4
CN0800100000000,2023-02-01,08,001,CO,Adams County,285116,274805,10311,3.6
CN0800300000000,2023-02-01,08,003,CO,Alamosa County,8236,7934,302,3.7
CN0800500000000,2023-02-01,08,005,CO,Arapahoe County,379089,367052,12037,3.2
CN0800700000000,2023-02-01,08,007,CO,Archuleta County,6954,6715,239,3.4
CN0800900000000,2023-02-01,08,009,CO,Baca County,2009,1967,42,2.1
CN0801100000000,2023-02-01,08,011,CO,Bent County,1759,1696,63,3.6
CN0801300000000,2023-02-01,08,013,CO,Boulder County,206252,200583,5669,2.7
CN0801400000000,2023-02-01,08,014,CO,Broomfield County/city,43013,41764,1249,2.9
CN0801500000000,2023-02-01,08,015,CO,Chaffee County,9865,9540,325,3.3
CN0801700000000,2023-02-01,08,017,CO,Cheyenne County,1005,979,26,2.6
CN0801900000000,2023-02-01,08,019,CO,Clear Creek County,6216,6028,188,3
CN0802100000000,2023-02-01,08,021,CO,Conejos County,3961,3829,132,3.3
CN0802300000000,2023-02-01,08,023,CO,Costilla County,1772,1684,88,5
CN0802500000000,2023-02-01,08,025,CO,Crowley County,1390,1324,66,4.7
CN0802700000000,2023-02-01,08,027,CO,Custer County,2324,2249,75,3.2
CN0802900000000,2023-02-01,08,029,CO,Delta County,12921,12348,573,4.4
CN0803100000000,2023-02-01,08,031,CO,Denver County/city,441615,426677,14938,3.4
CN0803300000000,2023-02-01,08,033,CO,Dolores County,1138,1106,32,2.8
CN0803500000000,2023-02-01,08,035,CO,Douglas County,210314,204353,5961,2.8
CN0803700000000,2023-02-01,08,037,CO,Eagle County,36979,36092,887,2.4
CN0803900000000,2023-02-01,08,039,CO,Elbert County,16081,15646,435,2.7
CN0804100000000,2023-02-01,08,041,CO,El Paso County,365898,353399,12499,3.4
CN0804300000000,2023-02-01,08,043,CO,Fremont County,14176,13404,772,5.4
CN0804500000000,2023-02-01,08,045,CO,Garfield County,32513,31456,1057,3.3
CN0804700000000,2023-02-01,08,047,CO,Gilpin County,3969,3857,112,2.8
CN0804900000000,2023-02-01,08,049,CO,Grand County,10035,9764,271,2.7
CN0805100000000,2023-02-01,08,051,CO,Gunnison County,11910,11617,293,2.5
CN0805300000000,2023-02-01,08,053,CO,Hinsdale County,386,373,13,3.4
CN0805500000000,2023-02-01,08,055,CO,Huerfano County,2405,2239,166,6.9
CN0805700000000,2023-02-01,08,057,CO,Jackson County,947,926,21,2.2
CN0805900000000,2023-02-01,08,059,CO,Jefferson County,346662,336444,10218,2.9
CN0806100000000,2023-02-01,08,061,CO,Kiowa County,853,831,22,2.6
CN0806300000000,2023-02-01,08,063,CO,Kit Carson County,4151,4070,81,2
CN0806500000000,2023-02-01,08,065,CO,Lake County,5295,5170,125,2.4
CN0806700000000,2023-02-01,08,067,CO,La Plata County,31419,30367,1052,3.3
CN0806900000000,2023-02-01,08,069,CO,Larimer County,210858,204648,6210,2.9
CN0807100000000,2023-02-01,08,071,CO,Las Animas County,6002,5712,290,4.8
CN0807300000000,2023-02-01,08,073,CO,Lincoln County,2159,2089,70,3.2
CN0807500000000,2023-02-01,08,075,CO,Logan County,10227,9934,293,2.9
CN0807700000000,2023-02-01,08,077,CO,Mesa County,77707,74728,2979,3.8
CN0807900000000,2023-02-01,08,079,CO,Mineral County,541,530,11,2
CN0808100000000,2023-02-01,08,081,CO,Moffat County,7028,6758,270,3.8
CN0808300000000,2023-02-01,08,083,CO,Montezuma County,12254,11654,600,4.9
CN0808500000000,2023-02-01,08,085,CO,Montrose County,21359,20578,781,3.7
CN0808700000000,2023-02-01,08,087,CO,Morgan County,15565,15082,483,3.1
CN0808900000000,2023-02-01,08,089,CO,Otero County,7824,7488,336,4.3
CN0809100000000,2023-02-01,08,091,CO,Ouray County,2413,2329,84,3.5
CN0809300000000,2023-02-01,08,093,CO,Park County,11745,11393,352,3
CN0809500000000,2023-02-01,08,095,CO,Phillips County,2346,2295,51,2.2
CN0809700000000,2023-02-01,08,097,CO,Pitkin County,11040,10754,286,2.6
CN0809900000000,2023-02-01,08,099,CO,Prowers County,6156,5980,176,2.9
CN0810100000000,2023-02-01,08,101,CO,Pueblo County,76967,73407,3560,4.6
CN0810300000000,2023-02-01,08,103,CO,Rio Blanco County,2828,2726,102,3.6
CN0810500000000,2023-02-01,08,105,CO,Rio Grande County,5174,4949,225,4.3
CN0810700000000,2023-02-01,08,107,CO,Routt County,16896,16503,393,2.3
CN0810900000000,2023-02-01,08,109,CO,Saguache County,3312,3190,122,3.7
CN0811100000000,2023-02-01,08,111,CO,San Juan County,550,534,16,2.9
CN0811300000000,2023-02-01,08,113,CO,San Miguel County,6384,6254,130,2
CN0811500000000,2023-02-01,08,115,CO,Sedgwick County,967,932,35,3.6
CN0811700000000,2023-02-01,08,117,CO,Summit County,24048,23558,490,2
CN0811900000000,2023-02-01,08,119,CO,Teller County,13682,13241,441,3.2
CN0812100000000,2023-02-01,08,121,CO,Washington County,2724,2662,62,2.3
CN0812300000000,2023-02-01,08,123,CO,Weld County,170931,165035,5896,3.4
CN0812500000000,2023-02-01,08,125,CO,Yuma County,5352,5238,114,2.1
CN0900100000000,2023-02-01,09,001,CT,Fairfield County,476358,454009,22349,4.7
CN0900300000000,2023-02-01,09,003,CT,Hartford County,472767,451206,21561,4.6
CN0900500000000,2023-02-01,09,005,CT,Litchfield County,103106,98314,4792,4.6
CN0900700000000,2023-02-01,09,007,CT,Middlesex County,93071,89209,3862,4.1
CN0900900000000,2023-02-01,09,009,CT,New Haven County,464098,442410,21688,4.7
CN0901100000000,2023-02-01,09,011,CT,New London County,131511,125531,5980,4.5
CN0901300000000,2023-02-01,09,013,CT,Tolland County,85659,81921,3738,4.4
CN0901500000000,2023-02-01,09,015,CT,Windham County,63229,60139,3090,4.9
CN1000100000000,2023-02-01,10,001,DE,Kent County,79949,75873,4076,5.1
CN1000300000000,2023-02-01,10,003,DE,New Castle County,305386,292183,13203,4.3
CN1000500000000,2023-02-01,10,005,DE,Sussex County,109329,103928,5401,4.9
CN1100100000000,2023-02-01,11,001,DC,District of Columbia,392256,373060,19196,4.9
CN1200100000000,2023-02-01,12,001,FL,Alachua County,144981,141280,3701,2.6
CN1200300000000,2023-02-01,12,003,FL,Baker County,12984,12668,316,2.4
CN1200500000000,2023-02-01,12,005,FL,Bay County,88170,85995,2175,2.5
CN1200700000000,2023-02-01,12,007,FL,Bradford County,11193,10899,294,2.6
CN1200900000000,2023-02-01,12,009,FL,Brevard County,300358,292565,7793,2.6
CN1201100000000,2023-02-01,12,011,FL,Broward County,1070001,1043194,26807,2.5
CN1201300000000,2023-02-01,12,013,FL,Calhoun County,4904,4755,149,3
CN1201500000000,2023-02-01,12,015,FL,Charlotte County,78423,75965,2458,3.1
CN1201700000000,2023-02-01,12,017,FL,Citrus County,50022,48112,1910,3.8
CN1201900000000,2023-02-01,12,019,FL,Clay County,116256,113442,2814,2.4
CN1202100000000,2023-02-01,12,021,FL,Collier County,191374,186663,4711,2.5
CN1202300000000,2023-02-01,12,023,FL,Columbia County,29706,28861,845,2.8
CN1202700000000,2023-02-01,12,027,FL,DeSoto County,13940,13516,424,3
CN1202900000000,2023-02-01,12,029,FL,Dixie County,5898,5716,182,3.1
CN1203100000000,2023-02-01,12,031,FL,Duval County,525425,511687,13738,2.6
CN1203300000000,2023-02-01,12,033,FL,Escambia County,150504,146472,4032,2.7
CN1203500000000,2023-02-01,12,035,FL,Flagler County,51617,49972,1645,3.2
CN1203700000000,2023-02-01,12,037,FL,Franklin County,4798,4677,121,2.5
CN1203900000000,2023-02-01,12,039,FL,Gadsden County,19351,18703,648,3.3
CN1204100000000,2023-02-01,12,041,FL,Gilchrist County,7543,7341,202,2.7
CN1204300000000,2023-02-01,12,043,FL,Glades County,5376,5220,156,2.9
CN1204500000000,2023-02-01,12,045,FL,Gulf County,5442,5321,121,2.2
CN1204700000000,2023-02-01,12,047,FL,Hamilton County,4180,4031,149,3.6
CN1204900000000,2023-02-01,12,049,FL,Hardee County,8896,8604,292,3.3
CN1205100000000,2023-02-01,12,051,FL,Hendry County,15602,15030,572,3.7
CN1205300000000,2023-02-01,12,053,FL,Hernando County,78530,75989,2541,3.2
CN1205500000000,2023-02-01,12,055,FL,Highlands County,36494,35129,1365,3.7
CN1205700000000,2023-02-01,12,057,FL,Hillsborough County,822998,802760,20238,2.5
CN1205900000000,2023-02-01,12,059,FL,Holmes County,7099,6897,202,2.8
CN1206100000000,2023-02-01,12,061,FL,Indian River County,68399,66340,2059,3
CN1206300000000,2023-02-01,12,063,FL,Jackson County,16551,16062,489,3
CN1206500000000,2023-02-01,12,065,FL,Jefferson County,5819,5661,158,2.7
CN1206700000000,2023-02-01,12,067,FL,Lafayette County,2831,2753,78,2.8
CN1206900000000,2023-02-01,12,069,FL,Lake County,174310,169574,4736,2.7
CN1207100000000,2023-02-01,12,071,FL,Lee County,384989,374135,10854,2.8
CN1207300000000,2023-02-01,12,073,FL,Leon County,162413,158135,4278,2.6
CN1207500000000,2023-02-01,12,075,FL,Levy County,17262,16736,526,3
CN1207700000000,2023-02-01,12,077,FL,Liberty County,2677,2604,73,2.7
CN1207900000000,2023-02-01,12,079,FL,Madison County,7873,7637,236,3
CN1208100000000,2023-02-01,12,081,FL,Manatee County,190278,185284,4994,2.6
CN1208300000000,2023-02-01,12,083,FL,Marion County,150345,145619,4726,3.1
CN1208500000000,2023-02-01,12,085,FL,Martin County,77112,75184,1928,2.5
CN1208600000000,2023-02-01,12,086,FL,Miami-Dade County,1398892,1375295,23597,1.7
CN1208700000000,2023-02-01,12,087,FL,Monroe County,51134,50295,839,1.6
CN1208900000000,2023-02-01,12,089,FL,Nassau County,45934,44836,1098,2.4
CN1209100000000,2023-02-01,12,091,FL,Okaloosa County,103647,101267,2380,2.3
CN1209300000000,2023-02-01,12,093,FL,Okeechobee County,17901,17412,489,2.7
CN1209500000000,2023-02-01,12,095,FL,Orange County,806583,786615,19968,2.5
CN1209700000000,2023-02-01,12,097,FL,Osceola County,200717,194849,5868,2.9
CN1209900000000,2023-02-01,12,099,FL,Palm Beach County,768650,748847,19803,2.6
CN1210100000000,2023-02-01,12,101,FL,Pasco County,263891,256497,7394,2.8
CN1210300000000,2023-02-01,12,103,FL,Pinellas County,521756,509130,12626,2.4
CN1210500000000,2023-02-01,12,105,FL,Polk County,342460,332003,10457,3.1
CN1210700000000,2023-02-01,12,107,FL,Putnam County,27725,26735,990,3.6
CN1210900000000,2023-02-01,12,109,FL,St. Johns County,153818,150382,3436,2.2
CN1211100000000,2023-02-01,12,111,FL,St. Lucie County,157819,153049,4770,3
CN1211300000000,2023-02-01,12,113,FL,Santa Rosa County,88347,86176,2171,2.5
CN1211500000000,2023-02-01,12,115,FL,Sarasota County,199721,194459,5262,2.6
CN1211700000000,2023-02-01,12,117,FL,Seminole County,269020,262498,6522,2.4
CN1211900000000,2023-02-01,12,119,FL,Sumter County,38386,36941,1445,3.8
CN1212100000000,2023-02-01,12,121,FL,Suwannee County,17802,17283,519,2.9
CN1212300000000,2023-02-01,12,123,FL,Taylor County,8003,7760,243,3
CN1212500000000,2023-02-01,12,125,FL,Union County,4573,4452,121,2.6
CN1212700000000,2023-02-01,12,127,FL,Volusia County,271714,264043,7671,2.8
CN1212900000000,2023-02-01,12,129,FL,Wakulla County,16277,15897,380,2.3
CN1213100000000,2023-02-01,12,131,FL,Walton County,35112,34236,876,2.5
CN1213300000000,2023-02-01,12,133,FL,Washington County,9929,9651,278,2.8
CN1300100000000,2023-02-01,13,001,GA,Appling County,9280,8955,325,3.5
CN1300300000000,2023-02-01,13,003,GA,Atkinson County,4262,4120,142,3.3
CN1300500000000,2023-02-01,13,005,GA,Bacon County,4798,4647,151,3.1
CN1300700000000,2023-02-01,13,007,GA,Baker County,1054,1010,44,4.2
CN1300900000000,2023-02-01,13,009,GA,Baldwin County,18318,17573,745,4.1
CN1301100000000,2023-02-01,13,011,GA,Banks County,10833,10581,252,2.3
CN1301300000000,2023-02-01,13,013,GA,Barrow County,43780,42529,1251,2.9
CN1301500000000,2023-02-01,13,015,GA,Bartow County,53067,51373,1694,3.2
CN1301700000000,2023-02-01,13,017,GA,Ben Hill County,5595,5328,267,4.8
CN1301900000000,2023-02-01,13,019,GA,Berrien County,7609,7338,271,3.6
CN1302100000000,2023-02-01,13,021,GA,Bibb County,66123,63494,2629,4
CN1302300000000,2023-02-01,13,023,GA,Bleckley County,4523,4321,202,4.5
CN1302500000000,2023-02-01,13,025,GA,Brantley County,7376,7100,276,3.7
CN1302700000000,2023-02-01,13,027,GA,Brooks County,6531,6289,242,3.7
CN1302900000000,2023-02-01,13,029,GA,Bryan County,20155,19583,572,2.8
CN1303100000000,2023-02-01,13,031,GA,Bulloch County,39109,37738,1371,3.5
CN1303300000000,2023-02-01,13,033,GA,Burke County,8880,8413,467,5.3
CN1303500000000,2023-02-01,13,035,GA,Butts County,11494,11145,349,3
CN1303700000000,2023-02-01,13,037,GA,Calhoun County,2078,2007,71,3.4
CN1303900000000,2023-02-01,13,039,GA,Camden County,22492,21766,726,3.2
CN1304300000000,2023-02-01,13,043,GA,Candler County,6143,5987,156,2.5
CN1304500000000,2023-02-01,13,045,GA,Carroll County,57997,56069,1928,3.3
CN1304700000000,2023-02-01,13,047,GA,Catoosa County,34041,33071,970,2.8
CN1304900000000,2023-02-01,13,049,GA,Charlton County,5100,4926,174,3.4
CN1305100000000,2023-02-01,13,051,GA,Chatham County,144303,139821,4482,3.1
CN1305300000000,2023-02-01,13,053,GA,Chattahoochee County,1932,1845,87,4.5
CN1305500000000,2023-02-01,13,055,GA,Chattooga County,9092,8705,387,4.3
CN1305700000000,2023-02-01,13,057,GA,Cherokee County,144958,141130,3828,2.6
CN1305900000000,2023-02-01,13,059,GA,Clarke County,59238,57246,1992,3.4
CN1306100000000,2023-02-01,13,061,GA,Clay County,771,709,62,8
CN1306300000000,2023-02-01,13,063,GA,Clayton County,142506,136555,5951,4.2
CN1306500000000,2023-02-01,13,065,GA,Clinch County,2949,2858,91,3.1
CN1306700000000,2023-02-01,13,067,GA,Cobb County,438380,425798,12582,2.9
CN1306900000000,2023-02-01,13,069,GA,Coffee County,19055,18285,770,4
CN1307100000000,2023-02-01,13,071,GA,Colquitt County,21366,20671,695,3.3
CN1307300000000,2023-02-01,13,073,GA,Columbia County,75588,73218,2370,3.1
CN1307500000000,2023-02-01,13,075,GA,Cook County,8221,7929,292,3.6
CN1307700000000,2023-02-01,13,077,GA,Coweta County,78916,76624,2292,2.9
CN1307900000000,2023-02-01,13,079,GA,Crawford County,5364,5195,169,3.2
CN1308100000000,2023-02-01,13,081,GA,Crisp County,9689,9284,405,4.2
CN1308300000000,2023-02-01,13,083,GA,Dade County,8117,7885,232,2.9
CN1308500000000,2023-02-01,13,085,GA,Dawson County,13562,13179,383,2.8
CN1308700000000,2023-02-01,13,087,GA,Decatur County,11664,11259,405,3.5
CN1308900000000,2023-02-01,13,089,GA,DeKalb County,411937,397980,13957,3.4
CN1309100000000,2023-02-01,13,091,GA,Dodge County,6790,6514,276,4.1
CN1309300000000,2023-02-01,13,093,GA,Dooly County,4902,4713,189,3.9
CN1309500000000,2023-02-01,13,095,GA,Dougherty County,36509,34878,1631,4.5
CN1309700000000,2023-02-01,13,097,GA,Douglas County,76359,73672,2687,3.5
CN1309900000000,2023-02-01,13,099,GA,Early County,4344,4184,160,3.7
CN1310100000000,2023-02-01,13,101,GA,Echols County,1801,1743,58,3.2
CN1310300000000,2023-02-01,13,103,GA,Effingham County,33736,32808,928,2.8
CN1310500000000,2023-02-01,13,105,GA,Elbert County,8108,7816,292,3.6
CN1310700000000,2023-02-01,13,107,GA,Emanuel County,8845,8475,370,4.2
CN1310900000000,2023-02-01,13,109,GA,Evans County,4965,4822,143,2.9
CN1311100000000,2023-02-01,13,111,GA,Fannin County,12175,11794,381,3.1
CN1311300000000,2023-02-01,13,113,GA,Fayette County,60586,58817,1769,2.9
CN1311500000000,2023-02-01,13,115,GA,Floyd County,45268,43735,1533,3.4
CN1311700000000,2023-02-01,13,117,GA,Forsyth County,132149,128770,3379,2.6
CN1311900000000,2023-02-01,13,119,GA,Franklin County,9827,9498,329,3.3
CN1312100000000,2023-02-01,13,121,GA,Fulton County,584940,564644,20296,3.5
CN1312300000000,2023-02-01,13,123,GA,Gilmer County,12375,11950,425,3.4
CN1312500000000,2023-02-01,13,125,GA,Glascock County,1233,1189,44,3.6
CN1312700000000,2023-02-01,13,127,GA,Glynn County,40177,38951,1226,3.1
CN1312900000000,2023-02-01,13,129,GA,Gordon County,29173,28223,950,3.3
CN1313100000000,2023-02-01,13,131,GA,Grady County,10866,10543,323,3
CN1313300000000,2023-02-01,13,133,GA,Greene County,7255,6999,256,3.5
CN1313500000000,2023-02-01,13,135,GA,Gwinnett County,508799,493805,14994,2.9
CN1313700000000,2023-02-01,13,137,GA,Habersham County,19000,18337,663,3.5
CN1313900000000,2023-02-01,13,139,GA,Hall County,108865,106069,2796,2.6
CN1314100000000,2023-02-01,13,141,GA,Hancock County,2514,2387,127,5.1
CN1314300000000,2023-02-01,13,143,GA,Haralson County,13208,12770,438,3.3
CN1314500000000,2023-02-01,13,145,GA,Harris County,17139,16620,519,3
CN1314700000000,2023-02-01,13,147,GA,Hart County,12298,11915,383,3.1
CN1314900000000,2023-02-01,13,149,GA,Heard County,5382,5208,174,3.2
CN1315100000000,2023-02-01,13,151,GA,Henry County,122941,118607,4334,3.5
CN1315300000000,2023-02-01,13,153,GA,Houston County,71221,68987,2234,3.1
CN1315500000000,2023-02-01,13,155,GA,Irwin County,3450,3288,162,4.7
CN1315700000000,2023-02-01,13,157,GA,Jackson County,46362,45311,1051,2.3
CN1315900000000,2023-02-01,13,159,GA,Jasper County,7256,7054,202,2.8
CN1316100000000,2023-02-01,13,161,GA,Jeff Davis County,6193,5913,280,4.5
CN1316300000000,2023-02-01,13,163,GA,Jefferson County,6595,6344,251,3.8
CN1316500000000,2023-02-01,13,165,GA,Jenkins County,3452,3290,162,4.7
CN1316700000000,2023-02-01,13,167,GA,Johnson County,3952,3823,129,3.3
CN1316900000000,2023-02-01,13,169,GA,Jones County,13380,12964,416,3.1
CN1317100000000,2023-02-01,13,171,GA,Lamar County,8495,8203,292,3.4
CN1317300000000,2023-02-01,13,173,GA,Lanier County,3797,3643,154,4.1
CN1317500000000,2023-02-01,13,175,GA,Laurens County,19055,18223,832,4.4
CN1317700000000,2023-02-01,13,177,GA,Lee County,15071,14593,478,3.2
CN1317900000000,2023-02-01,13,179,GA,Liberty County,26587,25681,906,3.4
CN1318100000000,2023-02-01,13,181,GA,Lincoln County,3442,3309,133,3.9
CN1318300000000,2023-02-01,13,183,GA,Long County,8505,8213,292,3.4
CN1318500000000,2023-02-01,13,185,GA,Lowndes County,50986,49145,1841,3.6
CN1318700000000,2023-02-01,13,187,GA,Lumpkin County,18990,18500,490,2.6
CN1318900000000,2023-02-01,13,189,GA,McDuffie County,8388,7976,412,4.9
CN1319100000000,2023-02-01,13,191,GA,McIntosh County,6201,5996,205,3.3
CN1319300000000,2023-02-01,13,193,GA,Macon County,4396,4209,187,4.3
CN1319500000000,2023-02-01,13,195,GA,Madison County,13624,13208,416,3.1
CN1319700000000,2023-02-01,13,197,GA,Marion County,3308,3168,140,4.2
CN1319900000000,2023-02-01,13,199,GA,Meriwether County,9070,8689,381,4.2
CN1320100000000,2023-02-01,13,201,GA,Miller County,2897,2806,91,3.1
CN1320500000000,2023-02-01,13,205,GA,Mitchell County,8117,7806,311,3.8
CN1320700000000,2023-02-01,13,207,GA,Monroe County,12836,12447,389,3
CN1320900000000,2023-02-01,13,209,GA,Montgomery County,3993,3848,145,3.6
CN1321100000000,2023-02-01,13,211,GA,Morgan County,9706,9417,289,3
CN1321300000000,2023-02-01,13,213,GA,Murray County,15427,14766,661,4.3
CN1321500000000,2023-02-01,13,215,GA,Muscogee County,77307,73959,3348,4.3
CN1321700000000,2023-02-01,13,217,GA,Newton County,55128,53074,2054,3.7
CN1321900000000,2023-02-01,13,219,GA,Oconee County,20409,19882,527,2.6
CN1322100000000,2023-02-01,13,221,GA,Oglethorpe County,6997,6786,211,3
CN1322300000000,2023-02-01,13,223,GA,Paulding County,92900,90200,2700,2.9
CN1322500000000,2023-02-01,13,225,GA,Peach County,11794,11335,459,3.9
CN1322700000000,2023-02-01,13,227,GA,Pickens County,16185,15715,470,2.9
CN1322900000000,2023-02-01,13,229,GA,Pierce County,8892,8618,274,3.1
CN1323100000000,2023-02-01,13,231,GA,Pike County,9288,9027,261,2.8
CN1323300000000,2023-02-01,13,233,GA,Polk County,18448,17782,666,3.6
CN1323500000000,2023-02-01,13,235,GA,Pulaski County,3970,3836,134,3.4
CN1323700000000,2023-02-01,13,237,GA,Putnam County,8712,8352,360,4.1
CN1323900000000,2023-02-01,13,239,GA,Quitman County,723,678,45,6.2
CN1324100000000,2023-02-01,13,241,GA,Rabun County,7692,7440,252,3.3
CN1324300000000,2023-02-01,13,243,GA,Randolph County,2385,2280,105,4.4
CN1324500000000,2023-02-01,13,245,GA,Richmond County,82679,78784,3895,4.7
CN1324700000000,2023-02-01,13,247,GA,Rockdale County,45982,44257,1725,3.8
CN1324900000000,2023-02-01,13,249,GA,Schley County,2197,2121,76,3.5
CN1325100000000,2023-02-01,13,251,GA,Screven County,5088,4797,291,5.7
CN1325300000000,2023-02-01,13,253,GA,Seminole County,3013,2886,127,4.2
CN1325500000000,2023-02-01,13,255,GA,Spalding County,29795,28705,1090,3.7
CN1325700000000,2023-02-01,13,257,GA,Stephens County,10657,10261,396,3.7
CN1325900000000,2023-02-01,13,259,GA,Stewart County,2629,2538,91,3.5
CN1326100000000,2023-02-01,13,261,GA,Sumter County,12547,11988,559,4.5
CN1326300000000,2023-02-01,13,263,GA,Talbot County,2800,2702,98,3.5
CN1326500000000,2023-02-01,13,265,GA,Taliaferro County,530,508,22,4.2
CN1326700000000,2023-02-01,13,267,GA,Tattnall County,8895,8575,320,3.6
CN1326900000000,2023-02-01,13,269,GA,Taylor County,2621,2499,122,4.7
CN1327100000000,2023-02-01,13,271,GA,Telfair County,3443,3205,238,6.9
CN1327300000000,2023-02-01,13,273,GA,Terrell County,3469,3306,163,4.7
CN1327500000000,2023-02-01,13,275,GA,Thomas County,16933,16301,632,3.7
CN1327700000000,2023-02-01,13,277,GA,Tift County,20789,20139,650,3.1
CN1327900000000,2023-02-01,13,279,GA,Toombs County,12554,12076,478,3.8
CN1328100000000,2023-02-01,13,281,GA,Towns County,4160,3978,182,4.4
CN1328300000000,2023-02-01,13,283,GA,Treutlen County,2715,2604,111,4.1
CN1328500000000,2023-02-01,13,285,GA,Troup County,36585,35463,1122,3.1
CN1328700000000,2023-02-01,13,287,GA,Turner County,3134,3000,134,4.3
CN1328900000000,2023-02-01,13,289,GA,Twiggs County,2752,2619,133,4.8
CN1329100000000,2023-02-01,13,291,GA,Union County,11343,10994,349,3.1
CN1329300000000,2023-02-01,13,293,GA,Upson County,11954,11576,378,3.2
CN1329500000000,2023-02-01,13,295,GA,Walker County,31751,30743,1008,3.2
CN1329700000000,2023-02-01,13,297,GA,Walton County,48745,47278,1467,3
CN1329900000000,2023-02-01,13,299,GA,Ware County,15901,15371,530,3.3
CN1330100000000,2023-02-01,13,301,GA,Warren County,2675,2577,98,3.7
CN1330300000000,2023-02-01,13,303,GA,Washington County,7046,6752,294,4.2
CN1330500000000,2023-02-01,13,305,GA,Wayne County,12210,11812,398,3.3
CN1330700000000,2023-02-01,13,307,GA,Webster County,957,921,36,3.8
CN1330900000000,2023-02-01,13,309,GA,Wheeler County,1678,1585,93,5.5
CN1331100000000,2023-02-01,13,311,GA,White County,17306,16865,441,2.5
CN1331300000000,2023-02-01,13,313,GA,Whitfield County,43395,41686,1709,3.9
CN1331500000000,2023-02-01,13,315,GA,Wilcox County,2646,2548,98,3.7
CN1331700000000,2023-02-01,13,317,GA,Wilkes County,3602,3455,147,4.1
CN1331900000000,2023-02-01,13,319,GA,Wilkinson County,3955,3813,142,3.6
CN1332100000000,2023-02-01,13,321,GA,Worth County,8715,8388,327,3.8
CN1500100000000,2023-02-01,15,001,HI,Hawaii County,95035,91798,3237,3.4
CN1500300000000,2023-02-01,15,003,HI,Honolulu County/city,459022,444769,14253,3.1
CN1500700000000,2023-02-01,15,007,HI,Kauai County,36882,35731,1151,3.1
CN1500900000000,2023-02-01,15,009,HI,Maui County,87081,84302,2779,3.2
CN1600100000000,2023-02-01,16,001,ID,Ada County,279668,272468,7200,2.6
CN1600300000000,2023-02-01,16,003,ID,Adams County,1717,1579,138,8
CN1600500000000,2023-02-01,16,005,ID,Bannock County,45239,43922,1317,2.9
CN1600700000000,2023-02-01,16,007,ID,Bear Lake County,3065,2979,86,2.8
CN1600900000000,2023-02-01,16,009,ID,Benewah County,3918,3697,221,5.6
CN1601100000000,2023-02-01,16,011,ID,Bingham County,24252,23483,769,3.2
CN1601300000000,2023-02-01,16,013,ID,Blaine County,13117,12735,382,2.9
CN1601500000000,2023-02-01,16,015,ID,Boise County,3902,3719,183,4.7
CN1601700000000,2023-02-01,16,017,ID,Bonner County,21548,20445,1103,5.1
CN1601900000000,2023-02-01,16,019,ID,Bonneville County,63718,61923,1795,2.8
CN1602100000000,2023-02-01,16,021,ID,Boundary County,5502,5192,310,5.6
CN1602300000000,2023-02-01,16,023,ID,Butte County,1438,1377,61,4.2
CN1602500000000,2023-02-01,16,025,ID,Camas County,705,677,28,4
CN1602700000000,2023-02-01,16,027,ID,Canyon County,117390,113344,4046,3.4
CN1602900000000,2023-02-01,16,029,ID,Caribou County,3943,3811,132,3.3
CN1603100000000,2023-02-01,16,031,ID,Cassia County,14708,14366,342,2.3
CN1603300000000,2023-02-01,16,033,ID,Clark County,337,319,18,5.3
CN1603500000000,2023-02-01,16,035,ID,Clearwater County,2879,2693,186,6.5
CN1603700000000,2023-02-01,16,037,ID,Custer County,1854,1760,94,5.1
CN1603900000000,2023-02-01,16,039,ID,Elmore County,12620,12172,448,3.5
CN1604100000000,2023-02-01,16,041,ID,Franklin County,7542,7302,240,3.2
CN1604300000000,2023-02-01,16,043,ID,Fremont County,7906,7678,228,2.9
CN1604500000000,2023-02-01,16,045,ID,Gem County,8990,8633,357,4
CN1604700000000,2023-02-01,16,047,ID,Gooding County,10581,10249,332,3.1
CN1604900000000,2023-02-01,16,049,ID,Idaho County,6725,6400,325,4.8
CN1605100000000,2023-02-01,16,051,ID,Jefferson County,15854,15421,433,2.7
CN1605300000000,2023-02-01,16,053,ID,Jerome County,16024,15587,437,2.7
CN1605500000000,2023-02-01,16,055,ID,Kootenai County,85556,82118,3438,4
CN1605700000000,2023-02-01,16,057,ID,Latah County,20793,20277,516,2.5
CN1605900000000,2023-02-01,16,059,ID,Lemhi County,3456,3293,163,4.7
CN1606100000000,2023-02-01,16,061,ID,Lewis County,1601,1542,59,3.7
CN1606300000000,2023-02-01,16,063,ID,Lincoln County,3319,3155,164,4.9
CN1606500000000,2023-02-01,16,065,ID,Madison County,23285,22769,516,2.2
CN1606700000000,2023-02-01,16,067,ID,Minidoka County,12682,12349,333,2.6
CN1606900000000,2023-02-01,16,069,ID,Nez Perce County,21229,20614,615,2.9
CN1607100000000,2023-02-01,16,071,ID,Oneida County,2707,2607,100,3.7
CN1607300000000,2023-02-01,16,073,ID,Owyhee County,6136,5876,260,4.2
CN1607500000000,2023-02-01,16,075,ID,Payette County,11805,11348,457,3.9
CN1607700000000,2023-02-01,16,077,ID,Power County,4442,4283,159,3.6
CN1607900000000,2023-02-01,16,079,ID,Shoshone County,5469,5133,336,6.1
CN1608100000000,2023-02-01,16,081,ID,Teton County,7206,7029,177,2.5
CN1608300000000,2023-02-01,16,083,ID,Twin Falls County,45424,43979,1445,3.2
CN1608500000000,2023-02-01,16,085,ID,Valley County,5643,5375,268,4.7
CN1608700000000,2023-02-01,16,087,ID,Washington County,4906,4708,198,4
CN1700100000000,2023-02-01,17,001,IL,Adams County,30006,28902,1104,3.7
CN1700300000000,2023-02-01,17,003,IL,Alexander County,1799,1686,113,6.3
CN1700500000000,2023-02-01,17,005,IL,Bond County,7462,7129,333,4.5
CN1700700000000,2023-02-01,17,007,IL,Boone County,25062,23086,1976,7.9
CN1700900000000,2023-02-01,17,009,IL,Brown County,3121,3049,72,2.3
CN1701100000000,2023-02-01,17,011,IL,Bureau County,15717,14773,944,6
CN1701300000000,2023-02-01,17,013,IL,Calhoun County,2177,2066,111,5.1
CN1701500000000,2023-02-01,17,015,IL,Carroll County,7023,6637,386,5.5
CN1701700000000,2023-02-01,17,017,IL,Cass County,5676,5380,296,5.2
CN1701900000000,2023-02-01,17,019,IL,Champaign County,111579,107056,4523,4.1
CN1702100000000,2023-02-01,17,021,IL,Christian County,13210,12481,729,5.5
CN1702300000000,2023-02-01,17,023,IL,Clark County,7177,6829,348,4.8
CN1702500000000,2023-02-01,17,025,IL,Clay County,5604,5272,332,5.9
CN1702700000000,2023-02-01,17,027,IL,Clinton County,19839,19149,690,3.5
CN1702900000000,2023-02-01,17,029,IL,Coles County,22991,21992,999,4.3
CN1703100000000,2023-02-01,17,031,IL,Cook County,2682804,2570216,112588,4.2
CN1703300000000,2023-02-01,17,033,IL,Crawford County,8174,7832,342,4.2
CN1703500000000,2023-02-01,17,035,IL,Cumberland County,6018,5773,245,4.1
CN1703700000000,2023-02-01,17,037,IL,DeKalb County,53303,50599,2704,5.1
CN1703900000000,2023-02-01,17,039,IL,De Witt County,7388,7046,342,4.6
CN1704100000000,2023-02-01,17,041,IL,Douglas County,10074,9670,404,4
CN1704300000000,2023-02-01,17,043,IL,DuPage County,525165,508627,16538,3.1
CN1704500000000,2023-02-01,17,045,IL,Edgar County,9218,8867,351,3.8
CN1704700000000,2023-02-01,17,047,IL,Edwards County,2346,2227,119,5.1
CN1704900000000,2023-02-01,17,049,IL,Effingham County,19773,18999,774,3.9
CN1705100000000,2023-02-01,17,051,IL,Fayette County,9665,9099,566,5.9
CN1705300000000,2023-02-01,17,053,IL,Ford County,6443,6137,306,4.7
CN1705500000000,2023-02-01,17,055,IL,Franklin County,15465,14571,894,5.8
CN1705700000000,2023-02-01,17,057,IL,Fulton County,14606,13685,921,6.3
CN1705900000000,2023-02-01,17,059,IL,Gallatin County,1973,1869,104,5.3
CN1706100000000,2023-02-01,17,061,IL,Greene County,5826,5563,263,4.5
CN1706300000000,2023-02-01,17,063,IL,Grundy County,26802,25393,1409,5.3
CN1706500000000,2023-02-01,17,065,IL,Hamilton County,4370,4194,176,4
CN1706700000000,2023-02-01,17,067,IL,Hancock County,7711,7352,359,4.7
CN1706900000000,2023-02-01,17,069,IL,Hardin County,1430,1361,69,4.8
CN1707100000000,2023-02-01,17,071,IL,Henderson County,3475,3266,209,6
CN1707300000000,2023-02-01,17,073,IL,Henry County,23427,22151,1276,5.4
CN1707500000000,2023-02-01,17,075,IL,Iroquois County,12095,11373,722,6
CN1707700000000,2023-02-01,17,077,IL,Jackson County,26964,25781,1183,4.4
CN1707900000000,2023-02-01,17,079,IL,Jasper County,4880,4668,212,4.3
CN1708100000000,2023-02-01,17,081,IL,Jefferson County,16222,15445,777,4.8
CN1708300000000,2023-02-01,17,083,IL,Jersey County,10523,10106,417,4
CN1708500000000,2023-02-01,17,085,IL,Jo Daviess County,10062,9504,558,5.5
CN1708700000000,2023-02-01,17,087,IL,Johnson County,4121,3861,260,6.3
CN1708900000000,2023-02-01,17,089,IL,Kane County,263481,247559,15922,6
CN1709100000000,2023-02-01,17,091,IL,Kankakee County,51785,48401,3384,6.5
CN1709300000000,2023-02-01,17,093,IL,Kendall County,73787,70865,2922,4
CN1709500000000,2023-02-01,17,095,IL,Knox County,19443,18248,1195,6.1
CN1709700000000,2023-02-01,17,097,IL,Lake County,358211,336821,21390,6
CN1709900000000,2023-02-01,17,099,IL,LaSalle County,51447,48049,3398,6.6
CN1710100000000,2023-02-01,17,101,IL,Lawrence County,4988,4707,281,5.6
CN1710300000000,2023-02-01,17,103,IL,Lee County,16298,15500,798,4.9
CN1710500000000,2023-02-01,17,105,IL,Livingston County,15354,14592,762,5
CN1710700000000,2023-02-01,17,107,IL,Logan County,11345,10791,554,4.9
CN1710900000000,2023-02-01,17,109,IL,McDonough County,12897,12270,627,4.9
CN1711100000000,2023-02-01,17,111,IL,McHenry County,172461,165675,6786,3.9
CN1711300000000,2023-02-01,17,113,IL,McLean County,89117,85602,3515,3.9
CN1711500000000,2023-02-01,17,115,IL,Macon County,45274,42595,2679,5.9
CN1711700000000,2023-02-01,17,117,IL,Macoupin County,21989,21065,924,4.2
CN1711900000000,2023-02-01,17,119,IL,Madison County,129984,124900,5084,3.9
CN1712100000000,2023-02-01,17,121,IL,Marion County,16373,15543,830,5.1
CN1712300000000,2023-02-01,17,123,IL,Marshall County,5129,4830,299,5.8
CN1712500000000,2023-02-01,17,125,IL,Mason County,5859,5527,332,5.7
CN1712700000000,2023-02-01,17,127,IL,Massac County,5275,5020,255,4.8
CN1712900000000,2023-02-01,17,129,IL,Menard County,6190,5888,302,4.9
CN1713100000000,2023-02-01,17,131,IL,Mercer County,7583,7082,501,6.6
CN1713300000000,2023-02-01,17,133,IL,Monroe County,18523,17966,557,3
CN1713500000000,2023-02-01,17,135,IL,Montgomery County,10970,10356,614,5.6
CN1713700000000,2023-02-01,17,137,IL,Morgan County,15536,14837,699,4.5
CN1713900000000,2023-02-01,17,139,IL,Moultrie County,7333,7084,249,3.4
CN1714100000000,2023-02-01,17,141,IL,Ogle County,23646,22171,1475,6.2
CN1714300000000,2023-02-01,17,143,IL,Peoria County,82088,77313,4775,5.8
CN1714500000000,2023-02-01,17,145,IL,Perry County,7712,7275,437,5.7
CN1714700000000,2023-02-01,17,147,IL,Piatt County,8797,8446,351,4
CN1714900000000,2023-02-01,17,149,IL,Pike County,6586,6223,363,5.5
CN1715100000000,2023-02-01,17,151,IL,Pope County,1751,1686,65,3.7
CN1715300000000,2023-02-01,17,153,IL,Pulaski County,1659,1539,120,7.2
CN1715500000000,2023-02-01,17,155,IL,Putnam County,2953,2770,183,6.2
CN1715700000000,2023-02-01,17,157,IL,Randolph County,13351,12805,546,4.1
CN1715900000000,2023-02-01,17,159,IL,Richland County,7117,6824,293,4.1
CN1716100000000,2023-02-01,17,161,IL,Rock Island County,66564,62830,3734,5.6
CN1716300000000,2023-02-01,17,163,IL,St. Clair County,122079,116614,5465,4.5
CN1716500000000,2023-02-01,17,165,IL,Saline County,9253,8776,477,5.2
CN1716700000000,2023-02-01,17,167,IL,Sangamon County,96671,92291,4380,4.5
CN1716900000000,2023-02-01,17,169,IL,Schuyler County,2987,2798,189,6.3
CN1717100000000,2023-02-01,17,171,IL,Scott County,2299,2138,161,7
CN1717300000000,2023-02-01,17,173,IL,Shelby County,9720,9273,447,4.6
CN1717500000000,2023-02-01,17,175,IL,Stark County,2416,2252,164,6.8
CN1717700000000,2023-02-01,17,177,IL,Stephenson County,20260,19109,1151,5.7
CN1717900000000,2023-02-01,17,179,IL,Tazewell County,61874,58751,3123,5
CN1718100000000,2023-02-01,17,181,IL,Union County,7086,6634,452,6.4
CN1718300000000,2023-02-01,17,183,IL,Vermilion County,31817,29908,1909,6
CN1718500000000,2023-02-01,17,185,IL,Wabash County,5639,5456,183,3.2
CN1718700000000,2023-02-01,17,187,IL,Warren County,7751,7406,345,4.5
CN1718900000000,2023-02-01,17,189,IL,Washington County,9874,9565,309,3.1
CN1719100000000,2023-02-01,17,191,IL,Wayne County,6951,6655,296,4.3
CN1719300000000,2023-02-01,17,193,IL,White County,5982,5742,240,4
CN1719500000000,2023-02-01,17,195,IL,Whiteside County,27338,25918,1420,5.2
CN1719700000000,2023-02-01,17,197,IL,Will County,373816,357361,16455,4.4
CN1719900000000,2023-02-01,17,199,IL,Williamson County,30923,29479,1444,4.7
CN1720100000000,2023-02-01,17,201,IL,Winnebago County,131250,123343,7907,6
CN1720300000000,2023-02-01,17,203,IL,Woodford County,18213,17415,798,4.4
CN1800100000000,2023-02-01,18,001,IN,Adams County,16876,16400,476,2.8
CN1800300000000,2023-02-01,18,003,IN,Allen County,188588,182429,6159,3.3
CN1800500000000,2023-02-01,18,005,IN,Bartholomew County,44480,43182,1298,2.9
CN1800700000000,2023-02-01,18,007,IN,Benton County,4363,4236,127,2.9
CN1800900000000,2023-02-01,18,009,IN,Blackford County,4772,4567,205,4.3
CN1801100000000,2023-02-01,18,011,IN,Boone County,38533,37585,948,2.5
CN1801300000000,2023-02-01,18,013,IN,Brown County,7943,7632,311,3.9
CN1801500000000,2023-02-01,18,015,IN,Carroll County,9858,9509,349,3.5
CN1801700000000,2023-02-01,18,017,IN,Cass County,17345,16645,700,4
CN1801900000000,2023-02-01,18,019,IN,Clark County,62566,60584,1982,3.2
CN1802100000000,2023-02-01,18,021,IN,Clay County,11689,11246,443,3.8
CN1802300000000,2023-02-01,18,023,IN,Clinton County,17080,16579,501,2.9
CN1802500000000,2023-02-01,18,025,IN,Crawford County,4788,4569,219,4.6
CN1802700000000,2023-02-01,18,027,IN,Daviess County,16622,16193,429,2.6
CN1802900000000,2023-02-01,18,029,IN,Dearborn County,26141,25232,909,3.5
CN1803100000000,2023-02-01,18,031,IN,Decatur County,14491,14055,436,3
CN1803300000000,2023-02-01,18,033,IN,DeKalb County,22404,21734,670,3
CN1803500000000,2023-02-01,18,035,IN,Delaware County,51857,49770,2087,4
CN1803700000000,2023-02-01,18,037,IN,Dubois County,21800,21210,590,2.7
CN1803900000000,2023-02-01,18,039,IN,Elkhart County,115521,111083,4438,3.8
CN1804100000000,2023-02-01,18,041,IN,Fayette County,8318,7947,371,4.5
CN1804300000000,2023-02-01,18,043,IN,Floyd County,42147,40913,1234,2.9
CN1804500000000,2023-02-01,18,045,IN,Fountain County,7943,7664,279,3.5
CN1804700000000,2023-02-01,18,047,IN,Franklin County,11305,10892,413,3.7
CN1804900000000,2023-02-01,18,049,IN,Fulton County,9361,8961,400,4.3
CN1805100000000,2023-02-01,18,051,IN,Gibson County,20373,19877,496,2.4
CN1805300000000,2023-02-01,18,053,IN,Grant County,32049,30912,1137,3.5
CN1805500000000,2023-02-01,18,055,IN,Greene County,13707,13102,605,4.4
CN1805700000000,2023-02-01,18,057,IN,Hamilton County,197110,192011,5099,2.6
CN1805900000000,2023-02-01,18,059,IN,Hancock County,43155,41859,1296,3
CN1806100000000,2023-02-01,18,061,IN,Harrison County,20450,19809,641,3.1
CN1806300000000,2023-02-01,18,063,IN,Hendricks County,95976,93341,2635,2.7
CN1806500000000,2023-02-01,18,065,IN,Henry County,22280,21400,880,3.9
CN1806700000000,2023-02-01,18,067,IN,Howard County,32765,30997,1768,5.4
CN1806900000000,2023-02-01,18,069,IN,Huntington County,18219,17613,606,3.3
CN1807100000000,2023-02-01,18,071,IN,Jackson County,23683,22992,691,2.9
CN1807300000000,2023-02-01,18,073,IN,Jasper County,15983,15293,690,4.3
CN1807500000000,2023-02-01,18,075,IN,Jay County,8787,8497,290,3.3
CN1807700000000,2023-02-01,18,077,IN,Jefferson County,15210,14700,510,3.4
CN1807900000000,2023-02-01,18,079,IN,Jennings County,13523,12980,543,4
CN1808100000000,2023-02-01,18,081,IN,Johnson County,87715,85255,2460,2.8
CN1808300000000,2023-02-01,18,083,IN,Knox County,18129,17561,568,3.1
CN1808500000000,2023-02-01,18,085,IN,Kosciusko County,40795,39414,1381,3.4
CN1808700000000,2023-02-01,18,087,IN,LaGrange County,21161,20499,662,3.1
CN1808900000000,2023-02-01,18,089,IN,Lake County,227444,215368,12076,5.3
CN1809100000000,2023-02-01,18,091,IN,LaPorte County,46978,44772,2206,4.7
CN1809300000000,2023-02-01,18,093,IN,Lawrence County,20559,19654,905,4.4
CN1809500000000,2023-02-01,18,095,IN,Madison County,60999,58523,2476,4.1
CN1809700000000,2023-02-01,18,097,IN,Marion County,511121,493910,17211,3.4
CN1809900000000,2023-02-01,18,099,IN,Marshall County,23173,22315,858,3.7
CN1810100000000,2023-02-01,18,101,IN,Martin County,5434,5277,157,2.9
CN1810300000000,2023-02-01,18,103,IN,Miami County,14128,13476,652,4.6
CN1810500000000,2023-02-01,18,105,IN,Monroe County,72422,70031,2391,3.3
CN1810700000000,2023-02-01,18,107,IN,Montgomery County,18998,18410,588,3.1
CN1810900000000,2023-02-01,18,109,IN,Morgan County,37847,36497,1350,3.6
CN1811100000000,2023-02-01,18,111,IN,Newton County,6782,6463,319,4.7
CN1811300000000,2023-02-01,18,113,IN,Noble County,21682,20875,807,3.7
CN1811500000000,2023-02-01,18,115,IN,Ohio County,3230,3130,100,3.1
CN1811700000000,2023-02-01,18,117,IN,Orange County,8428,8095,333,4
CN1811900000000,2023-02-01,18,119,IN,Owen County,9612,9196,416,4.3
CN1812100000000,2023-02-01,18,121,IN,Parke County,6935,6669,266,3.8
CN1812300000000,2023-02-01,18,123,IN,Perry County,8759,8444,315,3.6
CN1812500000000,2023-02-01,18,125,IN,Pike County,5923,5697,226,3.8
CN1812700000000,2023-02-01,18,127,IN,Porter County,85797,82266,3531,4.1
CN1812900000000,2023-02-01,18,129,IN,Posey County,13082,12707,375,2.9
CN1813100000000,2023-02-01,18,131,IN,Pulaski County,6620,6387,233,3.5
CN1813300000000,2023-02-01,18,133,IN,Putnam County,17088,16483,605,3.5
CN1813500000000,2023-02-01,18,135,IN,Randolph County,11587,11165,422,3.6
CN1813700000000,2023-02-01,18,137,IN,Ripley County,12753,12250,503,3.9
CN1813900000000,2023-02-01,18,139,IN,Rush County,8945,8670,275,3.1
CN1814100000000,2023-02-01,18,141,IN,St. Joseph County,131927,126566,5361,4.1
CN1814300000000,2023-02-01,18,143,IN,Scott County,10547,10138,409,3.9
CN1814500000000,2023-02-01,18,145,IN,Shelby County,23929,23227,702,2.9
CN1814700000000,2023-02-01,18,147,IN,Spencer County,10015,9673,342,3.4
CN1814900000000,2023-02-01,18,149,IN,Starke County,9495,9026,469,4.9
CN1815100000000,2023-02-01,18,151,IN,Steuben County,20627,20033,594,2.9
CN1815300000000,2023-02-01,18,153,IN,Sullivan County,8026,7688,338,4.2
CN1815500000000,2023-02-01,18,155,IN,Switzerland County,4729,4577,152,3.2
CN1815700000000,2023-02-01,18,157,IN,Tippecanoe County,96101,92990,3111,3.2
CN1815900000000,2023-02-01,18,159,IN,Tipton County,8935,8618,317,3.5
CN1816100000000,2023-02-01,18,161,IN,Union County,3610,3498,112,3.1
CN1816300000000,2023-02-01,18,163,IN,Vanderburgh County,92739,89640,3099,3.3
CN1816500000000,2023-02-01,18,165,IN,Vermillion County,6665,6332,333,5
CN1816700000000,2023-02-01,18,167,IN,Vigo County,46150,44217,1933,4.2
CN1816900000000,2023-02-01,18,169,IN,Wabash County,14624,14124,500,3.4
CN1817100000000,2023-02-01,18,171,IN,Warren County,4099,3963,136,3.3
CN1817300000000,2023-02-01,18,173,IN,Warrick County,32506,31523,983,3
CN1817500000000,2023-02-01,18,175,IN,Washington County,13779,13327,452,3.3
CN1817700000000,2023-02-01,18,177,IN,Wayne County,29699,28600,1099,3.7
CN1817900000000,2023-02-01,18,179,IN,Wells County,14329,13907,422,2.9
CN1818100000000,2023-02-01,18,181,IN,White County,13074,12658,416,3.2
CN1818300000000,2023-02-01,18,183,IN,Whitley County,17842,17306,536,3
CN1900100000000,2023-02-01,19,001,IA,Adair County,4376,4242,134,3.1
CN1900300000000,2023-02-01,19,003,IA,Adams County,2107,2064,43,2
CN1900500000000,2023-02-01,19,005,IA,Allamakee County,7135,6720,415,5.8
CN1900700000000,2023-02-01,19,007,IA,Appanoose County,6158,5952,206,3.3
CN1900900000000,2023-02-01,19,009,IA,Audubon County,3080,3000,80,2.6
CN1901100000000,2023-02-01,19,011,IA,Benton County,13346,12837,509,3.8
CN1901300000000,2023-02-01,19,013,IA,Black Hawk County,68814,66516,2298,3.3
CN1901500000000,2023-02-01,19,015,IA,Boone County,14953,14573,380,2.5
CN1901700000000,2023-02-01,19,017,IA,Bremer County,14210,13816,394,2.8
CN1901900000000,2023-02-01,19,019,IA,Buchanan County,11439,11045,394,3.4
CN1902100000000,2023-02-01,19,021,IA,Buena Vista County,12108,11833,275,2.3
CN1902300000000,2023-02-01,19,023,IA,Butler County,8390,8062,328,3.9
CN1902500000000,2023-02-01,19,025,IA,Calhoun County,4176,4067,109,2.6
CN1902700000000,2023-02-01,19,027,IA,Carroll County,10798,10513,285,2.6
CN1902900000000,2023-02-01,19,029,IA,Cass County,6903,6680,223,3.2
CN1903100000000,2023-02-01,19,031,IA,Cedar County,10583,10204,379,3.6
CN1903300000000,2023-02-01,19,033,IA,Cerro Gordo County,22268,21580,688,3.1
CN1903500000000,2023-02-01,19,035,IA,Cherokee County,6202,6020,182,2.9
CN1903700000000,2023-02-01,19,037,IA,Chickasaw County,6687,6479,208,3.1
CN1903900000000,2023-02-01,19,039,IA,Clarke County,5054,4883,171,3.4
CN1904100000000,2023-02-01,19,041,IA,Clay County,8581,8289,292,3.4
CN1904300000000,2023-02-01,19,043,IA,Clayton County,9548,8951,597,6.3
CN1904500000000,2023-02-01,19,045,IA,Clinton County,22375,21472,903,4
CN1904700000000,2023-02-01,19,047,IA,Crawford County,7932,7473,459,5.8
CN1904900000000,2023-02-01,19,049,IA,Dallas County,54651,53435,1216,2.2
CN1905100000000,2023-02-01,19,051,IA,Davis County,4351,4242,109,2.5
CN1905300000000,2023-02-01,19,053,IA,Decatur County,4426,4308,118,2.7
CN1905500000000,2023-02-01,19,055,IA,Delaware County,10563,10217,346,3.3
CN1905700000000,2023-02-01,19,057,IA,Des Moines County,18287,17431,856,4.7
CN1905900000000,2023-02-01,19,059,IA,Dickinson County,10005,9623,382,3.8
CN1906100000000,2023-02-01,19,061,IA,Dubuque County,56753,54776,1977,3.5
CN1906300000000,2023-02-01,19,063,IA,Emmet County,4843,4675,168,3.5
CN1906500000000,2023-02-01,19,065,IA,Fayette County,10641,10204,437,4.1
CN1906700000000,2023-02-01,19,067,IA,Floyd County,8483,8134,349,4.1
CN1906900000000,2023-02-01,19,069,IA,Franklin County,5668,5480,188,3.3
CN1907100000000,2023-02-01,19,071,IA,Fremont County,3711,3616,95,2.6
CN1907300000000,2023-02-01,19,073,IA,Greene County,5469,5360,109,2
CN1907500000000,2023-02-01,19,075,IA,Grundy County,6529,6317,212,3.2
CN1907700000000,2023-02-01,19,077,IA,Guthrie County,5777,5562,215,3.7
CN1907900000000,2023-02-01,19,079,IA,Hamilton County,7005,6800,205,2.9
CN1908100000000,2023-02-01,19,081,IA,Hancock County,5679,5536,143,2.5
CN1908300000000,2023-02-01,19,083,IA,Hardin County,7799,7497,302,3.9
CN1908500000000,2023-02-01,19,085,IA,Harrison County,7207,6990,217,3
CN1908700000000,2023-02-01,19,087,IA,Henry County,9498,9172,326,3.4
CN1908900000000,2023-02-01,19,089,IA,Howard County,5315,5078,237,4.5
CN1909100000000,2023-02-01,19,091,IA,Humboldt County,4908,4759,149,3
CN1909300000000,2023-02-01,19,093,IA,Ida County,4014,3908,106,2.6
CN1909500000000,2023-02-01,19,095,IA,Iowa County,9995,9646,349,3.5
CN1909700000000,2023-02-01,19,097,IA,Jackson County,10772,10261,511,4.7
CN1909900000000,2023-02-01,19,099,IA,Jasper County,18679,18023,656,3.5
CN1910100000000,2023-02-01,19,101,IA,Jefferson County,10215,9929,286,2.8
CN1910300000000,2023-02-01,19,103,IA,Johnson County,87857,85880,1977,2.3
CN1910500000000,2023-02-01,19,105,IA,Jones County,10703,10180,523,4.9
CN1910700000000,2023-02-01,19,107,IA,Keokuk County,5250,5042,208,4
CN1910900000000,2023-02-01,19,109,IA,Kossuth County,8236,8017,219,2.7
CN1911100000000,2023-02-01,19,111,IA,Lee County,14701,14039,662,4.5
CN1911300000000,2023-02-01,19,113,IA,Linn County,122561,118351,4210,3.4
CN1911500000000,2023-02-01,19,115,IA,Louisa County,5969,5707,262,4.4
CN1911700000000,2023-02-01,19,117,IA,Lucas County,4603,4477,126,2.7
CN1911900000000,2023-02-01,19,119,IA,Lyon County,7066,6904,162,2.3
CN1912100000000,2023-02-01,19,121,IA,Madison County,9020,8595,425,4.7
CN1912300000000,2023-02-01,19,123,IA,Mahaska County,12425,12063,362,2.9
CN1912500000000,2023-02-01,19,125,IA,Marion County,19463,18971,492,2.5
CN1912700000000,2023-02-01,19,127,IA,Marshall County,18025,16438,1587,8.8
CN1912900000000,2023-02-01,19,129,IA,Mills County,7181,6981,200,2.8
CN1913100000000,2023-02-01,19,131,IA,Mitchell County,5735,5570,165,2.9
CN1913300000000,2023-02-01,19,133,IA,Monona County,4434,4280,154,3.5
CN1913500000000,2023-02-01,19,135,IA,Monroe County,4086,3954,132,3.2
CN1913700000000,2023-02-01,19,137,IA,Montgomery County,5001,4853,148,3
CN1913900000000,2023-02-01,19,139,IA,Muscatine County,20961,20199,762,3.6
CN1914100000000,2023-02-01,19,141,IA,O'Brien County,8258,8046,212,2.6
CN1914300000000,2023-02-01,19,143,IA,Osceola County,3647,3582,65,1.8
CN1914500000000,2023-02-01,19,145,IA,Page County,6448,6288,160,2.5
CN1914700000000,2023-02-01,19,147,IA,Palo Alto County,4452,4318,134,3
CN1914900000000,2023-02-01,19,149,IA,Plymouth County,15018,14684,334,2.2
CN1915100000000,2023-02-01,19,151,IA,Pocahontas County,4086,3992,94,2.3
CN1915300000000,2023-02-01,19,153,IA,Polk County,280413,271665,8748,3.1
CN1915500000000,2023-02-01,19,155,IA,Pottawattamie County,48173,46642,1531,3.2
CN1915700000000,2023-02-01,19,157,IA,Poweshiek County,10452,10106,346,3.3
CN1915900000000,2023-02-01,19,159,IA,Ringgold County,2326,2280,46,2
CN1916100000000,2023-02-01,19,161,IA,Sac County,5298,5147,151,2.9
CN1916300000000,2023-02-01,19,163,IA,Scott County,88807,85666,3141,3.5
CN1916500000000,2023-02-01,19,165,IA,Shelby County,6456,6284,172,2.7
CN1916700000000,2023-02-01,19,167,IA,Sioux County,23113,22567,546,2.4
CN1916900000000,2023-02-01,19,169,IA,Story County,61182,60002,1180,1.9
CN1917100000000,2023-02-01,19,171,IA,Tama County,9393,8908,485,5.2
CN1917300000000,2023-02-01,19,173,IA,Taylor County,3181,3116,65,2
CN1917500000000,2023-02-01,19,175,IA,Union County,6213,5985,228,3.7
CN1917700000000,2023-02-01,19,177,IA,Van Buren County,3710,3579,131,3.5
CN1917900000000,2023-02-01,19,179,IA,Wapello County,16819,16185,634,3.8
CN1918100000000,2023-02-01,19,181,IA,Warren County,29841,28938,903,3
CN1918300000000,2023-02-01,19,183,IA,Washington County,12057,11638,419,3.5
CN1918500000000,2023-02-01,19,185,IA,Wayne County,3073,2962,111,3.6
CN1918700000000,2023-02-01,19,187,IA,Webster County,18876,18237,639,3.4
CN1918900000000,2023-02-01,19,189,IA,Winnebago County,5088,4920,168,3.3
CN1919100000000,2023-02-01,19,191,IA,Winneshiek County,11470,10941,529,4.6
CN1919300000000,2023-02-01,19,193,IA,Woodbury County,56760,55013,1747,3.1
CN1919500000000,2023-02-01,19,195,IA,Worth County,4036,3890,146,3.6
CN1919700000000,2023-02-01,19,197,IA,Wright County,6675,6493,182,2.7
CN2000100000000,2023-02-01,20,001,KS,Allen County,6359,6139,220,3.5
CN2000300000000,2023-02-01,20,003,KS,Anderson County,4330,4206,124,2.9
CN2000500000000,2023-02-01,20,005,KS,Atchison County,6744,6467,277,4.1
CN2000700000000,2023-02-01,20,007,KS,Barber County,2257,2193,64,2.8
CN2000900000000,2023-02-01,20,009,KS,Barton County,13164,12725,439,3.3
CN2001100000000,2023-02-01,20,011,KS,Bourbon County,6231,5962,269,4.3
CN2001300000000,2023-02-01,20,013,KS,Brown County,5074,4923,151,3
CN2001500000000,2023-02-01,20,015,KS,Butler County,32980,31937,1043,3.2
CN2001700000000,2023-02-01,20,017,KS,Chase County,1347,1312,35,2.6
CN2001900000000,2023-02-01,20,019,KS,Chautauqua County,1427,1374,53,3.7
CN2002100000000,2023-02-01,20,021,KS,Cherokee County,9812,9483,329,3.4
CN2002300000000,2023-02-01,20,023,KS,Cheyenne County,1269,1225,44,3.5
CN2002500000000,2023-02-01,20,025,KS,Clark County,1128,1103,25,2.2
CN2002700000000,2023-02-01,20,027,KS,Clay County,3753,3633,120,3.2
CN2002900000000,2023-02-01,20,029,KS,Cloud County,3853,3731,122,3.2
CN2003100000000,2023-02-01,20,031,KS,Coffey County,3767,3611,156,4.1
CN2003300000000,2023-02-01,20,033,KS,Comanche County,858,833,25,2.9
CN2003500000000,2023-02-01,20,035,KS,Cowley County,16358,15830,528,3.2
CN2003700000000,2023-02-01,20,037,KS,Crawford County,19132,18493,639,3.3
CN2003900000000,2023-02-01,20,039,KS,Decatur County,1147,1107,40,3.5
CN2004100000000,2023-02-01,20,041,KS,Dickinson County,8591,8285,306,3.6
CN2004300000000,2023-02-01,20,043,KS,Doniphan County,4058,3934,124,3.1
CN2004500000000,2023-02-01,20,045,KS,Douglas County,68826,66766,2060,3
CN2004700000000,2023-02-01,20,047,KS,Edwards County,1400,1360,40,2.9
CN2004900000000,2023-02-01,20,049,KS,Elk County,1205,1170,35,2.9
CN2005100000000,2023-02-01,20,051,KS,Ellis County,17083,16688,395,2.3
CN2005300000000,2023-02-01,20,053,KS,Ellsworth County,2628,2550,78,3
CN2005500000000,2023-02-01,20,055,KS,Finney County,20656,20161,495,2.4
CN2005700000000,2023-02-01,20,057,KS,Ford County,18039,17602,437,2.4
CN2005900000000,2023-02-01,20,059,KS,Franklin County,15129,14670,459,3
CN2006100000000,2023-02-01,20,061,KS,Geary County,11635,11105,530,4.6
CN2006300000000,2023-02-01,20,063,KS,Gove County,1362,1326,36,2.6
CN2006500000000,2023-02-01,20,065,KS,Graham County,1230,1195,35,2.8
CN2006700000000,2023-02-01,20,067,KS,Grant County,2773,2684,89,3.2
CN2006900000000,2023-02-01,20,069,KS,Gray County,3169,3094,75,2.4
CN2007100000000,2023-02-01,20,071,KS,Greeley County,799,784,15,1.9
CN2007300000000,2023-02-01,20,073,KS,Greenwood County,2977,2875,102,3.4
CN2007500000000,2023-02-01,20,075,KS,Hamilton County,1660,1627,33,2
CN2007700000000,2023-02-01,20,077,KS,Harper County,2836,2760,76,2.7
CN2007900000000,2023-02-01,20,079,KS,Harvey County,17264,16742,522,3
CN2008100000000,2023-02-01,20,081,KS,Haskell County,2252,2203,49,2.2
CN2008300000000,2023-02-01,20,083,KS,Hodgeman County,1049,1022,27,2.6
CN2008500000000,2023-02-01,20,085,KS,Jackson County,7338,7103,235,3.2
CN2008700000000,2023-02-01,20,087,KS,Jefferson County,10434,10097,337,3.2
CN2008900000000,2023-02-01,20,089,KS,Jewell County,1164,1124,40,3.4
CN2009100000000,2023-02-01,20,091,KS,Johnson County,350734,340686,10048,2.9
CN2009300000000,2023-02-01,20,093,KS,Kearny County,2001,1957,44,2.2
CN2009500000000,2023-02-01,20,095,KS,Kingman County,3330,3228,102,3.1
CN2009700000000,2023-02-01,20,097,KS,Kiowa County,1206,1170,36,3
CN2009900000000,2023-02-01,20,099,KS,Labette County,9357,9015,342,3.7
CN2010100000000,2023-02-01,20,101,KS,Lane County,735,711,24,3.3
CN2010300000000,2023-02-01,20,103,KS,Leavenworth County,37623,36276,1347,3.6
CN2010500000000,2023-02-01,20,105,KS,Lincoln County,1691,1646,45,2.7
CN2010700000000,2023-02-01,20,107,KS,Linn County,4475,4211,264,5.9
CN2010900000000,2023-02-01,20,109,KS,Logan County,1606,1571,35,2.2
CN2011100000000,2023-02-01,20,111,KS,Lyon County,17138,16603,535,3.1
CN2011300000000,2023-02-01,20,113,KS,McPherson County,17599,17188,411,2.3
CN2011500000000,2023-02-01,20,115,KS,Marion County,6013,5857,156,2.6
CN2011700000000,2023-02-01,20,117,KS,Marshall County,5208,5073,135,2.6
CN2011900000000,2023-02-01,20,119,KS,Meade County,2091,2042,49,2.3
CN2012100000000,2023-02-01,20,121,KS,Miami County,18170,17540,630,3.5
CN2012300000000,2023-02-01,20,123,KS,Mitchell County,3334,3259,75,2.2
CN2012500000000,2023-02-01,20,125,KS,Montgomery County,14698,14181,517,3.5
CN2012700000000,2023-02-01,20,127,KS,Morris County,3026,2937,89,2.9
CN2012900000000,2023-02-01,20,129,KS,Morton County,1122,1087,35,3.1
CN2013100000000,2023-02-01,20,131,KS,Nemaha County,5647,5516,131,2.3
CN2013300000000,2023-02-01,20,133,KS,Neosho County,6066,5817,249,4.1
CN2013500000000,2023-02-01,20,135,KS,Ness County,1324,1286,38,2.9
CN2013700000000,2023-02-01,20,137,KS,Norton County,2626,2562,64,2.4
CN2013900000000,2023-02-01,20,139,KS,Osage County,8107,7812,295,3.6
CN2014100000000,2023-02-01,20,141,KS,Osborne County,1901,1852,49,2.6
CN2014300000000,2023-02-01,20,143,KS,Ottawa County,3037,2951,86,2.8
CN2014500000000,2023-02-01,20,145,KS,Pawnee County,2716,2632,84,3.1
CN2014700000000,2023-02-01,20,147,KS,Phillips County,2668,2601,67,2.5
CN2014900000000,2023-02-01,20,149,KS,Pottawatomie County,13161,12783,378,2.9
CN2015100000000,2023-02-01,20,151,KS,Pratt County,4900,4787,113,2.3
CN2015300000000,2023-02-01,20,153,KS,Rawlins County,1538,1503,35,2.3
CN2015500000000,2023-02-01,20,155,KS,Reno County,29295,28321,974,3.3
CN2015700000000,2023-02-01,20,157,KS,Republic County,2385,2327,58,2.4
CN2015900000000,2023-02-01,20,159,KS,Rice County,5219,5077,142,2.7
CN2016100000000,2023-02-01,20,161,KS,Riley County,36281,35240,1041,2.9
CN2016300000000,2023-02-01,20,163,KS,Rooks County,2434,2361,73,3
CN2016500000000,2023-02-01,20,165,KS,Rush County,1651,1604,47,2.8
CN2016700000000,2023-02-01,20,167,KS,Russell County,3330,3239,91,2.7
CN2016900000000,2023-02-01,20,169,KS,Saline County,30360,29406,954,3.1
CN2017100000000,2023-02-01,20,171,KS,Scott County,2680,2616,64,2.4
CN2017300000000,2023-02-01,20,173,KS,Sedgwick County,257131,248240,8891,3.5
CN2017500000000,2023-02-01,20,175,KS,Seward County,9954,9665,289,2.9
CN2017700000000,2023-02-01,20,177,KS,Shawnee County,92257,89073,3184,3.5
CN2017900000000,2023-02-01,20,179,KS,Sheridan County,1483,1448,35,2.4
CN2018100000000,2023-02-01,20,181,KS,Sherman County,2795,2720,75,2.7
CN2018300000000,2023-02-01,20,183,KS,Smith County,2013,1957,56,2.8
CN2018500000000,2023-02-01,20,185,KS,Stafford County,1951,1895,56,2.9
CN2018700000000,2023-02-01,20,187,KS,Stanton County,1129,1104,25,2.2
CN2018900000000,2023-02-01,20,189,KS,Stevens County,3118,3049,69,2.2
CN2019100000000,2023-02-01,20,191,KS,Sumner County,10847,10499,348,3.2
CN2019300000000,2023-02-01,20,193,KS,Thomas County,4306,4213,93,2.2
CN2019500000000,2023-02-01,20,195,KS,Trego County,1342,1295,47,3.5
CN2019700000000,2023-02-01,20,197,KS,Wabaunsee County,3772,3652,120,3.2
CN2019900000000,2023-02-01,20,199,KS,Wallace County,874,849,25,2.9
CN2020100000000,2023-02-01,20,201,KS,Washington County,3008,2928,80,2.7
CN2020300000000,2023-02-01,20,203,KS,Wichita County,1182,1153,29,2.5
CN2020500000000,2023-02-01,20,205,KS,Wilson County,3686,3546,140,3.8
CN2020700000000,2023-02-01,20,207,KS,Woodson County,1564,1502,62,4
CN2020900000000,2023-02-01,20,209,KS,Wyandotte County,78574,75275,3299,4.2
CN2100100000000,2023-02-01,21,001,KY,Adair County,7208,6811,397,5.5
CN2100300000000,2023-02-01,21,003,KY,Allen County,9057,8654,403,4.4
CN2100500000000,2023-02-01,21,005,KY,Anderson County,11930,11496,434,3.6
CN2100700000000,2023-02-01,21,007,KY,Ballard County,3478,3295,183,5.3
CN2100900000000,2023-02-01,21,009,KY,Barren County,17927,17043,884,4.9
CN2101100000000,2023-02-01,21,011,KY,Bath County,4803,4479,324,6.7
CN2101300000000,2023-02-01,21,013,KY,Bell County,8232,7730,502,6.1
CN2101500000000,2023-02-01,21,015,KY,Boone County,71902,69142,2760,3.8
CN2101700000000,2023-02-01,21,017,KY,Bourbon County,9538,9185,353,3.7
CN2101900000000,2023-02-01,21,019,KY,Boyd County,17154,16078,1076,6.3
CN2102100000000,2023-02-01,21,021,KY,Boyle County,12855,12270,585,4.6
CN2102300000000,2023-02-01,21,023,KY,Bracken County,3843,3606,237,6.2
CN2102500000000,2023-02-01,21,025,KY,Breathitt County,3239,2950,289,8.9
CN2102700000000,2023-02-01,21,027,KY,Breckinridge County,7968,7528,440,5.5
CN2102900000000,2023-02-01,21,029,KY,Bullitt County,42737,40486,2251,5.3
CN2103100000000,2023-02-01,21,031,KY,Butler County,5133,4869,264,5.1
CN2103300000000,2023-02-01,21,033,KY,Caldwell County,6297,6042,255,4
CN2103500000000,2023-02-01,21,035,KY,Calloway County,17064,16233,831,4.9
CN2103700000000,2023-02-01,21,037,KY,Campbell County,50548,48569,1979,3.9
CN2103900000000,2023-02-01,21,039,KY,Carlisle County,2203,2107,96,4.4
CN2104100000000,2023-02-01,21,041,KY,Carroll County,5873,5661,212,3.6
CN2104300000000,2023-02-01,21,043,KY,Carter County,9696,8826,870,9
CN2104500000000,2023-02-01,21,045,KY,Casey County,6635,6319,316,4.8
CN2104700000000,2023-02-01,21,047,KY,Christian County,24999,23734,1265,5.1
CN2104900000000,2023-02-01,21,049,KY,Clark County,17314,16639,675,3.9
CN2105100000000,2023-02-01,21,051,KY,Clay County,5071,4728,343,6.8
CN2105300000000,2023-02-01,21,053,KY,Clinton County,3585,3367,218,6.1
CN2105500000000,2023-02-01,21,055,KY,Crittenden County,3848,3674,174,4.5
CN2105700000000,2023-02-01,21,057,KY,Cumberland County,3426,3285,141,4.1
CN2105900000000,2023-02-01,21,059,KY,Daviess County,45335,43140,2195,4.8
CN2106100000000,2023-02-01,21,061,KY,Edmonson County,4811,4543,268,5.6
CN2106300000000,2023-02-01,21,063,KY,Elliott County,1941,1737,204,10.5
CN2106500000000,2023-02-01,21,065,KY,Estill County,5167,4883,284,5.5
CN2106700000000,2023-02-01,21,067,KY,Fayette County,175800,169768,6032,3.4
CN2106900000000,2023-02-01,21,069,KY,Fleming County,6122,5806,316,5.2
CN2107100000000,2023-02-01,21,071,KY,Floyd County,10972,10245,727,6.6
CN2107300000000,2023-02-01,21,073,KY,Franklin County,25042,24077,965,3.9
CN2107500000000,2023-02-01,21,075,KY,Fulton County,2099,1997,102,4.9
CN2107700000000,2023-02-01,21,077,KY,Gallatin County,4013,3824,189,4.7
CN2107900000000,2023-02-01,21,079,KY,Garrard County,8009,7677,332,4.1
CN2108100000000,2023-02-01,21,081,KY,Grant County,11703,11159,544,4.6
CN2108300000000,2023-02-01,21,083,KY,Graves County,15560,14823,737,4.7
CN2108500000000,2023-02-01,21,085,KY,Grayson County,10430,9907,523,5
CN2108700000000,2023-02-01,21,087,KY,Green County,5076,4856,220,4.3
CN2108900000000,2023-02-01,21,089,KY,Greenup County,13011,12008,1003,7.7
CN2109100000000,2023-02-01,21,091,KY,Hancock County,3770,3579,191,5.1
CN2109300000000,2023-02-01,21,093,KY,Hardin County,46744,44566,2178,4.7
CN2109500000000,2023-02-01,21,095,KY,Harlan County,6403,5977,426,6.7
CN2109700000000,2023-02-01,21,097,KY,Harrison County,8842,8489,353,4
CN2109900000000,2023-02-01,21,099,KY,Hart County,7761,7393,368,4.7
CN2110100000000,2023-02-01,21,101,KY,Henderson County,20534,19664,870,4.2
CN2110300000000,2023-02-01,21,103,KY,Henry County,8033,7711,322,4
CN2110500000000,2023-02-01,21,105,KY,Hickman County,1613,1534,79,4.9
CN2110700000000,2023-02-01,21,107,KY,Hopkins County,18034,17176,858,4.8
CN2110900000000,2023-02-01,21,109,KY,Jackson County,4163,3912,251,6
CN2111100000000,2023-02-01,21,111,KY,Jefferson County,389829,372902,16927,4.3
CN2111300000000,2023-02-01,21,113,KY,Jessamine County,26710,25742,968,3.6
CN2111500000000,2023-02-01,21,115,KY,Johnson County,6683,6189,494,7.4
CN2111700000000,2023-02-01,21,117,KY,Kenton County,87434,83960,3474,4
CN2111900000000,2023-02-01,21,119,KY,Knott County,4303,3987,316,7.3
CN2112100000000,2023-02-01,21,121,KY,Knox County,10252,9656,596,5.8
CN2112300000000,2023-02-01,21,123,KY,Larue County,5787,5494,293,5.1
CN2112500000000,2023-02-01,21,125,KY,Laurel County,25868,24707,1161,4.5
CN2112700000000,2023-02-01,21,127,KY,Lawrence County,5612,5226,386,6.9
CN2112900000000,2023-02-01,21,129,KY,Lee County,2121,1992,129,6.1
CN2113100000000,2023-02-01,21,131,KY,Leslie County,2527,2344,183,7.2
CN2113300000000,2023-02-01,21,133,KY,Letcher County,5823,5402,421,7.2
CN2113500000000,2023-02-01,21,135,KY,Lewis County,4663,4217,446,9.6
CN2113700000000,2023-02-01,21,137,KY,Lincoln County,9465,8917,548,5.8
CN2113900000000,2023-02-01,21,139,KY,Livingston County,3656,3436,220,6
CN2114100000000,2023-02-01,21,141,KY,Logan County,12531,12035,496,4
CN2114300000000,2023-02-01,21,143,KY,Lyon County,3175,2999,176,5.5
CN2114500000000,2023-02-01,21,145,KY,McCracken County,29806,28508,1298,4.4
CN2114700000000,2023-02-01,21,147,KY,McCreary County,4756,4453,303,6.4
CN2114900000000,2023-02-01,21,149,KY,McLean County,3926,3718,208,5.3
CN2115100000000,2023-02-01,21,151,KY,Madison County,46828,44992,1836,3.9
CN2115300000000,2023-02-01,21,153,KY,Magoffin County,3230,2856,374,11.6
CN2115500000000,2023-02-01,21,155,KY,Marion County,9441,9098,343,3.6
CN2115700000000,2023-02-01,21,157,KY,Marshall County,14389,13687,702,4.9
CN2115900000000,2023-02-01,21,159,KY,Martin County,2188,1995,193,8.8
CN2116100000000,2023-02-01,21,161,KY,Mason County,6566,6174,392,6
CN2116300000000,2023-02-01,21,163,KY,Meade County,11584,10959,625,5.4
CN2116500000000,2023-02-01,21,165,KY,Menifee County,2411,2230,181,7.5
CN2116700000000,2023-02-01,21,167,KY,Mercer County,10106,9680,426,4.2
CN2116900000000,2023-02-01,21,169,KY,Metcalfe County,3944,3734,210,5.3
CN2117100000000,2023-02-01,21,171,KY,Monroe County,4641,4408,233,5
CN2117300000000,2023-02-01,21,173,KY,Montgomery County,11974,11351,623,5.2
CN2117500000000,2023-02-01,21,175,KY,Morgan County,4123,3845,278,6.7
CN2117700000000,2023-02-01,21,177,KY,Muhlenberg County,9944,9277,667,6.7
CN2117900000000,2023-02-01,21,179,KY,Nelson County,23737,22736,1001,4.2
CN2118100000000,2023-02-01,21,181,KY,Nicholas County,3260,3108,152,4.7
CN2118300000000,2023-02-01,21,183,KY,Ohio County,9079,8539,540,5.9
CN2118500000000,2023-02-01,21,185,KY,Oldham County,32838,31667,1171,3.6
CN2118700000000,2023-02-01,21,187,KY,Owen County,5188,4976,212,4.1
CN2118900000000,2023-02-01,21,189,KY,Owsley County,1084,1009,75,6.9
CN2119100000000,2023-02-01,21,191,KY,Pendleton County,6977,6649,328,4.7
CN2119300000000,2023-02-01,21,193,KY,Perry County,8030,7565,465,5.8
CN2119500000000,2023-02-01,21,195,KY,Pike County,19011,17938,1073,5.6
CN2119700000000,2023-02-01,21,197,KY,Powell County,5251,4987,264,5
CN2119900000000,2023-02-01,21,199,KY,Pulaski County,25177,23821,1356,5.4
CN2120100000000,2023-02-01,21,201,KY,Robertson County,812,766,46,5.7
CN2120300000000,2023-02-01,21,203,KY,Rockcastle County,6507,6167,340,5.2
CN2120500000000,2023-02-01,21,205,KY,Rowan County,10339,9776,563,5.4
CN2120700000000,2023-02-01,21,207,KY,Russell County,6198,5830,368,5.9
CN2120900000000,2023-02-01,21,209,KY,Scott County,30389,29336,1053,3.5
CN2121100000000,2023-02-01,21,211,KY,Shelby County,25638,24548,1090,4.3
CN2121300000000,2023-02-01,21,213,KY,Simpson County,8784,8416,368,4.2
CN2121500000000,2023-02-01,21,215,KY,Spencer County,10527,10014,513,4.9
CN2121700000000,2023-02-01,21,217,KY,Taylor County,12314,11824,490,4
CN2121900000000,2023-02-01,21,219,KY,Todd County,5802,5574,228,3.9
CN2122100000000,2023-02-01,21,221,KY,Trigg County,6119,5795,324,5.3
CN2122300000000,2023-02-01,21,223,KY,Trimble County,3761,3601,160,4.3
CN2122500000000,2023-02-01,21,225,KY,Union County,5853,5566,287,4.9
CN2122700000000,2023-02-01,21,227,KY,Warren County,66367,63645,2722,4.1
CN2122900000000,2023-02-01,21,229,KY,Washington County,6102,5871,231,3.8
CN2123100000000,2023-02-01,21,231,KY,Wayne County,7017,6568,449,6.4
CN2123300000000,2023-02-01,21,233,KY,Webster County,5128,4895,233,4.5
CN2123500000000,2023-02-01,21,235,KY,Whitley County,14294,13623,671,4.7
CN2123700000000,2023-02-01,21,237,KY,Wolfe County,2294,2126,168,7.3
CN2123900000000,2023-02-01,21,239,KY,Woodford County,14956,14474,482,3.2
CN2200100000000,2023-02-01,22,001,LA,Acadia Parish,23904,23043,861,3.6
CN2200300000000,2023-02-01,22,003,LA,Allen Parish,8176,7854,322,3.9
CN2200500000000,2023-02-01,22,005,LA,Ascension Parish,68227,66322,1905,2.8
CN2200700000000,2023-02-01,22,007,LA,Assumption Parish,8903,8512,391,4.4
CN2200900000000,2023-02-01,22,009,LA,Avoyelles Parish,14237,13661,576,4
CN2201100000000,2023-02-01,22,011,LA,Beauregard Parish,14980,14458,522,3.5
CN2201300000000,2023-02-01,22,013,LA,Bienville Parish,5333,5102,231,4.3
CN2201500000000,2023-02-01,22,015,LA,Bossier Parish,58585,56798,1787,3.1
CN2201700000000,2023-02-01,22,017,LA,Caddo Parish,102472,98491,3981,3.9
CN2201900000000,2023-02-01,22,019,LA,Calcasieu Parish,92587,89492,3095,3.3
CN2202100000000,2023-02-01,22,021,LA,Caldwell Parish,3672,3530,142,3.9
CN2202300000000,2023-02-01,22,023,LA,Cameron Parish,3443,3344,99,2.9
CN2202500000000,2023-02-01,22,025,LA,Catahoula Parish,3409,3254,155,4.5
CN2202700000000,2023-02-01,22,027,LA,Claiborne Parish,5445,5250,195,3.6
CN2202900000000,2023-02-01,22,029,LA,Concordia Parish,6818,6500,318,4.7
CN2203100000000,2023-02-01,22,031,LA,De Soto Parish,11014,10587,427,3.9
CN2203300000000,2023-02-01,22,033,LA,East Baton Rouge Parish,237783,230276,7507,3.2
CN2203500000000,2023-02-01,22,035,LA,East Carroll Parish,1622,1477,145,8.9
CN2203700000000,2023-02-01,22,037,LA,East Feliciana Parish,8061,7798,263,3.3
CN2203900000000,2023-02-01,22,039,LA,Evangeline Parish,12006,11530,476,4
CN2204100000000,2023-02-01,22,041,LA,Franklin Parish,7453,7065,388,5.2
CN2204300000000,2023-02-01,22,043,LA,Grant Parish,8415,8138,277,3.3
CN2204500000000,2023-02-01,22,045,LA,Iberia Parish,27644,26502,1142,4.1
CN2204700000000,2023-02-01,22,047,LA,Iberville Parish,14130,13571,559,4
CN2204900000000,2023-02-01,22,049,LA,Jackson Parish,6944,6717,227,3.3
CN2205100000000,2023-02-01,22,051,LA,Jefferson Parish,212643,205594,7049,3.3
CN2205300000000,2023-02-01,22,053,LA,Jefferson Davis Parish,12334,11896,438,3.6
CN2205500000000,2023-02-01,22,055,LA,Lafayette Parish,116662,113074,3588,3.1
CN2205700000000,2023-02-01,22,057,LA,Lafourche Parish,40205,38923,1282,3.2
CN2205900000000,2023-02-01,22,059,LA,LaSalle Parish,6790,6599,191,2.8
CN2206100000000,2023-02-01,22,061,LA,Lincoln Parish,21445,20728,717,3.3
CN2206300000000,2023-02-01,22,063,LA,Livingston Parish,73244,71142,2102,2.9
CN2206500000000,2023-02-01,22,065,LA,Madison Parish,3475,3290,185,5.3
CN2206700000000,2023-02-01,22,067,LA,Morehouse Parish,9934,9361,573,5.8
CN2206900000000,2023-02-01,22,069,LA,Natchitoches Parish,16878,16221,657,3.9
CN2207100000000,2023-02-01,22,071,LA,Orleans Parish,178260,170852,7408,4.2
CN2207300000000,2023-02-01,22,073,LA,Ouachita Parish,70833,68281,2552,3.6
CN2207500000000,2023-02-01,22,075,LA,Plaquemines Parish,9904,9588,316,3.2
CN2207700000000,2023-02-01,22,077,LA,Pointe Coupee Parish,9952,9607,345,3.5
CN2207900000000,2023-02-01,22,079,LA,Rapides Parish,56829,55000,1829,3.2
CN2208100000000,2023-02-01,22,081,LA,Red River Parish,4040,3906,134,3.3
CN2208300000000,2023-02-01,22,083,LA,Richland Parish,8328,7963,365,4.4
CN2208500000000,2023-02-01,22,085,LA,Sabine Parish,9235,8884,351,3.8
CN2208700000000,2023-02-01,22,087,LA,St. Bernard Parish,20225,19435,790,3.9
CN2208900000000,2023-02-01,22,089,LA,St. Charles Parish,25063,24289,774,3.1
CN2209100000000,2023-02-01,22,091,LA,St. Helena Parish,4326,4131,195,4.5
CN2209300000000,2023-02-01,22,093,LA,St. James Parish,8967,8612,355,4
CN2209500000000,2023-02-01,22,095,LA,St. John the Baptist Parish,19223,18394,829,4.3
CN2209700000000,2023-02-01,22,097,LA,St. Landry Parish,31737,30336,1401,4.4
CN2209900000000,2023-02-01,22,099,LA,St. Martin Parish,22088,21304,784,3.5
CN2210100000000,2023-02-01,22,101,LA,St. Mary Parish,18950,18160,790,4.2
CN2210300000000,2023-02-01,22,103,LA,St. Tammany Parish,121378,117697,3681,3
CN2210500000000,2023-02-01,22,105,LA,Tangipahoa Parish,57255,54879,2376,4.1
CN2210700000000,2023-02-01,22,107,LA,Tensas Parish,1297,1225,72,5.6
CN2210900000000,2023-02-01,22,109,LA,Terrebonne Parish,44117,42583,1534,3.5
CN2211100000000,2023-02-01,22,111,LA,Union Parish,9238,8879,359,3.9
CN2211300000000,2023-02-01,22,113,LA,Vermilion Parish,24150,23278,872,3.6
CN2211500000000,2023-02-01,22,115,LA,Vernon Parish,16499,15773,726,4.4
CN2211700000000,2023-02-01,22,117,LA,Washington Parish,17300,16596,704,4.1
CN2211900000000,2023-02-01,22,119,LA,Webster Parish,14313,13702,611,4.3
CN2212100000000,2023-02-01,22,121,LA,West Baton Rouge Parish,14272,13842,430,3
CN2212300000000,2023-02-01,22,123,LA,West Carroll Parish,3490,3231,259,7.4
CN2212500000000,2023-02-01,22,125,LA,West Feliciana Parish,5556,5407,149,2.7
CN2212700000000,2023-02-01,22,127,LA,Winn Parish,4722,4525,197,4.2
CN2300100000000,2023-02-01,23,001,ME,Androscoggin County,52801,51157,1644,3.1
CN2300300000000,2023-02-01,23,003,ME,Aroostook County,27571,26392,1179,4.3
CN2300500000000,2023-02-01,23,005,ME,Cumberland County,160042,156501,3541,2.2
CN2300700000000,2023-02-01,23,007,ME,Franklin County,13889,13434,455,3.3
CN2300900000000,2023-02-01,23,009,ME,Hancock County,26687,25340,1347,5
CN2301100000000,2023-02-01,23,011,ME,Kennebec County,60813,59193,1620,2.7
CN2301300000000,2023-02-01,23,013,ME,Knox County,19147,18434,713,3.7
CN2301500000000,2023-02-01,23,015,ME,Lincoln County,15687,15139,548,3.5
CN2301700000000,2023-02-01,23,017,ME,Oxford County,26019,25138,881,3.4
CN2301900000000,2023-02-01,23,019,ME,Penobscot County,74830,72549,2281,3
CN2302100000000,2023-02-01,23,021,ME,Piscataquis County,7110,6790,320,4.5
CN2302300000000,2023-02-01,23,023,ME,Sagadahoc County,18728,18281,447,2.4
CN2302500000000,2023-02-01,23,025,ME,Somerset County,21588,20546,1042,4.8
CN2302700000000,2023-02-01,23,027,ME,Waldo County,19969,19239,730,3.7
CN2302900000000,2023-02-01,23,029,ME,Washington County,12715,11981,734,5.8
CN2303100000000,2023-02-01,23,031,ME,York County,111197,107870,3327,3
CN2400100000000,2023-02-01,24,001,MD,Allegany County,31476,30179,1297,4.1
CN2400300000000,2023-02-01,24,003,MD,Anne Arundel County,311371,303103,8268,2.7
CN2400500000000,2023-02-01,24,005,MD,Baltimore County,441083,427155,13928,3.2
CN2400900000000,2023-02-01,24,009,MD,Calvert County,49528,48195,1333,2.7
CN2401100000000,2023-02-01,24,011,MD,Caroline County,17481,16944,537,3.1
CN2401300000000,2023-02-01,24,013,MD,Carroll County,94317,91916,2401,2.5
CN2401500000000,2023-02-01,24,015,MD,Cecil County,54504,52771,1733,3.2
CN2401700000000,2023-02-01,24,017,MD,Charles County,86953,84302,2651,3
CN2401900000000,2023-02-01,24,019,MD,Dorchester County,15689,15132,557,3.6
CN2402100000000,2023-02-01,24,021,MD,Frederick County,137732,133910,3822,2.8
CN2402300000000,2023-02-01,24,023,MD,Garrett County,15359,14762,597,3.9
CN2402500000000,2023-02-01,24,025,MD,Harford County,139228,135260,3968,2.9
CN2402700000000,2023-02-01,24,027,MD,Howard County,186045,181535,4510,2.4
CN2402900000000,2023-02-01,24,029,MD,Kent County,10041,9655,386,3.8
CN2403100000000,2023-02-01,24,031,MD,Montgomery County,550409,535966,14443,2.6
CN2403300000000,2023-02-01,24,033,MD,Prince George's County,498173,482336,15837,3.2
CN2403500000000,2023-02-01,24,035,MD,Queen Anne's County,28050,27287,763,2.7
CN2403700000000,2023-02-01,24,037,MD,St. Mary's County,57668,56007,1661,2.9
CN2403900000000,2023-02-01,24,039,MD,Somerset County,8965,8553,412,4.6
CN2404100000000,2023-02-01,24,041,MD,Talbot County,17276,16688,588,3.4
CN2404300000000,2023-02-01,24,043,MD,Washington County,71877,69390,2487,3.5
CN2404500000000,2023-02-01,24,045,MD,Wicomico County,50105,48110,1995,4
CN2404700000000,2023-02-01,24,047,MD,Worcester County,25058,23464,1594,6.4
CN2451000000000,2023-02-01,24,510,MD,Baltimore city,272006,260934,11072,4.1
CN2500100000000,2023-02-01,25,001,MA,Barnstable County,108791,100936,7855,7.2
CN2500300000000,2023-02-01,25,003,MA,Berkshire County,61404,58243,3161,5.1
CN2500500000000,2023-02-01,25,005,MA,Bristol County,300490,283380,17110,5.7
CN2500700000000,2023-02-01,25,007,MA,Dukes County,8398,7628,770,9.2
CN2500900000000,2023-02-01,25,009,MA,Essex County,424247,405759,18488,4.4
CN2501100000000,2023-02-01,25,011,MA,Franklin County,40076,38519,1557,3.9
CN2501300000000,2023-02-01,25,013,MA,Hampden County,225782,213820,11962,5.3
CN2501500000000,2023-02-01,25,015,MA,Hampshire County,90088,86752,3336,3.7
CN2501700000000,2023-02-01,25,017,MA,Middlesex County,915015,885074,29941,3.3
CN2501900000000,2023-02-01,25,019,MA,Nantucket County/town,6833,5763,1070,15.7
CN2502100000000,2023-02-01,25,021,MA,Norfolk County,395458,381074,14384,3.6
CN2502300000000,2023-02-01,25,023,MA,Plymouth County,285447,272637,12810,4.5
CN2502500000000,2023-02-01,25,025,MA,Suffolk County,455169,438822,16347,3.6
CN2502700000000,2023-02-01,25,027,MA,Worcester County,446198,426048,20150,4.5
CN2600100000000,2023-02-01,26,001,MI,Alcona County,3801,3440,361,9.5
CN2600300000000,2023-02-01,26,003,MI,Alger County,3245,2888,357,11
CN2600500000000,2023-02-01,26,005,MI,Allegan County,61899,59157,2742,4.4
CN2600700000000,2023-02-01,26,007,MI,Alpena County,13463,12584,879,6.5
CN2600900000000,2023-02-01,26,009,MI,Antrim County,9949,9124,825,8.3
CN2601100000000,2023-02-01,26,011,MI,Arenac County,5825,5192,633,10.9
CN2601300000000,2023-02-01,26,013,MI,Baraga County,3037,2761,276,9.1
CN2601500000000,2023-02-01,26,015,MI,Barry County,32251,30795,1456,4.5
CN2601700000000,2023-02-01,26,017,MI,Bay County,49778,46525,3253,6.5
CN2601900000000,2023-02-01,26,019,MI,Benzie County,8691,8014,677,7.8
CN2602100000000,2023-02-01,26,021,MI,Berrien County,72698,68940,3758,5.2
CN2602300000000,2023-02-01,26,023,MI,Branch County,19480,18516,964,4.9
CN2602500000000,2023-02-01,26,025,MI,Calhoun County,60177,57080,3097,5.1
CN2602700000000,2023-02-01,26,027,MI,Cass County,23672,22393,1279,5.4
CN2602900000000,2023-02-01,26,029,MI,Charlevoix County,12473,11621,852,6.8
CN2603100000000,2023-02-01,26,031,MI,Cheboygan County,9862,8259,1603,16.3
CN2603300000000,2023-02-01,26,033,MI,Chippewa County,16222,14786,1436,8.9
CN2603500000000,2023-02-01,26,035,MI,Clare County,11130,10116,1014,9.1
CN2603700000000,2023-02-01,26,037,MI,Clinton County,41077,39400,1677,4.1
CN2603900000000,2023-02-01,26,039,MI,Crawford County,5440,4968,472,8.7
CN2604100000000,2023-02-01,26,041,MI,Delta County,16436,15236,1200,7.3
CN2604300000000,2023-02-01,26,043,MI,Dickinson County,11975,11383,592,4.9
CN2604500000000,2023-02-01,26,045,MI,Eaton County,57310,54792,2518,4.4
CN2604700000000,2023-02-01,26,047,MI,Emmet County,16262,14841,1421,8.7
CN2604900000000,2023-02-01,26,049,MI,Genesee County,179425,168469,10956,6.1
CN2605100000000,2023-02-01,26,051,MI,Gladwin County,10054,9240,814,8.1
CN2605300000000,2023-02-01,26,053,MI,Gogebic County,5779,5438,341,5.9
CN2605500000000,2023-02-01,26,055,MI,Grand Traverse County,48347,46080,2267,4.7
CN2605700000000,2023-02-01,26,057,MI,Gratiot County,17368,16439,929,5.3
CN2605900000000,2023-02-01,26,059,MI,Hillsdale County,19981,18967,1014,5.1
CN2606100000000,2023-02-01,26,061,MI,Houghton County,16839,15881,958,5.7
CN2606300000000,2023-02-01,26,063,MI,Huron County,14698,13777,921,6.3
CN2606500000000,2023-02-01,26,065,MI,Ingham County,149672,143176,6496,4.3
CN2606700000000,2023-02-01,26,067,MI,Ionia County,30407,29006,1401,4.6
CN2606900000000,2023-02-01,26,069,MI,Iosco County,10243,9317,926,9
CN2607100000000,2023-02-01,26,071,MI,Iron County,4596,4203,393,8.6
CN2607300000000,2023-02-01,26,073,MI,Isabella County,31290,29553,1737,5.6
CN2607500000000,2023-02-01,26,075,MI,Jackson County,74659,71013,3646,4.9
CN2607700000000,2023-02-01,26,077,MI,Kalamazoo County,133238,127729,5509,4.1
CN2607900000000,2023-02-01,26,079,MI,Kalkaska County,7823,7165,658,8.4
CN2608100000000,2023-02-01,26,081,MI,Kent County,363947,350753,13194,3.6
CN2608300000000,2023-02-01,26,083,MI,Keweenaw County,938,869,69,7.4
CN2608500000000,2023-02-01,26,085,MI,Lake County,3964,3593,371,9.4
CN2608700000000,2023-02-01,26,087,MI,Lapeer County,39955,37848,2107,5.3
CN2608900000000,2023-02-01,26,089,MI,Leelanau County,10067,9521,546,5.4
CN2609100000000,2023-02-01,26,091,MI,Lenawee County,44745,42469,2276,5.1
CN2609300000000,2023-02-01,26,093,MI,Livingston County,101391,98384,3007,3
CN2609500000000,2023-02-01,26,095,MI,Luce County,2066,1904,162,7.8
CN2609700000000,2023-02-01,26,097,MI,Mackinac County,4561,3528,1033,22.6
CN2609900000000,2023-02-01,26,099,MI,Macomb County,434774,418487,16287,3.7
CN2610100000000,2023-02-01,26,101,MI,Manistee County,9382,8601,781,8.3
CN2610300000000,2023-02-01,26,103,MI,Marquette County,32255,30242,2013,6.2
CN2610500000000,2023-02-01,26,105,MI,Mason County,12705,11773,932,7.3
CN2610700000000,2023-02-01,26,107,MI,Mecosta County,18734,17455,1279,6.8
CN2610900000000,2023-02-01,26,109,MI,Menominee County,10437,9942,495,4.7
CN2611100000000,2023-02-01,26,111,MI,Midland County,40423,38372,2051,5.1
CN2611300000000,2023-02-01,26,113,MI,Missaukee County,6729,6279,450,6.7
CN2611500000000,2023-02-01,26,115,MI,Monroe County,75351,71475,3876,5.1
CN2611700000000,2023-02-01,26,117,MI,Montcalm County,28206,26709,1497,5.3
CN2611900000000,2023-02-01,26,119,MI,Montmorency County,3057,2723,334,10.9
CN2612100000000,2023-02-01,26,121,MI,Muskegon County,76803,72749,4054,5.3
CN2612300000000,2023-02-01,26,123,MI,Newaygo County,23051,21784,1267,5.5
CN2612500000000,2023-02-01,26,125,MI,Oakland County,655256,635986,19270,2.9
CN2612700000000,2023-02-01,26,127,MI,Oceana County,10984,10033,951,8.7
CN2612900000000,2023-02-01,26,129,MI,Ogemaw County,8114,7276,838,10.3
CN2613100000000,2023-02-01,26,131,MI,Ontonagon County,2026,1868,158,7.8
CN2613300000000,2023-02-01,26,133,MI,Osceola County,11624,10931,693,6
CN2613500000000,2023-02-01,26,135,MI,Oscoda County,2626,2342,284,10.8
CN2613700000000,2023-02-01,26,137,MI,Otsego County,11368,10671,697,6.1
CN2613900000000,2023-02-01,26,139,MI,Ottawa County,163346,157688,5658,3.5
CN2614100000000,2023-02-01,26,141,MI,Presque Isle County,4960,4301,659,13.3
CN2614300000000,2023-02-01,26,143,MI,Roscommon County,7862,6933,929,11.8
CN2614500000000,2023-02-01,26,145,MI,Saginaw County,83673,78144,5529,6.6
CN2614700000000,2023-02-01,26,147,MI,St. Clair County,73649,70382,3267,4.4
CN2614900000000,2023-02-01,26,149,MI,St. Joseph County,28283,26854,1429,5.1
CN2615100000000,2023-02-01,26,151,MI,Sanilac County,18641,17373,1268,6.8
CN2615300000000,2023-02-01,26,153,MI,Schoolcraft County,3103,2764,339,10.9
CN2615500000000,2023-02-01,26,155,MI,Shiawassee County,32557,30726,1831,5.6
CN2615700000000,2023-02-01,26,157,MI,Tuscola County,22915,21300,1615,7
CN2615900000000,2023-02-01,26,159,MI,Van Buren County,34788,32534,2254,6.5
CN2616100000000,2023-02-01,26,161,MI,Washtenaw County,200361,193343,7018,3.5
CN2616300000000,2023-02-01,26,163,MI,Wayne County,784477,749756,34721,4.4
CN2616500000000,2023-02-01,26,165,MI,Wexford County,14698,13837,861,5.9
CN2700100000000,2023-02-01,27,001,MN,Aitkin County,7470,6908,562,7.5
CN2700300000000,2023-02-01,27,003,MN,Anoka County,197904,191311,6593,3.3
CN2700500000000,2023-02-01,27,005,MN,Becker County,19310,18423,887,4.6
CN2700700000000,2023-02-01,27,007,MN,Beltrami County,25026,23839,1187,4.7
CN2700900000000,2023-02-01,27,009,MN,Benton County,22062,20883,1179,5.3
CN2701100000000,2023-02-01,27,011,MN,Big Stone County,2326,2208,118,5.1
CN2701300000000,2023-02-01,27,013,MN,Blue Earth County,41254,40025,1229,3
CN2701500000000,2023-02-01,27,015,MN,Brown County,13563,12963,600,4.4
CN2701700000000,2023-02-01,27,017,MN,Carlton County,17773,16851,922,5.2
CN2701900000000,2023-02-01,27,019,MN,Carver County,59093,57421,1672,2.8
CN2702100000000,2023-02-01,27,021,MN,Cass County,14237,13171,1066,7.5
CN2702300000000,2023-02-01,27,023,MN,Chippewa County,6341,6113,228,3.6
CN2702500000000,2023-02-01,27,025,MN,Chisago County,30214,28727,1487,4.9
CN2702700000000,2023-02-01,27,027,MN,Clay County,37799,36744,1055,2.8
CN2702900000000,2023-02-01,27,029,MN,Clearwater County,4572,4121,451,9.9
CN2703100000000,2023-02-01,27,031,MN,Cook County,2627,2472,155,5.9
CN2703300000000,2023-02-01,27,033,MN,Cottonwood County,6705,6494,211,3.1
CN2703500000000,2023-02-01,27,035,MN,Crow Wing County,32851,31128,1723,5.2
CN2703700000000,2023-02-01,27,037,MN,Dakota County,241032,233834,7198,3
CN2703900000000,2023-02-01,27,039,MN,Dodge County,12116,11615,501,4.1
CN2704100000000,2023-02-01,27,041,MN,Douglas County,21254,20489,765,3.6
CN2704300000000,2023-02-01,27,043,MN,Faribault County,6984,6664,320,4.6
CN2704500000000,2023-02-01,27,045,MN,Fillmore County,11677,11153,524,4.5
CN2704700000000,2023-02-01,27,047,MN,Freeborn County,15846,15299,547,3.5
CN2704900000000,2023-02-01,27,049,MN,Goodhue County,26532,25582,950,3.6
CN2705100000000,2023-02-01,27,051,MN,Grant County,3235,3080,155,4.8
CN2705300000000,2023-02-01,27,053,MN,Hennepin County,698797,679464,19333,2.8
CN2705500000000,2023-02-01,27,055,MN,Houston County,10670,10254,416,3.9
CN2705700000000,2023-02-01,27,057,MN,Hubbard County,9958,9280,678,6.8
CN2705900000000,2023-02-01,27,059,MN,Isanti County,22065,20779,1286,5.8
CN2706100000000,2023-02-01,27,061,MN,Itasca County,21413,20040,1373,6.4
CN2706300000000,2023-02-01,27,063,MN,Jackson County,5364,5185,179,3.3
CN2706500000000,2023-02-01,27,065,MN,Kanabec County,9422,8593,829,8.8
CN2706700000000,2023-02-01,27,067,MN,Kandiyohi County,22834,21842,992,4.3
CN2706900000000,2023-02-01,27,069,MN,Kittson County,2200,2117,83,3.8
CN2707100000000,2023-02-01,27,071,MN,Koochiching County,5631,5380,251,4.5
CN2707300000000,2023-02-01,27,073,MN,Lac qui Parle County,3412,3274,138,4
CN2707500000000,2023-02-01,27,075,MN,Lake County,5040,4731,309,6.1
CN2707700000000,2023-02-01,27,077,MN,Lake of the Woods County,2486,2402,84,3.4
CN2707900000000,2023-02-01,27,079,MN,Le Sueur County,16314,15190,1124,6.9
CN2708100000000,2023-02-01,27,081,MN,Lincoln County,3004,2837,167,5.6
CN2708300000000,2023-02-01,27,083,MN,Lyon County,14322,13808,514,3.6
CN2708500000000,2023-02-01,27,085,MN,McLeod County,19229,18358,871,4.5
CN2708700000000,2023-02-01,27,087,MN,Mahnomen County,2289,2133,156,6.8
CN2708900000000,2023-02-01,27,089,MN,Marshall County,5395,5015,380,7
CN2709100000000,2023-02-01,27,091,MN,Martin County,9523,9167,356,3.7
CN2709300000000,2023-02-01,27,093,MN,Meeker County,13669,13014,655,4.8
CN2709500000000,2023-02-01,27,095,MN,Mille Lacs County,13068,11983,1085,8.3
CN2709700000000,2023-02-01,27,097,MN,Morrison County,17429,16094,1335,7.7
CN2709900000000,2023-02-01,27,099,MN,Mower County,20718,20008,710,3.4
CN2710100000000,2023-02-01,27,101,MN,Murray County,4627,4301,326,7
CN2710300000000,2023-02-01,27,103,MN,Nicollet County,21148,20572,576,2.7
CN2710500000000,2023-02-01,27,105,MN,Nobles County,10876,10551,325,3
CN2710700000000,2023-02-01,27,107,MN,Norman County,3203,3036,167,5.2
CN2710900000000,2023-02-01,27,109,MN,Olmsted County,91627,89235,2392,2.6
CN2711100000000,2023-02-01,27,111,MN,Otter Tail County,30604,28993,1611,5.3
CN2711300000000,2023-02-01,27,113,MN,Pennington County,8826,8350,476,5.4
CN2711500000000,2023-02-01,27,115,MN,Pine County,14468,13259,1209,8.4
CN2711700000000,2023-02-01,27,117,MN,Pipestone County,4590,4361,229,5
CN2711900000000,2023-02-01,27,119,MN,Polk County,16422,15808,614,3.7
CN2712100000000,2023-02-01,27,121,MN,Pope County,6407,6146,261,4.1
CN2712300000000,2023-02-01,27,123,MN,Ramsey County,283188,274708,8480,3
CN2712500000000,2023-02-01,27,125,MN,Red Lake County,2184,2050,134,6.1
CN2712700000000,2023-02-01,27,127,MN,Redwood County,7504,7228,276,3.7
CN2712900000000,2023-02-01,27,129,MN,Renville County,7961,7535,426,5.4
CN2713100000000,2023-02-01,27,131,MN,Rice County,37408,36077,1331,3.6
CN2713300000000,2023-02-01,27,133,MN,Rock County,5950,5811,139,2.3
CN2713500000000,2023-02-01,27,135,MN,Roseau County,7833,7574,259,3.3
CN2713700000000,2023-02-01,27,137,MN,St. Louis County,100554,96435,4119,4.1
CN2713900000000,2023-02-01,27,139,MN,Scott County,84072,81531,2541,3
CN2714100000000,2023-02-01,27,141,MN,Sherburne County,53493,51061,2432,4.5
CN2714300000000,2023-02-01,27,143,MN,Sibley County,8176,7761,415,5.1
CN2714500000000,2023-02-01,27,145,MN,Stearns County,90396,87074,3322,3.7
CN2714700000000,2023-02-01,27,147,MN,Steele County,18329,17600,729,4
CN2714900000000,2023-02-01,27,149,MN,Stevens County,5211,5040,171,3.3
CN2715100000000,2023-02-01,27,151,MN,Swift County,4765,4561,204,4.3
CN2715300000000,2023-02-01,27,153,MN,Todd County,13662,12930,732,5.4
CN2715500000000,2023-02-01,27,155,MN,Traverse County,1625,1555,70,4.3
CN2715700000000,2023-02-01,27,157,MN,Wabasha County,12367,11875,492,4
CN2715900000000,2023-02-01,27,159,MN,Wadena County,6246,5803,443,7.1
CN2716100000000,2023-02-01,27,161,MN,Waseca County,8434,7936,498,5.9
CN2716300000000,2023-02-01,27,163,MN,Washington County,144061,139980,4081,2.8
CN2716500000000,2023-02-01,27,165,MN,Watonwan County,6566,6307,259,3.9
CN2716700000000,2023-02-01,27,167,MN,Wilkin County,3370,3266,104,3.1
CN2716900000000,2023-02-01,27,169,MN,Winona County,28448,27645,803,2.8
CN2717100000000,2023-02-01,27,171,MN,Wright County,77031,73829,3202,4.2
CN2717300000000,2023-02-01,27,173,MN,Yellow Medicine County,4969,4771,198,4
CN2800100000000,2023-02-01,28,001,MS,Adams County,10284,9839,445,4.3
CN2800300000000,2023-02-01,28,003,MS,Alcorn County,15113,14656,457,3
CN2800500000000,2023-02-01,28,005,MS,Amite County,4210,4038,172,4.1
CN2800700000000,2023-02-01,28,007,MS,Attala County,6816,6572,244,3.6
CN2800900000000,2023-02-01,28,009,MS,Benton County,3030,2915,115,3.8
CN2801100000000,2023-02-01,28,011,MS,Bolivar County,10936,10520,416,3.8
CN2801300000000,2023-02-01,28,013,MS,Calhoun County,5289,5102,187,3.5
CN2801500000000,2023-02-01,28,015,MS,Carroll County,3183,3062,121,3.8
CN2801700000000,2023-02-01,28,017,MS,Chickasaw County,6366,6115,251,3.9
CN2801900000000,2023-02-01,28,019,MS,Choctaw County,3511,3408,103,2.9
CN2802100000000,2023-02-01,28,021,MS,Claiborne County,2814,2629,185,6.6
CN2802300000000,2023-02-01,28,023,MS,Clarke County,5536,5338,198,3.6
CN2802500000000,2023-02-01,28,025,MS,Clay County,8895,8606,289,3.2
CN2802700000000,2023-02-01,28,027,MS,Coahoma County,7413,7051,362,4.9
CN2802900000000,2023-02-01,28,029,MS,Copiah County,10759,10355,404,3.8
CN2803100000000,2023-02-01,28,031,MS,Covington County,8096,7866,230,2.8
CN2803300000000,2023-02-01,28,033,MS,DeSoto County,93461,90895,2566,2.7
CN2803500000000,2023-02-01,28,035,MS,Forrest County,33137,32111,1026,3.1
CN2803700000000,2023-02-01,28,037,MS,Franklin County,2588,2470,118,4.6
CN2803900000000,2023-02-01,28,039,MS,George County,8608,8265,343,4
CN2804100000000,2023-02-01,28,041,MS,Greene County,4122,3944,178,4.3
CN2804300000000,2023-02-01,28,043,MS,Grenada County,8427,8152,275,3.3
CN2804500000000,2023-02-01,28,045,MS,Hancock County,18690,18051,639,3.4
CN2804700000000,2023-02-01,28,047,MS,Harrison County,86288,83648,2640,3.1
CN2804900000000,2023-02-01,28,049,MS,Hinds County,101565,98374,3191,3.1
CN2805100000000,2023-02-01,28,051,MS,Holmes County,4984,4703,281,5.6
CN2805300000000,2023-02-01,28,053,MS,Humphreys County,1916,1796,120,6.3
CN2805500000000,2023-02-01,28,055,MS,Issaquena County,301,282,19,6.3
CN2805700000000,2023-02-01,28,057,MS,Itawamba County,10096,9779,317,3.1
CN2805900000000,2023-02-01,28,059,MS,Jackson County,57828,55873,1955,3.4
CN2806100000000,2023-02-01,28,061,MS,Jasper County,5810,5582,228,3.9
CN2806300000000,2023-02-01,28,063,MS,Jefferson County,1764,1607,157,8.9
CN2806500000000,2023-02-01,28,065,MS,Jefferson Davis County,3843,3691,152,4
CN2806700000000,2023-02-01,28,067,MS,Jones County,24839,23997,842,3.4
CN2806900000000,2023-02-01,28,069,MS,Kemper County,3206,3060,146,4.6
CN2807100000000,2023-02-01,28,071,MS,Lafayette County,28169,27402,767,2.7
CN2807300000000,2023-02-01,28,073,MS,Lamar County,31572,30773,799,2.5
CN2807500000000,2023-02-01,28,075,MS,Lauderdale County,28670,27746,924,3.2
CN2807700000000,2023-02-01,28,077,MS,Lawrence County,4759,4578,181,3.8
CN2807900000000,2023-02-01,28,079,MS,Leake County,7877,7631,246,3.1
CN2808100000000,2023-02-01,28,081,MS,Lee County,40013,38909,1104,2.8
CN2808300000000,2023-02-01,28,083,MS,Leflore County,8990,8556,434,4.8
CN2808500000000,2023-02-01,28,085,MS,Lincoln County,14358,13913,445,3.1
CN2808700000000,2023-02-01,28,087,MS,Lowndes County,24504,23689,815,3.3
CN2808900000000,2023-02-01,28,089,MS,Madison County,53318,51953,1365,2.6
CN2809100000000,2023-02-01,28,091,MS,Marion County,9857,9541,316,3.2
CN2809300000000,2023-02-01,28,093,MS,Marshall County,14160,13671,489,3.5
CN2809500000000,2023-02-01,28,095,MS,Monroe County,15063,14523,540,3.6
CN2809700000000,2023-02-01,28,097,MS,Montgomery County,3850,3711,139,3.6
CN2809900000000,2023-02-01,28,099,MS,Neshoba County,9692,9338,354,3.7
CN2810100000000,2023-02-01,28,101,MS,Newton County,7785,7507,278,3.6
CN2810300000000,2023-02-01,28,103,MS,Noxubee County,3313,3159,154,4.6
CN2810500000000,2023-02-01,28,105,MS,Oktibbeha County,22317,21532,785,3.5
CN2810700000000,2023-02-01,28,107,MS,Panola County,12065,11601,464,3.8
CN2810900000000,2023-02-01,28,109,MS,Pearl River County,23285,22546,739,3.2
CN2811100000000,2023-02-01,28,111,MS,Perry County,4213,4049,164,3.9
CN2811300000000,2023-02-01,28,113,MS,Pike County,13772,13248,524,3.8
CN2811500000000,2023-02-01,28,115,MS,Pontotoc County,14578,14161,417,2.9
CN2811700000000,2023-02-01,28,117,MS,Prentiss County,11199,10888,311,2.8
CN2811900000000,2023-02-01,28,119,MS,Quitman County,2242,2135,107,4.8
CN2812100000000,2023-02-01,28,121,MS,Rankin County,76649,74798,1851,2.4
CN2812300000000,2023-02-01,28,123,MS,Scott County,12103,11774,329,2.7
CN2812500000000,2023-02-01,28,125,MS,Sharkey County,1283,1225,58,4.5
CN2812700000000,2023-02-01,28,127,MS,Simpson County,10569,10243,326,3.1
CN2812900000000,2023-02-01,28,129,MS,Smith County,6598,6412,186,2.8
CN2813100000000,2023-02-01,28,131,MS,Stone County,7002,6755,247,3.5
CN2813300000000,2023-02-01,28,133,MS,Sunflower County,7080,6725,355,5
CN2813500000000,2023-02-01,28,135,MS,Tallahatchie County,4486,4329,157,3.5
CN2813700000000,2023-02-01,28,137,MS,Tate County,12086,11675,411,3.4
CN2813900000000,2023-02-01,28,139,MS,Tippah County,9886,9605,281,2.8
CN2814100000000,2023-02-01,28,141,MS,Tishomingo County,8589,8318,271,3.2
CN2814300000000,2023-02-01,28,143,MS,Tunica County,4144,3990,154,3.7
CN2814500000000,2023-02-01,28,145,MS,Union County,14598,14250,348,2.4
CN2814700000000,2023-02-01,28,147,MS,Walthall County,4852,4655,197,4.1
CN2814900000000,2023-02-01,28,149,MS,Warren County,18878,18234,644,3.4
CN2815100000000,2023-02-01,28,151,MS,Washington County,14191,13505,686,4.8
CN2815300000000,2023-02-01,28,153,MS,Wayne County,6860,6604,256,3.7
CN2815500000000,2023-02-01,28,155,MS,Webster County,3838,3717,121,3.2
CN2815700000000,2023-02-01,28,157,MS,Wilkinson County,2551,2420,131,5.1
CN2815900000000,2023-02-01,28,159,MS,Winston County,7073,6835,238,3.4
CN2816100000000,2023-02-01,28,161,MS,Yalobusha County,4628,4466,162,3.5
CN2816300000000,2023-02-01,28,163,MS,Yazoo County,8788,8488,300,3.4
CN2900100000000,2023-02-01,29,001,MO,Adair County,9784,9489,295,3
CN2900300000000,2023-02-01,29,003,MO,Andrew County,9499,9274,225,2.4
CN2900500000000,2023-02-01,29,005,MO,Atchison County,2561,2510,51,2
CN2900700000000,2023-02-01,29,007,MO,Audrain County,9925,9647,278,2.8
CN2900900000000,2023-02-01,29,009,MO,Barry County,14155,13737,418,3
CN2901100000000,2023-02-01,29,011,MO,Barton County,5234,5108,126,2.4
CN2901300000000,2023-02-01,29,013,MO,Bates County,7794,7538,256,3.3
CN2901500000000,2023-02-01,29,015,MO,Benton County,7246,6943,303,4.2
CN2901700000000,2023-02-01,29,017,MO,Bollinger County,5377,5241,136,2.5
CN2901900000000,2023-02-01,29,019,MO,Boone County,101004,99003,2001,2
CN2902100000000,2023-02-01,29,021,MO,Buchanan County,42406,41325,1081,2.5
CN2902300000000,2023-02-01,29,023,MO,Butler County,17961,17324,637,3.5
CN2902500000000,2023-02-01,29,025,MO,Caldwell County,4311,4194,117,2.7
CN2902700000000,2023-02-01,29,027,MO,Callaway County,22043,21502,541,2.5
CN2902900000000,2023-02-01,29,029,MO,Camden County,17821,17029,792,4.4
CN2903100000000,2023-02-01,29,031,MO,Cape Girardeau County,40923,40057,866,2.1
CN2903300000000,2023-02-01,29,033,MO,Carroll County,4450,4327,123,2.8
CN2903500000000,2023-02-01,29,035,MO,Carter County,2437,2333,104,4.3
CN2903700000000,2023-02-01,29,037,MO,Cass County,55628,54165,1463,2.6
CN2903900000000,2023-02-01,29,039,MO,Cedar County,5635,5466,169,3
CN2904100000000,2023-02-01,29,041,MO,Chariton County,3718,3641,77,2.1
CN2904300000000,2023-02-01,29,043,MO,Christian County,48086,47030,1056,2.2
CN2904500000000,2023-02-01,29,045,MO,Clark County,3007,2890,117,3.9
CN2904700000000,2023-02-01,29,047,MO,Clay County,139606,136506,3100,2.2
CN2904900000000,2023-02-01,29,049,MO,Clinton County,10768,10441,327,3
CN2905100000000,2023-02-01,29,051,MO,Cole County,39941,39136,805,2
CN2905300000000,2023-02-01,29,053,MO,Cooper County,7034,6857,177,2.5
CN2905500000000,2023-02-01,29,055,MO,Crawford County,10755,10428,327,3
CN2905700000000,2023-02-01,29,057,MO,Dade County,3508,3420,88,2.5
CN2905900000000,2023-02-01,29,059,MO,Dallas County,7325,7132,193,2.6
CN2906100000000,2023-02-01,29,061,MO,Daviess County,4007,3911,96,2.4
CN2906300000000,2023-02-01,29,063,MO,DeKalb County,4077,3967,110,2.7
CN2906500000000,2023-02-01,29,065,MO,Dent County,6031,5855,176,2.9
CN2906700000000,2023-02-01,29,067,MO,Douglas County,5233,5100,133,2.5
CN2906900000000,2023-02-01,29,069,MO,Dunklin County,11060,10536,524,4.7
CN2907100000000,2023-02-01,29,071,MO,Franklin County,53345,51979,1366,2.6
CN2907300000000,2023-02-01,29,073,MO,Gasconade County,7567,7404,163,2.2
CN2907500000000,2023-02-01,29,075,MO,Gentry County,3199,3129,70,2.2
CN2907700000000,2023-02-01,29,077,MO,Greene County,156929,153655,3274,2.1
CN2907900000000,2023-02-01,29,079,MO,Grundy County,4068,3950,118,2.9
CN2908100000000,2023-02-01,29,081,MO,Harrison County,3726,3617,109,2.9
CN2908300000000,2023-02-01,29,083,MO,Henry County,10322,10050,272,2.6
CN2908500000000,2023-02-01,29,085,MO,Hickory County,3929,3784,145,3.7
CN2908700000000,2023-02-01,29,087,MO,Holt County,2439,2391,48,2
CN2908900000000,2023-02-01,29,089,MO,Howard County,4770,4657,113,2.4
CN2909100000000,2023-02-01,29,091,MO,Howell County,15919,15453,466,2.9
CN2909300000000,2023-02-01,29,093,MO,Iron County,3514,3357,157,4.5
CN2909500000000,2023-02-01,29,095,MO,Jackson County,363546,352882,10664,2.9
CN2909700000000,2023-02-01,29,097,MO,Jasper County,57418,56080,1338,2.3
CN2909900000000,2023-02-01,29,099,MO,Jefferson County,118817,115854,2963,2.5
CN2910100000000,2023-02-01,29,101,MO,Johnson County,23034,22400,634,2.8
CN2910300000000,2023-02-01,29,103,MO,Knox County,1718,1668,50,2.9
CN2910500000000,2023-02-01,29,105,MO,Laclede County,16968,16513,455,2.7
CN2910700000000,2023-02-01,29,107,MO,Lafayette County,16971,16501,470,2.8
CN2910900000000,2023-02-01,29,109,MO,Lawrence County,17187,16740,447,2.6
CN2911100000000,2023-02-01,29,111,MO,Lewis County,4739,4616,123,2.6
CN2911300000000,2023-02-01,29,113,MO,Lincoln County,29487,28684,803,2.7
CN2911500000000,2023-02-01,29,115,MO,Linn County,5163,4983,180,3.5
CN2911700000000,2023-02-01,29,117,MO,Livingston County,7215,7084,131,1.8
CN2911900000000,2023-02-01,29,119,MO,McDonald County,11361,11107,254,2.2
CN2912100000000,2023-02-01,29,121,MO,Macon County,7179,6946,233,3.2
CN2912300000000,2023-02-01,29,123,MO,Madison County,5347,5197,150,2.8
CN2912500000000,2023-02-01,29,125,MO,Maries County,3869,3770,99,2.6
CN2912700000000,2023-02-01,29,127,MO,Marion County,13532,13136,396,2.9
CN2912900000000,2023-02-01,29,129,MO,Mercer County,1704,1662,42,2.5
CN2913100000000,2023-02-01,29,131,MO,Miller County,12616,12191,425,3.4
CN2913300000000,2023-02-01,29,133,MO,Mississippi County,5189,5013,176,3.4
CN2913500000000,2023-02-01,29,135,MO,Moniteau County,7223,7071,152,2.1
CN2913700000000,2023-02-01,29,137,MO,Monroe County,3738,3626,112,3
CN2913900000000,2023-02-01,29,139,MO,Montgomery County,5863,5705,158,2.7
CN2914100000000,2023-02-01,29,141,MO,Morgan County,8092,7785,307,3.8
CN2914300000000,2023-02-01,29,143,MO,New Madrid County,8197,7948,249,3
CN2914500000000,2023-02-01,29,145,MO,Newton County,27210,26573,637,2.3
CN2914700000000,2023-02-01,29,147,MO,Nodaway County,11163,10925,238,2.1
CN2914900000000,2023-02-01,29,149,MO,Oregon County,3790,3678,112,3
CN2915100000000,2023-02-01,29,151,MO,Osage County,7214,7065,149,2.1
CN2915300000000,2023-02-01,29,153,MO,Ozark County,3339,3190,149,4.5
CN2915500000000,2023-02-01,29,155,MO,Pemiscot County,5705,5483,222,3.9
CN2915700000000,2023-02-01,29,157,MO,Perry County,9458,9252,206,2.2
CN2915900000000,2023-02-01,29,159,MO,Pettis County,20081,19548,533,2.7
CN2916100000000,2023-02-01,29,161,MO,Phelps County,20011,19502,509,2.5
CN2916300000000,2023-02-01,29,163,MO,Pike County,7240,7047,193,2.7
CN2916500000000,2023-02-01,29,165,MO,Platte County,60439,59195,1244,2.1
CN2916700000000,2023-02-01,29,167,MO,Polk County,14962,14599,363,2.4
CN2916900000000,2023-02-01,29,169,MO,Pulaski County,14736,14321,415,2.8
CN2917100000000,2023-02-01,29,171,MO,Putnam County,2193,2129,64,2.9
CN2917300000000,2023-02-01,29,173,MO,Ralls County,5335,5191,144,2.7
CN2917500000000,2023-02-01,29,175,MO,Randolph County,10294,10024,270,2.6
CN2917700000000,2023-02-01,29,177,MO,Ray County,10948,10640,308,2.8
CN2917900000000,2023-02-01,29,179,MO,Reynolds County,2716,2631,85,3.1
CN2918100000000,2023-02-01,29,181,MO,Ripley County,5100,4923,177,3.5
CN2918300000000,2023-02-01,29,183,MO,St. Charles County,230273,225497,4776,2.1
CN2918500000000,2023-02-01,29,185,MO,St. Clair County,3841,3724,117,3
CN2918600000000,2023-02-01,29,186,MO,Ste. Genevieve County,9193,8966,227,2.5
CN2918700000000,2023-02-01,29,187,MO,St. Francois County,25431,24490,941,3.7
CN2918900000000,2023-02-01,29,189,MO,St. Louis County,528963,516128,12835,2.4
CN2919500000000,2023-02-01,29,195,MO,Saline County,10311,10054,257,2.5
CN2919700000000,2023-02-01,29,197,MO,Schuyler County,1832,1757,75,4.1
CN2919900000000,2023-02-01,29,199,MO,Scotland County,2242,2197,45,2
CN2920100000000,2023-02-01,29,201,MO,Scott County,20127,19657,470,2.3
CN2920300000000,2023-02-01,29,203,MO,Shannon County,3256,3096,160,4.9
CN2920500000000,2023-02-01,29,205,MO,Shelby County,2992,2896,96,3.2
CN2920700000000,2023-02-01,29,207,MO,Stoddard County,13109,12684,425,3.2
CN2920900000000,2023-02-01,29,209,MO,Stone County,12399,11378,1021,8.2
CN2921100000000,2023-02-01,29,211,MO,Sullivan County,2614,2534,80,3.1
CN2921300000000,2023-02-01,29,213,MO,Taney County,24209,21644,2565,10.6
CN2921500000000,2023-02-01,29,215,MO,Texas County,9176,8881,295,3.2
CN2921700000000,2023-02-01,29,217,MO,Vernon County,9237,8980,257,2.8
CN2921900000000,2023-02-01,29,219,MO,Warren County,18894,18413,481,2.5
CN2922100000000,2023-02-01,29,221,MO,Washington County,10026,9624,402,4
CN2922300000000,2023-02-01,29,223,MO,Wayne County,4625,4433,192,4.2
CN2922500000000,2023-02-01,29,225,MO,Webster County,17861,17486,375,2.1
CN2922700000000,2023-02-01,29,227,MO,Worth County,1152,1126,26,2.3
CN2922900000000,2023-02-01,29,229,MO,Wright County,7696,7479,217,2.8
CN2951000000000,2023-02-01,29,510,MO,St. Louis city,149488,144835,4653,3.1
CN3000100000000,2023-02-01,30,001,MT,Beaverhead County,5605,5481,124,2.2
CN3000300000000,2023-02-01,30,003,MT,Big Horn County,4635,4436,199,4.3
CN3000500000000,2023-02-01,30,005,MT,Blaine County,2255,2174,81,3.6
CN3000700000000,2023-02-01,30,007,MT,Broadwater County,2863,2745,118,4.1
CN3000900000000,2023-02-01,30,009,MT,Carbon County,5755,5597,158,2.7
CN3001100000000,2023-02-01,30,011,MT,Carter County,698,684,14,2
CN3001300000000,2023-02-01,30,013,MT,Cascade County,39502,38446,1056,2.7
CN3001500000000,2023-02-01,30,015,MT,Chouteau County,2550,2483,67,2.6
CN3001700000000,2023-02-01,30,017,MT,Custer County,6440,6241,199,3.1
CN3001900000000,2023-02-01,30,019,MT,Daniels County,884,868,16,1.8
CN3002100000000,2023-02-01,30,021,MT,Dawson County,4550,4466,84,1.8
CN3002300000000,2023-02-01,30,023,MT,Deer Lodge County,5458,5304,154,2.8
CN3002500000000,2023-02-01,30,025,MT,Fallon County,1666,1638,28,1.7
CN3002700000000,2023-02-01,30,027,MT,Fergus County,5880,5659,221,3.8
CN3002900000000,2023-02-01,30,029,MT,Flathead County,52573,50660,1913,3.6
CN3003100000000,2023-02-01,30,031,MT,Gallatin County,79276,77832,1444,1.8
CN3003300000000,2023-02-01,30,033,MT,Garfield County,767,736,31,4
CN3003500000000,2023-02-01,30,035,MT,Glacier County,5719,5407,312,5.5
CN3003700000000,2023-02-01,30,037,MT,Golden Valley County,372,365,7,1.9
CN3003900000000,2023-02-01,30,039,MT,Granite County,1711,1628,83,4.9
CN3004100000000,2023-02-01,30,041,MT,Hill County,7527,7370,157,2.1
CN3004300000000,2023-02-01,30,043,MT,Jefferson County,6210,6034,176,2.8
CN3004500000000,2023-02-01,30,045,MT,Judith Basin County,1022,997,25,2.4
CN3004700000000,2023-02-01,30,047,MT,Lake County,14448,13929,519,3.6
CN3004900000000,2023-02-01,30,049,MT,Lewis and Clark County,39171,38216,955,2.4
CN3005100000000,2023-02-01,30,051,MT,Liberty County,1014,993,21,2.1
CN3005300000000,2023-02-01,30,053,MT,Lincoln County,8748,8224,524,6
CN3005500000000,2023-02-01,30,055,MT,McCone County,1001,981,20,2
CN3005700000000,2023-02-01,30,057,MT,Madison County,6087,5958,129,2.1
CN3005900000000,2023-02-01,30,059,MT,Meagher County,1076,1053,23,2.1
CN3006100000000,2023-02-01,30,061,MT,Mineral County,1826,1719,107,5.9
CN3006300000000,2023-02-01,30,063,MT,Missoula County,67805,65898,1907,2.8
CN3006500000000,2023-02-01,30,065,MT,Musselshell County,2364,2297,67,2.8
CN3006700000000,2023-02-01,30,067,MT,Park County,9993,9704,289,2.9
CN3006900000000,2023-02-01,30,069,MT,Petroleum County,277,269,8,2.9
CN3007100000000,2023-02-01,30,071,MT,Phillips County,1839,1756,83,4.5
CN3007300000000,2023-02-01,30,073,MT,Pondera County,2657,2595,62,2.3
CN3007500000000,2023-02-01,30,075,MT,Powder River County,1023,993,30,2.9
CN3007700000000,2023-02-01,30,077,MT,Powell County,2840,2745,95,3.3
CN3007900000000,2023-02-01,30,079,MT,Prairie County,509,489,20,3.9
CN3008100000000,2023-02-01,30,081,MT,Ravalli County,22104,21371,733,3.3
CN3008300000000,2023-02-01,30,083,MT,Richland County,5921,5796,125,2.1
CN3008500000000,2023-02-01,30,085,MT,Roosevelt County,4398,4240,158,3.6
CN3008700000000,2023-02-01,30,087,MT,Rosebud County,3535,3421,114,3.2
CN3008900000000,2023-02-01,30,089,MT,Sanders County,5453,5152,301,5.5
CN3009100000000,2023-02-01,30,091,MT,Sheridan County,1779,1737,42,2.4
CN3009300000000,2023-02-01,30,093,MT,Silver Bow County,17857,17254,603,3.4
CN3009500000000,2023-02-01,30,095,MT,Stillwater County,5413,5297,116,2.1
CN3009700000000,2023-02-01,30,097,MT,Sweet Grass County,1922,1883,39,2
CN3009900000000,2023-02-01,30,099,MT,Teton County,2830,2754,76,2.7
CN3010100000000,2023-02-01,30,101,MT,Toole County,2099,2063,36,1.7
CN3010300000000,2023-02-01,30,103,MT,Treasure County,363,354,9,2.5
CN3010500000000,2023-02-01,30,105,MT,Valley County,3958,3851,107,2.7
CN3010700000000,2023-02-01,30,107,MT,Wheatland County,768,737,31,4
CN3010900000000,2023-02-01,30,109,MT,Wibaux County,437,429,8,1.8
CN3011100000000,2023-02-01,30,111,MT,Yellowstone County,85621,83571,2050,2.4
CN3100100000000,2023-02-01,31,001,NE,Adams County,17242,16883,359,2.1
CN3100300000000,2023-02-01,31,003,NE,Antelope County,3698,3617,81,2.2
CN3100500000000,2023-02-01,31,005,NE,Arthur County,233,228,5,2.1
CN3100700000000,2023-02-01,31,007,NE,Banner County,394,386,8,2
CN3100900000000,2023-02-01,31,009,NE,Blaine County,255,245,10,3.9
CN3101100000000,2023-02-01,31,011,NE,Boone County,3057,3003,54,1.8
CN3101300000000,2023-02-01,31,013,NE,Box Butte County,5331,5242,89,1.7
CN3101500000000,2023-02-01,31,015,NE,Boyd County,1050,1025,25,2.4
CN3101700000000,2023-02-01,31,017,NE,Brown County,1429,1395,34,2.4
CN3101900000000,2023-02-01,31,019,NE,Buffalo County,28463,27961,502,1.8
CN3102100000000,2023-02-01,31,021,NE,Burt County,3603,3509,94,2.6
CN3102300000000,2023-02-01,31,023,NE,Butler County,4753,4694,59,1.2
CN3102500000000,2023-02-01,31,025,NE,Cass County,13711,13387,324,2.4
CN3102700000000,2023-02-01,31,027,NE,Cedar County,4662,4581,81,1.7
CN3102900000000,2023-02-01,31,029,NE,Chase County,2288,2254,34,1.5
CN3103100000000,2023-02-01,31,031,NE,Cherry County,3336,3279,57,1.7
CN3103300000000,2023-02-01,31,033,NE,Cheyenne County,4254,4166,88,2.1
CN3103500000000,2023-02-01,31,035,NE,Clay County,3060,2981,79,2.6
CN3103700000000,2023-02-01,31,037,NE,Colfax County,5785,5694,91,1.6
CN3103900000000,2023-02-01,31,039,NE,Cuming County,4880,4786,94,1.9
CN3104100000000,2023-02-01,31,041,NE,Custer County,6379,6285,94,1.5
CN3104300000000,2023-02-01,31,043,NE,Dakota County,11151,10809,342,3.1
CN3104500000000,2023-02-01,31,045,NE,Dawes County,5008,4920,88,1.8
CN3104700000000,2023-02-01,31,047,NE,Dawson County,13785,13463,322,2.3
CN3104900000000,2023-02-01,31,049,NE,Deuel County,1052,1025,27,2.6
CN3105100000000,2023-02-01,31,051,NE,Dixon County,3083,3017,66,2.1
CN3105300000000,2023-02-01,31,053,NE,Dodge County,21018,20564,454,2.2
CN3105500000000,2023-02-01,31,055,NE,Douglas County,306255,298460,7795,2.5
CN3105700000000,2023-02-01,31,057,NE,Dundy County,1206,1187,19,1.6
CN3105900000000,2023-02-01,31,059,NE,Fillmore County,3358,3304,54,1.6
CN3106100000000,2023-02-01,31,061,NE,Franklin County,1560,1531,29,1.9
CN3106300000000,2023-02-01,31,063,NE,Frontier County,1531,1497,34,2.2
CN3106500000000,2023-02-01,31,065,NE,Furnas County,2528,2486,42,1.7
CN3106700000000,2023-02-01,31,067,NE,Gage County,10857,10601,256,2.4
CN3106900000000,2023-02-01,31,069,NE,Garden County,1110,1085,25,2.3
CN3107100000000,2023-02-01,31,071,NE,Garfield County,1147,1127,20,1.7
CN3107300000000,2023-02-01,31,073,NE,Gosper County,1192,1167,25,2.1
CN3107500000000,2023-02-01,31,075,NE,Grant County,434,429,5,1.2
CN3107700000000,2023-02-01,31,077,NE,Greeley County,1244,1219,25,2
CN3107900000000,2023-02-01,31,079,NE,Hall County,33282,32466,816,2.5
CN3108100000000,2023-02-01,31,081,NE,Hamilton County,4977,4896,81,1.6
CN3108300000000,2023-02-01,31,083,NE,Harlan County,1829,1792,37,2
CN3108500000000,2023-02-01,31,085,NE,Hayes County,600,593,7,1.2
CN3108700000000,2023-02-01,31,087,NE,Hitchcock County,1309,1280,29,2.2
CN3108900000000,2023-02-01,31,089,NE,Holt County,5709,5598,111,1.9
CN3109100000000,2023-02-01,31,091,NE,Hooker County,349,342,7,2
CN3109300000000,2023-02-01,31,093,NE,Howard County,3539,3470,69,1.9
CN3109500000000,2023-02-01,31,095,NE,Jefferson County,4248,4165,83,2
CN3109700000000,2023-02-01,31,097,NE,Johnson County,2070,1986,84,4.1
CN3109900000000,2023-02-01,31,099,NE,Kearney County,3767,3711,56,1.5
CN3110100000000,2023-02-01,31,101,NE,Keith County,4618,4539,79,1.7
CN3110300000000,2023-02-01,31,103,NE,Keya Paha County,581,571,10,1.7
CN3110500000000,2023-02-01,31,105,NE,Kimball County,1964,1927,37,1.9
CN3110700000000,2023-02-01,31,107,NE,Knox County,4665,4554,111,2.4
CN3110900000000,2023-02-01,31,109,NE,Lancaster County,180826,177113,3713,2.1
CN3111100000000,2023-02-01,31,111,NE,Lincoln County,18264,17896,368,2
CN3111300000000,2023-02-01,31,113,NE,Logan County,498,485,13,2.6
CN3111500000000,2023-02-01,31,115,NE,Loup County,418,408,10,2.4
CN3111700000000,2023-02-01,31,117,NE,McPherson County,441,433,8,1.8
CN3111900000000,2023-02-01,31,119,NE,Madison County,19873,19435,438,2.2
CN3112100000000,2023-02-01,31,121,NE,Merrick County,4251,4178,73,1.7
CN3112300000000,2023-02-01,31,123,NE,Morrill County,2657,2601,56,2.1
CN3112500000000,2023-02-01,31,125,NE,Nance County,1981,1935,46,2.3
CN3112700000000,2023-02-01,31,127,NE,Nemaha County,3700,3629,71,1.9
CN3112900000000,2023-02-01,31,129,NE,Nuckolls County,2537,2471,66,2.6
CN3113100000000,2023-02-01,31,131,NE,Otoe County,8632,8440,192,2.2
CN3113300000000,2023-02-01,31,133,NE,Pawnee County,1508,1478,30,2
CN3113500000000,2023-02-01,31,135,NE,Perkins County,1865,1836,29,1.6
CN3113700000000,2023-02-01,31,137,NE,Phelps County,5092,5008,84,1.6
CN3113900000000,2023-02-01,31,139,NE,Pierce County,4193,4117,76,1.8
CN3114100000000,2023-02-01,31,141,NE,Platte County,18673,18343,330,1.8
CN3114300000000,2023-02-01,31,143,NE,Polk County,2919,2860,59,2
CN3114500000000,2023-02-01,31,145,NE,Red Willow County,5927,5839,88,1.5
CN3114700000000,2023-02-01,31,147,NE,Richardson County,4196,4123,73,1.7
CN3114900000000,2023-02-01,31,149,NE,Rock County,928,918,10,1.1
CN3115100000000,2023-02-01,31,151,NE,Saline County,7289,7080,209,2.9
CN3115300000000,2023-02-01,31,153,NE,Sarpy County,99738,97640,2098,2.1
CN3115500000000,2023-02-01,31,155,NE,Saunders County,11596,11375,221,1.9
CN3115700000000,2023-02-01,31,157,NE,Scotts Bluff County,17877,17400,477,2.7
CN3115900000000,2023-02-01,31,159,NE,Seward County,8936,8781,155,1.7
CN3116100000000,2023-02-01,31,161,NE,Sheridan County,2830,2776,54,1.9
CN3116300000000,2023-02-01,31,163,NE,Sherman County,1696,1664,32,1.9
CN3116500000000,2023-02-01,31,165,NE,Sioux County,774,759,15,1.9
CN3116700000000,2023-02-01,31,167,NE,Stanton County,3543,3479,64,1.8
CN3116900000000,2023-02-01,31,169,NE,Thayer County,2746,2702,44,1.6
CN3117100000000,2023-02-01,31,171,NE,Thomas County,456,441,15,3.3
CN3117300000000,2023-02-01,31,173,NE,Thurston County,3289,3216,73,2.2
CN3117500000000,2023-02-01,31,175,NE,Valley County,2128,2081,47,2.2
CN3117700000000,2023-02-01,31,177,NE,Washington County,11513,11284,229,2
CN3117900000000,2023-02-01,31,179,NE,Wayne County,5920,5822,98,1.7
CN3118100000000,2023-02-01,31,181,NE,Webster County,1711,1664,47,2.7
CN3118300000000,2023-02-01,31,183,NE,Wheeler County,590,578,12,2
CN3118500000000,2023-02-01,31,185,NE,York County,7411,7247,164,2.2
CN3200100000000,2023-02-01,32,001,NV,Churchill County,11084,10572,512,4.6
CN3200300000000,2023-02-01,32,003,NV,Clark County,1164896,1094938,69958,6
CN3200500000000,2023-02-01,32,005,NV,Douglas County,22669,21492,1177,5.2
CN3200700000000,2023-02-01,32,007,NV,Elko County,25353,24341,1012,4
CN3200900000000,2023-02-01,32,009,NV,Esmeralda County,418,401,17,4.1
CN3201100000000,2023-02-01,32,011,NV,Eureka County,1054,1010,44,4.2
CN3201300000000,2023-02-01,32,013,NV,Humboldt County,7787,7456,331,4.3
CN3201500000000,2023-02-01,32,015,NV,Lander County,3021,2901,120,4
CN3201700000000,2023-02-01,32,017,NV,Lincoln County,2053,1946,107,5.2
CN3201900000000,2023-02-01,32,019,NV,Lyon County,24006,22412,1594,6.6
CN3202100000000,2023-02-01,32,021,NV,Mineral County,2015,1899,116,5.8
CN3202300000000,2023-02-01,32,023,NV,Nye County,18060,16849,1211,6.7
CN3202700000000,2023-02-01,32,027,NV,Pershing County,2456,2326,130,5.3
CN3202900000000,2023-02-01,32,029,NV,Storey County,2149,2043,106,4.9
CN3203100000000,2023-02-01,32,031,NV,Washoe County,263856,252059,11797,4.5
CN3203300000000,2023-02-01,32,033,NV,White Pine County,4432,4257,175,3.9
CN3251000000000,2023-02-01,32,510,NV,Carson City,25872,24522,1350,5.2
CN3300100000000,2023-02-01,33,001,NH,Belknap County,30327,29600,727,2.4
CN3300300000000,2023-02-01,33,003,NH,Carroll County,22678,22132,546,2.4
CN3300500000000,2023-02-01,33,005,NH,Cheshire County,39101,38119,982,2.5
CN3300700000000,2023-02-01,33,007,NH,Coos County,14112,13683,429,3
CN3300900000000,2023-02-01,33,009,NH,Grafton County,48817,47883,934,1.9
CN3301100000000,2023-02-01,33,011,NH,Hillsborough County,242810,236617,6193,2.6
CN3301300000000,2023-02-01,33,013,NH,Merrimack County,82518,80893,1625,2
CN3301500000000,2023-02-01,33,015,NH,Rockingham County,188748,183626,5122,2.7
CN3301700000000,2023-02-01,33,017,NH,Strafford County,74530,73044,1486,2
CN3301900000000,2023-02-01,33,019,NH,Sullivan County,22516,22080,436,1.9
CN3400100000000,2023-02-01,34,001,NJ,Atlantic County,126175,118863,7312,5.8
CN3400300000000,2023-02-01,34,003,NJ,Bergen County,517779,499992,17787,3.4
CN3400500000000,2023-02-01,34,005,NJ,Burlington County,252426,243286,9140,3.6
CN3400700000000,2023-02-01,34,007,NJ,Camden County,276621,264312,12309,4.4
CN3400900000000,2023-02-01,34,009,NJ,Cape May County,43635,38679,4956,11.4
CN3401100000000,2023-02-01,34,011,NJ,Cumberland County,70746,66234,4512,6.4
CN3401300000000,2023-02-01,34,013,NJ,Essex County,398362,378559,19803,5
CN3401500000000,2023-02-01,34,015,NJ,Gloucester County,164683,157979,6704,4.1
CN3401700000000,2023-02-01,34,017,NJ,Hudson County,388216,373275,14941,3.8
CN3401900000000,2023-02-01,34,019,NJ,Hunterdon County,69455,67145,2310,3.3
CN3402100000000,2023-02-01,34,021,NJ,Mercer County,224019,216457,7562,3.4
CN3402300000000,2023-02-01,34,023,NJ,Middlesex County,470798,453971,16827,3.6
CN3402500000000,2023-02-01,34,025,NJ,Monmouth County,353779,341055,12724,3.6
CN3402700000000,2023-02-01,34,027,NJ,Morris County,275141,266005,9136,3.3
CN3402900000000,2023-02-01,34,029,NJ,Ocean County,304291,291412,12879,4.2
CN3403100000000,2023-02-01,34,031,NJ,Passaic County,260877,247622,13255,5.1
CN3403300000000,2023-02-01,34,033,NJ,Salem County,31183,29525,1658,5.3
CN3403500000000,2023-02-01,34,035,NJ,Somerset County,183566,177276,6290,3.4
CN3403700000000,2023-02-01,34,037,NJ,Sussex County,79475,76086,3389,4.3
CN3403900000000,2023-02-01,34,039,NJ,Union County,297133,284221,12912,4.3
CN3404100000000,2023-02-01,34,041,NJ,Warren County,60302,57956,2346,3.9
CN3500100000000,2023-02-01,35,001,NM,Bernalillo County,339471,327651,11820,3.5
CN3500300000000,2023-02-01,35,003,NM,Catron County,1082,1018,64,5.9
CN3500500000000,2023-02-01,35,005,NM,Chaves County,27919,26845,1074,3.8
CN3500600000000,2023-02-01,35,006,NM,Cibola County,8343,7891,452,5.4
CN3500700000000,2023-02-01,35,007,NM,Colfax County,5145,4960,185,3.6
CN3500900000000,2023-02-01,35,009,NM,Curry County,22258,21605,653,2.9
CN3501100000000,2023-02-01,35,011,NM,De Baca County,713,688,25,3.5
CN3501300000000,2023-02-01,35,013,NM,Dona Ana County,101325,96607,4718,4.7
CN3501500000000,2023-02-01,35,015,NM,Eddy County,32189,31319,870,2.7
CN3501700000000,2023-02-01,35,017,NM,Grant County,11705,11250,455,3.9
CN3501900000000,2023-02-01,35,019,NM,Guadalupe County,1504,1436,68,4.5
CN3502100000000,2023-02-01,35,021,NM,Harding County,284,273,11,3.9
CN3502300000000,2023-02-01,35,023,NM,Hidalgo County,1852,1792,60,3.2
CN3502500000000,2023-02-01,35,025,NM,Lea County,29078,28019,1059,3.6
CN3502700000000,2023-02-01,35,027,NM,Lincoln County,8696,8369,327,3.8
CN3502800000000,2023-02-01,35,028,NM,Los Alamos County,10919,10709,210,1.9
CN3502900000000,2023-02-01,35,029,NM,Luna County,9927,8598,1329,13.4
CN3503100000000,2023-02-01,35,031,NM,McKinley County,23614,22423,1191,5
CN3503300000000,2023-02-01,35,033,NM,Mora County,1987,1890,97,4.9
CN3503500000000,2023-02-01,35,035,NM,Otero County,26088,25022,1066,4.1
CN3503700000000,2023-02-01,35,037,NM,Quay County,2949,2821,128,4.3
CN3503900000000,2023-02-01,35,039,NM,Rio Arriba County,16495,15860,635,3.8
CN3504100000000,2023-02-01,35,041,NM,Roosevelt County,8384,8091,293,3.5
CN3504300000000,2023-02-01,35,043,NM,Sandoval County,68495,66027,2468,3.6
CN3504500000000,2023-02-01,35,045,NM,San Juan County,50365,48059,2306,4.6
CN3504700000000,2023-02-01,35,047,NM,San Miguel County,10749,10243,506,4.7
CN3504900000000,2023-02-01,35,049,NM,Santa Fe County,72505,70051,2454,3.4
CN3505100000000,2023-02-01,35,051,NM,Sierra County,4012,3721,291,7.3
CN3505300000000,2023-02-01,35,053,NM,Socorro County,6210,5951,259,4.2
CN3505500000000,2023-02-01,35,055,NM,Taos County,15286,14585,701,4.6
CN3505700000000,2023-02-01,35,057,NM,Torrance County,5379,5089,290,5.4
CN3505900000000,2023-02-01,35,059,NM,Union County,1557,1512,45,2.9
CN3506100000000,2023-02-01,35,061,NM,Valencia County,31186,29916,1270,4.1
CN3600100000000,2023-02-01,36,001,NY,Albany County,160345,155225,5120,3.2
CN3600300000000,2023-02-01,36,003,NY,Allegany County,19654,18702,952,4.8
CN3600500000000,2023-02-01,36,005,NY,Bronx County,612649,566639,46010,7.5
CN3600700000000,2023-02-01,36,007,NY,Broome County,82497,79020,3477,4.2
CN3600900000000,2023-02-01,36,009,NY,Cattaraugus County,33404,31793,1611,4.8
CN3601100000000,2023-02-01,36,011,NY,Cayuga County,35470,34070,1400,3.9
CN3601300000000,2023-02-01,36,013,NY,Chautauqua County,53736,51229,2507,4.7
CN3601500000000,2023-02-01,36,015,NY,Chemung County,34496,33033,1463,4.2
CN3601700000000,2023-02-01,36,017,NY,Chenango County,21862,20969,893,4.1
CN3601900000000,2023-02-01,36,019,NY,Clinton County,35093,33757,1336,3.8
CN3602100000000,2023-02-01,36,021,NY,Columbia County,30105,29118,987,3.3
CN3602300000000,2023-02-01,36,023,NY,Cortland County,23440,22348,1092,4.7
CN3602500000000,2023-02-01,36,025,NY,Delaware County,18529,17697,832,4.5
CN3602700000000,2023-02-01,36,027,NY,Dutchess County,142348,137635,4713,3.3
CN3602900000000,2023-02-01,36,029,NY,Erie County,443761,426255,17506,3.9
CN3603100000000,2023-02-01,36,031,NY,Essex County,16614,15814,800,4.8
CN3603300000000,2023-02-01,36,033,NY,Franklin County,18958,18155,803,4.2
CN3603500000000,2023-02-01,36,035,NY,Fulton County,22459,21335,1124,5
CN3603700000000,2023-02-01,36,037,NY,Genesee County,29482,28352,1130,3.8
CN3603900000000,2023-02-01,36,039,NY,Greene County,20610,19792,818,4
CN3604100000000,2023-02-01,36,041,NY,Hamilton County,2086,1945,141,6.8
CN3604300000000,2023-02-01,36,043,NY,Herkimer County,27477,26151,1326,4.8
CN3604500000000,2023-02-01,36,045,NY,Jefferson County,43574,41380,2194,5
CN3604700000000,2023-02-01,36,047,NY,Kings County,1230095,1158664,71431,5.8
CN3604900000000,2023-02-01,36,049,NY,Lewis County,11725,11060,665,5.7
CN3605100000000,2023-02-01,36,051,NY,Livingston County,30307,29102,1205,4
CN3605300000000,2023-02-01,36,053,NY,Madison County,33123,31739,1384,4.2
CN3605500000000,2023-02-01,36,055,NY,Monroe County,362494,349344,13150,3.6
CN3605700000000,2023-02-01,36,057,NY,Montgomery County,22347,21243,1104,4.9
CN3605900000000,2023-02-01,36,059,NY,Nassau County,722453,700538,21915,3
CN3606100000000,2023-02-01,36,061,NY,New York County,938096,893074,45022,4.8
CN3606300000000,2023-02-01,36,063,NY,Niagara County,98299,93890,4409,4.5
CN3606500000000,2023-02-01,36,065,NY,Oneida County,99922,96004,3918,3.9
CN3606700000000,2023-02-01,36,067,NY,Onondaga County,224220,216301,7919,3.5
CN3606900000000,2023-02-01,36,069,NY,Ontario County,55751,53743,2008,3.6
CN3607100000000,2023-02-01,36,071,NY,Orange County,189026,182564,6462,3.4
CN3607300000000,2023-02-01,36,073,NY,Orleans County,17134,16394,740,4.3
CN3607500000000,2023-02-01,36,075,NY,Oswego County,53156,50659,2497,4.7
CN3607700000000,2023-02-01,36,077,NY,Otsego County,26839,25652,1187,4.4
CN3607900000000,2023-02-01,36,079,NY,Putnam County,50492,48899,1593,3.2
CN3608100000000,2023-02-01,36,081,NY,Queens County,1159217,1101128,58089,5
CN3608300000000,2023-02-01,36,083,NY,Rensselaer County,82917,80071,2846,3.4
CN3608500000000,2023-02-01,36,085,NY,Richmond County,230610,218352,12258,5.3
CN3608700000000,2023-02-01,36,087,NY,Rockland County,158124,153412,4712,3
CN3608900000000,2023-02-01,36,089,NY,St. Lawrence County,43263,41306,1957,4.5
CN3609100000000,2023-02-01,36,091,NY,Saratoga County,122772,119000,3772,3.1
CN3609300000000,2023-02-01,36,093,NY,Schenectady County,78423,75678,2745,3.5
CN3609500000000,2023-02-01,36,095,NY,Schoharie County,15113,14327,786,5.2
CN3609700000000,2023-02-01,36,097,NY,Schuyler County,7831,7433,398,5.1
CN3609900000000,2023-02-01,36,099,NY,Seneca County,14486,13904,582,4
CN3610100000000,2023-02-01,36,101,NY,Steuben County,41230,39263,1967,4.8
CN3610300000000,2023-02-01,36,103,NY,Suffolk County,794874,766929,27945,3.5
CN3610500000000,2023-02-01,36,105,NY,Sullivan County,36852,35515,1337,3.6
CN3610700000000,2023-02-01,36,107,NY,Tioga County,22356,21494,862,3.9
CN3610900000000,2023-02-01,36,109,NY,Tompkins County,50883,49417,1466,2.9
CN3611100000000,2023-02-01,36,111,NY,Ulster County,87145,84094,3051,3.5
CN3611300000000,2023-02-01,36,113,NY,Warren County,31057,29718,1339,4.3
CN3611500000000,2023-02-01,36,115,NY,Washington County,27333,26264,1069,3.9
CN3611700000000,2023-02-01,36,117,NY,Wayne County,43411,41736,1675,3.9
CN3611900000000,2023-02-01,36,119,NY,Westchester County,492965,476767,16198,3.3
CN3612100000000,2023-02-01,36,121,NY,Wyoming County,17261,16403,858,5
CN3612300000000,2023-02-01,36,123,NY,Yates County,11710,11276,434,3.7
CN3700100000000,2023-02-01,37,001,NC,Alamance County,82933,80035,2898,3.5
CN3700300000000,2023-02-01,37,003,NC,Alexander County,18071,17509,562,3.1
CN3700500000000,2023-02-01,37,005,NC,Alleghany County,4608,4423,185,4
CN3700700000000,2023-02-01,37,007,NC,Anson County,10283,9873,410,4
CN3700900000000,2023-02-01,37,009,NC,Ashe County,12721,12288,433,3.4
CN3701100000000,2023-02-01,37,011,NC,Avery County,7734,7480,254,3.3
CN3701300000000,2023-02-01,37,013,NC,Beaufort County,20080,19267,813,4
CN3701500000000,2023-02-01,37,015,NC,Bertie County,7233,6909,324,4.5
CN3701700000000,2023-02-01,37,017,NC,Bladen County,14878,14221,657,4.4
CN3701900000000,2023-02-01,37,019,NC,Brunswick County,56689,53900,2789,4.9
CN3702100000000,2023-02-01,37,021,NC,Buncombe County,141613,137478,4135,2.9
CN3702300000000,2023-02-01,37,023,NC,Burke County,40884,39554,1330,3.3
CN3702500000000,2023-02-01,37,025,NC,Cabarrus County,116301,112369,3932,3.4
CN3702700000000,2023-02-01,37,027,NC,Caldwell County,36419,35165,1254,3.4
CN3702900000000,2023-02-01,37,029,NC,Camden County,4705,4539,166,3.5
CN3703100000000,2023-02-01,37,031,NC,Carteret County,31741,30520,1221,3.8
CN3703300000000,2023-02-01,37,033,NC,Caswell County,9698,9296,402,4.1
CN3703500000000,2023-02-01,37,035,NC,Catawba County,79523,76890,2633,3.3
CN3703700000000,2023-02-01,37,037,NC,Chatham County,37463,36318,1145,3.1
CN3703900000000,2023-02-01,37,039,NC,Cherokee County,11224,10752,472,4.2
CN3704100000000,2023-02-01,37,041,NC,Chowan County,5906,5691,215,3.6
CN3704300000000,2023-02-01,37,043,NC,Clay County,4232,4084,148,3.5
CN3704500000000,2023-02-01,37,045,NC,Cleveland County,49615,47838,1777,3.6
CN3704700000000,2023-02-01,37,047,NC,Columbus County,23949,22993,956,4
CN3704900000000,2023-02-01,37,049,NC,Craven County,42004,40418,1586,3.8
CN3705100000000,2023-02-01,37,051,NC,Cumberland County,126719,120369,6350,5
CN3705300000000,2023-02-01,37,053,NC,Currituck County,14594,14050,544,3.7
CN3705500000000,2023-02-01,37,055,NC,Dare County,18147,16834,1313,7.2
CN3705700000000,2023-02-01,37,057,NC,Davidson County,82075,79239,2836,3.5
CN3705900000000,2023-02-01,37,059,NC,Davie County,20917,20252,665,3.2
CN3706100000000,2023-02-01,37,061,NC,Duplin County,25272,24416,856,3.4
CN3706300000000,2023-02-01,37,063,NC,Durham County,179004,173366,5638,3.1
CN3706500000000,2023-02-01,37,065,NC,Edgecombe County,20049,18824,1225,6.1
CN3706700000000,2023-02-01,37,067,NC,Forsyth County,189839,183116,6723,3.5
CN3706900000000,2023-02-01,37,069,NC,Franklin County,34192,32928,1264,3.7
CN3707100000000,2023-02-01,37,071,NC,Gaston County,114835,110636,4199,3.7
CN3707300000000,2023-02-01,37,073,NC,Gates County,5104,4919,185,3.6
CN3707500000000,2023-02-01,37,075,NC,Graham County,2814,2674,140,5
CN3707700000000,2023-02-01,37,077,NC,Granville County,30378,29446,932,3.1
CN3707900000000,2023-02-01,37,079,NC,Greene County,9635,9350,285,3
CN3708100000000,2023-02-01,37,081,NC,Guilford County,260138,249838,10300,4
CN3708300000000,2023-02-01,37,083,NC,Halifax County,19204,18163,1041,5.4
CN3708500000000,2023-02-01,37,085,NC,Harnett County,55400,53202,2198,4
CN3708700000000,2023-02-01,37,087,NC,Haywood County,30129,29185,944,3.1
CN3708900000000,2023-02-01,37,089,NC,Henderson County,55420,53717,1703,3.1
CN3709100000000,2023-02-01,37,091,NC,Hertford County,8532,8122,410,4.8
CN3709300000000,2023-02-01,37,093,NC,Hoke County,20115,19183,932,4.6
CN3709500000000,2023-02-01,37,095,NC,Hyde County,1695,1516,179,10.6
CN3709700000000,2023-02-01,37,097,NC,Iredell County,94776,91597,3179,3.4
CN3709900000000,2023-02-01,37,099,NC,Jackson County,19386,18649,737,3.8
CN3710100000000,2023-02-01,37,101,NC,Johnston County,108562,105092,3470,3.2
CN3710300000000,2023-02-01,37,103,NC,Jones County,4337,4195,142,3.3
CN3710500000000,2023-02-01,37,105,NC,Lee County,26327,25313,1014,3.9
CN3710700000000,2023-02-01,37,107,NC,Lenoir County,27663,26670,993,3.6
CN3710900000000,2023-02-01,37,109,NC,Lincoln County,46410,45004,1406,3
CN3711100000000,2023-02-01,37,111,NC,McDowell County,20337,19662,675,3.3
CN3711300000000,2023-02-01,37,113,NC,Macon County,15863,15272,591,3.7
CN3711500000000,2023-02-01,37,115,NC,Madison County,10072,9725,347,3.4
CN3711700000000,2023-02-01,37,117,NC,Martin County,8576,8209,367,4.3
CN3711900000000,2023-02-01,37,119,NC,Mecklenburg County,653311,630126,23185,3.5
CN3712100000000,2023-02-01,37,121,NC,Mitchell County,6070,5830,240,4
CN3712300000000,2023-02-01,37,123,NC,Montgomery County,11132,10742,390,3.5
CN3712500000000,2023-02-01,37,125,NC,Moore County,42249,40745,1504,3.6
CN3712700000000,2023-02-01,37,127,NC,Nash County,41909,39916,1993,4.8
CN3712900000000,2023-02-01,37,129,NC,New Hanover County,130777,126516,4261,3.3
CN3713100000000,2023-02-01,37,131,NC,Northampton County,7271,6912,359,4.9
CN3713300000000,2023-02-01,37,133,NC,Onslow County,69148,66304,2844,4.1
CN3713500000000,2023-02-01,37,135,NC,Orange County,81306,79040,2266,2.8
CN3713700000000,2023-02-01,37,137,NC,Pamlico County,5488,5303,185,3.4
CN3713900000000,2023-02-01,37,139,NC,Pasquotank County,16847,16045,802,4.8
CN3714100000000,2023-02-01,37,141,NC,Pender County,31085,30047,1038,3.3
CN3714300000000,2023-02-01,37,143,NC,Perquimans County,4999,4788,211,4.2
CN3714500000000,2023-02-01,37,145,NC,Person County,18816,18151,665,3.5
CN3714700000000,2023-02-01,37,147,NC,Pitt County,88194,84734,3460,3.9
CN3714900000000,2023-02-01,37,149,NC,Polk County,9311,8985,326,3.5
CN3715100000000,2023-02-01,37,151,NC,Randolph County,65484,63128,2356,3.6
CN3715300000000,2023-02-01,37,153,NC,Richmond County,17018,16183,835,4.9
CN3715500000000,2023-02-01,37,155,NC,Robeson County,48080,45617,2463,5.1
CN3715700000000,2023-02-01,37,157,NC,Rockingham County,39674,37919,1755,4.4
CN3715900000000,2023-02-01,37,159,NC,Rowan County,67794,65413,2381,3.5
CN3716100000000,2023-02-01,37,161,NC,Rutherford County,24791,23615,1176,4.7
CN3716300000000,2023-02-01,37,163,NC,Sampson County,29559,28564,995,3.4
CN3716500000000,2023-02-01,37,165,NC,Scotland County,11373,10628,745,6.6
CN3716700000000,2023-02-01,37,167,NC,Stanly County,30849,29858,991,3.2
CN3716900000000,2023-02-01,37,169,NC,Stokes County,21783,21098,685,3.1
CN3717100000000,2023-02-01,37,171,NC,Surry County,32711,31617,1094,3.3
CN3717300000000,2023-02-01,37,173,NC,Swain County,6942,6696,246,3.5
CN3717500000000,2023-02-01,37,175,NC,Transylvania County,14581,14091,490,3.4
CN3717700000000,2023-02-01,37,177,NC,Tyrrell County,1216,1128,88,7.2
CN3717900000000,2023-02-01,37,179,NC,Union County,130390,126480,3910,3
CN3718100000000,2023-02-01,37,181,NC,Vance County,16726,15774,952,5.7
CN3718300000000,2023-02-01,37,183,NC,Wake County,633720,614455,19265,3
CN3718500000000,2023-02-01,37,185,NC,Warren County,6346,5970,376,5.9
CN3718700000000,2023-02-01,37,187,NC,Washington County,4271,4039,232,5.4
CN3718900000000,2023-02-01,37,189,NC,Watauga County,29528,28674,854,2.9
CN3719100000000,2023-02-01,37,191,NC,Wayne County,50505,48559,1946,3.9
CN3719300000000,2023-02-01,37,193,NC,Wilkes County,26901,25906,995,3.7
CN3719500000000,2023-02-01,37,195,NC,Wilson County,33908,32268,1640,4.8
CN3719700000000,2023-02-01,37,197,NC,Yadkin County,17803,17232,571,3.2
CN3719900000000,2023-02-01,37,199,NC,Yancey County,8137,7862,275,3.4
CN3800100000000,2023-02-01,38,001,ND,Adams County,947,925,22,2.3
CN3800300000000,2023-02-01,38,003,ND,Barnes County,5229,5074,155,3
CN3800500000000,2023-02-01,38,005,ND,Benson County,2325,2245,80,3.4
CN3800700000000,2023-02-01,38,007,ND,Billings County,379,368,11,2.9
CN3800900000000,2023-02-01,38,009,ND,Bottineau County,2858,2757,101,3.5
CN3801100000000,2023-02-01,38,011,ND,Bowman County,1493,1469,24,1.6
CN3801300000000,2023-02-01,38,013,ND,Burke County,1018,997,21,2.1
CN3801500000000,2023-02-01,38,015,ND,Burleigh County,51478,50213,1265,2.5
CN3801700000000,2023-02-01,38,017,ND,Cass County,110404,107827,2577,2.3
CN3801900000000,2023-02-01,38,019,ND,Cavalier County,1796,1728,68,3.8
CN3802100000000,2023-02-01,38,021,ND,Dickey County,2166,2121,45,2.1
CN3802300000000,2023-02-01,38,023,ND,Divide County,1441,1421,20,1.4
CN3802500000000,2023-02-01,38,025,ND,Dunn County,3237,3191,46,1.4
CN3802700000000,2023-02-01,38,027,ND,Eddy County,1188,1138,50,4.2
CN3802900000000,2023-02-01,38,029,ND,Emmons County,1474,1366,108,7.3
CN3803100000000,2023-02-01,38,031,ND,Foster County,1511,1468,43,2.8
CN3803300000000,2023-02-01,38,033,ND,Golden Valley County,859,842,17,2
CN3803500000000,2023-02-01,38,035,ND,Grand Forks County,38308,37415,893,2.3
CN3803700000000,2023-02-01,38,037,ND,Grant County,1226,1200,26,2.1
CN3803900000000,2023-02-01,38,039,ND,Griggs County,1013,981,32,3.2
CN3804100000000,2023-02-01,38,041,ND,Hettinger County,1358,1325,33,2.4
CN3804300000000,2023-02-01,38,043,ND,Kidder County,1334,1260,74,5.5
CN3804500000000,2023-02-01,38,045,ND,LaMoure County,2094,2041,53,2.5
CN3804700000000,2023-02-01,38,047,ND,Logan County,879,844,35,4
CN3804900000000,2023-02-01,38,049,ND,McHenry County,3155,2993,162,5.1
CN3805100000000,2023-02-01,38,051,ND,McIntosh County,1063,1031,32,3
CN3805300000000,2023-02-01,38,053,ND,McKenzie County,9611,9463,148,1.5
CN3805500000000,2023-02-01,38,055,ND,McLean County,4754,4561,193,4.1
CN3805700000000,2023-02-01,38,057,ND,Mercer County,3390,3247,143,4.2
CN3805900000000,2023-02-01,38,059,ND,Morton County,17118,16511,607,3.5
CN3806100000000,2023-02-01,38,061,ND,Mountrail County,6355,6260,95,1.5
CN3806300000000,2023-02-01,38,063,ND,Nelson County,1437,1378,59,4.1
CN3806500000000,2023-02-01,38,065,ND,Oliver County,883,845,38,4.3
CN3806700000000,2023-02-01,38,067,ND,Pembina County,3189,3051,138,4.3
CN3806900000000,2023-02-01,38,069,ND,Pierce County,1635,1573,62,3.8
CN3807100000000,2023-02-01,38,071,ND,Ramsey County,5490,5324,166,3
CN3807300000000,2023-02-01,38,073,ND,Ransom County,2628,2570,58,2.2
CN3807500000000,2023-02-01,38,075,ND,Renville County,1214,1189,25,2.1
CN3807700000000,2023-02-01,38,077,ND,Richland County,8769,8560,209,2.4
CN3807900000000,2023-02-01,38,079,ND,Rolette County,4668,4385,283,6.1
CN3808100000000,2023-02-01,38,081,ND,Sargent County,2290,2243,47,2.1
CN3808300000000,2023-02-01,38,083,ND,Sheridan County,653,624,29,4.4
CN3808500000000,2023-02-01,38,085,ND,Sioux County,1197,1169,28,2.3
CN3808700000000,2023-02-01,38,087,ND,Slope County,336,327,9,2.7
CN3808900000000,2023-02-01,38,089,ND,Stark County,18127,17760,367,2
CN3809100000000,2023-02-01,38,091,ND,Steele County,940,916,24,2.6
CN3809300000000,2023-02-01,38,093,ND,Stutsman County,10732,10442,290,2.7
CN3809500000000,2023-02-01,38,095,ND,Towner County,1088,1056,32,2.9
CN3809700000000,2023-02-01,38,097,ND,Traill County,4512,4412,100,2.2
CN3809900000000,2023-02-01,38,099,ND,Walsh County,5210,4981,229,4.4
CN3810100000000,2023-02-01,38,101,ND,Ward County,31841,30891,950,3
CN3810300000000,2023-02-01,38,103,ND,Wells County,1911,1815,96,5
CN3810500000000,2023-02-01,38,105,ND,Williams County,22266,21807,459,2.1
CN3900100000000,2023-02-01,39,001,OH,Adams County,11198,10396,802,7.2
CN3900300000000,2023-02-01,39,003,OH,Allen County,46315,44356,1959,4.2
CN3900500000000,2023-02-01,39,005,OH,Ashland County,25873,24721,1152,4.5
CN3900700000000,2023-02-01,39,007,OH,Ashtabula County,42867,40779,2088,4.9
CN3900900000000,2023-02-01,39,009,OH,Athens County,27240,25941,1299,4.8
CN3901100000000,2023-02-01,39,011,OH,Auglaize County,23764,23066,698,2.9
CN3901300000000,2023-02-01,39,013,OH,Belmont County,26909,25304,1605,6
CN3901500000000,2023-02-01,39,015,OH,Brown County,19856,18842,1014,5.1
CN3901700000000,2023-02-01,39,017,OH,Butler County,199368,192538,6830,3.4
CN3901900000000,2023-02-01,39,019,OH,Carroll County,12693,12082,611,4.8
CN3902100000000,2023-02-01,39,021,OH,Champaign County,19068,18374,694,3.6
CN3902300000000,2023-02-01,39,023,OH,Clark County,63093,60593,2500,4
CN3902500000000,2023-02-01,39,025,OH,Clermont County,109511,105571,3940,3.6
CN3902700000000,2023-02-01,39,027,OH,Clinton County,17988,17146,842,4.7
CN3902900000000,2023-02-01,39,029,OH,Columbiana County,44638,42289,2349,5.3
CN3903100000000,2023-02-01,39,031,OH,Coshocton County,13560,12816,744,5.5
CN3903300000000,2023-02-01,39,033,OH,Crawford County,17676,16772,904,5.1
CN3903500000000,2023-02-01,39,035,OH,Cuyahoga County,603120,573209,29911,5
CN3903700000000,2023-02-01,39,037,OH,Darke County,25505,24497,1008,4
CN3903900000000,2023-02-01,39,039,OH,Defiance County,17157,16477,680,4
CN3904100000000,2023-02-01,39,041,OH,Delaware County,115999,112536,3463,3
CN3904300000000,2023-02-01,39,043,OH,Erie County,34720,32687,2033,5.9
CN3904500000000,2023-02-01,39,045,OH,Fairfield County,80627,77785,2842,3.5
CN3904700000000,2023-02-01,39,047,OH,Fayette County,13722,13111,611,4.5
CN3904900000000,2023-02-01,39,049,OH,Franklin County,711351,687157,24194,3.4
CN3905100000000,2023-02-01,39,051,OH,Fulton County,21923,20882,1041,4.7
CN3905300000000,2023-02-01,39,053,OH,Gallia County,12309,11681,628,5.1
CN3905500000000,2023-02-01,39,055,OH,Geauga County,48772,46619,2153,4.4
CN3905700000000,2023-02-01,39,057,OH,Greene County,83391,80516,2875,3.4
CN3905900000000,2023-02-01,39,059,OH,Guernsey County,17605,16569,1036,5.9
CN3906100000000,2023-02-01,39,061,OH,Hamilton County,422137,407708,14429,3.4
CN3906300000000,2023-02-01,39,063,OH,Hancock County,40046,38744,1302,3.3
CN3906500000000,2023-02-01,39,065,OH,Hardin County,12763,12237,526,4.1
CN3906700000000,2023-02-01,39,067,OH,Harrison County,6427,6073,354,5.5
CN3906900000000,2023-02-01,39,069,OH,Henry County,12613,11890,723,5.7
CN3907100000000,2023-02-01,39,071,OH,Highland County,17772,16705,1067,6
CN3907300000000,2023-02-01,39,073,OH,Hocking County,13081,12477,604,4.6
CN3907500000000,2023-02-01,39,075,OH,Holmes County,21870,20988,882,4
CN3907700000000,2023-02-01,39,077,OH,Huron County,27569,25726,1843,6.7
CN3907900000000,2023-02-01,39,079,OH,Jackson County,12367,11651,716,5.8
CN3908100000000,2023-02-01,39,081,OH,Jefferson County,27079,25565,1514,5.6
CN3908300000000,2023-02-01,39,083,OH,Knox County,30895,29722,1173,3.8
CN3908500000000,2023-02-01,39,085,OH,Lake County,125856,119865,5991,4.8
CN3908700000000,2023-02-01,39,087,OH,Lawrence County,23468,22350,1118,4.8
CN3908900000000,2023-02-01,39,089,OH,Licking County,92419,89189,3230,3.5
CN3909100000000,2023-02-01,39,091,OH,Logan County,22624,21816,808,3.6
CN3909300000000,2023-02-01,39,093,OH,Lorain County,154800,146840,7960,5.1
CN3909500000000,2023-02-01,39,095,OH,Lucas County,204539,195157,9382,4.6
CN3909700000000,2023-02-01,39,097,OH,Madison County,21088,20368,720,3.4
CN3909900000000,2023-02-01,39,099,OH,Mahoning County,98427,93536,4891,5
CN3910100000000,2023-02-01,39,101,OH,Marion County,26893,25841,1052,3.9
CN3910300000000,2023-02-01,39,103,OH,Medina County,98668,94164,4504,4.6
CN3910500000000,2023-02-01,39,105,OH,Meigs County,8710,8090,620,7.1
CN3910700000000,2023-02-01,39,107,OH,Mercer County,22436,21844,592,2.6
CN3910900000000,2023-02-01,39,109,OH,Miami County,54379,52351,2028,3.7
CN3911100000000,2023-02-01,39,111,OH,Monroe County,5220,4807,413,7.9
CN3911300000000,2023-02-01,39,113,OH,Montgomery County,249843,239671,10172,4.1
CN3911500000000,2023-02-01,39,115,OH,Morgan County,6920,6456,464,6.7
CN3911700000000,2023-02-01,39,117,OH,Morrow County,17169,16422,747,4.4
CN3911900000000,2023-02-01,39,119,OH,Muskingum County,40678,38619,2059,5.1
CN3912100000000,2023-02-01,39,121,OH,Noble County,4565,4274,291,6.4
CN3912300000000,2023-02-01,39,123,OH,Ottawa County,19730,18344,1386,7
CN3912500000000,2023-02-01,39,125,OH,Paulding County,8571,8286,285,3.3
CN3912700000000,2023-02-01,39,127,OH,Perry County,16148,15316,832,5.2
CN3912900000000,2023-02-01,39,129,OH,Pickaway County,26974,25914,1060,3.9
CN3913100000000,2023-02-01,39,131,OH,Pike County,11074,10388,686,6.2
CN3913300000000,2023-02-01,39,133,OH,Portage County,85150,81652,3498,4.1
CN3913500000000,2023-02-01,39,135,OH,Preble County,22055,21278,777,3.5
CN3913700000000,2023-02-01,39,137,OH,Putnam County,18726,18110,616,3.3
CN3913900000000,2023-02-01,39,139,OH,Richland County,51048,48500,2548,5
CN3914100000000,2023-02-01,39,141,OH,Ross County,35249,33756,1493,4.2
CN3914300000000,2023-02-01,39,143,OH,Sandusky County,29491,28202,1289,4.4
CN3914500000000,2023-02-01,39,145,OH,Scioto County,29672,27850,1822,6.1
CN3914700000000,2023-02-01,39,147,OH,Seneca County,25972,24870,1102,4.2
CN3914900000000,2023-02-01,39,149,OH,Shelby County,23362,22498,864,3.7
CN3915100000000,2023-02-01,39,151,OH,Stark County,182014,174134,7880,4.3
CN3915300000000,2023-02-01,39,153,OH,Summit County,265185,253582,11603,4.4
CN3915500000000,2023-02-01,39,155,OH,Trumbull County,83248,78899,4349,5.2
CN3915700000000,2023-02-01,39,157,OH,Tuscarawas County,44648,42552,2096,4.7
CN3915900000000,2023-02-01,39,159,OH,Union County,30334,29396,938,3.1
CN3916100000000,2023-02-01,39,161,OH,Van Wert County,14190,13715,475,3.3
CN3916300000000,2023-02-01,39,163,OH,Vinton County,5436,5085,351,6.5
CN3916500000000,2023-02-01,39,165,OH,Warren County,124087,120073,4014,3.2
CN3916700000000,2023-02-01,39,167,OH,Washington County,26468,25006,1462,5.5
CN3916900000000,2023-02-01,39,169,OH,Wayne County,60215,58021,2194,3.6
CN3917100000000,2023-02-01,39,171,OH,Williams County,18047,17427,620,3.4
CN3917300000000,2023-02-01,39,173,OH,Wood County,69718,67236,2482,3.6
CN3917500000000,2023-02-01,39,175,OH,Wyandot County,13134,12734,400,3
CN4000100000000,2023-02-01,40,001,OK,Adair County,8561,8263,298,3.5
CN4000300000000,2023-02-01,40,003,OK,Alfalfa County,2647,2582,65,2.5
CN4000500000000,2023-02-01,40,005,OK,Atoka County,5157,4968,189,3.7
CN4000700000000,2023-02-01,40,007,OK,Beaver County,2552,2491,61,2.4
CN4000900000000,2023-02-01,40,009,OK,Beckham County,10497,10208,289,2.8
CN4001100000000,2023-02-01,40,011,OK,Blaine County,4323,4232,91,2.1
CN4001300000000,2023-02-01,40,013,OK,Bryan County,23656,22976,680,2.9
CN4001500000000,2023-02-01,40,015,OK,Caddo County,11634,11233,401,3.4
CN4001700000000,2023-02-01,40,017,OK,Canadian County,81876,79730,2146,2.6
CN4001900000000,2023-02-01,40,019,OK,Carter County,21282,20506,776,3.6
CN4002100000000,2023-02-01,40,021,OK,Cherokee County,20034,19329,705,3.5
CN4002300000000,2023-02-01,40,023,OK,Choctaw County,6063,5793,270,4.5
CN4002500000000,2023-02-01,40,025,OK,Cimarron County,1608,1583,25,1.6
CN4002700000000,2023-02-01,40,027,OK,Cleveland County,151262,147182,4080,2.7
CN4002900000000,2023-02-01,40,029,OK,Coal County,2407,2321,86,3.6
CN4003100000000,2023-02-01,40,031,OK,Comanche County,47499,45797,1702,3.6
CN4003300000000,2023-02-01,40,033,OK,Cotton County,2661,2584,77,2.9
CN4003500000000,2023-02-01,40,035,OK,Craig County,5847,5650,197,3.4
CN4003700000000,2023-02-01,40,037,OK,Creek County,31463,30402,1061,3.4
CN4003900000000,2023-02-01,40,039,OK,Custer County,15183,14779,404,2.7
CN4004100000000,2023-02-01,40,041,OK,Delaware County,19926,19294,632,3.2
CN4004300000000,2023-02-01,40,043,OK,Dewey County,3007,2947,60,2
CN4004500000000,2023-02-01,40,045,OK,Ellis County,2067,2017,50,2.4
CN4004700000000,2023-02-01,40,047,OK,Garfield County,26168,25375,793,3
CN4004900000000,2023-02-01,40,049,OK,Garvin County,12815,12416,399,3.1
CN4005100000000,2023-02-01,40,051,OK,Grady County,27787,26985,802,2.9
CN4005300000000,2023-02-01,40,053,OK,Grant County,2624,2565,59,2.2
CN4005500000000,2023-02-01,40,055,OK,Greer County,1791,1725,66,3.7
CN4005700000000,2023-02-01,40,057,OK,Harmon County,1159,1125,34,2.9
CN4005900000000,2023-02-01,40,059,OK,Harper County,1751,1713,38,2.2
CN4006100000000,2023-02-01,40,061,OK,Haskell County,4187,4006,181,4.3
CN4006300000000,2023-02-01,40,063,OK,Hughes County,5150,4962,188,3.7
CN4006500000000,2023-02-01,40,065,OK,Jackson County,10807,10417,390,3.6
CN4006700000000,2023-02-01,40,067,OK,Jefferson County,2450,2372,78,3.2
CN4006900000000,2023-02-01,40,069,OK,Johnston County,3772,3617,155,4.1
CN4007100000000,2023-02-01,40,071,OK,Kay County,18375,17728,647,3.5
CN4007300000000,2023-02-01,40,073,OK,Kingfisher County,8954,8756,198,2.2
CN4007500000000,2023-02-01,40,075,OK,Kiowa County,3598,3470,128,3.6
CN4007700000000,2023-02-01,40,077,OK,Latimer County,3126,2947,179,5.7
CN4007900000000,2023-02-01,40,079,OK,Le Flore County,19693,18973,720,3.7
CN4008100000000,2023-02-01,40,081,OK,Lincoln County,16491,15959,532,3.2
CN4008300000000,2023-02-01,40,083,OK,Logan County,23801,23087,714,3
CN4008500000000,2023-02-01,40,085,OK,Love County,5812,5666,146,2.5
CN4008700000000,2023-02-01,40,087,OK,McClain County,21260,20655,605,2.8
CN4008900000000,2023-02-01,40,089,OK,McCurtain County,15934,15338,596,3.7
CN4009100000000,2023-02-01,40,091,OK,McIntosh County,7241,6864,377,5.2
CN4009300000000,2023-02-01,40,093,OK,Major County,3789,3687,102,2.7
CN4009500000000,2023-02-01,40,095,OK,Marshall County,7239,7011,228,3.1
CN4009700000000,2023-02-01,40,097,OK,Mayes County,19754,19106,648,3.3
CN4009900000000,2023-02-01,40,099,OK,Murray County,6048,5851,197,3.3
CN4010100000000,2023-02-01,40,101,OK,Muskogee County,28810,27753,1057,3.7
CN4010300000000,2023-02-01,40,103,OK,Noble County,5886,5733,153,2.6
CN4010500000000,2023-02-01,40,105,OK,Nowata County,4742,4600,142,3
CN4010700000000,2023-02-01,40,107,OK,Okfuskee County,4438,4250,188,4.2
CN4010900000000,2023-02-01,40,109,OK,Oklahoma County,405719,393494,12225,3
CN4011100000000,2023-02-01,40,111,OK,Okmulgee County,15604,14937,667,4.3
CN4011300000000,2023-02-01,40,113,OK,Osage County,20501,19791,710,3.5
CN4011500000000,2023-02-01,40,115,OK,Ottawa County,15417,14975,442,2.9
CN4011700000000,2023-02-01,40,117,OK,Pawnee County,7369,7102,267,3.6
CN4011900000000,2023-02-01,40,119,OK,Payne County,39773,38511,1262,3.2
CN4012100000000,2023-02-01,40,121,OK,Pittsburg County,16340,15645,695,4.3
CN4012300000000,2023-02-01,40,123,OK,Pontotoc County,19705,19163,542,2.8
CN4012500000000,2023-02-01,40,125,OK,Pottawatomie County,33476,32312,1164,3.5
CN4012700000000,2023-02-01,40,127,OK,Pushmataha County,4576,4397,179,3.9
CN4012900000000,2023-02-01,40,129,OK,Roger Mills County,1777,1737,40,2.3
CN4013100000000,2023-02-01,40,131,OK,Rogers County,45548,44218,1330,2.9
CN4013300000000,2023-02-01,40,133,OK,Seminole County,9291,8896,395,4.3
CN4013500000000,2023-02-01,40,135,OK,Sequoyah County,16948,16367,581,3.4
CN4013700000000,2023-02-01,40,137,OK,Stephens County,19646,18997,649,3.3
CN4013900000000,2023-02-01,40,139,OK,Texas County,11742,11503,239,2
CN4014100000000,2023-02-01,40,141,OK,Tillman County,2937,2795,142,4.8
CN4014300000000,2023-02-01,40,143,OK,Tulsa County,327347,317257,10090,3.1
CN4014500000000,2023-02-01,40,145,OK,Wagoner County,39266,38047,1219,3.1
CN4014700000000,2023-02-01,40,147,OK,Washington County,22282,21519,763,3.4
CN4014900000000,2023-02-01,40,149,OK,Washita County,5356,5203,153,2.9
CN4015100000000,2023-02-01,40,151,OK,Woods County,4604,4511,93,2
CN4015300000000,2023-02-01,40,153,OK,Woodward County,8633,8372,261,3
CN4100100000000,2023-02-01,41,001,OR,Baker County,7211,6796,415,5.8
CN4100300000000,2023-02-01,41,003,OR,Benton County,49903,48150,1753,3.5
CN4100500000000,2023-02-01,41,005,OR,Clackamas County,226262,217357,8905,3.9
CN4100700000000,2023-02-01,41,007,OR,Clatsop County,18981,18070,911,4.8
CN4100900000000,2023-02-01,41,009,OR,Columbia County,25181,23892,1289,5.1
CN4101100000000,2023-02-01,41,011,OR,Coos County,26316,24881,1435,5.5
CN4101300000000,2023-02-01,41,013,OR,Crook County,11135,10345,790,7.1
CN4101500000000,2023-02-01,41,015,OR,Curry County,8834,8301,533,6
CN4101700000000,2023-02-01,41,017,OR,Deschutes County,102459,97449,5010,4.9
CN4101900000000,2023-02-01,41,019,OR,Douglas County,46841,44025,2816,6
CN4102100000000,2023-02-01,41,021,OR,Gilliam County,1024,983,41,4
CN4102300000000,2023-02-01,41,023,OR,Grant County,3052,2822,230,7.5
CN4102500000000,2023-02-01,41,025,OR,Harney County,3670,3430,240,6.5
CN4102700000000,2023-02-01,41,027,OR,Hood River County,13926,13397,529,3.8
CN4102900000000,2023-02-01,41,029,OR,Jackson County,105866,100041,5825,5.5
CN4103100000000,2023-02-01,41,031,OR,Jefferson County,10270,9638,632,6.2
CN4103300000000,2023-02-01,41,033,OR,Josephine County,36540,34203,2337,6.4
CN4103500000000,2023-02-01,41,035,OR,Klamath County,29949,27702,2247,7.5
CN4103700000000,2023-02-01,41,037,OR,Lake County,3586,3344,242,6.7
CN4103900000000,2023-02-01,41,039,OR,Lane County,180704,171787,8917,4.9
CN4104100000000,2023-02-01,41,041,OR,Lincoln County,20379,19238,1141,5.6
CN4104300000000,2023-02-01,41,043,OR,Linn County,61190,58179,3011,4.9
CN4104500000000,2023-02-01,41,045,OR,Malheur County,12242,11633,609,5
CN4104700000000,2023-02-01,41,047,OR,Marion County,169207,161412,7795,4.6
CN4104900000000,2023-02-01,41,049,OR,Morrow County,5829,5555,274,4.7
CN4105100000000,2023-02-01,41,051,OR,Multnomah County,467966,448658,19308,4.1
CN4105300000000,2023-02-01,41,053,OR,Polk County,42681,40681,2000,4.7
CN4105500000000,2023-02-01,41,055,OR,Sherman County,951,910,41,4.3
CN4105700000000,2023-02-01,41,057,OR,Tillamook County,11863,11269,594,5
CN4105900000000,2023-02-01,41,059,OR,Umatilla County,37849,35406,2443,6.5
CN4106100000000,2023-02-01,41,061,OR,Union County,11909,11248,661,5.6
CN4106300000000,2023-02-01,41,063,OR,Wallowa County,3449,3178,271,7.9
CN4106500000000,2023-02-01,41,065,OR,Wasco County,12723,11993,730,5.7
CN4106700000000,2023-02-01,41,067,OR,Washington County,334594,322424,12170,3.6
CN4106900000000,2023-02-01,41,069,OR,Wheeler County,728,702,26,3.6
CN4107100000000,2023-02-01,41,071,OR,Yamhill County,56405,54011,2394,4.2
CN4200100000000,2023-02-01,42,001,PA,Adams County,54528,52664,1864,3.4
CN4200300000000,2023-02-01,42,003,PA,Allegheny County,629714,601258,28456,4.5
CN4200500000000,2023-02-01,42,005,PA,Armstrong County,31182,29205,1977,6.3
CN4200700000000,2023-02-01,42,007,PA,Beaver County,81921,76972,4949,6
CN4200900000000,2023-02-01,42,009,PA,Bedford County,24024,22645,1379,5.7
CN4201100000000,2023-02-01,42,011,PA,Berks County,213491,203796,9695,4.5
CN4201300000000,2023-02-01,42,013,PA,Blair County,58704,55940,2764,4.7
CN4201500000000,2023-02-01,42,015,PA,Bradford County,27558,26198,1360,4.9
CN4201700000000,2023-02-01,42,017,PA,Bucks County,352189,338084,14105,4
CN4201900000000,2023-02-01,42,019,PA,Butler County,98346,93777,4569,4.6
CN4202100000000,2023-02-01,42,021,PA,Cambria County,55530,52255,3275,5.9
CN4202300000000,2023-02-01,42,023,PA,Cameron County,1864,1735,129,6.9
CN4202500000000,2023-02-01,42,025,PA,Carbon County,32617,30826,1791,5.5
CN4202700000000,2023-02-01,42,027,PA,Centre County,79388,76504,2884,3.6
CN4202900000000,2023-02-01,42,029,PA,Chester County,293662,284059,9603,3.3
CN4203100000000,2023-02-01,42,031,PA,Clarion County,15821,14790,1031,6.5
CN4203300000000,2023-02-01,42,033,PA,Clearfield County,34888,32686,2202,6.3
CN4203500000000,2023-02-01,42,035,PA,Clinton County,16874,15797,1077,6.4
CN4203700000000,2023-02-01,42,037,PA,Columbia County,34237,32462,1775,5.2
CN4203900000000,2023-02-01,42,039,PA,Crawford County,37056,35009,2047,5.5
CN4204100000000,2023-02-01,42,041,PA,Cumberland County,135537,130868,4669,3.4
CN4204300000000,2023-02-01,42,043,PA,Dauphin County,147267,141137,6130,4.2
CN4204500000000,2023-02-01,42,045,PA,Delaware County,303049,290707,12342,4.1
CN4204700000000,2023-02-01,42,047,PA,Elk County,14019,13359,660,4.7
CN4204900000000,2023-02-01,42,049,PA,Erie County,126064,119093,6971,5.5
CN4205100000000,2023-02-01,42,051,PA,Fayette County,55024,51296,3728,6.8
CN4205300000000,2023-02-01,42,053,PA,Forest County,1634,1495,139,8.5
CN4205500000000,2023-02-01,42,055,PA,Franklin County,77020,74044,2976,3.9
CN4205700000000,2023-02-01,42,057,PA,Fulton County,7096,6747,349,4.9
CN4205900000000,2023-02-01,42,059,PA,Greene County,15233,14413,820,5.4
CN4206100000000,2023-02-01,42,061,PA,Huntingdon County,19088,17680,1408,7.4
CN4206300000000,2023-02-01,42,063,PA,Indiana County,35859,33777,2082,5.8
CN4206500000000,2023-02-01,42,065,PA,Jefferson County,19062,17955,1107,5.8
CN4206700000000,2023-02-01,42,067,PA,Juniata County,12169,11480,689,5.7
CN4206900000000,2023-02-01,42,069,PA,Lackawanna County,106037,100608,5429,5.1
CN4207100000000,2023-02-01,42,071,PA,Lancaster County,287143,277128,10015,3.5
CN4207300000000,2023-02-01,42,073,PA,Lawrence County,38766,36095,2671,6.9
CN4207500000000,2023-02-01,42,075,PA,Lebanon County,73603,70924,2679,3.6
CN4207700000000,2023-02-01,42,077,PA,Lehigh County,197502,188344,9158,4.6
CN4207900000000,2023-02-01,42,079,PA,Luzerne County,160010,150473,9537,6
CN4208100000000,2023-02-01,42,081,PA,Lycoming County,55438,52556,2882,5.2
CN4208300000000,2023-02-01,42,083,PA,McKean County,16575,15521,1054,6.4
CN4208500000000,2023-02-01,42,085,PA,Mercer County,47138,44637,2501,5.3
CN4208700000000,2023-02-01,42,087,PA,Mifflin County,20707,19592,1115,5.4
CN4208900000000,2023-02-01,42,089,PA,Monroe County,82483,77360,5123,6.2
CN4209100000000,2023-02-01,42,091,PA,Montgomery County,468559,451820,16739,3.6
CN4209300000000,2023-02-01,42,093,PA,Montour County,9293,8928,365,3.9
CN4209500000000,2023-02-01,42,095,PA,Northampton County,164714,157148,7566,4.6
CN4209700000000,2023-02-01,42,097,PA,Northumberland County,41278,38882,2396,5.8
CN4209900000000,2023-02-01,42,099,PA,Perry County,24672,23692,980,4
CN4210100000000,2023-02-01,42,101,PA,Philadelphia County/city,741492,702463,39029,5.3
CN4210300000000,2023-02-01,42,103,PA,Pike County,25703,23986,1717,6.7
CN4210500000000,2023-02-01,42,105,PA,Potter County,6696,6141,555,8.3
CN4210700000000,2023-02-01,42,107,PA,Schuylkill County,65403,61725,3678,5.6
CN4210900000000,2023-02-01,42,109,PA,Snyder County,19371,18374,997,5.1
CN4211100000000,2023-02-01,42,111,PA,Somerset County,32149,30054,2095,6.5
CN4211300000000,2023-02-01,42,113,PA,Sullivan County,2461,2320,141,5.7
CN4211500000000,2023-02-01,42,115,PA,Susquehanna County,19963,18917,1046,5.2
CN4211700000000,2023-02-01,42,117,PA,Tioga County,18687,17563,1124,6
CN4211900000000,2023-02-01,42,119,PA,Union County,19138,18380,758,4
CN4212100000000,2023-02-01,42,121,PA,Venango County,20689,19417,1272,6.1
CN4212300000000,2023-02-01,42,123,PA,Warren County,17118,16117,1001,5.8
CN4212500000000,2023-02-01,42,125,PA,Washington County,104349,99113,5236,5
CN4212700000000,2023-02-01,42,127,PA,Wayne County,22074,20629,1445,6.5
CN4212900000000,2023-02-01,42,129,PA,Westmoreland County,175278,166306,8972,5.1
CN4213100000000,2023-02-01,42,131,PA,Wyoming County,13574,12821,753,5.5
CN4213300000000,2023-02-01,42,133,PA,York County,237995,228821,9174,3.9
CN4400100000000,2023-02-01,44,001,RI,Bristol County,26384,25521,863,3.3
CN4400300000000,2023-02-01,44,003,RI,Kent County,93121,89822,3299,3.5
CN4400500000000,2023-02-01,44,005,RI,Newport County,45023,43305,1718,3.8
CN4400700000000,2023-02-01,44,007,RI,Providence County,332705,318852,13853,4.2
CN4400900000000,2023-02-01,44,009,RI,Washington County,69737,67328,2409,3.5
CN4500100000000,2023-02-01,45,001,SC,Abbeville County,9585,9164,421,4.4
CN4500300000000,2023-02-01,45,003,SC,Aiken County,73078,70307,2771,3.8
CN4500500000000,2023-02-01,45,005,SC,Allendale County,2235,2094,141,6.3
CN4500700000000,2023-02-01,45,007,SC,Anderson County,93265,90016,3249,3.5
CN4500900000000,2023-02-01,45,009,SC,Bamberg County,4559,4296,263,5.8
CN4501100000000,2023-02-01,45,011,SC,Barnwell County,7456,7086,370,5
CN4501300000000,2023-02-01,45,013,SC,Beaufort County,76965,74046,2919,3.8
CN4501500000000,2023-02-01,45,015,SC,Berkeley County,113027,109219,3808,3.4
CN4501700000000,2023-02-01,45,017,SC,Calhoun County,6435,6175,260,4
CN4501900000000,2023-02-01,45,019,SC,Charleston County,221941,214980,6961,3.1
CN4502100000000,2023-02-01,45,021,SC,Cherokee County,24455,23379,1076,4.4
CN4502300000000,2023-02-01,45,023,SC,Chester County,13488,12860,628,4.7
CN4502500000000,2023-02-01,45,025,SC,Chesterfield County,21148,20342,806,3.8
CN4502700000000,2023-02-01,45,027,SC,Clarendon County,11843,11247,596,5
CN4502900000000,2023-02-01,45,029,SC,Colleton County,15884,15232,652,4.1
CN4503100000000,2023-02-01,45,031,SC,Darlington County,29969,28779,1190,4
CN4503300000000,2023-02-01,45,033,SC,Dillon County,12921,12250,671,5.2
CN4503500000000,2023-02-01,45,035,SC,Dorchester County,81922,79295,2627,3.2
CN4503700000000,2023-02-01,45,037,SC,Edgefield County,10212,9807,405,4
CN4503900000000,2023-02-01,45,039,SC,Fairfield County,9229,8785,444,4.8
CN4504100000000,2023-02-01,45,041,SC,Florence County,66676,64263,2413,3.6
CN4504300000000,2023-02-01,45,043,SC,Georgetown County,25932,24799,1133,4.4
CN4504500000000,2023-02-01,45,045,SC,Greenville County,265166,256477,8689,3.3
CN4504700000000,2023-02-01,45,047,SC,Greenwood County,30036,28772,1264,4.2
CN4504900000000,2023-02-01,45,049,SC,Hampton County,7840,7560,280,3.6
CN4505100000000,2023-02-01,45,051,SC,Horry County,151805,144559,7246,4.8
CN4505300000000,2023-02-01,45,053,SC,Jasper County,13248,12796,452,3.4
CN4505500000000,2023-02-01,45,055,SC,Kershaw County,29543,28403,1140,3.9
CN4505700000000,2023-02-01,45,057,SC,Lancaster County,44120,42338,1782,4
CN4505900000000,2023-02-01,45,059,SC,Laurens County,30668,29465,1203,3.9
CN4506100000000,2023-02-01,45,061,SC,Lee County,6347,6027,320,5
CN4506300000000,2023-02-01,45,063,SC,Lexington County,152182,147367,4815,3.2
CN4506500000000,2023-02-01,45,065,SC,McCormick County,3579,3435,144,4
CN4506700000000,2023-02-01,45,067,SC,Marion County,12581,11890,691,5.5
CN4506900000000,2023-02-01,45,069,SC,Marlboro County,8061,7413,648,8
CN4507100000000,2023-02-01,45,071,SC,Newberry County,19272,18630,642,3.3
CN4507300000000,2023-02-01,45,073,SC,Oconee County,34333,33115,1218,3.5
CN4507500000000,2023-02-01,45,075,SC,Orangeburg County,32983,31284,1699,5.2
CN4507700000000,2023-02-01,45,077,SC,Pickens County,59138,57034,2104,3.6
CN4507900000000,2023-02-01,45,079,SC,Richland County,198452,191305,7147,3.6
CN4508100000000,2023-02-01,45,081,SC,Saluda County,8350,8045,305,3.7
CN4508300000000,2023-02-01,45,083,SC,Spartanburg County,156789,151319,5470,3.5
CN4508500000000,2023-02-01,45,085,SC,Sumter County,42290,40340,1950,4.6
CN4508700000000,2023-02-01,45,087,SC,Union County,11391,10813,578,5.1
CN4508900000000,2023-02-01,45,089,SC,Williamsburg County,10668,10074,594,5.6
CN4509100000000,2023-02-01,45,091,SC,York County,149938,144797,5141,3.4
CN4600300000000,2023-02-01,46,003,SD,Aurora County,1532,1502,30,2
CN4600500000000,2023-02-01,46,005,SD,Beadle County,9279,9063,216,2.3
CN4600700000000,2023-02-01,46,007,SD,Bennett County,1089,1051,38,3.5
CN4600900000000,2023-02-01,46,009,SD,Bon Homme County,2888,2812,76,2.6
CN4601100000000,2023-02-01,46,011,SD,Brookings County,19458,19013,445,2.3
CN4601300000000,2023-02-01,46,013,SD,Brown County,19850,19346,504,2.5
CN4601500000000,2023-02-01,46,015,SD,Brule County,2641,2584,57,2.2
CN4601700000000,2023-02-01,46,017,SD,Buffalo County,724,689,35,4.8
CN4601900000000,2023-02-01,46,019,SD,Butte County,5007,4889,118,2.4
CN4602100000000,2023-02-01,46,021,SD,Campbell County,787,766,21,2.7
CN4602300000000,2023-02-01,46,023,SD,Charles Mix County,3815,3715,100,2.6
CN4602500000000,2023-02-01,46,025,SD,Clark County,2003,1941,62,3.1
CN4602700000000,2023-02-01,46,027,SD,Clay County,7743,7570,173,2.2
CN4602900000000,2023-02-01,46,029,SD,Codington County,15904,15518,386,2.4
CN4603100000000,2023-02-01,46,031,SD,Corson County,1332,1297,35,2.6
CN4603300000000,2023-02-01,46,033,SD,Custer County,4302,4165,137,3.2
CN4603500000000,2023-02-01,46,035,SD,Davison County,10997,10743,254,2.3
CN4603700000000,2023-02-01,46,037,SD,Day County,2690,2583,107,4
CN4603900000000,2023-02-01,46,039,SD,Deuel County,2265,2165,100,4.4
CN4604100000000,2023-02-01,46,041,SD,Dewey County,2299,2208,91,4
CN4604300000000,2023-02-01,46,043,SD,Douglas County,1555,1512,43,2.8
CN4604500000000,2023-02-01,46,045,SD,Edmunds County,2044,1994,50,2.4
CN4604700000000,2023-02-01,46,047,SD,Fall River County,2990,2895,95,3.2
CN4604900000000,2023-02-01,46,049,SD,Faulk County,1123,1100,23,2
CN4605100000000,2023-02-01,46,051,SD,Grant County,4444,4266,178,4
CN4605300000000,2023-02-01,46,053,SD,Gregory County,2145,2095,50,2.3
CN4605500000000,2023-02-01,46,055,SD,Haakon County,1124,1098,26,2.3
CN4605700000000,2023-02-01,46,057,SD,Hamlin County,3631,3538,93,2.6
CN4605900000000,2023-02-01,46,059,SD,Hand County,1833,1798,35,1.9
CN4606100000000,2023-02-01,46,061,SD,Hanson County,1819,1761,58,3.2
CN4606300000000,2023-02-01,46,063,SD,Harding County,811,795,16,2
CN4606500000000,2023-02-01,46,065,SD,Hughes County,9655,9446,209,2.2
CN4606700000000,2023-02-01,46,067,SD,Hutchinson County,3690,3579,111,3
CN4606900000000,2023-02-01,46,069,SD,Hyde County,670,658,12,1.8
CN4607100000000,2023-02-01,46,071,SD,Jackson County,1197,1146,51,4.3
CN4607300000000,2023-02-01,46,073,SD,Jerauld County,1295,1274,21,1.6
CN4607500000000,2023-02-01,46,075,SD,Jones County,498,484,14,2.8
CN4607700000000,2023-02-01,46,077,SD,Kingsbury County,2761,2693,68,2.5
CN4607900000000,2023-02-01,46,079,SD,Lake County,6773,6621,152,2.2
CN4608100000000,2023-02-01,46,081,SD,Lawrence County,13917,13604,313,2.2
CN4608300000000,2023-02-01,46,083,SD,Lincoln County,37504,36751,753,2
CN4608500000000,2023-02-01,46,085,SD,Lyman County,1672,1615,57,3.4
CN4608700000000,2023-02-01,46,087,SD,McCook County,3187,3115,72,2.3
CN4608900000000,2023-02-01,46,089,SD,McPherson County,1015,986,29,2.9
CN4609100000000,2023-02-01,46,091,SD,Marshall County,2515,2436,79,3.1
CN4609300000000,2023-02-01,46,093,SD,Meade County,14441,14065,376,2.6
CN4609500000000,2023-02-01,46,095,SD,Mellette County,785,760,25,3.2
CN4609700000000,2023-02-01,46,097,SD,Miner County,1279,1250,29,2.3
CN4609900000000,2023-02-01,46,099,SD,Minnehaha County,116502,113729,2773,2.4
CN4610100000000,2023-02-01,46,101,SD,Moody County,4023,3933,90,2.2
CN4610200000000,2023-02-01,46,102,SD,Oglala Lakota County,3708,3539,169,4.6
CN4610300000000,2023-02-01,46,103,SD,Pennington County,59087,57747,1340,2.3
CN4610500000000,2023-02-01,46,105,SD,Perkins County,1482,1445,37,2.5
CN4610700000000,2023-02-01,46,107,SD,Potter County,1053,1002,51,4.8
CN4610900000000,2023-02-01,46,109,SD,Roberts County,4593,4420,173,3.8
CN4611100000000,2023-02-01,46,111,SD,Sanborn County,1257,1226,31,2.5
CN4611500000000,2023-02-01,46,115,SD,Spink County,3087,2990,97,3.1
CN4611700000000,2023-02-01,46,117,SD,Stanley County,1933,1884,49,2.5
CN4611900000000,2023-02-01,46,119,SD,Sully County,845,832,13,1.5
CN4612100000000,2023-02-01,46,121,SD,Todd County,2995,2890,105,3.5
CN4612300000000,2023-02-01,46,123,SD,Tripp County,3175,3114,61,1.9
CN4612500000000,2023-02-01,46,125,SD,Turner County,4876,4751,125,2.6
CN4612700000000,2023-02-01,46,127,SD,Union County,8722,8517,205,2.4
CN4612900000000,2023-02-01,46,129,SD,Walworth County,2072,1981,91,4.4
CN4613500000000,2023-02-01,46,135,SD,Yankton County,11610,11349,261,2.2
CN4613700000000,2023-02-01,46,137,SD,Ziebach County,980,945,35,3.6
CN4700100000000,2023-02-01,47,001,TN,Anderson County,35309,34133,1176,3.3
CN4700300000000,2023-02-01,47,003,TN,Bedford County,21585,20849,736,3.4
CN4700500000000,2023-02-01,47,005,TN,Benton County,6721,6391,330,4.9
CN4700700000000,2023-02-01,47,007,TN,Bledsoe County,4423,4164,259,5.9
CN4700900000000,2023-02-01,47,009,TN,Blount County,65776,63560,2216,3.4
CN4701100000000,2023-02-01,47,011,TN,Bradley County,50268,48391,1877,3.7
CN4701300000000,2023-02-01,47,013,TN,Campbell County,15063,14347,716,4.8
CN4701500000000,2023-02-01,47,015,TN,Cannon County,6909,6710,199,2.9
CN4701700000000,2023-02-01,47,017,TN,Carroll County,11678,11195,483,4.1
CN4701900000000,2023-02-01,47,019,TN,Carter County,24185,23221,964,4
CN4702100000000,2023-02-01,47,021,TN,Cheatham County,22674,22060,614,2.7
CN4702300000000,2023-02-01,47,023,TN,Chester County,8520,8247,273,3.2
CN4702500000000,2023-02-01,47,025,TN,Claiborne County,12798,12231,567,4.4
CN4702700000000,2023-02-01,47,027,TN,Clay County,2816,2663,153,5.4
CN4702900000000,2023-02-01,47,029,TN,Cocke County,14548,13597,951,6.5
CN4703100000000,2023-02-01,47,031,TN,Coffee County,25106,24193,913,3.6
CN4703300000000,2023-02-01,47,033,TN,Crockett County,6879,6611,268,3.9
CN4703500000000,2023-02-01,47,035,TN,Cumberland County,23386,22190,1196,5.1
CN4703700000000,2023-02-01,47,037,TN,Davidson County,415617,403814,11803,2.8
CN4703900000000,2023-02-01,47,039,TN,Decatur County,4443,4201,242,5.4
CN4704100000000,2023-02-01,47,041,TN,DeKalb County,8074,7735,339,4.2
CN4704300000000,2023-02-01,47,043,TN,Dickson County,28155,27295,860,3.1
CN4704500000000,2023-02-01,47,045,TN,Dyer County,16543,15918,625,3.8
CN4704700000000,2023-02-01,47,047,TN,Fayette County,19240,18504,736,3.8
CN4704900000000,2023-02-01,47,049,TN,Fentress County,7867,7524,343,4.4
CN4705100000000,2023-02-01,47,051,TN,Franklin County,18945,18258,687,3.6
CN4705300000000,2023-02-01,47,053,TN,Gibson County,21507,20687,820,3.8
CN4705500000000,2023-02-01,47,055,TN,Giles County,14775,14270,505,3.4
CN4705700000000,2023-02-01,47,057,TN,Grainger County,9784,9350,434,4.4
CN4705900000000,2023-02-01,47,059,TN,Greene County,28806,27439,1367,4.7
CN4706100000000,2023-02-01,47,061,TN,Grundy County,5057,4791,266,5.3
CN4706300000000,2023-02-01,47,063,TN,Hamblen County,28356,27224,1132,4
CN4706500000000,2023-02-01,47,065,TN,Hamilton County,184067,177857,6210,3.4
CN4706700000000,2023-02-01,47,067,TN,Hancock County,2299,2197,102,4.4
CN4706900000000,2023-02-01,47,069,TN,Hardeman County,8947,8495,452,5.1
CN4707100000000,2023-02-01,47,071,TN,Hardin County,9874,9457,417,4.2
CN4707300000000,2023-02-01,47,073,TN,Hawkins County,23384,22418,966,4.1
CN4707500000000,2023-02-01,47,075,TN,Haywood County,7568,7174,394,5.2
CN4707700000000,2023-02-01,47,077,TN,Henderson County,11690,11229,461,3.9
CN4707900000000,2023-02-01,47,079,TN,Henry County,13429,12811,618,4.6
CN4708100000000,2023-02-01,47,081,TN,Hickman County,11810,11447,363,3.1
CN4708300000000,2023-02-01,47,083,TN,Houston County,3244,3080,164,5.1
CN4708500000000,2023-02-01,47,085,TN,Humphreys County,8604,8249,355,4.1
CN4708700000000,2023-02-01,47,087,TN,Jackson County,4809,4585,224,4.7
CN4708900000000,2023-02-01,47,089,TN,Jefferson County,25316,24186,1130,4.5
CN4709100000000,2023-02-01,47,091,TN,Johnson County,7509,7236,273,3.6
CN4709300000000,2023-02-01,47,093,TN,Knox County,251516,244122,7394,2.9
CN4709500000000,2023-02-01,47,095,TN,Lake County,1604,1518,86,5.4
CN4709700000000,2023-02-01,47,097,TN,Lauderdale County,9423,8942,481,5.1
CN4709900000000,2023-02-01,47,099,TN,Lawrence County,19159,18441,718,3.7
CN4710100000000,2023-02-01,47,101,TN,Lewis County,5537,5335,202,3.6
CN4710300000000,2023-02-01,47,103,TN,Lincoln County,16672,16107,565,3.4
CN4710500000000,2023-02-01,47,105,TN,Loudon County,24484,23664,820,3.3
CN4710700000000,2023-02-01,47,107,TN,McMinn County,21308,20326,982,4.6
CN4710900000000,2023-02-01,47,109,TN,McNairy County,8411,7997,414,4.9
CN4711100000000,2023-02-01,47,111,TN,Macon County,11814,11413,401,3.4
CN4711300000000,2023-02-01,47,113,TN,Madison County,48853,47072,1781,3.6
CN4711500000000,2023-02-01,47,115,TN,Marion County,12339,11852,487,3.9
CN4711700000000,2023-02-01,47,117,TN,Marshall County,15675,15159,516,3.3
CN4711900000000,2023-02-01,47,119,TN,Maury County,53303,51725,1578,3
CN4712100000000,2023-02-01,47,121,TN,Meigs County,5177,4922,255,4.9
CN4712300000000,2023-02-01,47,123,TN,Monroe County,20893,20109,784,3.8
CN4712500000000,2023-02-01,47,125,TN,Montgomery County,88868,85334,3534,4
CN4712700000000,2023-02-01,47,127,TN,Moore County,3802,3707,95,2.5
CN4712900000000,2023-02-01,47,129,TN,Morgan County,7972,7586,386,4.8
CN4713100000000,2023-02-01,47,131,TN,Obion County,12760,12226,534,4.2
CN4713300000000,2023-02-01,47,133,TN,Overton County,9945,9511,434,4.4
CN4713500000000,2023-02-01,47,135,TN,Perry County,2768,2628,140,5.1
CN4713700000000,2023-02-01,47,137,TN,Pickett County,2096,2001,95,4.5
CN4713900000000,2023-02-01,47,139,TN,Polk County,7094,6775,319,4.5
CN4714100000000,2023-02-01,47,141,TN,Putnam County,35443,34127,1316,3.7
CN4714300000000,2023-02-01,47,143,TN,Rhea County,13879,13225,654,4.7
CN4714500000000,2023-02-01,47,145,TN,Roane County,23862,22951,911,3.8
CN4714700000000,2023-02-01,47,147,TN,Robertson County,39581,38449,1132,2.9
CN4714900000000,2023-02-01,47,149,TN,Rutherford County,197158,191838,5320,2.7
CN4715100000000,2023-02-01,47,151,TN,Scott County,8056,7613,443,5.5
CN4715300000000,2023-02-01,47,153,TN,Sequatchie County,6176,5921,255,4.1
CN4715500000000,2023-02-01,47,155,TN,Sevier County,52588,49761,2827,5.4
CN4715700000000,2023-02-01,47,157,TN,Shelby County,436814,416814,20000,4.6
CN4715900000000,2023-02-01,47,159,TN,Smith County,9860,9528,332,3.4
CN4716100000000,2023-02-01,47,161,TN,Stewart County,5596,5370,226,4
CN4716300000000,2023-02-01,47,163,TN,Sullivan County,69330,66740,2590,3.7
CN4716500000000,2023-02-01,47,165,TN,Sumner County,109517,106377,3140,2.9
CN4716700000000,2023-02-01,47,167,TN,Tipton County,27591,26552,1039,3.8
CN4716900000000,2023-02-01,47,169,TN,Trousdale County,5789,5596,193,3.3
CN4717100000000,2023-02-01,47,171,TN,Unicoi County,7149,6810,339,4.7
CN4717300000000,2023-02-01,47,173,TN,Union County,7861,7535,326,4.1
CN4717500000000,2023-02-01,47,175,TN,Van Buren County,2067,1967,100,4.8
CN4717700000000,2023-02-01,47,177,TN,Warren County,16330,15663,667,4.1
CN4717900000000,2023-02-01,47,179,TN,Washington County,61834,59674,2160,3.5
CN4718100000000,2023-02-01,47,181,TN,Wayne County,6500,6172,328,5
CN4718300000000,2023-02-01,47,183,TN,Weakley County,15353,14850,503,3.3
CN4718500000000,2023-02-01,47,185,TN,White County,11991,11517,474,4
CN4718700000000,2023-02-01,47,187,TN,Williamson County,138977,135405,3572,2.6
CN4718900000000,2023-02-01,47,189,TN,Wilson County,82785,80401,2384,2.9
CN4800100000000,2023-02-01,48,001,TX,Anderson County,23611,22636,975,4.1
CN4800300000000,2023-02-01,48,003,TX,Andrews County,9814,9480,334,3.4
CN4800500000000,2023-02-01,48,005,TX,Angelina County,36060,34199,1861,5.2
CN4800700000000,2023-02-01,48,007,TX,Aransas County,9439,8884,555,5.9
CN4800900000000,2023-02-01,48,009,TX,Archer County,4089,3922,167,4.1
CN4801100000000,2023-02-01,48,011,TX,Armstrong County,961,925,36,3.7
CN4801300000000,2023-02-01,48,013,TX,Atascosa County,23112,22078,1034,4.5
CN4801500000000,2023-02-01,48,015,TX,Austin County,14459,13814,645,4.5
CN4801700000000,2023-02-01,48,017,TX,Bailey County,2441,2309,132,5.4
CN4801900000000,2023-02-01,48,019,TX,Bandera County,10915,10445,470,4.3
CN4802100000000,2023-02-01,48,021,TX,Bastrop County,49234,47317,1917,3.9
CN4802300000000,2023-02-01,48,023,TX,Baylor County,2001,1945,56,2.8
CN4802500000000,2023-02-01,48,025,TX,Bee County,9323,8754,569,6.1
CN4802700000000,2023-02-01,48,027,TX,Bell County,153246,144994,8252,5.4
CN4802900000000,2023-02-01,48,029,TX,Bexar County,1006868,963484,43384,4.3
CN4803100000000,2023-02-01,48,031,TX,Blanco County,7271,7024,247,3.4
CN4803300000000,2023-02-01,48,033,TX,Borden County,797,782,15,1.9
CN4803500000000,2023-02-01,48,035,TX,Bosque County,8832,8457,375,4.2
CN4803700000000,2023-02-01,48,037,TX,Bowie County,38940,36991,1949,5
CN4803900000000,2023-02-01,48,039,TX,Brazoria County,188759,179466,9293,4.9
CN4804100000000,2023-02-01,48,041,TX,Brazos County,133953,129008,4945,3.7
CN4804300000000,2023-02-01,48,043,TX,Brewster County,4365,4192,173,4
CN4804500000000,2023-02-01,48,045,TX,Briscoe County,614,588,26,4.2
CN4804700000000,2023-02-01,48,047,TX,Brooks County,2412,2268,144,6
CN4804900000000,2023-02-01,48,049,TX,Brown County,15562,14796,766,4.9
CN4805100000000,2023-02-01,48,051,TX,Burleson County,9219,8831,388,4.2
CN4805300000000,2023-02-01,48,053,TX,Burnet County,26398,25424,974,3.7
CN4805500000000,2023-02-01,48,055,TX,Caldwell County,21789,20882,907,4.2
CN4805700000000,2023-02-01,48,057,TX,Calhoun County,12564,12097,467,3.7
CN4805900000000,2023-02-01,48,059,TX,Callahan County,6400,6132,268,4.2
CN4806100000000,2023-02-01,48,061,TX,Cameron County,181587,170140,11447,6.3
CN4806300000000,2023-02-01,48,063,TX,Camp County,5214,4941,273,5.2
CN4806500000000,2023-02-01,48,065,TX,Carson County,3080,2965,115,3.7
CN4806700000000,2023-02-01,48,067,TX,Cass County,11992,11334,658,5.5
CN4806900000000,2023-02-01,48,069,TX,Castro County,3373,3246,127,3.8
CN4807100000000,2023-02-01,48,071,TX,Chambers County,21525,20277,1248,5.8
CN4807300000000,2023-02-01,48,073,TX,Cherokee County,20653,19573,1080,5.2
CN4807500000000,2023-02-01,48,075,TX,Childress County,3284,3178,106,3.2
CN4807700000000,2023-02-01,48,077,TX,Clay County,4956,4735,221,4.5
CN4807900000000,2023-02-01,48,079,TX,Cochran County,1155,1096,59,5.1
CN4808100000000,2023-02-01,48,081,TX,Coke County,1615,1551,64,4
CN4808300000000,2023-02-01,48,083,TX,Coleman County,3120,2953,167,5.4
CN4808500000000,2023-02-01,48,085,TX,Collin County,645330,620439,24891,3.9
CN4808700000000,2023-02-01,48,087,TX,Collingsworth County,1087,1040,47,4.3
CN4808900000000,2023-02-01,48,089,TX,Colorado County,10355,9932,423,4.1
CN4809100000000,2023-02-01,48,091,TX,Comal County,84561,81081,3480,4.1
CN4809300000000,2023-02-01,48,093,TX,Comanche County,6620,6352,268,4
CN4809500000000,2023-02-01,48,095,TX,Concho County,1332,1279,53,4
CN4809700000000,2023-02-01,48,097,TX,Cooke County,20529,19737,792,3.9
CN4809900000000,2023-02-01,48,099,TX,Coryell County,25278,23948,1330,5.3
CN4810100000000,2023-02-01,48,101,TX,Cottle County,1004,975,29,2.9
CN4810300000000,2023-02-01,48,103,TX,Crane County,1723,1629,94,5.5
CN4810500000000,2023-02-01,48,105,TX,Crockett County,1439,1378,61,4.2
CN4810700000000,2023-02-01,48,107,TX,Crosby County,2480,2363,117,4.7
CN4810900000000,2023-02-01,48,109,TX,Culberson County,1229,1185,44,3.6
CN4811100000000,2023-02-01,48,111,TX,Dallam County,3899,3779,120,3.1
CN4811300000000,2023-02-01,48,113,TX,Dallas County,1463963,1401295,62668,4.3
CN4811500000000,2023-02-01,48,115,TX,Dawson County,4665,4431,234,5
CN4811700000000,2023-02-01,48,117,TX,Deaf Smith County,9289,8954,335,3.6
CN4811900000000,2023-02-01,48,119,TX,Delta County,2608,2465,143,5.5
CN4812100000000,2023-02-01,48,121,TX,Denton County,569048,547157,21891,3.8
CN4812300000000,2023-02-01,48,123,TX,DeWitt County,9201,8851,350,3.8
CN4812500000000,2023-02-01,48,125,TX,Dickens County,715,676,39,5.5
CN4812700000000,2023-02-01,48,127,TX,Dimmit County,6150,5894,256,4.2
CN4812900000000,2023-02-01,48,129,TX,Donley County,1514,1449,65,4.3
CN4813100000000,2023-02-01,48,131,TX,Duval County,5142,4908,234,4.6
CN4813300000000,2023-02-01,48,133,TX,Eastland County,6696,6331,365,5.5
CN4813500000000,2023-02-01,48,135,TX,Ector County,86375,82970,3405,3.9
CN4813700000000,2023-02-01,48,137,TX,Edwards County,1152,1119,33,2.9
CN4813900000000,2023-02-01,48,139,TX,Ellis County,106591,102149,4442,4.2
CN4814100000000,2023-02-01,48,141,TX,El Paso County,379070,359927,19143,5
CN4814300000000,2023-02-01,48,143,TX,Erath County,22243,21313,930,4.2
CN4814500000000,2023-02-01,48,145,TX,Falls County,7045,6704,341,4.8
CN4814700000000,2023-02-01,48,147,TX,Fannin County,17910,17076,834,4.7
CN4814900000000,2023-02-01,48,149,TX,Fayette County,12102,11620,482,4
CN4815100000000,2023-02-01,48,151,TX,Fisher County,1669,1598,71,4.3
CN4815300000000,2023-02-01,48,153,TX,Floyd County,2459,2327,132,5.4
CN4815500000000,2023-02-01,48,155,TX,Foard County,553,530,23,4.2
CN4815700000000,2023-02-01,48,157,TX,Fort Bend County,429046,409614,19432,4.5
CN4815900000000,2023-02-01,48,159,TX,Franklin County,5509,5291,218,4
CN4816100000000,2023-02-01,48,161,TX,Freestone County,6436,6040,396,6.2
CN4816300000000,2023-02-01,48,163,TX,Frio County,9535,9174,361,3.8
CN4816500000000,2023-02-01,48,165,TX,Gaines County,10485,10109,376,3.6
CN4816700000000,2023-02-01,48,167,TX,Galveston County,173071,164627,8444,4.9
CN4816900000000,2023-02-01,48,169,TX,Garza County,1980,1897,83,4.2
CN4817100000000,2023-02-01,48,171,TX,Gillespie County,14993,14529,464,3.1
CN4817300000000,2023-02-01,48,173,TX,Glasscock County,934,908,26,2.8
CN4817500000000,2023-02-01,48,175,TX,Goliad County,3233,3083,150,4.6
CN4817700000000,2023-02-01,48,177,TX,Gonzales County,9699,9309,390,4
CN4817900000000,2023-02-01,48,179,TX,Gray County,7825,7434,391,5
CN4818100000000,2023-02-01,48,181,TX,Grayson County,67738,64741,2997,4.4
CN4818300000000,2023-02-01,48,183,TX,Gregg County,58107,55310,2797,4.8
CN4818500000000,2023-02-01,48,185,TX,Grimes County,11789,11216,573,4.9
CN4818700000000,2023-02-01,48,187,TX,Guadalupe County,88086,84624,3462,3.9
CN4818900000000,2023-02-01,48,189,TX,Hale County,11662,11016,646,5.5
CN4819100000000,2023-02-01,48,191,TX,Hall County,1088,1035,53,4.9
CN4819300000000,2023-02-01,48,193,TX,Hamilton County,4009,3844,165,4.1
CN4819500000000,2023-02-01,48,195,TX,Hansford County,2929,2840,89,3
CN4819700000000,2023-02-01,48,197,TX,Hardeman County,1817,1743,74,4.1
CN4819900000000,2023-02-01,48,199,TX,Hardin County,25527,24098,1429,5.6
CN4820100000000,2023-02-01,48,201,TX,Harris County,2395602,2281028,114574,4.8
CN4820300000000,2023-02-01,48,203,TX,Harrison County,29525,28011,1514,5.1
CN4820500000000,2023-02-01,48,205,TX,Hartley County,2613,2546,67,2.6
CN4820700000000,2023-02-01,48,207,TX,Haskell County,2831,2726,105,3.7
CN4820900000000,2023-02-01,48,209,TX,Hays County,141950,136610,5340,3.8
CN4821100000000,2023-02-01,48,211,TX,Hemphill County,1639,1569,70,4.3
CN4821300000000,2023-02-01,48,213,TX,Henderson County,39877,37819,2058,5.2
CN4821500000000,2023-02-01,48,215,TX,Hidalgo County,382726,356631,26095,6.8
CN4821700000000,2023-02-01,48,217,TX,Hill County,18670,17739,931,5
CN4821900000000,2023-02-01,48,219,TX,Hockley County,10961,10492,469,4.3
CN4822100000000,2023-02-01,48,221,TX,Hood County,30733,29391,1342,4.4
CN4822300000000,2023-02-01,48,223,TX,Hopkins County,19098,18177,921,4.8
CN4822500000000,2023-02-01,48,225,TX,Houston County,10682,10282,400,3.7
CN4822700000000,2023-02-01,48,227,TX,Howard County,13089,12431,658,5
CN4822900000000,2023-02-01,48,229,TX,Hudspeth County,1937,1844,93,4.8
CN4823100000000,2023-02-01,48,231,TX,Hunt County,48365,46067,2298,4.8
CN4823300000000,2023-02-01,48,233,TX,Hutchinson County,8515,8083,432,5.1
CN4823500000000,2023-02-01,48,235,TX,Irion County,811,778,33,4.1
CN4823700000000,2023-02-01,48,237,TX,Jack County,3498,3357,141,4
CN4823900000000,2023-02-01,48,239,TX,Jackson County,7157,6873,284,4
CN4824100000000,2023-02-01,48,241,TX,Jasper County,12953,12076,877,6.8
CN4824300000000,2023-02-01,48,243,TX,Jeff Davis County,994,955,39,3.9
CN4824500000000,2023-02-01,48,245,TX,Jefferson County,103824,96742,7082,6.8
CN4824700000000,2023-02-01,48,247,TX,Jim Hogg County,1799,1702,97,5.4
CN4824900000000,2023-02-01,48,249,TX,Jim Wells County,15835,14889,946,6
CN4825100000000,2023-02-01,48,251,TX,Johnson County,91576,87844,3732,4.1
CN4825300000000,2023-02-01,48,253,TX,Jones County,5976,5662,314,5.3
CN4825500000000,2023-02-01,48,255,TX,Karnes County,6830,6572,258,3.8
CN4825700000000,2023-02-01,48,257,TX,Kaufman County,77556,74104,3452,4.5
CN4825900000000,2023-02-01,48,259,TX,Kendall County,24451,23477,974,4
CN4826100000000,2023-02-01,48,261,TX,Kenedy County,135,124,11,8.1
CN4826300000000,2023-02-01,48,263,TX,Kent County,712,695,17,2.4
CN4826500000000,2023-02-01,48,265,TX,Kerr County,22634,21665,969,4.3
CN4826700000000,2023-02-01,48,267,TX,Kimble County,1808,1731,77,4.3
CN4826900000000,2023-02-01,48,269,TX,King County,608,602,6,1
CN4827100000000,2023-02-01,48,271,TX,Kinney County,1261,1188,73,5.8
CN4827300000000,2023-02-01,48,273,TX,Kleberg County,13413,12677,736,5.5
CN4827500000000,2023-02-01,48,275,TX,Knox County,1525,1463,62,4.1
CN4827700000000,2023-02-01,48,277,TX,Lamar County,24769,23507,1262,5.1
CN4827900000000,2023-02-01,48,279,TX,Lamb County,5342,5092,250,4.7
CN4828100000000,2023-02-01,48,281,TX,Lampasas County,9640,9215,425,4.4
CN4828300000000,2023-02-01,48,283,TX,La Salle County,4283,4162,121,2.8
CN4828500000000,2023-02-01,48,285,TX,Lavaca County,9241,8877,364,3.9
CN4828700000000,2023-02-01,48,287,TX,Lee County,8409,8068,341,4.1
CN4828900000000,2023-02-01,48,289,TX,Leon County,6106,5741,365,6
CN4829100000000,2023-02-01,48,291,TX,Liberty County,36060,33837,2223,6.2
CN4829300000000,2023-02-01,48,293,TX,Limestone County,8486,8036,450,5.3
CN4829500000000,2023-02-01,48,295,TX,Lipscomb County,1460,1405,55,3.8
CN4829700000000,2023-02-01,48,297,TX,Live Oak County,4876,4649,227,4.7
CN4829900000000,2023-02-01,48,299,TX,Llano County,9386,8964,422,4.5
CN4830100000000,2023-02-01,48,301,TX,Loving County,1420,1414,6,0.4
CN4830300000000,2023-02-01,48,303,TX,Lubbock County,166876,160391,6485,3.9
CN4830500000000,2023-02-01,48,305,TX,Lynn County,2932,2817,115,3.9
CN4830700000000,2023-02-01,48,307,TX,McCulloch County,3182,3030,152,4.8
CN4830900000000,2023-02-01,48,309,TX,McLennan County,130760,124921,5839,4.5
CN4831100000000,2023-02-01,48,311,TX,McMullen County,886,871,15,1.7
CN4831300000000,2023-02-01,48,313,TX,Madison County,4828,4581,247,5.1
CN4831500000000,2023-02-01,48,315,TX,Marion County,4195,3964,231,5.5
CN4831700000000,2023-02-01,48,317,TX,Martin County,2938,2844,94,3.2
CN4831900000000,2023-02-01,48,319,TX,Mason County,1848,1774,74,4
CN4832100000000,2023-02-01,48,321,TX,Matagorda County,17766,16685,1081,6.1
CN4832300000000,2023-02-01,48,323,TX,Maverick County,24261,21877,2384,9.8
CN4832500000000,2023-02-01,48,325,TX,Medina County,23342,22311,1031,4.4
CN4832700000000,2023-02-01,48,327,TX,Menard County,852,816,36,4.2
CN4832900000000,2023-02-01,48,329,TX,Midland County,111541,108212,3329,3
CN4833100000000,2023-02-01,48,331,TX,Milam County,10371,9837,534,5.1
CN4833300000000,2023-02-01,48,333,TX,Mills County,1942,1846,96,4.9
CN4833500000000,2023-02-01,48,335,TX,Mitchell County,2320,2211,109,4.7
CN4833700000000,2023-02-01,48,337,TX,Montague County,9372,8959,413,4.4
CN4833900000000,2023-02-01,48,339,TX,Montgomery County,309325,295209,14116,4.6
CN4834100000000,2023-02-01,48,341,TX,Moore County,11580,11211,369,3.2
CN4834300000000,2023-02-01,48,343,TX,Morris County,4541,4247,294,6.5
CN4834500000000,2023-02-01,48,345,TX,Motley County,542,516,26,4.8
CN4834700000000,2023-02-01,48,347,TX,Nacogdoches County,28657,27209,1448,5.1
CN4834900000000,2023-02-01,48,349,TX,Navarro County,23764,22668,1096,4.6
CN4835100000000,2023-02-01,48,351,TX,Newton County,5015,4642,373,7.4
CN4835300000000,2023-02-01,48,353,TX,Nolan County,6849,6562,287,4.2
CN4835500000000,2023-02-01,48,355,TX,Nueces County,166299,158003,8296,5
CN4835700000000,2023-02-01,48,357,TX,Ochiltree County,3897,3735,162,4.2
CN4835900000000,2023-02-01,48,359,TX,Oldham County,960,925,35,3.6
CN4836100000000,2023-02-01,48,361,TX,Orange County,35724,33514,2210,6.2
CN4836300000000,2023-02-01,48,363,TX,Palo Pinto County,13325,12740,585,4.4
CN4836500000000,2023-02-01,48,365,TX,Panola County,9758,9276,482,4.9
CN4836700000000,2023-02-01,48,367,TX,Parker County,76743,73743,3000,3.9
CN4836900000000,2023-02-01,48,369,TX,Parmer County,5265,5101,164,3.1
CN4837100000000,2023-02-01,48,371,TX,Pecos County,6331,6053,278,4.4
CN4837300000000,2023-02-01,48,373,TX,Polk County,19211,18031,1180,6.1
CN4837500000000,2023-02-01,48,375,TX,Potter County,56035,53983,2052,3.7
CN4837700000000,2023-02-01,48,377,TX,Presidio County,3120,2914,206,6.6
CN4837900000000,2023-02-01,48,379,TX,Rains County,6714,6424,290,4.3
CN4838100000000,2023-02-01,48,381,TX,Randall County,77610,74953,2657,3.4
CN4838300000000,2023-02-01,48,383,TX,Reagan County,1630,1566,64,3.9
CN4838500000000,2023-02-01,48,385,TX,Real County,1138,1071,67,5.9
CN4838700000000,2023-02-01,48,387,TX,Red River County,5086,4799,287,5.6
CN4838900000000,2023-02-01,48,389,TX,Reeves County,8533,8222,311,3.6
CN4839100000000,2023-02-01,48,391,TX,Refugio County,2942,2801,141,4.8
CN4839300000000,2023-02-01,48,393,TX,Roberts County,398,383,15,3.8
CN4839500000000,2023-02-01,48,395,TX,Robertson County,8293,7932,361,4.4
CN4839700000000,2023-02-01,48,397,TX,Rockwall County,61118,58646,2472,4
CN4839900000000,2023-02-01,48,399,TX,Runnels County,4809,4589,220,4.6
CN4840100000000,2023-02-01,48,401,TX,Rusk County,22874,21791,1083,4.7
CN4840300000000,2023-02-01,48,403,TX,Sabine County,3965,3680,285,7.2
CN4840500000000,2023-02-01,48,405,TX,San Augustine County,3210,3016,194,6
CN4840700000000,2023-02-01,48,407,TX,San Jacinto County,12255,11576,679,5.5
CN4840900000000,2023-02-01,48,409,TX,San Patricio County,29528,27837,1691,5.7
CN4841100000000,2023-02-01,48,411,TX,San Saba County,2278,2182,96,4.2
CN4841300000000,2023-02-01,48,413,TX,Schleicher County,1278,1226,52,4.1
CN4841500000000,2023-02-01,48,415,TX,Scurry County,6474,6175,299,4.6
CN4841700000000,2023-02-01,48,417,TX,Shackelford County,1844,1782,62,3.4
CN4841900000000,2023-02-01,48,419,TX,Shelby County,11250,10756,494,4.4
CN4842100000000,2023-02-01,48,421,TX,Sherman County,1410,1358,52,3.7
CN4842300000000,2023-02-01,48,423,TX,Smith County,114080,109180,4900,4.3
CN4842500000000,2023-02-01,48,425,TX,Somervell County,4695,4493,202,4.3
CN4842700000000,2023-02-01,48,427,TX,Starr County,25062,22173,2889,11.5
CN4842900000000,2023-02-01,48,429,TX,Stephens County,4191,4007,184,4.4
CN4843100000000,2023-02-01,48,431,TX,Sterling County,531,505,26,4.9
CN4843300000000,2023-02-01,48,433,TX,Stonewall County,784,760,24,3.1
CN4843500000000,2023-02-01,48,435,TX,Sutton County,981,910,71,7.2
CN4843700000000,2023-02-01,48,437,TX,Swisher County,2617,2473,144,5.5
CN4843900000000,2023-02-01,48,439,TX,Tarrant County,1172684,1123980,48704,4.2
CN4844100000000,2023-02-01,48,441,TX,Taylor County,70392,67547,2845,4
CN4844300000000,2023-02-01,48,443,TX,Terrell County,420,405,15,3.6
CN4844500000000,2023-02-01,48,445,TX,Terry County,4689,4465,224,4.8
CN4844700000000,2023-02-01,48,447,TX,Throckmorton County,661,635,26,3.9
CN4844900000000,2023-02-01,48,449,TX,Titus County,14191,13504,687,4.8
CN4845100000000,2023-02-01,48,451,TX,Tom Green County,57079,54781,2298,4
CN4845300000000,2023-02-01,48,453,TX,Travis County,842762,812348,30414,3.6
CN4845500000000,2023-02-01,48,455,TX,Trinity County,5472,5157,315,5.8
CN4845700000000,2023-02-01,48,457,TX,Tyler County,7250,6747,503,6.9
CN4845900000000,2023-02-01,48,459,TX,Upshur County,18192,17306,886,4.9
CN4846100000000,2023-02-01,48,461,TX,Upton County,2389,2318,71,3
CN4846300000000,2023-02-01,48,463,TX,Uvalde County,11360,10775,585,5.1
CN4846500000000,2023-02-01,48,465,TX,Val Verde County,22736,21185,1551,6.8
CN4846700000000,2023-02-01,48,467,TX,Van Zandt County,28472,27297,1175,4.1
CN4846900000000,2023-02-01,48,469,TX,Victoria County,41938,39979,1959,4.7
CN4847100000000,2023-02-01,48,471,TX,Walker County,24523,23202,1321,5.4
CN4847300000000,2023-02-01,48,473,TX,Waller County,26186,24810,1376,5.3
CN4847500000000,2023-02-01,48,475,TX,Ward County,6265,6030,235,3.8
CN4847700000000,2023-02-01,48,477,TX,Washington County,15432,14700,732,4.7
CN4847900000000,2023-02-01,48,479,TX,Webb County,119582,113769,5813,4.9
CN4848100000000,2023-02-01,48,481,TX,Wharton County,21818,20825,993,4.6
CN4848300000000,2023-02-01,48,483,TX,Wheeler County,1979,1883,96,4.9
CN4848500000000,2023-02-01,48,485,TX,Wichita County,56374,53846,2528,4.5
CN4848700000000,2023-02-01,48,487,TX,Wilbarger County,4849,4556,293,6
CN4848900000000,2023-02-01,48,489,TX,Willacy County,7534,6864,670,8.9
CN4849100000000,2023-02-01,48,491,TX,Williamson County,374179,359960,14219,3.8
CN4849300000000,2023-02-01,48,493,TX,Wilson County,26711,25699,1012,3.8
CN4849500000000,2023-02-01,48,495,TX,Winkler County,4278,4117,161,3.8
CN4849700000000,2023-02-01,48,497,TX,Wise County,35286,33819,1467,4.2
CN4849900000000,2023-02-01,48,499,TX,Wood County,18663,17709,954,5.1
CN4850100000000,2023-02-01,48,501,TX,Yoakum County,3329,3179,150,4.5
CN4850300000000,2023-02-01,48,503,TX,Young County,8095,7769,326,4
CN4850500000000,2023-02-01,48,505,TX,Zapata County,4567,4218,349,7.6
CN4850700000000,2023-02-01,48,507,TX,Zavala County,3599,3290,309,8.6
CN4900100000000,2023-02-01,49,001,UT,Beaver County,3098,3004,94,3
CN4900300000000,2023-02-01,49,003,UT,Box Elder County,28338,27635,703,2.5
CN4900500000000,2023-02-01,49,005,UT,Cache County,73287,71698,1589,2.2
CN4900700000000,2023-02-01,49,007,UT,Carbon County,8469,8158,311,3.7
CN4900900000000,2023-02-01,49,009,UT,Daggett County,363,341,22,6.1
CN4901100000000,2023-02-01,49,011,UT,Davis County,186210,181917,4293,2.3
CN4901300000000,2023-02-01,49,013,UT,Duchesne County,8298,8020,278,3.4
CN4901500000000,2023-02-01,49,015,UT,Emery County,4559,4393,166,3.6
CN4901700000000,2023-02-01,49,017,UT,Garfield County,2655,2325,330,12.4
CN4901900000000,2023-02-01,49,019,UT,Grand County,6678,6211,467,7
CN4902100000000,2023-02-01,49,021,UT,Iron County,29247,28486,761,2.6
CN4902300000000,2023-02-01,49,023,UT,Juab County,6552,6402,150,2.3
CN4902500000000,2023-02-01,49,025,UT,Kane County,4040,3888,152,3.8
CN4902700000000,2023-02-01,49,027,UT,Millard County,6721,6562,159,2.4
CN4902900000000,2023-02-01,49,029,UT,Morgan County,6038,5913,125,2.1
CN4903100000000,2023-02-01,49,031,UT,Piute County,535,507,28,5.2
CN4903300000000,2023-02-01,49,033,UT,Rich County,1113,1079,34,3.1
CN4903500000000,2023-02-01,49,035,UT,Salt Lake County,694200,676288,17912,2.6
CN4903700000000,2023-02-01,49,037,UT,San Juan County,5620,5332,288,5.1
CN4903900000000,2023-02-01,49,039,UT,Sanpete County,14348,13917,431,3
CN4904100000000,2023-02-01,49,041,UT,Sevier County,10668,10335,333,3.1
CN4904300000000,2023-02-01,49,043,UT,Summit County,28987,28452,535,1.8
CN4904500000000,2023-02-01,49,045,UT,Tooele County,39072,37978,1094,2.8
CN4904700000000,2023-02-01,49,047,UT,Uintah County,14757,14262,495,3.4
CN4904900000000,2023-02-01,49,049,UT,Utah County,352757,344263,8494,2.4
CN4905100000000,2023-02-01,49,051,UT,Wasatch County,18466,18050,416,2.3
CN4905300000000,2023-02-01,49,053,UT,Washington County,89232,86675,2557,2.9
CN4905500000000,2023-02-01,49,055,UT,Wayne County,1519,1415,104,6.8
CN4905700000000,2023-02-01,49,057,UT,Weber County,136947,133094,3853,2.8
CN5000100000000,2023-02-01,50,001,VT,Addison County,20734,20209,525,2.5
CN5000300000000,2023-02-01,50,003,VT,Bennington County,17583,16984,599,3.4
CN5000500000000,2023-02-01,50,005,VT,Caledonia County,14767,14223,544,3.7
CN5000700000000,2023-02-01,50,007,VT,Chittenden County,97906,95997,1909,1.9
CN5000900000000,2023-02-01,50,009,VT,Essex County,2668,2549,119,4.5
CN5001100000000,2023-02-01,50,011,VT,Franklin County,28077,27291,786,2.8
CN5001300000000,2023-02-01,50,013,VT,Grand Isle County,4184,4028,156,3.7
CN5001500000000,2023-02-01,50,015,VT,Lamoille County,14242,13726,516,3.6
CN5001700000000,2023-02-01,50,017,VT,Orange County,15801,15297,504,3.2
CN5001900000000,2023-02-01,50,019,VT,Orleans County,13667,12891,776,5.7
CN5002100000000,2023-02-01,50,021,VT,Rutland County,29853,28827,1026,3.4
CN5002300000000,2023-02-01,50,023,VT,Washington County,34321,33418,903,2.6
CN5002500000000,2023-02-01,50,025,VT,Windham County,21425,20839,586,2.7
CN5002700000000,2023-02-01,50,027,VT,Windsor County,30142,29490,652,2.2
CN5100100000000,2023-02-01,51,001,VA,Accomack County,15970,15253,717,4.5
CN5100300000000,2023-02-01,51,003,VA,Albemarle County,59863,58352,1511,2.5
CN5100500000000,2023-02-01,51,005,VA,Alleghany County,6909,6675,234,3.4
CN5100700000000,2023-02-01,51,007,VA,Amelia County,6393,6188,205,3.2
CN5100900000000,2023-02-01,51,009,VA,Amherst County,15168,14665,503,3.3
CN5101100000000,2023-02-01,51,011,VA,Appomattox County,7316,7035,281,3.8
CN5101300000000,2023-02-01,51,013,VA,Arlington County,160023,156652,3371,2.1
CN5101500000000,2023-02-01,51,015,VA,Augusta County,39124,38149,975,2.5
CN5101700000000,2023-02-01,51,017,VA,Bath County,2665,2591,74,2.8
CN5101900000000,2023-02-01,51,019,VA,Bedford County,39412,38261,1151,2.9
CN5102100000000,2023-02-01,51,021,VA,Bland County,2902,2821,81,2.8
CN5102300000000,2023-02-01,51,023,VA,Botetourt County,18130,17670,460,2.5
CN5102500000000,2023-02-01,51,025,VA,Brunswick County,6070,5765,305,5
CN5102700000000,2023-02-01,51,027,VA,Buchanan County,6497,6171,326,5
CN5102900000000,2023-02-01,51,029,VA,Buckingham County,6671,6366,305,4.6
CN5103100000000,2023-02-01,51,031,VA,Campbell County,26482,25572,910,3.4
CN5103300000000,2023-02-01,51,033,VA,Caroline County,15711,15158,553,3.5
CN5103500000000,2023-02-01,51,035,VA,Carroll County,13204,12742,462,3.5
CN5103600000000,2023-02-01,51,036,VA,Charles City County,3666,3530,136,3.7
CN5103700000000,2023-02-01,51,037,VA,Charlotte County,5697,5514,183,3.2
CN5104100000000,2023-02-01,51,041,VA,Chesterfield County,197919,192170,5749,2.9
CN5104300000000,2023-02-01,51,043,VA,Clarke County,7779,7584,195,2.5
CN5104500000000,2023-02-01,51,045,VA,Craig County,2385,2304,81,3.4
CN5104700000000,2023-02-01,51,047,VA,Culpeper County,26064,25313,751,2.9
CN5104900000000,2023-02-01,51,049,VA,Cumberland County,4965,4782,183,3.7
CN5105100000000,2023-02-01,51,051,VA,Dickenson County,4660,4453,207,4.4
CN5105300000000,2023-02-01,51,053,VA,Dinwiddie County,14085,13608,477,3.4
CN5105700000000,2023-02-01,51,057,VA,Essex County,5647,5449,198,3.5
CN5105900000000,2023-02-01,51,059,VA,Fairfax County,651739,635985,15754,2.4
CN5106100000000,2023-02-01,51,061,VA,Fauquier County,38299,37320,979,2.6
CN5106300000000,2023-02-01,51,063,VA,Floyd County,8730,8504,226,2.6
CN5106500000000,2023-02-01,51,065,VA,Fluvanna County,14717,14324,393,2.7
CN5106700000000,2023-02-01,51,067,VA,Franklin County,27201,26369,832,3.1
CN5106900000000,2023-02-01,51,069,VA,Frederick County,52489,51145,1344,2.6
CN5107100000000,2023-02-01,51,071,VA,Giles County,8410,8155,255,3
CN5107300000000,2023-02-01,51,073,VA,Gloucester County,19725,19184,541,2.7
CN5107500000000,2023-02-01,51,075,VA,Goochland County,12114,11761,353,2.9
CN5107700000000,2023-02-01,51,077,VA,Grayson County,8376,8166,210,2.5
CN5107900000000,2023-02-01,51,079,VA,Greene County,11013,10729,284,2.6
CN5108100000000,2023-02-01,51,081,VA,Greensville County,4446,4258,188,4.2
CN5108300000000,2023-02-01,51,083,VA,Halifax County,15799,15149,650,4.1
CN5108500000000,2023-02-01,51,085,VA,Hanover County,61232,59750,1482,2.4
CN5108700000000,2023-02-01,51,087,VA,Henrico County,189360,183918,5442,2.9
CN5108900000000,2023-02-01,51,089,VA,Henry County,24299,23434,865,3.6
CN5109100000000,2023-02-01,51,091,VA,Highland County,1485,1440,45,3
CN5109300000000,2023-02-01,51,093,VA,Isle of Wight County,19914,19349,565,2.8
CN5109500000000,2023-02-01,51,095,VA,James City County,37437,36398,1039,2.8
CN5109700000000,2023-02-01,51,097,VA,King and Queen County,4025,3923,102,2.5
CN5109900000000,2023-02-01,51,099,VA,King George County,14664,14257,407,2.8
CN5110100000000,2023-02-01,51,101,VA,King William County,9799,9515,284,2.9
CN5110300000000,2023-02-01,51,103,VA,Lancaster County,5591,5269,322,5.8
CN5110500000000,2023-02-01,51,105,VA,Lee County,8358,8022,336,4
CN5110700000000,2023-02-01,51,107,VA,Loudoun County,236679,230896,5783,2.4
CN5110900000000,2023-02-01,51,109,VA,Louisa County,21280,20696,584,2.7
CN5111100000000,2023-02-01,51,111,VA,Lunenburg County,5270,5084,186,3.5
CN5111300000000,2023-02-01,51,113,VA,Madison County,7682,7501,181,2.4
CN5111500000000,2023-02-01,51,115,VA,Mathews County,4138,4026,112,2.7
CN5111700000000,2023-02-01,51,117,VA,Mecklenburg County,13578,13078,500,3.7
CN5111900000000,2023-02-01,51,119,VA,Middlesex County,5418,5273,145,2.7
CN5112100000000,2023-02-01,51,121,VA,Montgomery County,53903,52495,1408,2.6
CN5112500000000,2023-02-01,51,125,VA,Nelson County,7604,7401,203,2.7
CN5112700000000,2023-02-01,51,127,VA,New Kent County,13534,13181,353,2.6
CN5113100000000,2023-02-01,51,131,VA,Northampton County,5497,5254,243,4.4
CN5113300000000,2023-02-01,51,133,VA,Northumberland County,5792,5413,379,6.5
CN5113500000000,2023-02-01,51,135,VA,Nottoway County,7363,7146,217,2.9
CN5113700000000,2023-02-01,51,137,VA,Orange County,17759,17209,550,3.1
CN5113900000000,2023-02-01,51,139,VA,Page County,12417,11852,565,4.6
CN5114100000000,2023-02-01,51,141,VA,Patrick County,7153,6889,264,3.7
CN5114300000000,2023-02-01,51,143,VA,Pittsylvania County,30736,29721,1015,3.3
CN5114500000000,2023-02-01,51,145,VA,Powhatan County,15038,14614,424,2.8
CN5114700000000,2023-02-01,51,147,VA,Prince Edward County,10352,9961,391,3.8
CN5114900000000,2023-02-01,51,149,VA,Prince George County,15692,15161,531,3.4
CN5115300000000,2023-02-01,51,153,VA,Prince William County,255754,248758,6996,2.7
CN5115500000000,2023-02-01,51,155,VA,Pulaski County,17283,16778,505,2.9
CN5115700000000,2023-02-01,51,157,VA,Rappahannock County,3802,3690,112,2.9
CN5115900000000,2023-02-01,51,159,VA,Richmond County,4082,3930,152,3.7
CN5116100000000,2023-02-01,51,161,VA,Roanoke County,51321,49963,1358,2.6
CN5116300000000,2023-02-01,51,163,VA,Rockbridge County,11245,10945,300,2.7
CN5116500000000,2023-02-01,51,165,VA,Rockingham County,44100,43021,1079,2.4
CN5116700000000,2023-02-01,51,167,VA,Russell County,11115,10677,438,3.9
CN5116900000000,2023-02-01,51,169,VA,Scott County,9514,9185,329,3.5
CN5117100000000,2023-02-01,51,171,VA,Shenandoah County,22305,21635,670,3
CN5117300000000,2023-02-01,51,173,VA,Smyth County,13530,13065,465,3.4
CN5117500000000,2023-02-01,51,175,VA,Southampton County,8850,8616,234,2.6
CN5117700000000,2023-02-01,51,177,VA,Spotsylvania County,70801,68642,2159,3
CN5117900000000,2023-02-01,51,179,VA,Stafford County,77021,74817,2204,2.9
CN5118100000000,2023-02-01,51,181,VA,Surry County,3655,3555,100,2.7
CN5118300000000,2023-02-01,51,183,VA,Sussex County,3699,3530,169,4.6
CN5118500000000,2023-02-01,51,185,VA,Tazewell County,15652,14975,677,4.3
CN5118700000000,2023-02-01,51,187,VA,Warren County,21215,20562,653,3.1
CN5119100000000,2023-02-01,51,191,VA,Washington County,27237,26429,808,3
CN5119300000000,2023-02-01,51,193,VA,Westmoreland County,9606,9263,343,3.6
CN5119500000000,2023-02-01,51,195,VA,Wise County,13112,12576,536,4.1
CN5119700000000,2023-02-01,51,197,VA,Wythe County,14374,13931,443,3.1
CN5119900000000,2023-02-01,51,199,VA,York County,33593,32678,915,2.7
CN5151000000000,2023-02-01,51,510,VA,Alexandria city,102786,100375,2411,2.3
CN5152000000000,2023-02-01,51,520,VA,Bristol city,7865,7589,276,3.5
CN5153000000000,2023-02-01,51,530,VA,Buena Vista city,3123,3035,88,2.8
CN5154000000000,2023-02-01,51,540,VA,Charlottesville city,26531,25881,650,2.4
CN5155000000000,2023-02-01,51,550,VA,Chesapeake city,125443,121745,3698,2.9
CN5157000000000,2023-02-01,51,570,VA,Colonial Heights city,8700,8436,264,3
CN5158000000000,2023-02-01,51,580,VA,Covington city,2361,2263,98,4.2
CN5159000000000,2023-02-01,51,590,VA,Danville city,18986,18057,929,4.9
CN5159500000000,2023-02-01,51,595,VA,Emporia city,2373,2261,112,4.7
CN5160000000000,2023-02-01,51,600,VA,Fairfax city,13187,12865,322,2.4
CN5161000000000,2023-02-01,51,610,VA,Falls Church city,8743,8552,191,2.2
CN5162000000000,2023-02-01,51,620,VA,Franklin city,3493,3343,150,4.3
CN5163000000000,2023-02-01,51,630,VA,Fredericksburg city,14660,14155,505,3.4
CN5164000000000,2023-02-01,51,640,VA,Galax city,2946,2839,107,3.6
CN5165000000000,2023-02-01,51,650,VA,Hampton city,65291,62706,2585,4
CN5166000000000,2023-02-01,51,660,VA,Harrisonburg city,25729,24902,827,3.2
CN5167000000000,2023-02-01,51,670,VA,Hopewell city,9859,9394,465,4.7
CN5167800000000,2023-02-01,51,678,VA,Lexington city,2423,2321,102,4.2
CN5168000000000,2023-02-01,51,680,VA,Lynchburg city,36488,35070,1418,3.9
CN5168300000000,2023-02-01,51,683,VA,Manassas city,22193,21607,586,2.6
CN5168500000000,2023-02-01,51,685,VA,Manassas Park city,10012,9755,257,2.6
CN5169000000000,2023-02-01,51,690,VA,Martinsville city,5712,5433,279,4.9
CN5170000000000,2023-02-01,51,700,VA,Newport News city,89475,86273,3202,3.6
CN5171000000000,2023-02-01,51,710,VA,Norfolk city,111573,107620,3953,3.5
CN5172000000000,2023-02-01,51,720,VA,Norton city,1636,1574,62,3.8
CN5173000000000,2023-02-01,51,730,VA,Petersburg city,12916,12156,760,5.9
CN5173500000000,2023-02-01,51,735,VA,Poquoson city,6428,6273,155,2.4
CN5174000000000,2023-02-01,51,740,VA,Portsmouth city,44628,42943,1685,3.8
CN5175000000000,2023-02-01,51,750,VA,Radford city,9299,9004,295,3.2
CN5176000000000,2023-02-01,51,760,VA,Richmond city,123575,119181,4394,3.6
CN5177000000000,2023-02-01,51,770,VA,Roanoke city,50534,48864,1670,3.3
CN5177500000000,2023-02-01,51,775,VA,Salem city,13265,12879,386,2.9
CN5179000000000,2023-02-01,51,790,VA,Staunton city,12767,12441,326,2.6
CN5180000000000,2023-02-01,51,800,VA,Suffolk city,46161,44689,1472,3.2
CN5181000000000,2023-02-01,51,810,VA,Virginia Beach city,235206,228437,6769,2.9
CN5182000000000,2023-02-01,51,820,VA,Waynesboro city,11114,10792,322,2.9
CN5183000000000,2023-02-01,51,830,VA,Williamsburg city,6894,6627,267,3.9
CN5184000000000,2023-02-01,51,840,VA,Winchester city,15365,14919,446,2.9
CN5300100000000,2023-02-01,53,001,WA,Adams County,9600,8833,767,8
CN5300300000000,2023-02-01,53,003,WA,Asotin County,10867,10321,546,5
CN5300500000000,2023-02-01,53,005,WA,Benton County,109230,101817,7413,6.8
CN5300700000000,2023-02-01,53,007,WA,Chelan County,44513,41410,3103,7
CN5300900000000,2023-02-01,53,009,WA,Clallam County,29592,27302,2290,7.7
CN5301100000000,2023-02-01,53,011,WA,Clark County,258217,242612,15605,6
CN5301300000000,2023-02-01,53,013,WA,Columbia County,1832,1698,134,7.3
CN5301500000000,2023-02-01,53,015,WA,Cowlitz County,50793,47138,3655,7.2
CN5301700000000,2023-02-01,53,017,WA,Douglas County,21712,20041,1671,7.7
CN5301900000000,2023-02-01,53,019,WA,Ferry County,2472,2123,349,14.1
CN5302100000000,2023-02-01,53,021,WA,Franklin County,44572,40586,3986,8.9
CN5302300000000,2023-02-01,53,023,WA,Garfield County,802,729,73,9.1
CN5302500000000,2023-02-01,53,025,WA,Grant County,48289,43930,4359,9
CN5302700000000,2023-02-01,53,027,WA,Grays Harbor County,30652,27875,2777,9.1
CN5302900000000,2023-02-01,53,029,WA,Island County,37685,35355,2330,6.2
CN5303100000000,2023-02-01,53,031,WA,Jefferson County,13155,12214,941,7.2
CN5303300000000,2023-02-01,53,033,WA,King County,1344987,1312522,32465,2.4
CN5303500000000,2023-02-01,53,035,WA,Kitsap County,133542,125794,7748,5.8
CN5303700000000,2023-02-01,53,037,WA,Kittitas County,23244,21277,1967,8.5
CN5303900000000,2023-02-01,53,039,WA,Klickitat County,10177,9378,799,7.9
CN5304100000000,2023-02-01,53,041,WA,Lewis County,35950,33108,2842,7.9
CN5304300000000,2023-02-01,53,043,WA,Lincoln County,4869,4488,381,7.8
CN5304500000000,2023-02-01,53,045,WA,Mason County,26254,24124,2130,8.1
CN5304700000000,2023-02-01,53,047,WA,Okanogan County,19386,17542,1844,9.5
CN5304900000000,2023-02-01,53,049,WA,Pacific County,8917,8175,742,8.3
CN5305100000000,2023-02-01,53,051,WA,Pend Oreille County,5405,4894,511,9.5
CN5305300000000,2023-02-01,53,053,WA,Pierce County,470505,439529,30976,6.6
CN5305500000000,2023-02-01,53,055,WA,San Juan County,8955,8493,462,5.2
CN5305700000000,2023-02-01,53,057,WA,Skagit County,63208,59007,4201,6.6
CN5305900000000,2023-02-01,53,059,WA,Skamania County,5813,5383,430,7.4
CN5306100000000,2023-02-01,53,061,WA,Snohomish County,457487,445691,11796,2.6
CN5306300000000,2023-02-01,53,063,WA,Spokane County,272957,255325,17632,6.5
CN5306500000000,2023-02-01,53,065,WA,Stevens County,20177,18210,1967,9.7
CN5306700000000,2023-02-01,53,067,WA,Thurston County,155986,146810,9176,5.9
CN5306900000000,2023-02-01,53,069,WA,Wahkiakum County,1438,1314,124,8.6
CN5307100000000,2023-02-01,53,071,WA,Walla Walla County,31217,29278,1939,6.2
CN5307300000000,2023-02-01,53,073,WA,Whatcom County,118561,111229,7332,6.2
CN5307500000000,2023-02-01,53,075,WA,Whitman County,24236,22776,1460,6
CN5307700000000,2023-02-01,53,077,WA,Yakima County,131592,119323,12269,9.3
CN5400100000000,2023-02-01,54,001,WV,Barbour County,7369,7048,321,4.4
CN5400300000000,2023-02-01,54,003,WV,Berkeley County,58654,56960,1694,2.9
CN5400500000000,2023-02-01,54,005,WV,Boone County,6864,6616,248,3.6
CN5400700000000,2023-02-01,54,007,WV,Braxton County,4930,4636,294,6
CN5400900000000,2023-02-01,54,009,WV,Brooke County,9761,9318,443,4.5
CN5401100000000,2023-02-01,54,011,WV,Cabell County,41083,39809,1274,3.1
CN5401300000000,2023-02-01,54,013,WV,Calhoun County,2521,2280,241,9.6
CN5401500000000,2023-02-01,54,015,WV,Clay County,2931,2737,194,6.6
CN5401700000000,2023-02-01,54,017,WV,Doddridge County,3860,3737,123,3.2
CN5401900000000,2023-02-01,54,019,WV,Fayette County,15545,14868,677,4.4
CN5402100000000,2023-02-01,54,021,WV,Gilmer County,2351,2228,123,5.2
CN5402300000000,2023-02-01,54,023,WV,Grant County,5951,5738,213,3.6
CN5402500000000,2023-02-01,54,025,WV,Greenbrier County,15013,14436,577,3.8
CN5402700000000,2023-02-01,54,027,WV,Hampshire County,11257,10978,279,2.5
CN5402900000000,2023-02-01,54,029,WV,Hancock County,12988,12244,744,5.7
CN5403100000000,2023-02-01,54,031,WV,Hardy County,5729,5479,250,4.4
CN5403300000000,2023-02-01,54,033,WV,Harrison County,33076,31995,1081,3.3
CN5403500000000,2023-02-01,54,035,WV,Jackson County,11539,11019,520,4.5
CN5403700000000,2023-02-01,54,037,WV,Jefferson County,30329,29649,680,2.2
CN5403900000000,2023-02-01,54,039,WV,Kanawha County,77889,75238,2651,3.4
CN5404100000000,2023-02-01,54,041,WV,Lewis County,6356,6054,302,4.8
CN5404300000000,2023-02-01,54,043,WV,Lincoln County,6988,6669,319,4.6
CN5404500000000,2023-02-01,54,045,WV,Logan County,10729,10351,378,3.5
CN5404700000000,2023-02-01,54,047,WV,McDowell County,4054,3832,222,5.5
CN5404900000000,2023-02-01,54,049,WV,Marion County,25193,24275,918,3.6
CN5405100000000,2023-02-01,54,051,WV,Marshall County,12776,12022,754,5.9
CN5405300000000,2023-02-01,54,053,WV,Mason County,10511,10090,421,4
CN5405500000000,2023-02-01,54,055,WV,Mercer County,20496,19713,783,3.8
CN5405700000000,2023-02-01,54,057,WV,Mineral County,12490,12052,438,3.5
CN5405900000000,2023-02-01,54,059,WV,Mingo County,6470,6189,281,4.3
CN5406100000000,2023-02-01,54,061,WV,Monongalia County,54883,53439,1444,2.6
CN5406300000000,2023-02-01,54,063,WV,Monroe County,6179,6020,159,2.6
CN5406500000000,2023-02-01,54,065,WV,Morgan County,8380,8142,238,2.8
CN5406700000000,2023-02-01,54,067,WV,Nicholas County,8758,8368,390,4.5
CN5406900000000,2023-02-01,54,069,WV,Ohio County,19233,18504,729,3.8
CN5407100000000,2023-02-01,54,071,WV,Pendleton County,3792,3698,94,2.5
CN5407300000000,2023-02-01,54,073,WV,Pleasants County,2710,2540,170,6.3
CN5407500000000,2023-02-01,54,075,WV,Pocahontas County,4301,4158,143,3.3
CN5407700000000,2023-02-01,54,077,WV,Preston County,15564,14927,637,4.1
CN5407900000000,2023-02-01,54,079,WV,Putnam County,26763,25978,785,2.9
CN5408100000000,2023-02-01,54,081,WV,Raleigh County,29288,28277,1011,3.5
CN5408300000000,2023-02-01,54,083,WV,Randolph County,11707,11158,549,4.7
CN5408500000000,2023-02-01,54,085,WV,Ritchie County,4212,4037,175,4.2
CN5408700000000,2023-02-01,54,087,WV,Roane County,4832,4500,332,6.9
CN5408900000000,2023-02-01,54,089,WV,Summers County,4643,4490,153,3.3
CN5409100000000,2023-02-01,54,091,WV,Taylor County,7838,7536,302,3.9
CN5409300000000,2023-02-01,54,093,WV,Tucker County,3429,3316,113,3.3
CN5409500000000,2023-02-01,54,095,WV,Tyler County,2917,2743,174,6
CN5409700000000,2023-02-01,54,097,WV,Upshur County,9636,9221,415,4.3
CN5409900000000,2023-02-01,54,099,WV,Wayne County,15478,14892,586,3.8
CN5410100000000,2023-02-01,54,101,WV,Webster County,3015,2886,129,4.3
CN5410300000000,2023-02-01,54,103,WV,Wetzel County,6485,6029,456,7
CN5410500000000,2023-02-01,54,105,WV,Wirt County,2251,2099,152,6.8
CN5410700000000,2023-02-01,54,107,WV,Wood County,35996,34469,1527,4.2
CN5410900000000,2023-02-01,54,109,WV,Wyoming County,7160,6898,262,3.7
CN5500100000000,2023-02-01,55,001,WI,Adams County,7574,7089,485,6.4
CN5500300000000,2023-02-01,55,003,WI,Ashland County,7178,6918,260,3.6
CN5500500000000,2023-02-01,55,005,WI,Barron County,23579,22576,1003,4.3
CN5500700000000,2023-02-01,55,007,WI,Bayfield County,7177,6804,373,5.2
CN5500900000000,2023-02-01,55,009,WI,Brown County,141380,138090,3290,2.3
CN5501100000000,2023-02-01,55,011,WI,Buffalo County,6232,5912,320,5.1
CN5501300000000,2023-02-01,55,013,WI,Burnett County,7099,6671,428,6
CN5501500000000,2023-02-01,55,015,WI,Calumet County,27615,27107,508,1.8
CN5501700000000,2023-02-01,55,017,WI,Chippewa County,34036,32652,1384,4.1
CN5501900000000,2023-02-01,55,019,WI,Clark County,17632,17140,492,2.8
CN5502100000000,2023-02-01,55,021,WI,Columbia County,32148,31367,781,2.4
CN5502300000000,2023-02-01,55,023,WI,Crawford County,6894,6555,339,4.9
CN5502500000000,2023-02-01,55,025,WI,Dane County,332001,326217,5784,1.7
CN5502700000000,2023-02-01,55,027,WI,Dodge County,46856,45651,1205,2.6
CN5502900000000,2023-02-01,55,029,WI,Door County,13705,13178,527,3.8
CN5503100000000,2023-02-01,55,031,WI,Douglas County,22878,21833,1045,4.6
CN5503300000000,2023-02-01,55,033,WI,Dunn County,24561,23781,780,3.2
CN5503500000000,2023-02-01,55,035,WI,Eau Claire County,59621,58231,1390,2.3
CN5503700000000,2023-02-01,55,037,WI,Florence County,2096,2022,74,3.5
CN5503900000000,2023-02-01,55,039,WI,Fond du Lac County,56304,55024,1280,2.3
CN5504100000000,2023-02-01,55,041,WI,Forest County,3901,3703,198,5.1
CN5504300000000,2023-02-01,55,043,WI,Grant County,27527,26727,800,2.9
CN5504500000000,2023-02-01,55,045,WI,Green County,21181,20665,516,2.4
CN5504700000000,2023-02-01,55,047,WI,Green Lake County,8868,8569,299,3.4
CN5504900000000,2023-02-01,55,049,WI,Iowa County,13931,13535,396,2.8
CN5505100000000,2023-02-01,55,051,WI,Iron County,2529,2390,139,5.5
CN5505300000000,2023-02-01,55,053,WI,Jackson County,9337,8929,408,4.4
CN5505500000000,2023-02-01,55,055,WI,Jefferson County,45833,44604,1229,2.7
CN5505700000000,2023-02-01,55,057,WI,Juneau County,13203,12744,459,3.5
CN5505900000000,2023-02-01,55,059,WI,Kenosha County,88355,85569,2786,3.2
CN5506100000000,2023-02-01,55,061,WI,Kewaunee County,10958,10708,250,2.3
CN5506300000000,2023-02-01,55,063,WI,La Crosse County,67001,65507,1494,2.2
CN5506500000000,2023-02-01,55,065,WI,Lafayette County,10272,9990,282,2.7
CN5506700000000,2023-02-01,55,067,WI,Langlade County,9267,8935,332,3.6
CN5506900000000,2023-02-01,55,069,WI,Lincoln County,14669,14222,447,3
CN5507100000000,2023-02-01,55,071,WI,Manitowoc County,39711,38589,1122,2.8
CN5507300000000,2023-02-01,55,073,WI,Marathon County,72928,71271,1657,2.3
CN5507500000000,2023-02-01,55,075,WI,Marinette County,18679,17968,711,3.8
CN5507700000000,2023-02-01,55,077,WI,Marquette County,7647,7299,348,4.6
CN5507800000000,2023-02-01,55,078,WI,Menominee County,1473,1414,59,4
CN5507900000000,2023-02-01,55,079,WI,Milwaukee County,450378,436269,14109,3.1
CN5508100000000,2023-02-01,55,081,WI,Monroe County,23056,22483,573,2.5
CN5508300000000,2023-02-01,55,083,WI,Oconto County,20886,20179,707,3.4
CN5508500000000,2023-02-01,55,085,WI,Oneida County,17394,16714,680,3.9
CN5508700000000,2023-02-01,55,087,WI,Outagamie County,104031,101852,2179,2.1
CN5508900000000,2023-02-01,55,089,WI,Ozaukee County,48187,47180,1007,2.1
CN5509100000000,2023-02-01,55,091,WI,Pepin County,4016,3834,182,4.5
CN5509300000000,2023-02-01,55,093,WI,Pierce County,24705,23748,957,3.9
CN5509500000000,2023-02-01,55,095,WI,Polk County,24811,23489,1322,5.3
CN5509700000000,2023-02-01,55,097,WI,Portage County,37759,36751,1008,2.7
CN5509900000000,2023-02-01,55,099,WI,Price County,6138,5933,205,3.3
CN5510100000000,2023-02-01,55,101,WI,Racine County,97639,94385,3254,3.3
CN5510300000000,2023-02-01,55,103,WI,Richland County,8807,8540,267,3
CN5510500000000,2023-02-01,55,105,WI,Rock County,85568,82884,2684,3.1
CN5510700000000,2023-02-01,55,107,WI,Rusk County,6557,6289,268,4.1
CN5510900000000,2023-02-01,55,109,WI,St. Croix County,50082,48175,1907,3.8
CN5511100000000,2023-02-01,55,111,WI,Sauk County,33604,32701,903,2.7
CN5511300000000,2023-02-01,55,113,WI,Sawyer County,7737,7353,384,5
CN5511500000000,2023-02-01,55,115,WI,Shawano County,20388,19806,582,2.9
CN5511700000000,2023-02-01,55,117,WI,Sheboygan County,61004,59756,1248,2
CN5511900000000,2023-02-01,55,119,WI,Taylor County,10654,10162,492,4.6
CN5512100000000,2023-02-01,55,121,WI,Trempealeau County,14915,14318,597,4
CN5512300000000,2023-02-01,55,123,WI,Vernon County,15371,14894,477,3.1
CN5512500000000,2023-02-01,55,125,WI,Vilas County,9779,9392,387,4
CN5512700000000,2023-02-01,55,127,WI,Walworth County,57263,55589,1674,2.9
CN5512900000000,2023-02-01,55,129,WI,Washburn County,7514,7206,308,4.1
CN5513100000000,2023-02-01,55,131,WI,Washington County,75365,73648,1717,2.3
CN5513300000000,2023-02-01,55,133,WI,Waukesha County,219623,214910,4713,2.1
CN5513500000000,2023-02-01,55,135,WI,Waupaca County,24738,24014,724,2.9
CN5513700000000,2023-02-01,55,137,WI,Waushara County,11124,10646,478,4.3
CN5513900000000,2023-02-01,55,139,WI,Winnebago County,92082,90162,1920,2.1
CN5514100000000,2023-02-01,55,141,WI,Wood County,33135,32003,1132,3.4
CN5600100000000,2023-02-01,56,001,WY,Albany County,22384,21621,763,3.4
CN5600300000000,2023-02-01,56,003,WY,Big Horn County,4992,4755,237,4.7
CN5600500000000,2023-02-01,56,005,WY,Campbell County,23418,22583,835,3.6
CN5600700000000,2023-02-01,56,007,WY,Carbon County,7057,6744,313,4.4
CN5600900000000,2023-02-01,56,009,WY,Converse County,7756,7535,221,2.8
CN5601100000000,2023-02-01,56,011,WY,Crook County,3820,3694,126,3.3
CN5601300000000,2023-02-01,56,013,WY,Fremont County,19184,18232,952,5
CN5601500000000,2023-02-01,56,015,WY,Goshen County,6530,6314,216,3.3
CN5601700000000,2023-02-01,56,017,WY,Hot Springs County,2308,2235,73,3.2
CN5601900000000,2023-02-01,56,019,WY,Johnson County,4152,3982,170,4.1
CN5602100000000,2023-02-01,56,021,WY,Laramie County,50394,48426,1968,3.9
CN5602300000000,2023-02-01,56,023,WY,Lincoln County,9786,9379,407,4.2
CN5602500000000,2023-02-01,56,025,WY,Natrona County,40422,38695,1727,4.3
CN5602700000000,2023-02-01,56,027,WY,Niobrara County,1202,1145,57,4.7
CN5602900000000,2023-02-01,56,029,WY,Park County,14748,14099,649,4.4
CN5603100000000,2023-02-01,56,031,WY,Platte County,4368,4193,175,4
CN5603300000000,2023-02-01,56,033,WY,Sheridan County,16389,15732,657,4
CN5603500000000,2023-02-01,56,035,WY,Sublette County,3804,3620,184,4.8
CN5603700000000,2023-02-01,56,037,WY,Sweetwater County,19945,19009,936,4.7
CN5603900000000,2023-02-01,56,039,WY,Teton County,17050,16629,421,2.5
CN5604100000000,2023-02-01,56,041,WY,Uinta County,9051,8665,386,4.3
CN5604300000000,2023-02-01,56,043,WY,Washakie County,3821,3644,177,4.6
CN5604500000000,2023-02-01,56,045,WY,Weston County,3843,3735,108,2.8
CN7200100000000,2023-02-01,72,001,PR,Adjuntas Municipio,4656,4168,488,10.5
CN7200300000000,2023-02-01,72,003,PR,Aguada Municipio,13769,12751,1018,7.4
CN7200500000000,2023-02-01,72,005,PR,Aguadilla Municipio,16740,15381,1359,8.1
CN7200700000000,2023-02-01,72,007,PR,Aguas Buenas Municipio,7129,6740,389,5.5
CN7200900000000,2023-02-01,72,009,PR,Aibonito Municipio,6989,6459,530,7.6
CN7201100000000,2023-02-01,72,011,PR,Anasco Municipio,10375,9686,689,6.6
CN7201300000000,2023-02-01,72,013,PR,Arecibo Municipio,26391,24701,1690,6.4
CN7201500000000,2023-02-01,72,015,PR,Arroyo Municipio,5115,4610,505,9.9
CN7201700000000,2023-02-01,72,017,PR,Barceloneta Municipio,6495,6002,493,7.6
CN7201900000000,2023-02-01,72,019,PR,Barranquitas Municipio,8038,7460,578,7.2
CN7202100000000,2023-02-01,72,021,PR,Bayamon Municipio,71133,67946,3187,4.5
CN7202300000000,2023-02-01,72,023,PR,Cabo Rojo Municipio,15494,14515,979,6.3
CN7202500000000,2023-02-01,72,025,PR,Caguas Municipio,52490,50198,2292,4.4
CN7202700000000,2023-02-01,72,027,PR,Camuy Municipio,10648,9959,689,6.5
CN7202900000000,2023-02-01,72,029,PR,Canovanas Municipio,17916,17128,788,4.4
CN7203100000000,2023-02-01,72,031,PR,Carolina Municipio,67206,64406,2800,4.2
CN7203300000000,2023-02-01,72,033,PR,Catano Municipio,8445,8092,353,4.2
CN7203500000000,2023-02-01,72,035,PR,Cayey Municipio,17768,16927,841,4.7
CN7203700000000,2023-02-01,72,037,PR,Ceiba Municipio,3955,3675,280,7.1
CN7203900000000,2023-02-01,72,039,PR,Ciales Municipio,3977,3689,288,7.2
CN7204100000000,2023-02-01,72,041,PR,Cidra Municipio,17020,16241,779,4.6
CN7204300000000,2023-02-01,72,043,PR,Coamo Municipio,11387,10471,916,8
CN7204500000000,2023-02-01,72,045,PR,Comerio Municipio,5400,5040,360,6.7
CN7204700000000,2023-02-01,72,047,PR,Corozal Municipio,9636,9012,624,6.5
CN7204900000000,2023-02-01,72,049,PR,Culebra Municipio,960,945,15,1.6
CN7205100000000,2023-02-01,72,051,PR,Dorado Municipio,14897,14227,670,4.5
CN7205300000000,2023-02-01,72,053,PR,Fajardo Municipio,11587,10825,762,6.6
CN7205400000000,2023-02-01,72,054,PR,Florida Municipio,3622,3322,300,8.3
CN7205500000000,2023-02-01,72,055,PR,Guanica Municipio,4305,3756,549,12.8
CN7205700000000,2023-02-01,72,057,PR,Guayama Municipio,11785,11021,764,6.5
CN7205900000000,2023-02-01,72,059,PR,Guayanilla Municipio,5399,4727,672,12.4
CN7206100000000,2023-02-01,72,061,PR,Guaynabo Municipio,41651,40531,1120,2.7
CN7206300000000,2023-02-01,72,063,PR,Gurabo Municipio,20719,19933,786,3.8
CN7206500000000,2023-02-01,72,065,PR,Hatillo Municipio,15601,13850,1751,11.2
CN7206700000000,2023-02-01,72,067,PR,Hormigueros Municipio,6115,5832,283,4.6
CN7206900000000,2023-02-01,72,069,PR,Humacao Municipio,19255,17959,1296,6.7
CN7207100000000,2023-02-01,72,071,PR,Isabela Municipio,13706,12751,955,7
CN7207300000000,2023-02-01,72,073,PR,Jayuya Municipio,4750,4305,445,9.4
CN7207500000000,2023-02-01,72,075,PR,Juana Diaz Municipio,17379,16122,1257,7.2
CN7207700000000,2023-02-01,72,077,PR,Juncos Municipio,13725,12884,841,6.1
CN7207900000000,2023-02-01,72,079,PR,Lajas Municipio,5826,5260,566,9.7
CN7208100000000,2023-02-01,72,081,PR,Lares Municipio,8071,7094,977,12.1
CN7208300000000,2023-02-01,72,083,PR,Las Marias Municipio,2777,2412,365,13.1
CN7208500000000,2023-02-01,72,085,PR,Las Piedras Municipio,12575,11864,711,5.7
CN7208700000000,2023-02-01,72,087,PR,Loiza Municipio,9082,8625,457,5
CN7208900000000,2023-02-01,72,089,PR,Luquillo Municipio,6740,6334,406,6
CN7209100000000,2023-02-01,72,091,PR,Manati Municipio,12323,11622,701,5.7
CN7209300000000,2023-02-01,72,093,PR,Maricao Municipio,2180,1907,273,12.5
CN7209500000000,2023-02-01,72,095,PR,Maunabo Municipio,3263,2787,476,14.6
CN7209700000000,2023-02-01,72,097,PR,Mayaguez Municipio,24723,23098,1625,6.6
CN7209900000000,2023-02-01,72,099,PR,Moca Municipio,12156,11162,994,8.2
CN7210100000000,2023-02-01,72,101,PR,Morovis Municipio,8860,8297,563,6.4
CN7210300000000,2023-02-01,72,103,PR,Naguabo Municipio,9035,8542,493,5.5
CN7210500000000,2023-02-01,72,105,PR,Naranjito Municipio,7754,7263,491,6.3
CN7210700000000,2023-02-01,72,107,PR,Orocovis Municipio,5365,4898,467,8.7
CN7210900000000,2023-02-01,72,109,PR,Patillas Municipio,4590,4080,510,11.1
CN7211100000000,2023-02-01,72,111,PR,Penuelas Municipio,6319,5649,670,10.6
CN7211300000000,2023-02-01,72,113,PR,Ponce Municipio,49671,46184,3487,7
CN7211500000000,2023-02-01,72,115,PR,Quebradillas Municipio,6692,6187,505,7.5
CN7211700000000,2023-02-01,72,117,PR,Rincon Municipio,5641,4920,721,12.8
CN7211900000000,2023-02-01,72,119,PR,Rio Grande Municipio,18563,17726,837,4.5
CN7212100000000,2023-02-01,72,121,PR,Sabana Grande Municipio,6610,6061,549,8.3
CN7212300000000,2023-02-01,72,123,PR,Salinas Municipio,7574,6887,687,9.1
CN7212500000000,2023-02-01,72,125,PR,San German Municipio,10759,9910,849,7.9
CN7212700000000,2023-02-01,72,127,PR,San Juan Municipio,146514,140447,6067,4.1
CN7212900000000,2023-02-01,72,129,PR,San Lorenzo Municipio,12728,11990,738,5.8
CN7213100000000,2023-02-01,72,131,PR,San Sebastian Municipio,11634,10379,1255,10.8
CN7213300000000,2023-02-01,72,133,PR,Santa Isabel Municipio,8408,7670,738,8.8
CN7213500000000,2023-02-01,72,135,PR,Toa Alta Municipio,30658,29422,1236,4
CN7213700000000,2023-02-01,72,137,PR,Toa Baja Municipio,31879,30547,1332,4.2
CN7213900000000,2023-02-01,72,139,PR,Trujillo Alto Municipio,29628,28840,788,2.7
CN7214100000000,2023-02-01,72,141,PR,Utuado Municipio,7580,6963,617,8.1
CN7214300000000,2023-02-01,72,143,PR,Vega Alta Municipio,10703,10111,592,5.5
CN7214500000000,2023-02-01,72,145,PR,Vega Baja Municipio,14492,13435,1057,7.3
CN7214700000000,2023-02-01,72,147,PR,Vieques Municipio,2669,2577,92,3.4
CN7214900000000,2023-02-01,72,149,PR,Villalba Municipio,8037,7055,982,12.2
CN7215100000000,2023-02-01,72,151,PR,Yabucoa Municipio,9458,8633,825,8.7
CN7215300000000,2023-02-01,72,153,PR,Yauco Municipio,10890,9446,1444,13.3
CN0100100000000,2023-03-01,01,001,AL,Autauga County,26776,26315,461,1.7
CN0100300000000,2023-03-01,01,003,AL,Baldwin County,103386,101549,1837,1.8
CN0100500000000,2023-03-01,01,005,AL,Barbour County,7901,7623,278,3.5
CN0100700000000,2023-03-01,01,007,AL,Bibb County,8665,8514,151,1.7
CN0100900000000,2023-03-01,01,009,AL,Blount County,25420,25005,415,1.6
CN0101100000000,2023-03-01,01,011,AL,Bullock County,4156,4074,82,2
CN0101300000000,2023-03-01,01,013,AL,Butler County,8962,8752,210,2.3
CN0101500000000,2023-03-01,01,015,AL,Calhoun County,46250,45294,956,2.1
CN0101700000000,2023-03-01,01,017,AL,Chambers County,15872,15599,273,1.7
CN0101900000000,2023-03-01,01,019,AL,Cherokee County,11517,11291,226,2
CN0102100000000,2023-03-01,01,021,AL,Chilton County,19950,19617,333,1.7
CN0102300000000,2023-03-01,01,023,AL,Choctaw County,4225,4099,126,3
CN0102500000000,2023-03-01,01,025,AL,Clarke County,7622,7309,313,4.1
CN0102700000000,2023-03-01,01,027,AL,Clay County,5884,5769,115,2
CN0102900000000,2023-03-01,01,029,AL,Cleburne County,6050,5939,111,1.8
CN0103100000000,2023-03-01,01,031,AL,Coffee County,21580,21175,405,1.9
CN0103300000000,2023-03-01,01,033,AL,Colbert County,23802,23281,521,2.2
CN0103500000000,2023-03-01,01,035,AL,Conecuh County,4134,4026,108,2.6
CN0103700000000,2023-03-01,01,037,AL,Coosa County,4516,4428,88,1.9
CN0103900000000,2023-03-01,01,039,AL,Covington County,14396,14075,321,2.2
CN0104100000000,2023-03-01,01,041,AL,Crenshaw County,5664,5556,108,1.9
CN0104300000000,2023-03-01,01,043,AL,Cullman County,39611,39015,596,1.5
CN0104500000000,2023-03-01,01,045,AL,Dale County,21537,21137,400,1.9
CN0104700000000,2023-03-01,01,047,AL,Dallas County,13409,12865,544,4.1
CN0104900000000,2023-03-01,01,049,AL,DeKalb County,30210,29664,546,1.8
CN0105100000000,2023-03-01,01,051,AL,Elmore County,38358,37733,625,1.6
CN0105300000000,2023-03-01,01,053,AL,Escambia County,14337,13980,357,2.5
CN0105500000000,2023-03-01,01,055,AL,Etowah County,38906,38054,852,2.2
CN0105700000000,2023-03-01,01,057,AL,Fayette County,6543,6413,130,2
CN0105900000000,2023-03-01,01,059,AL,Franklin County,14560,14280,280,1.9
CN0106100000000,2023-03-01,01,061,AL,Geneva County,10959,10756,203,1.9
CN0106300000000,2023-03-01,01,063,AL,Greene County,2718,2597,121,4.5
CN0106500000000,2023-03-01,01,065,AL,Hale County,5730,5575,155,2.7
CN0106700000000,2023-03-01,01,067,AL,Henry County,6976,6847,129,1.8
CN0106900000000,2023-03-01,01,069,AL,Houston County,48403,47472,931,1.9
CN0107100000000,2023-03-01,01,071,AL,Jackson County,23050,22607,443,1.9
CN0107300000000,2023-03-01,01,073,AL,Jefferson County,323317,317184,6133,1.9
CN0107500000000,2023-03-01,01,075,AL,Lamar County,5628,5511,117,2.1
CN0107700000000,2023-03-01,01,077,AL,Lauderdale County,42821,42008,813,1.9
CN0107900000000,2023-03-01,01,079,AL,Lawrence County,14730,14479,251,1.7
CN0108100000000,2023-03-01,01,081,AL,Lee County,80470,79006,1464,1.8
CN0108300000000,2023-03-01,01,083,AL,Limestone County,49165,48368,797,1.6
CN0108500000000,2023-03-01,01,085,AL,Lowndes County,3430,3305,125,3.6
CN0108700000000,2023-03-01,01,087,AL,Macon County,7822,7609,213,2.7
CN0108900000000,2023-03-01,01,089,AL,Madison County,203749,200479,3270,1.6
CN0109100000000,2023-03-01,01,091,AL,Marengo County,7604,7405,199,2.6
CN0109300000000,2023-03-01,01,093,AL,Marion County,13572,13269,303,2.2
CN0109500000000,2023-03-01,01,095,AL,Marshall County,45714,44975,739,1.6
CN0109700000000,2023-03-01,01,097,AL,Mobile County,193351,188741,4610,2.4
CN0109900000000,2023-03-01,01,099,AL,Monroe County,6977,6738,239,3.4
CN0110100000000,2023-03-01,01,101,AL,Montgomery County,107596,105116,2480,2.3
CN0110300000000,2023-03-01,01,103,AL,Morgan County,61568,60619,949,1.5
CN0110500000000,2023-03-01,01,105,AL,Perry County,2864,2749,115,4
CN0110700000000,2023-03-01,01,107,AL,Pickens County,7631,7445,186,2.4
CN0110900000000,2023-03-01,01,109,AL,Pike County,16070,15733,337,2.1
CN0111100000000,2023-03-01,01,111,AL,Randolph County,9387,9205,182,1.9
CN0111300000000,2023-03-01,01,113,AL,Russell County,24137,23676,461,1.9
CN0111500000000,2023-03-01,01,115,AL,St. Clair County,42090,41411,679,1.6
CN0111700000000,2023-03-01,01,117,AL,Shelby County,121605,119884,1721,1.4
CN0111900000000,2023-03-01,01,119,AL,Sumter County,4480,4361,119,2.7
CN0112100000000,2023-03-01,01,121,AL,Talladega County,37172,36374,798,2.1
CN0112300000000,2023-03-01,01,123,AL,Tallapoosa County,16676,16340,336,2
CN0112500000000,2023-03-01,01,125,AL,Tuscaloosa County,105513,103588,1925,1.8
CN0112700000000,2023-03-01,01,127,AL,Walker County,25400,24872,528,2.1
CN0112900000000,2023-03-01,01,129,AL,Washington County,6378,6209,169,2.6
CN0113100000000,2023-03-01,01,131,AL,Wilcox County,2414,2247,167,6.9
CN0113300000000,2023-03-01,01,133,AL,Winston County,9866,9662,204,2.1
CN0201300000000,2023-03-01,02,013,AK,Aleutians East Borough,2788,2752,36,1.3
CN0201600000000,2023-03-01,02,016,AK,Aleutians West Census Area,4448,4366,82,1.8
CN0202000000000,2023-03-01,02,020,AK,Anchorage Borough/municipality,151699,147166,4533,3
CN0205000000000,2023-03-01,02,050,AK,Bethel Census Area,6795,6219,576,8.5
CN0206000000000,2023-03-01,02,060,AK,Bristol Bay Borough,232,212,20,8.6
CN0206300000000,2023-03-01,02,063,AK,Chugach Census Area,3041,2855,186,6.1
CN0206600000000,2023-03-01,02,066,AK,Copper River Census Area,1221,1105,116,9.5
CN0206800000000,2023-03-01,02,068,AK,Denali Borough,595,522,73,12.3
CN0207000000000,2023-03-01,02,070,AK,Dillingham Census Area,1493,1409,84,5.6
CN0209000000000,2023-03-01,02,090,AK,Fairbanks North Star Borough,45794,44165,1629,3.6
CN0210000000000,2023-03-01,02,100,AK,Haines Borough,926,848,78,8.4
CN0210500000000,2023-03-01,02,105,AK,Hoonah-Angoon Census Area,999,896,103,10.3
CN0211000000000,2023-03-01,02,110,AK,Juneau Borough/city,16948,16507,441,2.6
CN0212200000000,2023-03-01,02,122,AK,Kenai Peninsula Borough,26821,25482,1339,5
CN0213000000000,2023-03-01,02,130,AK,Ketchikan Gateway Borough,6239,5970,269,4.3
CN0215000000000,2023-03-01,02,150,AK,Kodiak Island Borough,5941,5762,179,3
CN0215800000000,2023-03-01,02,158,AK,Kusilvak Census Area,2370,2067,303,12.8
CN0216400000000,2023-03-01,02,164,AK,Lake and Peninsula Borough,554,523,31,5.6
CN0217000000000,2023-03-01,02,170,AK,Matanuska-Susitna Borough,50220,47752,2468,4.9
CN0218000000000,2023-03-01,02,180,AK,Nome Census Area,4145,3859,286,6.9
CN0218500000000,2023-03-01,02,185,AK,North Slope Borough,3035,2912,123,4.1
CN0218800000000,2023-03-01,02,188,AK,Northwest Arctic Borough,2845,2562,283,9.9
CN0219500000000,2023-03-01,02,195,AK,Petersburg Borough,1374,1306,68,4.9
CN0219800000000,2023-03-01,02,198,AK,Prince of Wales-Hyder Census Area,2730,2532,198,7.3
CN0222000000000,2023-03-01,02,220,AK,Sitka Borough/city,4372,4246,126,2.9
CN0223000000000,2023-03-01,02,230,AK,Skagway Municipality,559,507,52,9.3
CN0224000000000,2023-03-01,02,240,AK,Southeast Fairbanks Census Area,3150,2981,169,5.4
CN0227500000000,2023-03-01,02,275,AK,Wrangell Borough/city,867,825,42,4.8
CN0228200000000,2023-03-01,02,282,AK,Yakutat Borough/city,285,265,20,7
CN0229000000000,2023-03-01,02,290,AK,Yukon-Koyukuk Census Area,2327,2113,214,9.2
CN0400100000000,2023-03-01,04,001,AZ,Apache County,19023,17728,1295,6.8
CN0400300000000,2023-03-01,04,003,AZ,Cochise County,49435,47444,1991,4
CN0400500000000,2023-03-01,04,005,AZ,Coconino County,75076,72457,2619,3.5
CN0400700000000,2023-03-01,04,007,AZ,Gila County,20625,19872,753,3.7
CN0400900000000,2023-03-01,04,009,AZ,Graham County,16730,16225,505,3
CN0401100000000,2023-03-01,04,011,AZ,Greenlee County,5046,4938,108,2.1
CN0401200000000,2023-03-01,04,012,AZ,La Paz County,9596,9194,402,4.2
CN0401300000000,2023-03-01,04,013,AZ,Maricopa County,2424414,2355132,69282,2.9
CN0401500000000,2023-03-01,04,015,AZ,Mohave County,90304,86690,3614,4
CN0401700000000,2023-03-01,04,017,AZ,Navajo County,40139,38128,2011,5
CN0401900000000,2023-03-01,04,019,AZ,Pima County,495700,479900,15800,3.2
CN0402100000000,2023-03-01,04,021,AZ,Pinal County,204367,197422,6945,3.4
CN0402300000000,2023-03-01,04,023,AZ,Santa Cruz County,19393,18163,1230,6.3
CN0402500000000,2023-03-01,04,025,AZ,Yavapai County,109349,105826,3523,3.2
CN0402700000000,2023-03-01,04,027,AZ,Yuma County,97916,88983,8933,9.1
CN0500100000000,2023-03-01,05,001,AR,Arkansas County,9189,8984,205,2.2
CN0500300000000,2023-03-01,05,003,AR,Ashley County,6538,6244,294,4.5
CN0500500000000,2023-03-01,05,005,AR,Baxter County,16496,16022,474,2.9
CN0500700000000,2023-03-01,05,007,AR,Benton County,156336,153203,3133,2
CN0500900000000,2023-03-01,05,009,AR,Boone County,16024,15607,417,2.6
CN0501100000000,2023-03-01,05,011,AR,Bradley County,4072,3903,169,4.2
CN0501300000000,2023-03-01,05,013,AR,Calhoun County,2413,2350,63,2.6
CN0501500000000,2023-03-01,05,015,AR,Carroll County,12314,12016,298,2.4
CN0501700000000,2023-03-01,05,017,AR,Chicot County,3008,2869,139,4.6
CN0501900000000,2023-03-01,05,019,AR,Clark County,8661,8354,307,3.5
CN0502100000000,2023-03-01,05,021,AR,Clay County,5535,5347,188,3.4
CN0502300000000,2023-03-01,05,023,AR,Cleburne County,8883,8585,298,3.4
CN0502500000000,2023-03-01,05,025,AR,Cleveland County,3122,3035,87,2.8
CN0502700000000,2023-03-01,05,027,AR,Columbia County,8856,8547,309,3.5
CN0502900000000,2023-03-01,05,029,AR,Conway County,8313,8055,258,3.1
CN0503100000000,2023-03-01,05,031,AR,Craighead County,58271,57000,1271,2.2
CN0503300000000,2023-03-01,05,033,AR,Crawford County,26422,25750,672,2.5
CN0503500000000,2023-03-01,05,035,AR,Crittenden County,20701,19996,705,3.4
CN0503700000000,2023-03-01,05,037,AR,Cross County,6923,6737,186,2.7
CN0503900000000,2023-03-01,05,039,AR,Dallas County,2693,2600,93,3.5
CN0504100000000,2023-03-01,05,041,AR,Desha County,4952,4764,188,3.8
CN0504300000000,2023-03-01,05,043,AR,Drew County,7552,7290,262,3.5
CN0504500000000,2023-03-01,05,045,AR,Faulkner County,63331,61754,1577,2.5
CN0504700000000,2023-03-01,05,047,AR,Franklin County,7544,7349,195,2.6
CN0504900000000,2023-03-01,05,049,AR,Fulton County,4974,4833,141,2.8
CN0505100000000,2023-03-01,05,051,AR,Garland County,42175,40905,1270,3
CN0505300000000,2023-03-01,05,053,AR,Grant County,8513,8307,206,2.4
CN0505500000000,2023-03-01,05,055,AR,Greene County,20090,19547,543,2.7
CN0505700000000,2023-03-01,05,057,AR,Hempstead County,9453,9216,237,2.5
CN0505900000000,2023-03-01,05,059,AR,Hot Spring County,13991,13602,389,2.8
CN0506100000000,2023-03-01,05,061,AR,Howard County,5390,5238,152,2.8
CN0506300000000,2023-03-01,05,063,AR,Independence County,16910,16471,439,2.6
CN0506500000000,2023-03-01,05,065,AR,Izard County,4468,4299,169,3.8
CN0506700000000,2023-03-01,05,067,AR,Jackson County,5534,5314,220,4
CN0506900000000,2023-03-01,05,069,AR,Jefferson County,25611,24644,967,3.8
CN0507100000000,2023-03-01,05,071,AR,Johnson County,10164,9842,322,3.2
CN0507300000000,2023-03-01,05,073,AR,Lafayette County,2347,2252,95,4
CN0507500000000,2023-03-01,05,075,AR,Lawrence County,7047,6872,175,2.5
CN0507700000000,2023-03-01,05,077,AR,Lee County,2689,2579,110,4.1
CN0507900000000,2023-03-01,05,079,AR,Lincoln County,3747,3621,126,3.4
CN0508100000000,2023-03-01,05,081,AR,Little River County,5193,5042,151,2.9
CN0508300000000,2023-03-01,05,083,AR,Logan County,8320,8063,257,3.1
CN0508500000000,2023-03-01,05,085,AR,Lonoke County,34461,33683,778,2.3
CN0508700000000,2023-03-01,05,087,AR,Madison County,8105,7936,169,2.1
CN0508900000000,2023-03-01,05,089,AR,Marion County,6171,5976,195,3.2
CN0509100000000,2023-03-01,05,091,AR,Miller County,18687,18130,557,3
CN0509300000000,2023-03-01,05,093,AR,Mississippi County,16625,16000,625,3.8
CN0509500000000,2023-03-01,05,095,AR,Monroe County,2574,2487,87,3.4
CN0509700000000,2023-03-01,05,097,AR,Montgomery County,2953,2840,113,3.8
CN0509900000000,2023-03-01,05,099,AR,Nevada County,3447,3353,94,2.7
CN0510100000000,2023-03-01,05,101,AR,Newton County,3235,3154,81,2.5
CN0510300000000,2023-03-01,05,103,AR,Ouachita County,9731,9405,326,3.4
CN0510500000000,2023-03-01,05,105,AR,Perry County,4239,4116,123,2.9
CN0510700000000,2023-03-01,05,107,AR,Phillips County,5593,5278,315,5.6
CN0510900000000,2023-03-01,05,109,AR,Pike County,4057,3947,110,2.7
CN0511100000000,2023-03-01,05,111,AR,Poinsett County,10149,9892,257,2.5
CN0511300000000,2023-03-01,05,113,AR,Polk County,7964,7730,234,2.9
CN0511500000000,2023-03-01,05,115,AR,Pope County,27836,26999,837,3
CN0511700000000,2023-03-01,05,117,AR,Prairie County,3609,3524,85,2.4
CN0511900000000,2023-03-01,05,119,AR,Pulaski County,189248,184277,4971,2.6
CN0512100000000,2023-03-01,05,121,AR,Randolph County,7323,7125,198,2.7
CN0512300000000,2023-03-01,05,123,AR,St. Francis County,7641,7346,295,3.9
CN0512500000000,2023-03-01,05,125,AR,Saline County,60158,58770,1388,2.3
CN0512700000000,2023-03-01,05,127,AR,Scott County,4372,4270,102,2.3
CN0512900000000,2023-03-01,05,129,AR,Searcy County,2832,2724,108,3.8
CN0513100000000,2023-03-01,05,131,AR,Sebastian County,55466,54058,1408,2.5
CN0513300000000,2023-03-01,05,133,AR,Sevier County,5487,5320,167,3
CN0513500000000,2023-03-01,05,135,AR,Sharp County,5887,5694,193,3.3
CN0513700000000,2023-03-01,05,137,AR,Stone County,4497,4344,153,3.4
CN0513900000000,2023-03-01,05,139,AR,Union County,14792,14241,551,3.7
CN0514100000000,2023-03-01,05,141,AR,Van Buren County,6016,5816,200,3.3
CN0514300000000,2023-03-01,05,143,AR,Washington County,137996,135390,2606,1.9
CN0514500000000,2023-03-01,05,145,AR,White County,34491,33514,977,2.8
CN0514700000000,2023-03-01,05,147,AR,Woodruff County,2959,2865,94,3.2
CN0514900000000,2023-03-01,05,149,AR,Yell County,8060,7817,243,3
CN0600100000000,2023-03-01,06,001,CA,Alameda County,833885,802184,31701,3.8
CN0600300000000,2023-03-01,06,003,CA,Alpine County,624,589,35,5.6
CN0600500000000,2023-03-01,06,005,CA,Amador County,14579,13735,844,5.8
CN0600700000000,2023-03-01,06,007,CA,Butte County,93503,88133,5370,5.7
CN0600900000000,2023-03-01,06,009,CA,Calaveras County,22490,21454,1036,4.6
CN0601100000000,2023-03-01,06,011,CA,Colusa County,10729,8668,2061,19.2
CN0601300000000,2023-03-01,06,013,CA,Contra Costa County,556556,534360,22196,4
CN0601500000000,2023-03-01,06,015,CA,Del Norte County,9388,8833,555,5.9
CN0601700000000,2023-03-01,06,017,CA,El Dorado County,94805,90879,3926,4.1
CN0601900000000,2023-03-01,06,019,CA,Fresno County,466843,426575,40268,8.6
CN0602100000000,2023-03-01,06,021,CA,Glenn County,13043,12104,939,7.2
CN0602300000000,2023-03-01,06,023,CA,Humboldt County,60471,57612,2859,4.7
CN0602500000000,2023-03-01,06,025,CA,Imperial County,71508,60239,11269,15.8
CN0602700000000,2023-03-01,06,027,CA,Inyo County,8381,8056,325,3.9
CN0602900000000,2023-03-01,06,029,CA,Kern County,392455,354784,37671,9.6
CN0603100000000,2023-03-01,06,031,CA,Kings County,58459,52721,5738,9.8
CN0603300000000,2023-03-01,06,033,CA,Lake County,29016,27172,1844,6.4
CN0603500000000,2023-03-01,06,035,CA,Lassen County,8985,8426,559,6.2
CN0603700000000,2023-03-01,06,037,CA,Los Angeles County,5032959,4782649,250310,5
CN0603900000000,2023-03-01,06,039,CA,Madera County,65770,59983,5787,8.8
CN0604100000000,2023-03-01,06,041,CA,Marin County,131982,127874,4108,3.1
CN0604300000000,2023-03-01,06,043,CA,Mariposa County,7335,6834,501,6.8
CN0604500000000,2023-03-01,06,045,CA,Mendocino County,37627,35622,2005,5.3
CN0604700000000,2023-03-01,06,047,CA,Merced County,118160,104821,13339,11.3
CN0604900000000,2023-03-01,06,049,CA,Modoc County,3190,2901,289,9.1
CN0605100000000,2023-03-01,06,051,CA,Mono County,8899,8551,348,3.9
CN0605300000000,2023-03-01,06,053,CA,Monterey County,225229,203345,21884,9.7
CN0605500000000,2023-03-01,06,055,CA,Napa County,72169,69516,2653,3.7
CN0605700000000,2023-03-01,06,057,CA,Nevada County,48786,46725,2061,4.2
CN0605900000000,2023-03-01,06,059,CA,Orange County,1610312,1555717,54595,3.4
CN0606100000000,2023-03-01,06,061,CA,Placer County,196687,189371,7316,3.7
CN0606300000000,2023-03-01,06,063,CA,Plumas County,7225,6408,817,11.3
CN0606500000000,2023-03-01,06,065,CA,Riverside County,1158796,1105668,53128,4.6
CN0606700000000,2023-03-01,06,067,CA,Sacramento County,739062,705437,33625,4.5
CN0606900000000,2023-03-01,06,069,CA,San Benito County,33359,31087,2272,6.8
CN0607100000000,2023-03-01,06,071,CA,San Bernardino County,1014559,968624,45935,4.5
CN0607300000000,2023-03-01,06,073,CA,San Diego County,1618219,1558734,59485,3.7
CN0607500000000,2023-03-01,06,075,CA,San Francisco County/city,581860,564449,17411,3
CN0607700000000,2023-03-01,06,077,CA,San Joaquin County,350420,326981,23439,6.7
CN0607900000000,2023-03-01,06,079,CA,San Luis Obispo County,140729,135968,4761,3.4
CN0608100000000,2023-03-01,06,081,CA,San Mateo County,460172,447392,12780,2.8
CN0608300000000,2023-03-01,06,083,CA,Santa Barbara County,228144,217889,10255,4.5
CN0608500000000,2023-03-01,06,085,CA,Santa Clara County,1059931,1026057,33874,3.2
CN0608700000000,2023-03-01,06,087,CA,Santa Cruz County,135683,126257,9426,6.9
CN0608900000000,2023-03-01,06,089,CA,Shasta County,74507,70061,4446,6
CN0609100000000,2023-03-01,06,091,CA,Sierra County,1295,1209,86,6.6
CN0609300000000,2023-03-01,06,093,CA,Siskiyou County,16707,15375,1332,8
CN0609500000000,2023-03-01,06,095,CA,Solano County,203938,194060,9878,4.8
CN0609700000000,2023-03-01,06,097,CA,Sonoma County,251143,242012,9131,3.6
CN0609900000000,2023-03-01,06,099,CA,Stanislaus County,246098,228953,17145,7
CN0610100000000,2023-03-01,06,101,CA,Sutter County,47710,43111,4599,9.6
CN0610300000000,2023-03-01,06,103,CA,Tehama County,25891,24145,1746,6.7
CN0610500000000,2023-03-01,06,105,CA,Trinity County,4462,4136,326,7.3
CN0610700000000,2023-03-01,06,107,CA,Tulare County,212536,188380,24156,11.4
CN0610900000000,2023-03-01,06,109,CA,Tuolumne County,20049,18914,1135,5.7
CN0611100000000,2023-03-01,06,111,CA,Ventura County,420234,403207,17027,4.1
CN0611300000000,2023-03-01,06,113,CA,Yolo County,110989,105268,5721,5.2
CN0611500000000,2023-03-01,06,115,CA,Yuba County,32743,30201,2542,7.8
CN0800100000000,2023-03-01,08,001,CO,Adams County,283557,275074,8483,3
CN0800300000000,2023-03-01,08,003,CO,Alamosa County,8336,8091,245,2.9
CN0800500000000,2023-03-01,08,005,CO,Arapahoe County,376987,366964,10023,2.7
CN0800700000000,2023-03-01,08,007,CO,Archuleta County,6956,6751,205,2.9
CN0800900000000,2023-03-01,08,009,CO,Baca County,2057,2026,31,1.5
CN0801100000000,2023-03-01,08,011,CO,Bent County,1789,1735,54,3
CN0801300000000,2023-03-01,08,013,CO,Boulder County,204669,199943,4726,2.3
CN0801400000000,2023-03-01,08,014,CO,Broomfield County/city,42845,41796,1049,2.4
CN0801500000000,2023-03-01,08,015,CO,Chaffee County,9863,9607,256,2.6
CN0801700000000,2023-03-01,08,017,CO,Cheyenne County,1016,999,17,1.7
CN0801900000000,2023-03-01,08,019,CO,Clear Creek County,6172,6024,148,2.4
CN0802100000000,2023-03-01,08,021,CO,Conejos County,4030,3920,110,2.7
CN0802300000000,2023-03-01,08,023,CO,Costilla County,1774,1707,67,3.8
CN0802500000000,2023-03-01,08,025,CO,Crowley County,1391,1340,51,3.7
CN0802700000000,2023-03-01,08,027,CO,Custer County,2323,2266,57,2.5
CN0802900000000,2023-03-01,08,029,CO,Delta County,12993,12529,464,3.6
CN0803100000000,2023-03-01,08,031,CO,Denver County/city,439012,426625,12387,2.8
CN0803300000000,2023-03-01,08,033,CO,Dolores County,1150,1125,25,2.2
CN0803500000000,2023-03-01,08,035,CO,Douglas County,209356,204385,4971,2.4
CN0803700000000,2023-03-01,08,037,CO,Eagle County,36984,36274,710,1.9
CN0803900000000,2023-03-01,08,039,CO,Elbert County,16033,15696,337,2.1
CN0804100000000,2023-03-01,08,041,CO,El Paso County,364940,354658,10282,2.8
CN0804300000000,2023-03-01,08,043,CO,Fremont County,14146,13525,621,4.4
CN0804500000000,2023-03-01,08,045,CO,Garfield County,32431,31579,852,2.6
CN0804700000000,2023-03-01,08,047,CO,Gilpin County,3933,3851,82,2.1
CN0804900000000,2023-03-01,08,049,CO,Grand County,10025,9803,222,2.2
CN0805100000000,2023-03-01,08,051,CO,Gunnison County,11949,11717,232,1.9
CN0805300000000,2023-03-01,08,053,CO,Hinsdale County,390,381,9,2.3
CN0805500000000,2023-03-01,08,055,CO,Huerfano County,2382,2249,133,5.6
CN0805700000000,2023-03-01,08,057,CO,Jackson County,977,959,18,1.8
CN0805900000000,2023-03-01,08,059,CO,Jefferson County,344676,336304,8372,2.4
CN0806100000000,2023-03-01,08,061,CO,Kiowa County,888,872,16,1.8
CN0806300000000,2023-03-01,08,063,CO,Kit Carson County,4220,4159,61,1.4
CN0806500000000,2023-03-01,08,065,CO,Lake County,5282,5184,98,1.9
CN0806700000000,2023-03-01,08,067,CO,La Plata County,31340,30507,833,2.7
CN0806900000000,2023-03-01,08,069,CO,Larimer County,212338,207214,5124,2.4
CN0807100000000,2023-03-01,08,071,CO,Las Animas County,6006,5763,243,4
CN0807300000000,2023-03-01,08,073,CO,Lincoln County,2181,2119,62,2.8
CN0807500000000,2023-03-01,08,075,CO,Logan County,10300,10073,227,2.2
CN0807700000000,2023-03-01,08,077,CO,Mesa County,77208,74811,2397,3.1
CN0807900000000,2023-03-01,08,079,CO,Mineral County,571,563,8,1.4
CN0808100000000,2023-03-01,08,081,CO,Moffat County,6959,6736,223,3.2
CN0808300000000,2023-03-01,08,083,CO,Montezuma County,12165,11685,480,3.9
CN0808500000000,2023-03-01,08,085,CO,Montrose County,21368,20740,628,2.9
CN0808700000000,2023-03-01,08,087,CO,Morgan County,15702,15310,392,2.5
CN0808900000000,2023-03-01,08,089,CO,Otero County,7871,7588,283,3.6
CN0809100000000,2023-03-01,08,091,CO,Ouray County,2315,2248,67,2.9
CN0809300000000,2023-03-01,08,093,CO,Park County,11636,11363,273,2.3
CN0809500000000,2023-03-01,08,095,CO,Phillips County,2398,2357,41,1.7
CN0809700000000,2023-03-01,08,097,CO,Pitkin County,10984,10763,221,2
CN0809900000000,2023-03-01,08,099,CO,Prowers County,6272,6129,143,2.3
CN0810100000000,2023-03-01,08,101,CO,Pueblo County,76505,73563,2942,3.8
CN0810300000000,2023-03-01,08,103,CO,Rio Blanco County,2849,2765,84,2.9
CN0810500000000,2023-03-01,08,105,CO,Rio Grande County,5208,5033,175,3.4
CN0810700000000,2023-03-01,08,107,CO,Routt County,16811,16499,312,1.9
CN0810900000000,2023-03-01,08,109,CO,Saguache County,3374,3279,95,2.8
CN0811100000000,2023-03-01,08,111,CO,San Juan County,539,524,15,2.8
CN0811300000000,2023-03-01,08,113,CO,San Miguel County,6306,6205,101,1.6
CN0811500000000,2023-03-01,08,115,CO,Sedgwick County,988,959,29,2.9
CN0811700000000,2023-03-01,08,117,CO,Summit County,24251,23853,398,1.6
CN0811900000000,2023-03-01,08,119,CO,Teller County,13602,13248,354,2.6
CN0812100000000,2023-03-01,08,121,CO,Washington County,2749,2701,48,1.7
CN0812300000000,2023-03-01,08,123,CO,Weld County,170758,165936,4822,2.8
CN0812500000000,2023-03-01,08,125,CO,Yuma County,5530,5443,87,1.6
CN0900100000000,2023-03-01,09,001,CT,Fairfield County,473274,452928,20346,4.3
CN0900300000000,2023-03-01,09,003,CT,Hartford County,471900,451701,20199,4.3
CN0900500000000,2023-03-01,09,005,CT,Litchfield County,102539,97897,4642,4.5
CN0900700000000,2023-03-01,09,007,CT,Middlesex County,92690,89155,3535,3.8
CN0900900000000,2023-03-01,09,009,CT,New Haven County,462050,441395,20655,4.5
CN0901100000000,2023-03-01,09,011,CT,New London County,131358,125902,5456,4.2
CN0901300000000,2023-03-01,09,013,CT,Tolland County,85278,82007,3271,3.8
CN0901500000000,2023-03-01,09,015,CT,Windham County,62997,60046,2951,4.7
CN1000100000000,2023-03-01,10,001,DE,Kent County,80905,76971,3934,4.9
CN1000300000000,2023-03-01,10,003,DE,New Castle County,309227,296398,12829,4.1
CN1000500000000,2023-03-01,10,005,DE,Sussex County,110484,105488,4996,4.5
CN1100100000000,2023-03-01,11,001,DC,District of Columbia,391796,371942,19854,5.1
CN1200100000000,2023-03-01,12,001,FL,Alachua County,145819,142050,3769,2.6
CN1200300000000,2023-03-01,12,003,FL,Baker County,13057,12736,321,2.5
CN1200500000000,2023-03-01,12,005,FL,Bay County,89544,87414,2130,2.4
CN1200700000000,2023-03-01,12,007,FL,Bradford County,11242,10949,293,2.6
CN1200900000000,2023-03-01,12,009,FL,Brevard County,301917,293939,7978,2.6
CN1201100000000,2023-03-01,12,011,FL,Broward County,1080560,1053197,27363,2.5
CN1201300000000,2023-03-01,12,013,FL,Calhoun County,4970,4825,145,2.9
CN1201500000000,2023-03-01,12,015,FL,Charlotte County,78954,76475,2479,3.1
CN1201700000000,2023-03-01,12,017,FL,Citrus County,50570,48658,1912,3.8
CN1201900000000,2023-03-01,12,019,FL,Clay County,116881,114038,2843,2.4
CN1202100000000,2023-03-01,12,021,FL,Collier County,192331,187630,4701,2.4
CN1202300000000,2023-03-01,12,023,FL,Columbia County,29834,29008,826,2.8
CN1202700000000,2023-03-01,12,027,FL,DeSoto County,14048,13620,428,3
CN1202900000000,2023-03-01,12,029,FL,Dixie County,5926,5744,182,3.1
CN1203100000000,2023-03-01,12,031,FL,Duval County,528742,514338,14404,2.7
CN1203300000000,2023-03-01,12,033,FL,Escambia County,152324,148252,4072,2.7
CN1203500000000,2023-03-01,12,035,FL,Flagler County,52163,50505,1658,3.2
CN1203700000000,2023-03-01,12,037,FL,Franklin County,4939,4809,130,2.6
CN1203900000000,2023-03-01,12,039,FL,Gadsden County,19417,18777,640,3.3
CN1204100000000,2023-03-01,12,041,FL,Gilchrist County,7586,7379,207,2.7
CN1204300000000,2023-03-01,12,043,FL,Glades County,5438,5271,167,3.1
CN1204500000000,2023-03-01,12,045,FL,Gulf County,5533,5411,122,2.2
CN1204700000000,2023-03-01,12,047,FL,Hamilton County,4223,4075,148,3.5
CN1204900000000,2023-03-01,12,049,FL,Hardee County,8979,8680,299,3.3
CN1205100000000,2023-03-01,12,051,FL,Hendry County,15663,15092,571,3.6
CN1205300000000,2023-03-01,12,053,FL,Hernando County,79316,76694,2622,3.3
CN1205500000000,2023-03-01,12,055,FL,Highlands County,36913,35529,1384,3.7
CN1205700000000,2023-03-01,12,057,FL,Hillsborough County,831379,810540,20839,2.5
CN1205900000000,2023-03-01,12,059,FL,Holmes County,7168,6969,199,2.8
CN1206100000000,2023-03-01,12,061,FL,Indian River County,68935,66841,2094,3
CN1206300000000,2023-03-01,12,063,FL,Jackson County,16718,16220,498,3
CN1206500000000,2023-03-01,12,065,FL,Jefferson County,5831,5673,158,2.7
CN1206700000000,2023-03-01,12,067,FL,Lafayette County,2867,2788,79,2.8
CN1206900000000,2023-03-01,12,069,FL,Lake County,175643,170796,4847,2.8
CN1207100000000,2023-03-01,12,071,FL,Lee County,390532,379527,11005,2.8
CN1207300000000,2023-03-01,12,073,FL,Leon County,162844,158555,4289,2.6
CN1207500000000,2023-03-01,12,075,FL,Levy County,17348,16818,530,3.1
CN1207700000000,2023-03-01,12,077,FL,Liberty County,2699,2626,73,2.7
CN1207900000000,2023-03-01,12,079,FL,Madison County,7939,7710,229,2.9
CN1208100000000,2023-03-01,12,081,FL,Manatee County,191971,186851,5120,2.7
CN1208300000000,2023-03-01,12,083,FL,Marion County,151637,146829,4808,3.2
CN1208500000000,2023-03-01,12,085,FL,Martin County,77887,75981,1906,2.4
CN1208600000000,2023-03-01,12,086,FL,Miami-Dade County,1398332,1373339,24993,1.8
CN1208700000000,2023-03-01,12,087,FL,Monroe County,51639,50773,866,1.7
CN1208900000000,2023-03-01,12,089,FL,Nassau County,46188,45067,1121,2.4
CN1209100000000,2023-03-01,12,091,FL,Okaloosa County,105531,103176,2355,2.2
CN1209300000000,2023-03-01,12,093,FL,Okeechobee County,18037,17547,490,2.7
CN1209500000000,2023-03-01,12,095,FL,Orange County,812528,792223,20305,2.5
CN1209700000000,2023-03-01,12,097,FL,Osceola County,202166,196246,5920,2.9
CN1209900000000,2023-03-01,12,099,FL,Palm Beach County,774074,753692,20382,2.6
CN1210100000000,2023-03-01,12,101,FL,Pasco County,266549,258913,7636,2.9
CN1210300000000,2023-03-01,12,103,FL,Pinellas County,526733,513934,12799,2.4
CN1210500000000,2023-03-01,12,105,FL,Polk County,346383,335678,10705,3.1
CN1210700000000,2023-03-01,12,107,FL,Putnam County,27941,26936,1005,3.6
CN1210900000000,2023-03-01,12,109,FL,St. Johns County,154630,151127,3503,2.3
CN1211100000000,2023-03-01,12,111,FL,St. Lucie County,159514,154646,4868,3.1
CN1211300000000,2023-03-01,12,113,FL,Santa Rosa County,89476,87245,2231,2.5
CN1211500000000,2023-03-01,12,115,FL,Sarasota County,201397,196077,5320,2.6
CN1211700000000,2023-03-01,12,117,FL,Seminole County,270966,264340,6626,2.4
CN1211900000000,2023-03-01,12,119,FL,Sumter County,38838,37386,1452,3.7
CN1212100000000,2023-03-01,12,121,FL,Suwannee County,17910,17394,516,2.9
CN1212300000000,2023-03-01,12,123,FL,Taylor County,8130,7899,231,2.8
CN1212500000000,2023-03-01,12,125,FL,Union County,4585,4469,116,2.5
CN1212700000000,2023-03-01,12,127,FL,Volusia County,274628,266797,7831,2.9
CN1212900000000,2023-03-01,12,129,FL,Wakulla County,16319,15938,381,2.3
CN1213100000000,2023-03-01,12,131,FL,Walton County,35705,34839,866,2.4
CN1213300000000,2023-03-01,12,133,FL,Washington County,10042,9764,278,2.8
CN1300100000000,2023-03-01,13,001,GA,Appling County,9200,8865,335,3.6
CN1300300000000,2023-03-01,13,003,GA,Atkinson County,4250,4094,156,3.7
CN1300500000000,2023-03-01,13,005,GA,Bacon County,4789,4636,153,3.2
CN1300700000000,2023-03-01,13,007,GA,Baker County,1052,1003,49,4.7
CN1300900000000,2023-03-01,13,009,GA,Baldwin County,18328,17587,741,4
CN1301100000000,2023-03-01,13,011,GA,Banks County,10854,10594,260,2.4
CN1301300000000,2023-03-01,13,013,GA,Barrow County,44019,42717,1302,3
CN1301500000000,2023-03-01,13,015,GA,Bartow County,53280,51593,1687,3.2
CN1301700000000,2023-03-01,13,017,GA,Ben Hill County,5625,5368,257,4.6
CN1301900000000,2023-03-01,13,019,GA,Berrien County,7654,7383,271,3.5
CN1302100000000,2023-03-01,13,021,GA,Bibb County,66554,63823,2731,4.1
CN1302300000000,2023-03-01,13,023,GA,Bleckley County,4545,4337,208,4.6
CN1302500000000,2023-03-01,13,025,GA,Brantley County,7468,7185,283,3.8
CN1302700000000,2023-03-01,13,027,GA,Brooks County,6543,6307,236,3.6
CN1302900000000,2023-03-01,13,029,GA,Bryan County,20335,19736,599,2.9
CN1303100000000,2023-03-01,13,031,GA,Bulloch County,39157,37820,1337,3.4
CN1303300000000,2023-03-01,13,033,GA,Burke County,8884,8408,476,5.4
CN1303500000000,2023-03-01,13,035,GA,Butts County,11543,11189,354,3.1
CN1303700000000,2023-03-01,13,037,GA,Calhoun County,2047,1976,71,3.5
CN1303900000000,2023-03-01,13,039,GA,Camden County,22640,21892,748,3.3
CN1304300000000,2023-03-01,13,043,GA,Candler County,6123,5968,155,2.5
CN1304500000000,2023-03-01,13,045,GA,Carroll County,58264,56347,1917,3.3
CN1304700000000,2023-03-01,13,047,GA,Catoosa County,34324,33341,983,2.9
CN1304900000000,2023-03-01,13,049,GA,Charlton County,5107,4930,177,3.5
CN1305100000000,2023-03-01,13,051,GA,Chatham County,145531,140898,4633,3.2
CN1305300000000,2023-03-01,13,053,GA,Chattahoochee County,1940,1846,94,4.8
CN1305500000000,2023-03-01,13,055,GA,Chattooga County,9113,8743,370,4.1
CN1305700000000,2023-03-01,13,057,GA,Cherokee County,145830,141887,3943,2.7
CN1305900000000,2023-03-01,13,059,GA,Clarke County,59736,57696,2040,3.4
CN1306100000000,2023-03-01,13,061,GA,Clay County,768,706,62,8.1
CN1306300000000,2023-03-01,13,063,GA,Clayton County,143200,137146,6054,4.2
CN1306500000000,2023-03-01,13,065,GA,Clinch County,2953,2864,89,3
CN1306700000000,2023-03-01,13,067,GA,Cobb County,440898,428011,12887,2.9
CN1306900000000,2023-03-01,13,069,GA,Coffee County,19050,18297,753,4
CN1307100000000,2023-03-01,13,071,GA,Colquitt County,21265,20597,668,3.1
CN1307300000000,2023-03-01,13,073,GA,Columbia County,75829,73419,2410,3.2
CN1307500000000,2023-03-01,13,075,GA,Cook County,8249,7950,299,3.6
CN1307700000000,2023-03-01,13,077,GA,Coweta County,79290,76972,2318,2.9
CN1307900000000,2023-03-01,13,079,GA,Crawford County,5395,5213,182,3.4
CN1308100000000,2023-03-01,13,081,GA,Crisp County,9694,9293,401,4.1
CN1308300000000,2023-03-01,13,083,GA,Dade County,8207,7974,233,2.8
CN1308500000000,2023-03-01,13,085,GA,Dawson County,13647,13256,391,2.9
CN1308700000000,2023-03-01,13,087,GA,Decatur County,11676,11251,425,3.6
CN1308900000000,2023-03-01,13,089,GA,DeKalb County,414031,399952,14079,3.4
CN1309100000000,2023-03-01,13,091,GA,Dodge County,6826,6543,283,4.1
CN1309300000000,2023-03-01,13,093,GA,Dooly County,4900,4700,200,4.1
CN1309500000000,2023-03-01,13,095,GA,Dougherty County,36625,35040,1585,4.3
CN1309700000000,2023-03-01,13,097,GA,Douglas County,76796,74043,2753,3.6
CN1309900000000,2023-03-01,13,099,GA,Early County,4375,4201,174,4
CN1310100000000,2023-03-01,13,101,GA,Echols County,1792,1736,56,3.1
CN1310300000000,2023-03-01,13,103,GA,Effingham County,34018,33041,977,2.9
CN1310500000000,2023-03-01,13,105,GA,Elbert County,8187,7878,309,3.8
CN1310700000000,2023-03-01,13,107,GA,Emanuel County,8873,8493,380,4.3
CN1310900000000,2023-03-01,13,109,GA,Evans County,4979,4826,153,3.1
CN1311100000000,2023-03-01,13,111,GA,Fannin County,12286,11908,378,3.1
CN1311300000000,2023-03-01,13,113,GA,Fayette County,60896,59089,1807,3
CN1311500000000,2023-03-01,13,115,GA,Floyd County,45546,44067,1479,3.2
CN1311700000000,2023-03-01,13,117,GA,Forsyth County,132907,129393,3514,2.6
CN1311900000000,2023-03-01,13,119,GA,Franklin County,9777,9440,337,3.4
CN1312100000000,2023-03-01,13,121,GA,Fulton County,588036,567391,20645,3.5
CN1312300000000,2023-03-01,13,123,GA,Gilmer County,12519,12075,444,3.5
CN1312500000000,2023-03-01,13,125,GA,Glascock County,1230,1187,43,3.5
CN1312700000000,2023-03-01,13,127,GA,Glynn County,40681,39428,1253,3.1
CN1312900000000,2023-03-01,13,129,GA,Gordon County,29189,28330,859,2.9
CN1313100000000,2023-03-01,13,131,GA,Grady County,10874,10544,330,3
CN1313300000000,2023-03-01,13,133,GA,Greene County,7338,7058,280,3.8
CN1313500000000,2023-03-01,13,135,GA,Gwinnett County,511753,496474,15279,3
CN1313700000000,2023-03-01,13,137,GA,Habersham County,19065,18430,635,3.3
CN1313900000000,2023-03-01,13,139,GA,Hall County,109310,106485,2825,2.6
CN1314100000000,2023-03-01,13,141,GA,Hancock County,2508,2376,132,5.3
CN1314300000000,2023-03-01,13,143,GA,Haralson County,13303,12841,462,3.5
CN1314500000000,2023-03-01,13,145,GA,Harris County,17205,16681,524,3
CN1314700000000,2023-03-01,13,147,GA,Hart County,12342,11948,394,3.2
CN1314900000000,2023-03-01,13,149,GA,Heard County,5410,5231,179,3.3
CN1315100000000,2023-03-01,13,151,GA,Henry County,123397,119073,4324,3.5
CN1315300000000,2023-03-01,13,153,GA,Houston County,71603,69343,2260,3.2
CN1315500000000,2023-03-01,13,155,GA,Irwin County,3449,3303,146,4.2
CN1315700000000,2023-03-01,13,157,GA,Jackson County,46384,45297,1087,2.3
CN1315900000000,2023-03-01,13,159,GA,Jasper County,7295,7085,210,2.9
CN1316100000000,2023-03-01,13,161,GA,Jeff Davis County,6206,5923,283,4.6
CN1316300000000,2023-03-01,13,163,GA,Jefferson County,6593,6324,269,4.1
CN1316500000000,2023-03-01,13,165,GA,Jenkins County,3457,3301,156,4.5
CN1316700000000,2023-03-01,13,167,GA,Johnson County,3953,3826,127,3.2
CN1316900000000,2023-03-01,13,169,GA,Jones County,13459,13023,436,3.2
CN1317100000000,2023-03-01,13,171,GA,Lamar County,8546,8251,295,3.5
CN1317300000000,2023-03-01,13,173,GA,Lanier County,3826,3671,155,4.1
CN1317500000000,2023-03-01,13,175,GA,Laurens County,19192,18277,915,4.8
CN1317700000000,2023-03-01,13,177,GA,Lee County,15113,14660,453,3
CN1317900000000,2023-03-01,13,179,GA,Liberty County,26677,25736,941,3.5
CN1318100000000,2023-03-01,13,181,GA,Lincoln County,3439,3305,134,3.9
CN1318300000000,2023-03-01,13,183,GA,Long County,8505,8220,285,3.4
CN1318500000000,2023-03-01,13,185,GA,Lowndes County,51336,49511,1825,3.6
CN1318700000000,2023-03-01,13,187,GA,Lumpkin County,19154,18647,507,2.6
CN1318900000000,2023-03-01,13,189,GA,McDuffie County,8397,7989,408,4.9
CN1319100000000,2023-03-01,13,191,GA,McIntosh County,6252,6049,203,3.2
CN1319300000000,2023-03-01,13,193,GA,Macon County,4394,4198,196,4.5
CN1319500000000,2023-03-01,13,195,GA,Madison County,13761,13325,436,3.2
CN1319700000000,2023-03-01,13,197,GA,Marion County,3320,3181,139,4.2
CN1319900000000,2023-03-01,13,199,GA,Meriwether County,9120,8729,391,4.3
CN1320100000000,2023-03-01,13,201,GA,Miller County,2884,2801,83,2.9
CN1320500000000,2023-03-01,13,205,GA,Mitchell County,8111,7795,316,3.9
CN1320700000000,2023-03-01,13,207,GA,Monroe County,12916,12512,404,3.1
CN1320900000000,2023-03-01,13,209,GA,Montgomery County,3984,3843,141,3.5
CN1321100000000,2023-03-01,13,211,GA,Morgan County,9753,9461,292,3
CN1321300000000,2023-03-01,13,213,GA,Murray County,15474,14826,648,4.2
CN1321500000000,2023-03-01,13,215,GA,Muscogee County,77729,74271,3458,4.4
CN1321700000000,2023-03-01,13,217,GA,Newton County,55378,53309,2069,3.7
CN1321900000000,2023-03-01,13,219,GA,Oconee County,20593,20055,538,2.6
CN1322100000000,2023-03-01,13,221,GA,Oglethorpe County,7040,6825,215,3.1
CN1322300000000,2023-03-01,13,223,GA,Paulding County,93373,90592,2781,3
CN1322500000000,2023-03-01,13,225,GA,Peach County,11849,11382,467,3.9
CN1322700000000,2023-03-01,13,227,GA,Pickens County,16260,15791,469,2.9
CN1322900000000,2023-03-01,13,229,GA,Pierce County,8949,8666,283,3.2
CN1323100000000,2023-03-01,13,231,GA,Pike County,9344,9073,271,2.9
CN1323300000000,2023-03-01,13,233,GA,Polk County,18519,17852,667,3.6
CN1323500000000,2023-03-01,13,235,GA,Pulaski County,3997,3851,146,3.7
CN1323700000000,2023-03-01,13,237,GA,Putnam County,8741,8383,358,4.1
CN1323900000000,2023-03-01,13,239,GA,Quitman County,719,677,42,5.8
CN1324100000000,2023-03-01,13,241,GA,Rabun County,7793,7527,266,3.4
CN1324300000000,2023-03-01,13,243,GA,Randolph County,2372,2263,109,4.6
CN1324500000000,2023-03-01,13,245,GA,Richmond County,82853,78916,3937,4.8
CN1324700000000,2023-03-01,13,247,GA,Rockdale County,46220,44477,1743,3.8
CN1324900000000,2023-03-01,13,249,GA,Schley County,2227,2149,78,3.5
CN1325100000000,2023-03-01,13,251,GA,Screven County,5095,4807,288,5.7
CN1325300000000,2023-03-01,13,253,GA,Seminole County,3022,2900,122,4
CN1325500000000,2023-03-01,13,255,GA,Spalding County,29952,28837,1115,3.7
CN1325700000000,2023-03-01,13,257,GA,Stephens County,10673,10265,408,3.8
CN1325900000000,2023-03-01,13,259,GA,Stewart County,2635,2540,95,3.6
CN1326100000000,2023-03-01,13,261,GA,Sumter County,12688,12127,561,4.4
CN1326300000000,2023-03-01,13,263,GA,Talbot County,2803,2706,97,3.5
CN1326500000000,2023-03-01,13,265,GA,Taliaferro County,535,512,23,4.3
CN1326700000000,2023-03-01,13,267,GA,Tattnall County,8923,8614,309,3.5
CN1326900000000,2023-03-01,13,269,GA,Taylor County,2651,2516,135,5.1
CN1327100000000,2023-03-01,13,271,GA,Telfair County,3465,3210,255,7.4
CN1327300000000,2023-03-01,13,273,GA,Terrell County,3482,3319,163,4.7
CN1327500000000,2023-03-01,13,275,GA,Thomas County,16977,16324,653,3.8
CN1327700000000,2023-03-01,13,277,GA,Tift County,20776,20132,644,3.1
CN1327900000000,2023-03-01,13,279,GA,Toombs County,12532,12072,460,3.7
CN1328100000000,2023-03-01,13,281,GA,Towns County,4245,4058,187,4.4
CN1328300000000,2023-03-01,13,283,GA,Treutlen County,2719,2604,115,4.2
CN1328500000000,2023-03-01,13,285,GA,Troup County,36631,35499,1132,3.1
CN1328700000000,2023-03-01,13,287,GA,Turner County,3130,2986,144,4.6
CN1328900000000,2023-03-01,13,289,GA,Twiggs County,2774,2626,148,5.3
CN1329100000000,2023-03-01,13,291,GA,Union County,11518,11162,356,3.1
CN1329300000000,2023-03-01,13,293,GA,Upson County,12064,11644,420,3.5
CN1329500000000,2023-03-01,13,295,GA,Walker County,32011,30976,1035,3.2
CN1329700000000,2023-03-01,13,297,GA,Walton County,49017,47488,1529,3.1
CN1329900000000,2023-03-01,13,299,GA,Ware County,15969,15453,516,3.2
CN1330100000000,2023-03-01,13,301,GA,Warren County,2680,2581,99,3.7
CN1330300000000,2023-03-01,13,303,GA,Washington County,7122,6820,302,4.2
CN1330500000000,2023-03-01,13,305,GA,Wayne County,12361,11948,413,3.3
CN1330700000000,2023-03-01,13,307,GA,Webster County,961,923,38,4
CN1330900000000,2023-03-01,13,309,GA,Wheeler County,1687,1593,94,5.6
CN1331100000000,2023-03-01,13,311,GA,White County,17425,16981,444,2.5
CN1331300000000,2023-03-01,13,313,GA,Whitfield County,43733,41881,1852,4.2
CN1331500000000,2023-03-01,13,315,GA,Wilcox County,2638,2543,95,3.6
CN1331700000000,2023-03-01,13,317,GA,Wilkes County,3634,3474,160,4.4
CN1331900000000,2023-03-01,13,319,GA,Wilkinson County,4003,3871,132,3.3
CN1332100000000,2023-03-01,13,321,GA,Worth County,8711,8407,304,3.5
CN1500100000000,2023-03-01,15,001,HI,Hawaii County,95177,91897,3280,3.4
CN1500300000000,2023-03-01,15,003,HI,Honolulu County/city,460336,446951,13385,2.9
CN1500700000000,2023-03-01,15,007,HI,Kauai County,36961,35870,1091,3
CN1500900000000,2023-03-01,15,009,HI,Maui County,87906,84913,2993,3.4
CN1600100000000,2023-03-01,16,001,ID,Ada County,279802,272539,7263,2.6
CN1600300000000,2023-03-01,16,003,ID,Adams County,1643,1500,143,8.7
CN1600500000000,2023-03-01,16,005,ID,Bannock County,45071,43758,1313,2.9
CN1600700000000,2023-03-01,16,007,ID,Bear Lake County,3050,2963,87,2.9
CN1600900000000,2023-03-01,16,009,ID,Benewah County,3836,3591,245,6.4
CN1601100000000,2023-03-01,16,011,ID,Bingham County,24392,23633,759,3.1
CN1601300000000,2023-03-01,16,013,ID,Blaine County,13114,12740,374,2.9
CN1601500000000,2023-03-01,16,015,ID,Boise County,3924,3738,186,4.7
CN1601700000000,2023-03-01,16,017,ID,Bonner County,21500,20377,1123,5.2
CN1601900000000,2023-03-01,16,019,ID,Bonneville County,63639,61834,1805,2.8
CN1602100000000,2023-03-01,16,021,ID,Boundary County,5501,5172,329,6
CN1602300000000,2023-03-01,16,023,ID,Butte County,1437,1379,58,4
CN1602500000000,2023-03-01,16,025,ID,Camas County,712,690,22,3.1
CN1602700000000,2023-03-01,16,027,ID,Canyon County,117796,113923,3873,3.3
CN1602900000000,2023-03-01,16,029,ID,Caribou County,3893,3773,120,3.1
CN1603100000000,2023-03-01,16,031,ID,Cassia County,14785,14447,338,2.3
CN1603300000000,2023-03-01,16,033,ID,Clark County,338,320,18,5.3
CN1603500000000,2023-03-01,16,035,ID,Clearwater County,2947,2750,197,6.7
CN1603700000000,2023-03-01,16,037,ID,Custer County,1891,1811,80,4.2
CN1603900000000,2023-03-01,16,039,ID,Elmore County,12618,12171,447,3.5
CN1604100000000,2023-03-01,16,041,ID,Franklin County,7605,7402,203,2.7
CN1604300000000,2023-03-01,16,043,ID,Fremont County,8009,7784,225,2.8
CN1604500000000,2023-03-01,16,045,ID,Gem County,9005,8657,348,3.9
CN1604700000000,2023-03-01,16,047,ID,Gooding County,10514,10213,301,2.9
CN1604900000000,2023-03-01,16,049,ID,Idaho County,6724,6419,305,4.5
CN1605100000000,2023-03-01,16,051,ID,Jefferson County,15846,15412,434,2.7
CN1605300000000,2023-03-01,16,053,ID,Jerome County,16239,15811,428,2.6
CN1605500000000,2023-03-01,16,055,ID,Kootenai County,85528,82198,3330,3.9
CN1605700000000,2023-03-01,16,057,ID,Latah County,20592,20024,568,2.8
CN1605900000000,2023-03-01,16,059,ID,Lemhi County,3537,3387,150,4.2
CN1606100000000,2023-03-01,16,061,ID,Lewis County,1608,1548,60,3.7
CN1606300000000,2023-03-01,16,063,ID,Lincoln County,3304,3165,139,4.2
CN1606500000000,2023-03-01,16,065,ID,Madison County,23540,23011,529,2.2
CN1606700000000,2023-03-01,16,067,ID,Minidoka County,13045,12718,327,2.5
CN1606900000000,2023-03-01,16,069,ID,Nez Perce County,21163,20558,605,2.9
CN1607100000000,2023-03-01,16,071,ID,Oneida County,2720,2644,76,2.8
CN1607300000000,2023-03-01,16,073,ID,Owyhee County,6292,6040,252,4
CN1607500000000,2023-03-01,16,075,ID,Payette County,11930,11464,466,3.9
CN1607700000000,2023-03-01,16,077,ID,Power County,4588,4430,158,3.4
CN1607900000000,2023-03-01,16,079,ID,Shoshone County,5501,5188,313,5.7
CN1608100000000,2023-03-01,16,081,ID,Teton County,7281,7100,181,2.5
CN1608300000000,2023-03-01,16,083,ID,Twin Falls County,45608,44199,1409,3.1
CN1608500000000,2023-03-01,16,085,ID,Valley County,5446,5190,256,4.7
CN1608700000000,2023-03-01,16,087,ID,Washington County,4914,4702,212,4.3
CN1700100000000,2023-03-01,17,001,IL,Adams County,30244,29297,947,3.1
CN1700300000000,2023-03-01,17,003,IL,Alexander County,1789,1691,98,5.5
CN1700500000000,2023-03-01,17,005,IL,Bond County,7437,7162,275,3.7
CN1700700000000,2023-03-01,17,007,IL,Boone County,25142,23034,2108,8.4
CN1700900000000,2023-03-01,17,009,IL,Brown County,3165,3100,65,2.1
CN1701100000000,2023-03-01,17,011,IL,Bureau County,15819,14958,861,5.4
CN1701300000000,2023-03-01,17,013,IL,Calhoun County,2169,2077,92,4.2
CN1701500000000,2023-03-01,17,015,IL,Carroll County,7015,6698,317,4.5
CN1701700000000,2023-03-01,17,017,IL,Cass County,5670,5427,243,4.3
CN1701900000000,2023-03-01,17,019,IL,Champaign County,111285,107369,3916,3.5
CN1702100000000,2023-03-01,17,021,IL,Christian County,13273,12639,634,4.8
CN1702300000000,2023-03-01,17,023,IL,Clark County,7183,6882,301,4.2
CN1702500000000,2023-03-01,17,025,IL,Clay County,5564,5277,287,5.2
CN1702700000000,2023-03-01,17,027,IL,Clinton County,19843,19245,598,3
CN1702900000000,2023-03-01,17,029,IL,Coles County,22905,22056,849,3.7
CN1703100000000,2023-03-01,17,031,IL,Cook County,2677282,2564113,113169,4.2
CN1703300000000,2023-03-01,17,033,IL,Crawford County,8345,8076,269,3.2
CN1703500000000,2023-03-01,17,035,IL,Cumberland County,5985,5808,177,3
CN1703700000000,2023-03-01,17,037,IL,DeKalb County,53333,50910,2423,4.5
CN1703900000000,2023-03-01,17,039,IL,De Witt County,7406,7081,325,4.4
CN1704100000000,2023-03-01,17,041,IL,Douglas County,10041,9722,319,3.2
CN1704300000000,2023-03-01,17,043,IL,DuPage County,523673,507405,16268,3.1
CN1704500000000,2023-03-01,17,045,IL,Edgar County,9100,8805,295,3.2
CN1704700000000,2023-03-01,17,047,IL,Edwards County,2332,2231,101,4.3
CN1704900000000,2023-03-01,17,049,IL,Effingham County,19733,19179,554,2.8
CN1705100000000,2023-03-01,17,051,IL,Fayette County,9653,9197,456,4.7
CN1705300000000,2023-03-01,17,053,IL,Ford County,6428,6153,275,4.3
CN1705500000000,2023-03-01,17,055,IL,Franklin County,15451,14679,772,5
CN1705700000000,2023-03-01,17,057,IL,Fulton County,14660,13850,810,5.5
CN1705900000000,2023-03-01,17,059,IL,Gallatin County,1982,1893,89,4.5
CN1706100000000,2023-03-01,17,061,IL,Greene County,5827,5599,228,3.9
CN1706300000000,2023-03-01,17,063,IL,Grundy County,26661,25328,1333,5
CN1706500000000,2023-03-01,17,065,IL,Hamilton County,4380,4234,146,3.3
CN1706700000000,2023-03-01,17,067,IL,Hancock County,7782,7483,299,3.8
CN1706900000000,2023-03-01,17,069,IL,Hardin County,1444,1381,63,4.4
CN1707100000000,2023-03-01,17,071,IL,Henderson County,3497,3346,151,4.3
CN1707300000000,2023-03-01,17,073,IL,Henry County,23361,22245,1116,4.8
CN1707500000000,2023-03-01,17,075,IL,Iroquois County,12167,11525,642,5.3
CN1707700000000,2023-03-01,17,077,IL,Jackson County,26959,25946,1013,3.8
CN1707900000000,2023-03-01,17,079,IL,Jasper County,4872,4707,165,3.4
CN1708100000000,2023-03-01,17,081,IL,Jefferson County,16130,15462,668,4.1
CN1708300000000,2023-03-01,17,083,IL,Jersey County,10527,10158,369,3.5
CN1708500000000,2023-03-01,17,085,IL,Jo Daviess County,10126,9626,500,4.9
CN1708700000000,2023-03-01,17,087,IL,Johnson County,4137,3909,228,5.5
CN1708900000000,2023-03-01,17,089,IL,Kane County,263462,249082,14380,5.5
CN1709100000000,2023-03-01,17,091,IL,Kankakee County,51624,48623,3001,5.8
CN1709300000000,2023-03-01,17,093,IL,Kendall County,73451,70673,2778,3.8
CN1709500000000,2023-03-01,17,095,IL,Knox County,19500,18441,1059,5.4
CN1709700000000,2023-03-01,17,097,IL,Lake County,361354,341324,20030,5.5
CN1709900000000,2023-03-01,17,099,IL,LaSalle County,51327,48315,3012,5.9
CN1710100000000,2023-03-01,17,101,IL,Lawrence County,4947,4707,240,4.9
CN1710300000000,2023-03-01,17,103,IL,Lee County,16334,15620,714,4.4
CN1710500000000,2023-03-01,17,105,IL,Livingston County,15370,14718,652,4.2
CN1710700000000,2023-03-01,17,107,IL,Logan County,11350,10882,468,4.1
CN1710900000000,2023-03-01,17,109,IL,McDonough County,12848,12360,488,3.8
CN1711100000000,2023-03-01,17,111,IL,McHenry County,172012,165272,6740,3.9
CN1711300000000,2023-03-01,17,113,IL,McLean County,88964,86026,2938,3.3
CN1711500000000,2023-03-01,17,115,IL,Macon County,45085,42329,2756,6.1
CN1711700000000,2023-03-01,17,117,IL,Macoupin County,21952,21171,781,3.6
CN1711900000000,2023-03-01,17,119,IL,Madison County,130025,125539,4486,3.5
CN1712100000000,2023-03-01,17,121,IL,Marion County,16411,15691,720,4.4
CN1712300000000,2023-03-01,17,123,IL,Marshall County,5148,4876,272,5.3
CN1712500000000,2023-03-01,17,125,IL,Mason County,5878,5588,290,4.9
CN1712700000000,2023-03-01,17,127,IL,Massac County,5297,5070,227,4.3
CN1712900000000,2023-03-01,17,129,IL,Menard County,6156,5920,236,3.8
CN1713100000000,2023-03-01,17,131,IL,Mercer County,7509,7110,399,5.3
CN1713300000000,2023-03-01,17,133,IL,Monroe County,18551,18056,495,2.7
CN1713500000000,2023-03-01,17,135,IL,Montgomery County,11043,10526,517,4.7
CN1713700000000,2023-03-01,17,137,IL,Morgan County,15616,15033,583,3.7
CN1713900000000,2023-03-01,17,139,IL,Moultrie County,7359,7131,228,3.1
CN1714100000000,2023-03-01,17,141,IL,Ogle County,23815,22439,1376,5.8
CN1714300000000,2023-03-01,17,143,IL,Peoria County,82401,78092,4309,5.2
CN1714500000000,2023-03-01,17,145,IL,Perry County,7709,7337,372,4.8
CN1714700000000,2023-03-01,17,147,IL,Piatt County,8796,8471,325,3.7
CN1714900000000,2023-03-01,17,149,IL,Pike County,6603,6312,291,4.4
CN1715100000000,2023-03-01,17,151,IL,Pope County,1759,1706,53,3
CN1715300000000,2023-03-01,17,153,IL,Pulaski County,1665,1556,109,6.5
CN1715500000000,2023-03-01,17,155,IL,Putnam County,2952,2792,160,5.4
CN1715700000000,2023-03-01,17,157,IL,Randolph County,13354,12901,453,3.4
CN1715900000000,2023-03-01,17,159,IL,Richland County,7172,6912,260,3.6
CN1716100000000,2023-03-01,17,161,IL,Rock Island County,66329,63106,3223,4.9
CN1716300000000,2023-03-01,17,163,IL,St. Clair County,122152,117218,4934,4
CN1716500000000,2023-03-01,17,165,IL,Saline County,9294,8882,412,4.4
CN1716700000000,2023-03-01,17,167,IL,Sangamon County,96600,92802,3798,3.9
CN1716900000000,2023-03-01,17,169,IL,Schuyler County,2982,2843,139,4.7
CN1717100000000,2023-03-01,17,171,IL,Scott County,2315,2172,143,6.2
CN1717300000000,2023-03-01,17,173,IL,Shelby County,9727,9331,396,4.1
CN1717500000000,2023-03-01,17,175,IL,Stark County,2412,2272,140,5.8
CN1717700000000,2023-03-01,17,177,IL,Stephenson County,20396,19337,1059,5.2
CN1717900000000,2023-03-01,17,179,IL,Tazewell County,62011,59335,2676,4.3
CN1718100000000,2023-03-01,17,181,IL,Union County,7110,6713,397,5.6
CN1718300000000,2023-03-01,17,183,IL,Vermilion County,31746,30042,1704,5.4
CN1718500000000,2023-03-01,17,185,IL,Wabash County,5636,5480,156,2.8
CN1718700000000,2023-03-01,17,187,IL,Warren County,7765,7477,288,3.7
CN1718900000000,2023-03-01,17,189,IL,Washington County,9931,9704,227,2.3
CN1719100000000,2023-03-01,17,191,IL,Wayne County,7028,6780,248,3.5
CN1719300000000,2023-03-01,17,193,IL,White County,6039,5817,222,3.7
CN1719500000000,2023-03-01,17,195,IL,Whiteside County,27478,26241,1237,4.5
CN1719700000000,2023-03-01,17,197,IL,Will County,372402,356420,15982,4.3
CN1719900000000,2023-03-01,17,199,IL,Williamson County,30982,29671,1311,4.2
CN1720100000000,2023-03-01,17,201,IL,Winnebago County,131508,123077,8431,6.4
CN1720300000000,2023-03-01,17,203,IL,Woodford County,18262,17585,677,3.7
CN1800100000000,2023-03-01,18,001,IN,Adams County,16764,16296,468,2.8
CN1800300000000,2023-03-01,18,003,IN,Allen County,191408,185191,6217,3.2
CN1800500000000,2023-03-01,18,005,IN,Bartholomew County,44953,43609,1344,3
CN1800700000000,2023-03-01,18,007,IN,Benton County,4236,4103,133,3.1
CN1800900000000,2023-03-01,18,009,IN,Blackford County,4810,4601,209,4.3
CN1801100000000,2023-03-01,18,011,IN,Boone County,38808,37837,971,2.5
CN1801300000000,2023-03-01,18,013,IN,Brown County,7962,7674,288,3.6
CN1801500000000,2023-03-01,18,015,IN,Carroll County,9684,9344,340,3.5
CN1801700000000,2023-03-01,18,017,IN,Cass County,17271,16563,708,4.1
CN1801900000000,2023-03-01,18,019,IN,Clark County,63594,61578,2016,3.2
CN1802100000000,2023-03-01,18,021,IN,Clay County,11771,11333,438,3.7
CN1802300000000,2023-03-01,18,023,IN,Clinton County,17119,16624,495,2.9
CN1802500000000,2023-03-01,18,025,IN,Crawford County,4814,4605,209,4.3
CN1802700000000,2023-03-01,18,027,IN,Daviess County,16598,16183,415,2.5
CN1802900000000,2023-03-01,18,029,IN,Dearborn County,26553,25614,939,3.5
CN1803100000000,2023-03-01,18,031,IN,Decatur County,14431,13991,440,3
CN1803300000000,2023-03-01,18,033,IN,DeKalb County,22600,21911,689,3
CN1803500000000,2023-03-01,18,035,IN,Delaware County,52465,50406,2059,3.9
CN1803700000000,2023-03-01,18,037,IN,Dubois County,21782,21199,583,2.7
CN1803900000000,2023-03-01,18,039,IN,Elkhart County,116371,111991,4380,3.8
CN1804100000000,2023-03-01,18,041,IN,Fayette County,8392,8022,370,4.4
CN1804300000000,2023-03-01,18,043,IN,Floyd County,42778,41551,1227,2.9
CN1804500000000,2023-03-01,18,045,IN,Fountain County,7990,7712,278,3.5
CN1804700000000,2023-03-01,18,047,IN,Franklin County,11315,10916,399,3.5
CN1804900000000,2023-03-01,18,049,IN,Fulton County,9261,8893,368,4
CN1805100000000,2023-03-01,18,051,IN,Gibson County,19854,19375,479,2.4
CN1805300000000,2023-03-01,18,053,IN,Grant County,32157,31024,1133,3.5
CN1805500000000,2023-03-01,18,055,IN,Greene County,13588,13013,575,4.2
CN1805700000000,2023-03-01,18,057,IN,Hamilton County,199662,194537,5125,2.6
CN1805900000000,2023-03-01,18,059,IN,Hancock County,43539,42265,1274,2.9
CN1806100000000,2023-03-01,18,061,IN,Harrison County,20701,20075,626,3
CN1806300000000,2023-03-01,18,063,IN,Hendricks County,97322,94668,2654,2.7
CN1806500000000,2023-03-01,18,065,IN,Henry County,22307,21446,861,3.9
CN1806700000000,2023-03-01,18,067,IN,Howard County,33083,31334,1749,5.3
CN1806900000000,2023-03-01,18,069,IN,Huntington County,18434,17851,583,3.2
CN1807100000000,2023-03-01,18,071,IN,Jackson County,23388,22693,695,3
CN1807300000000,2023-03-01,18,073,IN,Jasper County,15921,15252,669,4.2
CN1807500000000,2023-03-01,18,075,IN,Jay County,8806,8505,301,3.4
CN1807700000000,2023-03-01,18,077,IN,Jefferson County,15320,14807,513,3.3
CN1807900000000,2023-03-01,18,079,IN,Jennings County,13664,13089,575,4.2
CN1808100000000,2023-03-01,18,081,IN,Johnson County,88667,86242,2425,2.7
CN1808300000000,2023-03-01,18,083,IN,Knox County,17866,17322,544,3
CN1808500000000,2023-03-01,18,085,IN,Kosciusko County,40867,39544,1323,3.2
CN1808700000000,2023-03-01,18,087,IN,LaGrange County,21077,20441,636,3
CN1808900000000,2023-03-01,18,089,IN,Lake County,231222,218518,12704,5.5
CN1809100000000,2023-03-01,18,091,IN,LaPorte County,47255,45067,2188,4.6
CN1809300000000,2023-03-01,18,093,IN,Lawrence County,20684,19788,896,4.3
CN1809500000000,2023-03-01,18,095,IN,Madison County,61533,59108,2425,3.9
CN1809700000000,2023-03-01,18,097,IN,Marion County,518702,501072,17630,3.4
CN1809900000000,2023-03-01,18,099,IN,Marshall County,23065,22227,838,3.6
CN1810100000000,2023-03-01,18,101,IN,Martin County,5329,5167,162,3
CN1810300000000,2023-03-01,18,103,IN,Miami County,14177,13559,618,4.4
CN1810500000000,2023-03-01,18,105,IN,Monroe County,72560,70237,2323,3.2
CN1810700000000,2023-03-01,18,107,IN,Montgomery County,19055,18499,556,2.9
CN1810900000000,2023-03-01,18,109,IN,Morgan County,38132,36829,1303,3.4
CN1811100000000,2023-03-01,18,111,IN,Newton County,6745,6406,339,5
CN1811300000000,2023-03-01,18,113,IN,Noble County,21589,20785,804,3.7
CN1811500000000,2023-03-01,18,115,IN,Ohio County,3294,3188,106,3.2
CN1811700000000,2023-03-01,18,117,IN,Orange County,8323,7992,331,4
CN1811900000000,2023-03-01,18,119,IN,Owen County,9540,9135,405,4.2
CN1812100000000,2023-03-01,18,121,IN,Parke County,6883,6615,268,3.9
CN1812300000000,2023-03-01,18,123,IN,Perry County,8962,8655,307,3.4
CN1812500000000,2023-03-01,18,125,IN,Pike County,5864,5662,202,3.4
CN1812700000000,2023-03-01,18,127,IN,Porter County,86997,83392,3605,4.1
CN1812900000000,2023-03-01,18,129,IN,Posey County,13111,12739,372,2.8
CN1813100000000,2023-03-01,18,131,IN,Pulaski County,6648,6419,229,3.4
CN1813300000000,2023-03-01,18,133,IN,Putnam County,17162,16577,585,3.4
CN1813500000000,2023-03-01,18,135,IN,Randolph County,12158,11724,434,3.6
CN1813700000000,2023-03-01,18,137,IN,Ripley County,12914,12421,493,3.8
CN1813900000000,2023-03-01,18,139,IN,Rush County,8790,8528,262,3
CN1814100000000,2023-03-01,18,141,IN,St. Joseph County,133354,127998,5356,4
CN1814300000000,2023-03-01,18,143,IN,Scott County,10679,10292,387,3.6
CN1814500000000,2023-03-01,18,145,IN,Shelby County,24131,23425,706,2.9
CN1814700000000,2023-03-01,18,147,IN,Spencer County,10085,9758,327,3.2
CN1814900000000,2023-03-01,18,149,IN,Starke County,9666,9210,456,4.7
CN1815100000000,2023-03-01,18,151,IN,Steuben County,20921,20344,577,2.8
CN1815300000000,2023-03-01,18,153,IN,Sullivan County,8023,7700,323,4
CN1815500000000,2023-03-01,18,155,IN,Switzerland County,4748,4595,153,3.2
CN1815700000000,2023-03-01,18,157,IN,Tippecanoe County,96801,93815,2986,3.1
CN1815900000000,2023-03-01,18,159,IN,Tipton County,8978,8669,309,3.4
CN1816100000000,2023-03-01,18,161,IN,Union County,3627,3517,110,3
CN1816300000000,2023-03-01,18,163,IN,Vanderburgh County,94049,90990,3059,3.3
CN1816500000000,2023-03-01,18,165,IN,Vermillion County,6665,6340,325,4.9
CN1816700000000,2023-03-01,18,167,IN,Vigo County,46770,44889,1881,4
CN1816900000000,2023-03-01,18,169,IN,Wabash County,14759,14266,493,3.3
CN1817100000000,2023-03-01,18,171,IN,Warren County,4073,3936,137,3.4
CN1817300000000,2023-03-01,18,173,IN,Warrick County,32908,31930,978,3
CN1817500000000,2023-03-01,18,175,IN,Washington County,13698,13256,442,3.2
CN1817700000000,2023-03-01,18,177,IN,Wayne County,30238,29166,1072,3.5
CN1817900000000,2023-03-01,18,179,IN,Wells County,14362,13933,429,3
CN1818100000000,2023-03-01,18,181,IN,White County,12955,12548,407,3.1
CN1818300000000,2023-03-01,18,183,IN,Whitley County,18026,17486,540,3
CN1900100000000,2023-03-01,19,001,IA,Adair County,4457,4336,121,2.7
CN1900300000000,2023-03-01,19,003,IA,Adams County,2153,2112,41,1.9
CN1900500000000,2023-03-01,19,005,IA,Allamakee County,7280,6924,356,4.9
CN1900700000000,2023-03-01,19,007,IA,Appanoose County,6254,6071,183,2.9
CN1900900000000,2023-03-01,19,009,IA,Audubon County,3178,3101,77,2.4
CN1901100000000,2023-03-01,19,011,IA,Benton County,13361,12934,427,3.2
CN1901300000000,2023-03-01,19,013,IA,Black Hawk County,68548,66327,2221,3.2
CN1901500000000,2023-03-01,19,015,IA,Boone County,15060,14691,369,2.5
CN1901700000000,2023-03-01,19,017,IA,Bremer County,14233,13879,354,2.5
CN1901900000000,2023-03-01,19,019,IA,Buchanan County,11549,11180,369,3.2
CN1902100000000,2023-03-01,19,021,IA,Buena Vista County,12211,11949,262,2.1
CN1902300000000,2023-03-01,19,023,IA,Butler County,8520,8212,308,3.6
CN1902500000000,2023-03-01,19,025,IA,Calhoun County,4276,4164,112,2.6
CN1902700000000,2023-03-01,19,027,IA,Carroll County,11014,10752,262,2.4
CN1902900000000,2023-03-01,19,029,IA,Cass County,7002,6805,197,2.8
CN1903100000000,2023-03-01,19,031,IA,Cedar County,10641,10308,333,3.1
CN1903300000000,2023-03-01,19,033,IA,Cerro Gordo County,22238,21583,655,2.9
CN1903500000000,2023-03-01,19,035,IA,Cherokee County,6270,6103,167,2.7
CN1903700000000,2023-03-01,19,037,IA,Chickasaw County,6759,6573,186,2.8
CN1903900000000,2023-03-01,19,039,IA,Clarke County,5066,4896,170,3.4
CN1904100000000,2023-03-01,19,041,IA,Clay County,8692,8391,301,3.5
CN1904300000000,2023-03-01,19,043,IA,Clayton County,9706,9214,492,5.1
CN1904500000000,2023-03-01,19,045,IA,Clinton County,22428,21645,783,3.5
CN1904700000000,2023-03-01,19,047,IA,Crawford County,8088,7643,445,5.5
CN1904900000000,2023-03-01,19,049,IA,Dallas County,54693,53487,1206,2.2
CN1905100000000,2023-03-01,19,051,IA,Davis County,4411,4300,111,2.5
CN1905300000000,2023-03-01,19,053,IA,Decatur County,4505,4394,111,2.5
CN1905500000000,2023-03-01,19,055,IA,Delaware County,10761,10446,315,2.9
CN1905700000000,2023-03-01,19,057,IA,Des Moines County,18182,17462,720,4
CN1905900000000,2023-03-01,19,059,IA,Dickinson County,10218,9824,394,3.9
CN1906100000000,2023-03-01,19,061,IA,Dubuque County,56403,54656,1747,3.1
CN1906300000000,2023-03-01,19,063,IA,Emmet County,4961,4761,200,4
CN1906500000000,2023-03-01,19,065,IA,Fayette County,10747,10366,381,3.5
CN1906700000000,2023-03-01,19,067,IA,Floyd County,8525,8220,305,3.6
CN1906900000000,2023-03-01,19,069,IA,Franklin County,5802,5619,183,3.2
CN1907100000000,2023-03-01,19,071,IA,Fremont County,3745,3659,86,2.3
CN1907300000000,2023-03-01,19,073,IA,Greene County,5524,5412,112,2
CN1907500000000,2023-03-01,19,075,IA,Grundy County,6621,6414,207,3.1
CN1907700000000,2023-03-01,19,077,IA,Guthrie County,5866,5663,203,3.5
CN1907900000000,2023-03-01,19,079,IA,Hamilton County,7084,6886,198,2.8
CN1908100000000,2023-03-01,19,081,IA,Hancock County,5789,5646,143,2.5
CN1908300000000,2023-03-01,19,083,IA,Hardin County,7953,7672,281,3.5
CN1908500000000,2023-03-01,19,085,IA,Harrison County,7313,7112,201,2.7
CN1908700000000,2023-03-01,19,087,IA,Henry County,9540,9255,285,3
CN1908900000000,2023-03-01,19,089,IA,Howard County,5401,5187,214,4
CN1909100000000,2023-03-01,19,091,IA,Humboldt County,4977,4827,150,3
CN1909300000000,2023-03-01,19,093,IA,Ida County,4073,3971,102,2.5
CN1909500000000,2023-03-01,19,095,IA,Iowa County,10085,9783,302,3
CN1909700000000,2023-03-01,19,097,IA,Jackson County,10853,10411,442,4.1
CN1909900000000,2023-03-01,19,099,IA,Jasper County,18797,18121,676,3.6
CN1910100000000,2023-03-01,19,101,IA,Jefferson County,10244,9999,245,2.4
CN1910300000000,2023-03-01,19,103,IA,Johnson County,87777,85872,1905,2.2
CN1910500000000,2023-03-01,19,105,IA,Jones County,10778,10307,471,4.4
CN1910700000000,2023-03-01,19,107,IA,Keokuk County,5363,5176,187,3.5
CN1910900000000,2023-03-01,19,109,IA,Kossuth County,8422,8211,211,2.5
CN1911100000000,2023-03-01,19,111,IA,Lee County,14723,14160,563,3.8
CN1911300000000,2023-03-01,19,113,IA,Linn County,122196,118266,3930,3.2
CN1911500000000,2023-03-01,19,115,IA,Louisa County,6006,5800,206,3.4
CN1911700000000,2023-03-01,19,117,IA,Lucas County,4662,4547,115,2.5
CN1911900000000,2023-03-01,19,119,IA,Lyon County,7206,7050,156,2.2
CN1912100000000,2023-03-01,19,121,IA,Madison County,9047,8647,400,4.4
CN1912300000000,2023-03-01,19,123,IA,Mahaska County,12453,12131,322,2.6
CN1912500000000,2023-03-01,19,125,IA,Marion County,19436,18992,444,2.3
CN1912700000000,2023-03-01,19,127,IA,Marshall County,17996,16541,1455,8.1
CN1912900000000,2023-03-01,19,129,IA,Mills County,7239,7070,169,2.3
CN1913100000000,2023-03-01,19,131,IA,Mitchell County,5841,5701,140,2.4
CN1913300000000,2023-03-01,19,133,IA,Monona County,4502,4373,129,2.9
CN1913500000000,2023-03-01,19,135,IA,Monroe County,4082,3974,108,2.6
CN1913700000000,2023-03-01,19,137,IA,Montgomery County,5079,4941,138,2.7
CN1913900000000,2023-03-01,19,139,IA,Muscatine County,20899,20219,680,3.3
CN1914100000000,2023-03-01,19,141,IA,O'Brien County,8421,8206,215,2.6
CN1914300000000,2023-03-01,19,143,IA,Osceola County,3750,3682,68,1.8
CN1914500000000,2023-03-01,19,145,IA,Page County,6558,6405,153,2.3
CN1914700000000,2023-03-01,19,147,IA,Palo Alto County,4523,4398,125,2.8
CN1914900000000,2023-03-01,19,149,IA,Plymouth County,15202,14916,286,1.9
CN1915100000000,2023-03-01,19,151,IA,Pocahontas County,4198,4103,95,2.3
CN1915300000000,2023-03-01,19,153,IA,Polk County,279455,271265,8190,2.9
CN1915500000000,2023-03-01,19,155,IA,Pottawattamie County,48265,46959,1306,2.7
CN1915700000000,2023-03-01,19,157,IA,Poweshiek County,10658,10223,435,4.1
CN1915900000000,2023-03-01,19,159,IA,Ringgold County,2401,2349,52,2.2
CN1916100000000,2023-03-01,19,161,IA,Sac County,5445,5293,152,2.8
CN1916300000000,2023-03-01,19,163,IA,Scott County,88354,85534,2820,3.2
CN1916500000000,2023-03-01,19,165,IA,Shelby County,6522,6366,156,2.4
CN1916700000000,2023-03-01,19,167,IA,Sioux County,23412,22900,512,2.2
CN1916900000000,2023-03-01,19,169,IA,Story County,61231,60005,1226,2
CN1917100000000,2023-03-01,19,171,IA,Tama County,9475,9037,438,4.6
CN1917300000000,2023-03-01,19,173,IA,Taylor County,3248,3190,58,1.8
CN1917500000000,2023-03-01,19,175,IA,Union County,6291,6081,210,3.3
CN1917700000000,2023-03-01,19,177,IA,Van Buren County,3807,3681,126,3.3
CN1917900000000,2023-03-01,19,179,IA,Wapello County,16824,16268,556,3.3
CN1918100000000,2023-03-01,19,181,IA,Warren County,29764,28942,822,2.8
CN1918300000000,2023-03-01,19,183,IA,Washington County,12116,11784,332,2.7
CN1918500000000,2023-03-01,19,185,IA,Wayne County,3125,3026,99,3.2
CN1918700000000,2023-03-01,19,187,IA,Webster County,19068,18480,588,3.1
CN1918900000000,2023-03-01,19,189,IA,Winnebago County,5156,5000,156,3
CN1919100000000,2023-03-01,19,191,IA,Winneshiek County,11646,11185,461,4
CN1919300000000,2023-03-01,19,193,IA,Woodbury County,56800,55229,1571,2.8
CN1919500000000,2023-03-01,19,195,IA,Worth County,4074,3955,119,2.9
CN1919700000000,2023-03-01,19,197,IA,Wright County,6807,6630,177,2.6
CN2000100000000,2023-03-01,20,001,KS,Allen County,6349,6149,200,3.2
CN2000300000000,2023-03-01,20,003,KS,Anderson County,4348,4244,104,2.4
CN2000500000000,2023-03-01,20,005,KS,Atchison County,6727,6470,257,3.8
CN2000700000000,2023-03-01,20,007,KS,Barber County,2224,2157,67,3
CN2000900000000,2023-03-01,20,009,KS,Barton County,12980,12577,403,3.1
CN2001100000000,2023-03-01,20,011,KS,Bourbon County,6252,5995,257,4.1
CN2001300000000,2023-03-01,20,013,KS,Brown County,4915,4756,159,3.2
CN2001500000000,2023-03-01,20,015,KS,Butler County,33279,32251,1028,3.1
CN2001700000000,2023-03-01,20,017,KS,Chase County,1341,1310,31,2.3
CN2001900000000,2023-03-01,20,019,KS,Chautauqua County,1401,1358,43,3.1
CN2002100000000,2023-03-01,20,021,KS,Cherokee County,9822,9513,309,3.1
CN2002300000000,2023-03-01,20,023,KS,Cheyenne County,1198,1161,37,3.1
CN2002500000000,2023-03-01,20,025,KS,Clark County,1112,1085,27,2.4
CN2002700000000,2023-03-01,20,027,KS,Clay County,3677,3571,106,2.9
CN2002900000000,2023-03-01,20,029,KS,Cloud County,3703,3593,110,3
CN2003100000000,2023-03-01,20,031,KS,Coffey County,3783,3632,151,4
CN2003300000000,2023-03-01,20,033,KS,Comanche County,822,800,22,2.7
CN2003500000000,2023-03-01,20,035,KS,Cowley County,16425,15914,511,3.1
CN2003700000000,2023-03-01,20,037,KS,Crawford County,19483,18841,642,3.3
CN2003900000000,2023-03-01,20,039,KS,Decatur County,1169,1132,37,3.2
CN2004100000000,2023-03-01,20,041,KS,Dickinson County,8541,8255,286,3.3
CN2004300000000,2023-03-01,20,043,KS,Doniphan County,4025,3909,116,2.9
CN2004500000000,2023-03-01,20,045,KS,Douglas County,69059,67044,2015,2.9
CN2004700000000,2023-03-01,20,047,KS,Edwards County,1338,1297,41,3.1
CN2004900000000,2023-03-01,20,049,KS,Elk County,1199,1170,29,2.4
CN2005100000000,2023-03-01,20,051,KS,Ellis County,17207,16845,362,2.1
CN2005300000000,2023-03-01,20,053,KS,Ellsworth County,2611,2542,69,2.6
CN2005500000000,2023-03-01,20,055,KS,Finney County,20800,20314,486,2.3
CN2005700000000,2023-03-01,20,057,KS,Ford County,18140,17711,429,2.4
CN2005900000000,2023-03-01,20,059,KS,Franklin County,14983,14531,452,3
CN2006100000000,2023-03-01,20,061,KS,Geary County,11598,11089,509,4.4
CN2006300000000,2023-03-01,20,063,KS,Gove County,1321,1286,35,2.6
CN2006500000000,2023-03-01,20,065,KS,Graham County,1204,1169,35,2.9
CN2006700000000,2023-03-01,20,067,KS,Grant County,2688,2600,88,3.3
CN2006900000000,2023-03-01,20,069,KS,Gray County,3163,3089,74,2.3
CN2007100000000,2023-03-01,20,071,KS,Greeley County,740,726,14,1.9
CN2007300000000,2023-03-01,20,073,KS,Greenwood County,3007,2913,94,3.1
CN2007500000000,2023-03-01,20,075,KS,Hamilton County,1602,1567,35,2.2
CN2007700000000,2023-03-01,20,077,KS,Harper County,2883,2809,74,2.6
CN2007900000000,2023-03-01,20,079,KS,Harvey County,17409,16872,537,3.1
CN2008100000000,2023-03-01,20,081,KS,Haskell County,2121,2076,45,2.1
CN2008300000000,2023-03-01,20,083,KS,Hodgeman County,981,956,25,2.5
CN2008500000000,2023-03-01,20,085,KS,Jackson County,7338,7130,208,2.8
CN2008700000000,2023-03-01,20,087,KS,Jefferson County,10415,10108,307,2.9
CN2008900000000,2023-03-01,20,089,KS,Jewell County,1135,1100,35,3.1
CN2009100000000,2023-03-01,20,091,KS,Johnson County,352921,343382,9539,2.7
CN2009300000000,2023-03-01,20,093,KS,Kearny County,1967,1922,45,2.3
CN2009500000000,2023-03-01,20,095,KS,Kingman County,3295,3191,104,3.2
CN2009700000000,2023-03-01,20,097,KS,Kiowa County,1174,1139,35,3
CN2009900000000,2023-03-01,20,099,KS,Labette County,10446,10125,321,3.1
CN2010100000000,2023-03-01,20,101,KS,Lane County,686,664,22,3.2
CN2010300000000,2023-03-01,20,103,KS,Leavenworth County,37770,36566,1204,3.2
CN2010500000000,2023-03-01,20,105,KS,Lincoln County,1620,1579,41,2.5
CN2010700000000,2023-03-01,20,107,KS,Linn County,4436,4197,239,5.4
CN2010900000000,2023-03-01,20,109,KS,Logan County,1700,1669,31,1.8
CN2011100000000,2023-03-01,20,111,KS,Lyon County,17375,16850,525,3
CN2011300000000,2023-03-01,20,113,KS,McPherson County,17721,17337,384,2.2
CN2011500000000,2023-03-01,20,115,KS,Marion County,5931,5774,157,2.6
CN2011700000000,2023-03-01,20,117,KS,Marshall County,5184,5055,129,2.5
CN2011900000000,2023-03-01,20,119,KS,Meade County,2102,2051,51,2.4
CN2012100000000,2023-03-01,20,121,KS,Miami County,18201,17664,537,3
CN2012300000000,2023-03-01,20,123,KS,Mitchell County,3271,3202,69,2.1
CN2012500000000,2023-03-01,20,125,KS,Montgomery County,14813,14290,523,3.5
CN2012700000000,2023-03-01,20,127,KS,Morris County,2882,2794,88,3.1
CN2012900000000,2023-03-01,20,129,KS,Morton County,1149,1118,31,2.7
CN2013100000000,2023-03-01,20,131,KS,Nemaha County,5669,5555,114,2
CN2013300000000,2023-03-01,20,133,KS,Neosho County,6228,5995,233,3.7
CN2013500000000,2023-03-01,20,135,KS,Ness County,1272,1239,33,2.6
CN2013700000000,2023-03-01,20,137,KS,Norton County,2555,2496,59,2.3
CN2013900000000,2023-03-01,20,139,KS,Osage County,8046,7801,245,3
CN2014100000000,2023-03-01,20,141,KS,Osborne County,1847,1804,43,2.3
CN2014300000000,2023-03-01,20,143,KS,Ottawa County,3010,2930,80,2.7
CN2014500000000,2023-03-01,20,145,KS,Pawnee County,2655,2575,80,3
CN2014700000000,2023-03-01,20,147,KS,Phillips County,2575,2516,59,2.3
CN2014900000000,2023-03-01,20,149,KS,Pottawatomie County,13081,12748,333,2.5
CN2015100000000,2023-03-01,20,151,KS,Pratt County,4861,4753,108,2.2
CN2015300000000,2023-03-01,20,153,KS,Rawlins County,1540,1505,35,2.3
CN2015500000000,2023-03-01,20,155,KS,Reno County,29249,28289,960,3.3
CN2015700000000,2023-03-01,20,157,KS,Republic County,2303,2248,55,2.4
CN2015900000000,2023-03-01,20,159,KS,Rice County,5794,5635,159,2.7
CN2016100000000,2023-03-01,20,161,KS,Riley County,36376,35342,1034,2.8
CN2016300000000,2023-03-01,20,163,KS,Rooks County,2400,2339,61,2.5
CN2016500000000,2023-03-01,20,165,KS,Rush County,1631,1584,47,2.9
CN2016700000000,2023-03-01,20,167,KS,Russell County,3268,3188,80,2.4
CN2016900000000,2023-03-01,20,169,KS,Saline County,30203,29357,846,2.8
CN2017100000000,2023-03-01,20,171,KS,Scott County,2578,2513,65,2.5
CN2017300000000,2023-03-01,20,173,KS,Sedgwick County,259950,251318,8632,3.3
CN2017500000000,2023-03-01,20,175,KS,Seward County,10022,9736,286,2.9
CN2017700000000,2023-03-01,20,177,KS,Shawnee County,92766,89807,2959,3.2
CN2017900000000,2023-03-01,20,179,KS,Sheridan County,1417,1384,33,2.3
CN2018100000000,2023-03-01,20,181,KS,Sherman County,2698,2635,63,2.3
CN2018300000000,2023-03-01,20,183,KS,Smith County,1982,1939,43,2.2
CN2018500000000,2023-03-01,20,185,KS,Stafford County,1910,1861,49,2.6
CN2018700000000,2023-03-01,20,187,KS,Stanton County,1049,1027,22,2.1
CN2018900000000,2023-03-01,20,189,KS,Stevens County,2979,2910,69,2.3
CN2019100000000,2023-03-01,20,191,KS,Sumner County,10871,10546,325,3
CN2019300000000,2023-03-01,20,193,KS,Thomas County,4170,4082,88,2.1
CN2019500000000,2023-03-01,20,195,KS,Trego County,1356,1303,53,3.9
CN2019700000000,2023-03-01,20,197,KS,Wabaunsee County,3740,3624,116,3.1
CN2019900000000,2023-03-01,20,199,KS,Wallace County,836,814,22,2.6
CN2020100000000,2023-03-01,20,201,KS,Washington County,2947,2869,78,2.6
CN2020300000000,2023-03-01,20,203,KS,Wichita County,1064,1039,25,2.3
CN2020500000000,2023-03-01,20,205,KS,Wilson County,3713,3580,133,3.6
CN2020700000000,2023-03-01,20,207,KS,Woodson County,1464,1405,59,4
CN2020900000000,2023-03-01,20,209,KS,Wyandotte County,79055,75943,3112,3.9
CN2100100000000,2023-03-01,21,001,KY,Adair County,7127,6797,330,4.6
CN2100300000000,2023-03-01,21,003,KY,Allen County,8937,8597,340,3.8
CN2100500000000,2023-03-01,21,005,KY,Anderson County,11890,11536,354,3
CN2100700000000,2023-03-01,21,007,KY,Ballard County,3478,3316,162,4.7
CN2100900000000,2023-03-01,21,009,KY,Barren County,17894,17170,724,4
CN2101100000000,2023-03-01,21,011,KY,Bath County,4707,4470,237,5
CN2101300000000,2023-03-01,21,013,KY,Bell County,8263,7826,437,5.3
CN2101500000000,2023-03-01,21,015,KY,Boone County,72814,70467,2347,3.2
CN2101700000000,2023-03-01,21,017,KY,Bourbon County,9245,8939,306,3.3
CN2101900000000,2023-03-01,21,019,KY,Boyd County,17192,16279,913,5.3
CN2102100000000,2023-03-01,21,021,KY,Boyle County,12944,12428,516,4
CN2102300000000,2023-03-01,21,023,KY,Bracken County,3850,3646,204,5.3
CN2102500000000,2023-03-01,21,025,KY,Breathitt County,3205,2962,243,7.6
CN2102700000000,2023-03-01,21,027,KY,Breckinridge County,7955,7595,360,4.5
CN2102900000000,2023-03-01,21,029,KY,Bullitt County,42942,41097,1845,4.3
CN2103100000000,2023-03-01,21,031,KY,Butler County,5116,4904,212,4.1
CN2103300000000,2023-03-01,21,033,KY,Caldwell County,6287,6068,219,3.5
CN2103500000000,2023-03-01,21,035,KY,Calloway County,16861,16165,696,4.1
CN2103700000000,2023-03-01,21,037,KY,Campbell County,51238,49540,1698,3.3
CN2103900000000,2023-03-01,21,039,KY,Carlisle County,2289,2216,73,3.2
CN2104100000000,2023-03-01,21,041,KY,Carroll County,5858,5676,182,3.1
CN2104300000000,2023-03-01,21,043,KY,Carter County,9624,8918,706,7.3
CN2104500000000,2023-03-01,21,045,KY,Casey County,6536,6273,263,4
CN2104700000000,2023-03-01,21,047,KY,Christian County,25046,23927,1119,4.5
CN2104900000000,2023-03-01,21,049,KY,Clark County,17323,16722,601,3.5
CN2105100000000,2023-03-01,21,051,KY,Clay County,5112,4806,306,6
CN2105300000000,2023-03-01,21,053,KY,Clinton County,3524,3354,170,4.8
CN2105500000000,2023-03-01,21,055,KY,Crittenden County,3836,3694,142,3.7
CN2105700000000,2023-03-01,21,057,KY,Cumberland County,3397,3284,113,3.3
CN2105900000000,2023-03-01,21,059,KY,Daviess County,45227,43459,1768,3.9
CN2106100000000,2023-03-01,21,061,KY,Edmonson County,4806,4577,229,4.8
CN2106300000000,2023-03-01,21,063,KY,Elliott County,1888,1728,160,8.5
CN2106500000000,2023-03-01,21,065,KY,Estill County,5178,4935,243,4.7
CN2106700000000,2023-03-01,21,067,KY,Fayette County,175987,170755,5232,3
CN2106900000000,2023-03-01,21,069,KY,Fleming County,6081,5816,265,4.4
CN2107100000000,2023-03-01,21,071,KY,Floyd County,11006,10383,623,5.7
CN2107300000000,2023-03-01,21,073,KY,Franklin County,24979,24164,815,3.3
CN2107500000000,2023-03-01,21,075,KY,Fulton County,2119,2010,109,5.1
CN2107700000000,2023-03-01,21,077,KY,Gallatin County,4008,3860,148,3.7
CN2107900000000,2023-03-01,21,079,KY,Garrard County,8016,7725,291,3.6
CN2108100000000,2023-03-01,21,081,KY,Grant County,11777,11338,439,3.7
CN2108300000000,2023-03-01,21,083,KY,Graves County,15445,14832,613,4
CN2108500000000,2023-03-01,21,085,KY,Grayson County,10375,9950,425,4.1
CN2108700000000,2023-03-01,21,087,KY,Green County,5038,4864,174,3.5
CN2108900000000,2023-03-01,21,089,KY,Greenup County,12948,12129,819,6.3
CN2109100000000,2023-03-01,21,091,KY,Hancock County,3770,3604,166,4.4
CN2109300000000,2023-03-01,21,093,KY,Hardin County,46967,45174,1793,3.8
CN2109500000000,2023-03-01,21,095,KY,Harlan County,6454,6072,382,5.9
CN2109700000000,2023-03-01,21,097,KY,Harrison County,8835,8542,293,3.3
CN2109900000000,2023-03-01,21,099,KY,Hart County,7733,7432,301,3.9
CN2110100000000,2023-03-01,21,101,KY,Henderson County,20599,19862,737,3.6
CN2110300000000,2023-03-01,21,103,KY,Henry County,8018,7735,283,3.5
CN2110500000000,2023-03-01,21,105,KY,Hickman County,1579,1508,71,4.5
CN2110700000000,2023-03-01,21,107,KY,Hopkins County,17933,17215,718,4
CN2110900000000,2023-03-01,21,109,KY,Jackson County,4192,3976,216,5.2
CN2111100000000,2023-03-01,21,111,KY,Jefferson County,392907,378847,14060,3.6
CN2111300000000,2023-03-01,21,113,KY,Jessamine County,26758,25924,834,3.1
CN2111500000000,2023-03-01,21,115,KY,Johnson County,6713,6286,427,6.4
CN2111700000000,2023-03-01,21,117,KY,Kenton County,88607,85612,2995,3.4
CN2111900000000,2023-03-01,21,119,KY,Knott County,4286,4017,269,6.3
CN2112100000000,2023-03-01,21,121,KY,Knox County,10297,9781,516,5
CN2112300000000,2023-03-01,21,123,KY,Larue County,5769,5536,233,4
CN2112500000000,2023-03-01,21,125,KY,Laurel County,26017,25040,977,3.8
CN2112700000000,2023-03-01,21,127,KY,Lawrence County,5616,5312,304,5.4
CN2112900000000,2023-03-01,21,129,KY,Lee County,2045,1940,105,5.1
CN2113100000000,2023-03-01,21,131,KY,Leslie County,2520,2364,156,6.2
CN2113300000000,2023-03-01,21,133,KY,Letcher County,5804,5454,350,6
CN2113500000000,2023-03-01,21,135,KY,Lewis County,4576,4204,372,8.1
CN2113700000000,2023-03-01,21,137,KY,Lincoln County,9476,9015,461,4.9
CN2113900000000,2023-03-01,21,139,KY,Livingston County,3654,3472,182,5
CN2114100000000,2023-03-01,21,141,KY,Logan County,12603,12057,546,4.3
CN2114300000000,2023-03-01,21,143,KY,Lyon County,3208,3076,132,4.1
CN2114500000000,2023-03-01,21,145,KY,McCracken County,29990,28899,1091,3.6
CN2114700000000,2023-03-01,21,147,KY,McCreary County,4710,4455,255,5.4
CN2114900000000,2023-03-01,21,149,KY,McLean County,3860,3696,164,4.2
CN2115100000000,2023-03-01,21,151,KY,Madison County,47049,45469,1580,3.4
CN2115300000000,2023-03-01,21,153,KY,Magoffin County,3192,2895,297,9.3
CN2115500000000,2023-03-01,21,155,KY,Marion County,9477,9171,306,3.2
CN2115700000000,2023-03-01,21,157,KY,Marshall County,14404,13829,575,4
CN2115900000000,2023-03-01,21,159,KY,Martin County,2200,2040,160,7.3
CN2116100000000,2023-03-01,21,161,KY,Mason County,6562,6252,310,4.7
CN2116300000000,2023-03-01,21,163,KY,Meade County,11590,11072,518,4.5
CN2116500000000,2023-03-01,21,165,KY,Menifee County,2392,2254,138,5.8
CN2116700000000,2023-03-01,21,167,KY,Mercer County,10253,9883,370,3.6
CN2116900000000,2023-03-01,21,169,KY,Metcalfe County,3890,3716,174,4.5
CN2117100000000,2023-03-01,21,171,KY,Monroe County,4549,4371,178,3.9
CN2117300000000,2023-03-01,21,173,KY,Montgomery County,12001,11473,528,4.4
CN2117500000000,2023-03-01,21,175,KY,Morgan County,4050,3846,204,5
CN2117700000000,2023-03-01,21,177,KY,Muhlenberg County,10117,9561,556,5.5
CN2117900000000,2023-03-01,21,179,KY,Nelson County,23766,22932,834,3.5
CN2118100000000,2023-03-01,21,181,KY,Nicholas County,3228,3103,125,3.9
CN2118300000000,2023-03-01,21,183,KY,Ohio County,9018,8595,423,4.7
CN2118500000000,2023-03-01,21,185,KY,Oldham County,33086,32086,1000,3
CN2118700000000,2023-03-01,21,187,KY,Owen County,5210,5040,170,3.3
CN2118900000000,2023-03-01,21,189,KY,Owsley County,1033,970,63,6.1
CN2119100000000,2023-03-01,21,191,KY,Pendleton County,7030,6753,277,3.9
CN2119300000000,2023-03-01,21,193,KY,Perry County,8051,7652,399,5
CN2119500000000,2023-03-01,21,195,KY,Pike County,18865,17942,923,4.9
CN2119700000000,2023-03-01,21,197,KY,Powell County,5266,5047,219,4.2
CN2119900000000,2023-03-01,21,199,KY,Pulaski County,25109,23992,1117,4.4
CN2120100000000,2023-03-01,21,201,KY,Robertson County,792,756,36,4.5
CN2120300000000,2023-03-01,21,203,KY,Rockcastle County,6497,6226,271,4.2
CN2120500000000,2023-03-01,21,205,KY,Rowan County,10281,9812,469,4.6
CN2120700000000,2023-03-01,21,207,KY,Russell County,6203,5875,328,5.3
CN2120900000000,2023-03-01,21,209,KY,Scott County,30372,29478,894,2.9
CN2121100000000,2023-03-01,21,211,KY,Shelby County,25573,24723,850,3.3
CN2121300000000,2023-03-01,21,213,KY,Simpson County,8794,8486,308,3.5
CN2121500000000,2023-03-01,21,215,KY,Spencer County,10557,10154,403,3.8
CN2121700000000,2023-03-01,21,217,KY,Taylor County,12344,11927,417,3.4
CN2121900000000,2023-03-01,21,219,KY,Todd County,5876,5662,214,3.6
CN2122100000000,2023-03-01,21,221,KY,Trigg County,6067,5788,279,4.6
CN2122300000000,2023-03-01,21,223,KY,Trimble County,3768,3626,142,3.8
CN2122500000000,2023-03-01,21,225,KY,Union County,5792,5537,255,4.4
CN2122700000000,2023-03-01,21,227,KY,Warren County,66763,64317,2446,3.7
CN2122900000000,2023-03-01,21,229,KY,Washington County,6028,5842,186,3.1
CN2123100000000,2023-03-01,21,231,KY,Wayne County,6911,6527,384,5.6
CN2123300000000,2023-03-01,21,233,KY,Webster County,5100,4892,208,4.1
CN2123500000000,2023-03-01,21,235,KY,Whitley County,14393,13812,581,4
CN2123700000000,2023-03-01,21,237,KY,Wolfe County,2321,2194,127,5.5
CN2123900000000,2023-03-01,21,239,KY,Woodford County,14586,14169,417,2.9
CN2200100000000,2023-03-01,22,001,LA,Acadia Parish,24030,23247,783,3.3
CN2200300000000,2023-03-01,22,003,LA,Allen Parish,8265,7966,299,3.6
CN2200500000000,2023-03-01,22,005,LA,Ascension Parish,69093,67311,1782,2.6
CN2200700000000,2023-03-01,22,007,LA,Assumption Parish,8928,8548,380,4.3
CN2200900000000,2023-03-01,22,009,LA,Avoyelles Parish,14359,13817,542,3.8
CN2201100000000,2023-03-01,22,011,LA,Beauregard Parish,14720,14265,455,3.1
CN2201300000000,2023-03-01,22,013,LA,Bienville Parish,5274,5055,219,4.2
CN2201500000000,2023-03-01,22,015,LA,Bossier Parish,58873,57201,1672,2.8
CN2201700000000,2023-03-01,22,017,LA,Caddo Parish,102898,99187,3711,3.6
CN2201900000000,2023-03-01,22,019,LA,Calcasieu Parish,93673,90810,2863,3.1
CN2202100000000,2023-03-01,22,021,LA,Caldwell Parish,3769,3631,138,3.7
CN2202300000000,2023-03-01,22,023,LA,Cameron Parish,3484,3393,91,2.6
CN2202500000000,2023-03-01,22,025,LA,Catahoula Parish,3434,3300,134,3.9
CN2202700000000,2023-03-01,22,027,LA,Claiborne Parish,5461,5277,184,3.4
CN2202900000000,2023-03-01,22,029,LA,Concordia Parish,6911,6616,295,4.3
CN2203100000000,2023-03-01,22,031,LA,De Soto Parish,11060,10660,400,3.6
CN2203300000000,2023-03-01,22,033,LA,East Baton Rouge Parish,240765,233706,7059,2.9
CN2203500000000,2023-03-01,22,035,LA,East Carroll Parish,1702,1546,156,9.2
CN2203700000000,2023-03-01,22,037,LA,East Feliciana Parish,8146,7905,241,3
CN2203900000000,2023-03-01,22,039,LA,Evangeline Parish,12272,11826,446,3.6
CN2204100000000,2023-03-01,22,041,LA,Franklin Parish,7497,7127,370,4.9
CN2204300000000,2023-03-01,22,043,LA,Grant Parish,8452,8190,262,3.1
CN2204500000000,2023-03-01,22,045,LA,Iberia Parish,27823,26720,1103,4
CN2204700000000,2023-03-01,22,047,LA,Iberville Parish,14308,13769,539,3.8
CN2204900000000,2023-03-01,22,049,LA,Jackson Parish,7028,6821,207,2.9
CN2205100000000,2023-03-01,22,051,LA,Jefferson Parish,213611,206975,6636,3.1
CN2205300000000,2023-03-01,22,053,LA,Jefferson Davis Parish,12572,12166,406,3.2
CN2205500000000,2023-03-01,22,055,LA,Lafayette Parish,117469,114150,3319,2.8
CN2205700000000,2023-03-01,22,057,LA,Lafourche Parish,40603,39452,1151,2.8
CN2205900000000,2023-03-01,22,059,LA,LaSalle Parish,6833,6652,181,2.6
CN2206100000000,2023-03-01,22,061,LA,Lincoln Parish,21683,20986,697,3.2
CN2206300000000,2023-03-01,22,063,LA,Livingston Parish,74116,72160,1956,2.6
CN2206500000000,2023-03-01,22,065,LA,Madison Parish,3474,3301,173,5
CN2206700000000,2023-03-01,22,067,LA,Morehouse Parish,9939,9380,559,5.6
CN2206900000000,2023-03-01,22,069,LA,Natchitoches Parish,16993,16363,630,3.7
CN2207100000000,2023-03-01,22,071,LA,Orleans Parish,179138,171952,7186,4
CN2207300000000,2023-03-01,22,073,LA,Ouachita Parish,71470,69026,2444,3.4
CN2207500000000,2023-03-01,22,075,LA,Plaquemines Parish,9925,9640,285,2.9
CN2207700000000,2023-03-01,22,077,LA,Pointe Coupee Parish,10039,9729,310,3.1
CN2207900000000,2023-03-01,22,079,LA,Rapides Parish,57093,55404,1689,3
CN2208100000000,2023-03-01,22,081,LA,Red River Parish,3816,3702,114,3
CN2208300000000,2023-03-01,22,083,LA,Richland Parish,8271,7916,355,4.3
CN2208500000000,2023-03-01,22,085,LA,Sabine Parish,9191,8869,322,3.5
CN2208700000000,2023-03-01,22,087,LA,St. Bernard Parish,20294,19544,750,3.7
CN2208900000000,2023-03-01,22,089,LA,St. Charles Parish,25181,24453,728,2.9
CN2209100000000,2023-03-01,22,091,LA,St. Helena Parish,4383,4189,194,4.4
CN2209300000000,2023-03-01,22,093,LA,St. James Parish,9002,8674,328,3.6
CN2209500000000,2023-03-01,22,095,LA,St. John the Baptist Parish,19325,18527,798,4.1
CN2209700000000,2023-03-01,22,097,LA,St. Landry Parish,31943,30616,1327,4.2
CN2209900000000,2023-03-01,22,099,LA,St. Martin Parish,22243,21520,723,3.3
CN2210100000000,2023-03-01,22,101,LA,St. Mary Parish,19880,19137,743,3.7
CN2210300000000,2023-03-01,22,103,LA,St. Tammany Parish,121847,118420,3427,2.8
CN2210500000000,2023-03-01,22,105,LA,Tangipahoa Parish,57510,55275,2235,3.9
CN2210700000000,2023-03-01,22,107,LA,Tensas Parish,1271,1208,63,5
CN2210900000000,2023-03-01,22,109,LA,Terrebonne Parish,44573,43171,1402,3.1
CN2211100000000,2023-03-01,22,111,LA,Union Parish,9309,8962,347,3.7
CN2211300000000,2023-03-01,22,113,LA,Vermilion Parish,24280,23462,818,3.4
CN2211500000000,2023-03-01,22,115,LA,Vernon Parish,16507,15885,622,3.8
CN2211700000000,2023-03-01,22,117,LA,Washington Parish,17008,16349,659,3.9
CN2211900000000,2023-03-01,22,119,LA,Webster Parish,14367,13800,567,3.9
CN2212100000000,2023-03-01,22,121,LA,West Baton Rouge Parish,14492,14051,441,3
CN2212300000000,2023-03-01,22,123,LA,West Carroll Parish,3496,3244,252,7.2
CN2212500000000,2023-03-01,22,125,LA,West Feliciana Parish,5612,5481,131,2.3
CN2212700000000,2023-03-01,22,127,LA,Winn Parish,4634,4438,196,4.2
CN2300100000000,2023-03-01,23,001,ME,Androscoggin County,52898,51292,1606,3
CN2300300000000,2023-03-01,23,003,ME,Aroostook County,27925,26802,1123,4
CN2300500000000,2023-03-01,23,005,ME,Cumberland County,160398,156615,3783,2.4
CN2300700000000,2023-03-01,23,007,ME,Franklin County,13698,13242,456,3.3
CN2300900000000,2023-03-01,23,009,ME,Hancock County,26082,24923,1159,4.4
CN2301100000000,2023-03-01,23,011,ME,Kennebec County,61072,59505,1567,2.6
CN2301300000000,2023-03-01,23,013,ME,Knox County,18974,18352,622,3.3
CN2301500000000,2023-03-01,23,015,ME,Lincoln County,15699,15189,510,3.2
CN2301700000000,2023-03-01,23,017,ME,Oxford County,25781,24952,829,3.2
CN2301900000000,2023-03-01,23,019,ME,Penobscot County,74601,72394,2207,3
CN2302100000000,2023-03-01,23,021,ME,Piscataquis County,7181,6871,310,4.3
CN2302300000000,2023-03-01,23,023,ME,Sagadahoc County,18709,18260,449,2.4
CN2302500000000,2023-03-01,23,025,ME,Somerset County,21549,20515,1034,4.8
CN2302700000000,2023-03-01,23,027,ME,Waldo County,19768,19101,667,3.4
CN2302900000000,2023-03-01,23,029,ME,Washington County,12699,12103,596,4.7
CN2303100000000,2023-03-01,23,031,ME,York County,110861,107843,3018,2.7
CN2400100000000,2023-03-01,24,001,MD,Allegany County,31750,30745,1005,3.2
CN2400300000000,2023-03-01,24,003,MD,Anne Arundel County,316729,310438,6291,2
CN2400500000000,2023-03-01,24,005,MD,Baltimore County,448125,437373,10752,2.4
CN2400900000000,2023-03-01,24,009,MD,Calvert County,50046,49047,999,2
CN2401100000000,2023-03-01,24,011,MD,Caroline County,18172,17767,405,2.2
CN2401300000000,2023-03-01,24,013,MD,Carroll County,96321,94542,1779,1.8
CN2401500000000,2023-03-01,24,015,MD,Cecil County,55410,54096,1314,2.4
CN2401700000000,2023-03-01,24,017,MD,Charles County,87798,85729,2069,2.4
CN2401900000000,2023-03-01,24,019,MD,Dorchester County,16158,15728,430,2.7
CN2402100000000,2023-03-01,24,021,MD,Frederick County,139166,136288,2878,2.1
CN2402300000000,2023-03-01,24,023,MD,Garrett County,15713,15277,436,2.8
CN2402500000000,2023-03-01,24,025,MD,Harford County,141637,138589,3048,2.2
CN2402700000000,2023-03-01,24,027,MD,Howard County,189286,185863,3423,1.8
CN2402900000000,2023-03-01,24,029,MD,Kent County,10484,10223,261,2.5
CN2403100000000,2023-03-01,24,031,MD,Montgomery County,555375,544408,10967,2
CN2403300000000,2023-03-01,24,033,MD,Prince George's County,503060,490720,12340,2.5
CN2403500000000,2023-03-01,24,035,MD,Queen Anne's County,28788,28245,543,1.9
CN2403700000000,2023-03-01,24,037,MD,St. Mary's County,58269,57033,1236,2.1
CN2403900000000,2023-03-01,24,039,MD,Somerset County,9317,9002,315,3.4
CN2404100000000,2023-03-01,24,041,MD,Talbot County,17808,17386,422,2.4
CN2404300000000,2023-03-01,24,043,MD,Washington County,72476,70556,1920,2.6
CN2404500000000,2023-03-01,24,045,MD,Wicomico County,51348,49799,1549,3
CN2404700000000,2023-03-01,24,047,MD,Worcester County,25494,24359,1135,4.5
CN2451000000000,2023-03-01,24,510,MD,Baltimore city,275721,266982,8739,3.2
CN2500100000000,2023-03-01,25,001,MA,Barnstable County,107626,100895,6731,6.3
CN2500300000000,2023-03-01,25,003,MA,Berkshire County,60684,57858,2826,4.7
CN2500500000000,2023-03-01,25,005,MA,Bristol County,297068,281689,15379,5.2
CN2500700000000,2023-03-01,25,007,MA,Dukes County,8456,7791,665,7.9
CN2500900000000,2023-03-01,25,009,MA,Essex County,421513,404424,17089,4.1
CN2501100000000,2023-03-01,25,011,MA,Franklin County,39906,38511,1395,3.5
CN2501300000000,2023-03-01,25,013,MA,Hampden County,223518,212881,10637,4.8
CN2501500000000,2023-03-01,25,015,MA,Hampshire County,89206,86385,2821,3.2
CN2501700000000,2023-03-01,25,017,MA,Middlesex County,911133,883642,27491,3
CN2501900000000,2023-03-01,25,019,MA,Nantucket County/town,6819,5928,891,13.1
CN2502100000000,2023-03-01,25,021,MA,Norfolk County,393769,380733,13036,3.3
CN2502300000000,2023-03-01,25,023,MA,Plymouth County,283864,271766,12098,4.3
CN2502500000000,2023-03-01,25,025,MA,Suffolk County,453414,438551,14863,3.3
CN2502700000000,2023-03-01,25,027,MA,Worcester County,441416,423144,18272,4.1
CN2600100000000,2023-03-01,26,001,MI,Alcona County,3825,3471,354,9.3
CN2600300000000,2023-03-01,26,003,MI,Alger County,3239,2862,377,11.6
CN2600500000000,2023-03-01,26,005,MI,Allegan County,62007,59445,2562,4.1
CN2600700000000,2023-03-01,26,007,MI,Alpena County,13410,12599,811,6
CN2600900000000,2023-03-01,26,009,MI,Antrim County,9909,9129,780,7.9
CN2601100000000,2023-03-01,26,011,MI,Arenac County,5832,5223,609,10.4
CN2601300000000,2023-03-01,26,013,MI,Baraga County,2965,2706,259,8.7
CN2601500000000,2023-03-01,26,015,MI,Barry County,32267,30877,1390,4.3
CN2601700000000,2023-03-01,26,017,MI,Bay County,49674,46571,3103,6.2
CN2601900000000,2023-03-01,26,019,MI,Benzie County,8695,8047,648,7.5
CN2602100000000,2023-03-01,26,021,MI,Berrien County,72845,69270,3575,4.9
CN2602300000000,2023-03-01,26,023,MI,Branch County,19539,18643,896,4.6
CN2602500000000,2023-03-01,26,025,MI,Calhoun County,60099,57059,3040,5.1
CN2602700000000,2023-03-01,26,027,MI,Cass County,23655,22458,1197,5.1
CN2602900000000,2023-03-01,26,029,MI,Charlevoix County,12441,11628,813,6.5
CN2603100000000,2023-03-01,26,031,MI,Cheboygan County,9960,8386,1574,15.8
CN2603300000000,2023-03-01,26,033,MI,Chippewa County,16121,14753,1368,8.5
CN2603500000000,2023-03-01,26,035,MI,Clare County,11122,10161,961,8.6
CN2603700000000,2023-03-01,26,037,MI,Clinton County,40977,39349,1628,4
CN2603900000000,2023-03-01,26,039,MI,Crawford County,5391,4941,450,8.3
CN2604100000000,2023-03-01,26,041,MI,Delta County,16508,15365,1143,6.9
CN2604300000000,2023-03-01,26,043,MI,Dickinson County,11918,11338,580,4.9
CN2604500000000,2023-03-01,26,045,MI,Eaton County,57058,54664,2394,4.2
CN2604700000000,2023-03-01,26,047,MI,Emmet County,16176,14765,1411,8.7
CN2604900000000,2023-03-01,26,049,MI,Genesee County,180212,169431,10781,6
CN2605100000000,2023-03-01,26,051,MI,Gladwin County,10058,9262,796,7.9
CN2605300000000,2023-03-01,26,053,MI,Gogebic County,5806,5463,343,5.9
CN2605500000000,2023-03-01,26,055,MI,Grand Traverse County,48436,46247,2189,4.5
CN2605700000000,2023-03-01,26,057,MI,Gratiot County,17358,16458,900,5.2
CN2605900000000,2023-03-01,26,059,MI,Hillsdale County,19960,18980,980,4.9
CN2606100000000,2023-03-01,26,061,MI,Houghton County,16613,15622,991,6
CN2606300000000,2023-03-01,26,063,MI,Huron County,14723,13839,884,6
CN2606500000000,2023-03-01,26,065,MI,Ingham County,149351,142829,6522,4.4
CN2606700000000,2023-03-01,26,067,MI,Ionia County,30440,29073,1367,4.5
CN2606900000000,2023-03-01,26,069,MI,Iosco County,10258,9396,862,8.4
CN2607100000000,2023-03-01,26,071,MI,Iron County,4594,4223,371,8.1
CN2607300000000,2023-03-01,26,073,MI,Isabella County,31652,29917,1735,5.5
CN2607500000000,2023-03-01,26,075,MI,Jackson County,74511,71039,3472,4.7
CN2607700000000,2023-03-01,26,077,MI,Kalamazoo County,133295,127817,5478,4.1
CN2607900000000,2023-03-01,26,079,MI,Kalkaska County,7834,7189,645,8.2
CN2608100000000,2023-03-01,26,081,MI,Kent County,364500,351327,13173,3.6
CN2608300000000,2023-03-01,26,083,MI,Keweenaw County,924,856,68,7.4
CN2608500000000,2023-03-01,26,085,MI,Lake County,3980,3621,359,9
CN2608700000000,2023-03-01,26,087,MI,Lapeer County,40362,38767,1595,4
CN2608900000000,2023-03-01,26,089,MI,Leelanau County,10107,9571,536,5.3
CN2609100000000,2023-03-01,26,091,MI,Lenawee County,44497,42136,2361,5.3
CN2609300000000,2023-03-01,26,093,MI,Livingston County,103048,100743,2305,2.2
CN2609500000000,2023-03-01,26,095,MI,Luce County,2047,1880,167,8.2
CN2609700000000,2023-03-01,26,097,MI,Mackinac County,4562,3576,986,21.6
CN2609900000000,2023-03-01,26,099,MI,Macomb County,440510,428259,12251,2.8
CN2610100000000,2023-03-01,26,101,MI,Manistee County,9400,8647,753,8
CN2610300000000,2023-03-01,26,103,MI,Marquette County,32255,30266,1989,6.2
CN2610500000000,2023-03-01,26,105,MI,Mason County,12802,11934,868,6.8
CN2610700000000,2023-03-01,26,107,MI,Mecosta County,18766,17531,1235,6.6
CN2610900000000,2023-03-01,26,109,MI,Menominee County,10445,9953,492,4.7
CN2611100000000,2023-03-01,26,111,MI,Midland County,40423,38382,2041,5
CN2611300000000,2023-03-01,26,113,MI,Missaukee County,6780,6340,440,6.5
CN2611500000000,2023-03-01,26,115,MI,Monroe County,75274,71619,3655,4.9
CN2611700000000,2023-03-01,26,117,MI,Montcalm County,28221,26773,1448,5.1
CN2611900000000,2023-03-01,26,119,MI,Montmorency County,3066,2737,329,10.7
CN2612100000000,2023-03-01,26,121,MI,Muskegon County,76845,72882,3963,5.2
CN2612300000000,2023-03-01,26,123,MI,Newaygo County,23200,21934,1266,5.5
CN2612500000000,2023-03-01,26,125,MI,Oakland County,665978,651041,14937,2.2
CN2612700000000,2023-03-01,26,127,MI,Oceana County,11028,10135,893,8.1
CN2612900000000,2023-03-01,26,129,MI,Ogemaw County,8145,7346,799,9.8
CN2613100000000,2023-03-01,26,131,MI,Ontonagon County,2047,1861,186,9.1
CN2613300000000,2023-03-01,26,133,MI,Osceola County,11645,10977,668,5.7
CN2613500000000,2023-03-01,26,135,MI,Oscoda County,2639,2367,272,10.3
CN2613700000000,2023-03-01,26,137,MI,Otsego County,11444,10708,736,6.4
CN2613900000000,2023-03-01,26,139,MI,Ottawa County,163588,158014,5574,3.4
CN2614100000000,2023-03-01,26,141,MI,Presque Isle County,4956,4384,572,11.5
CN2614300000000,2023-03-01,26,143,MI,Roscommon County,7788,6915,873,11.2
CN2614500000000,2023-03-01,26,145,MI,Saginaw County,83584,78201,5383,6.4
CN2614700000000,2023-03-01,26,147,MI,St. Clair County,74501,72071,2430,3.3
CN2614900000000,2023-03-01,26,149,MI,St. Joseph County,28310,26937,1373,4.8
CN2615100000000,2023-03-01,26,151,MI,Sanilac County,18811,17591,1220,6.5
CN2615300000000,2023-03-01,26,153,MI,Schoolcraft County,3110,2777,333,10.7
CN2615500000000,2023-03-01,26,155,MI,Shiawassee County,32580,30803,1777,5.5
CN2615700000000,2023-03-01,26,157,MI,Tuscola County,22982,21458,1524,6.6
CN2615900000000,2023-03-01,26,159,MI,Van Buren County,34717,32617,2100,6
CN2616100000000,2023-03-01,26,161,MI,Washtenaw County,200750,193665,7085,3.5
CN2616300000000,2023-03-01,26,163,MI,Wayne County,793326,766836,26490,3.3
CN2616500000000,2023-03-01,26,165,MI,Wexford County,14765,13930,835,5.7
CN2700100000000,2023-03-01,27,001,MN,Aitkin County,7442,6965,477,6.4
CN2700300000000,2023-03-01,27,003,MN,Anoka County,198828,192897,5931,3
CN2700500000000,2023-03-01,27,005,MN,Becker County,19347,18601,746,3.9
CN2700700000000,2023-03-01,27,007,MN,Beltrami County,25210,24168,1042,4.1
CN2700900000000,2023-03-01,27,009,MN,Benton County,22084,21089,995,4.5
CN2701100000000,2023-03-01,27,011,MN,Big Stone County,2308,2213,95,4.1
CN2701300000000,2023-03-01,27,013,MN,Blue Earth County,41761,40686,1075,2.6
CN2701500000000,2023-03-01,27,015,MN,Brown County,13625,13076,549,4
CN2701700000000,2023-03-01,27,017,MN,Carlton County,17823,17000,823,4.6
CN2701900000000,2023-03-01,27,019,MN,Carver County,59336,57810,1526,2.6
CN2702100000000,2023-03-01,27,021,MN,Cass County,14065,13178,887,6.3
CN2702300000000,2023-03-01,27,023,MN,Chippewa County,6411,6206,205,3.2
CN2702500000000,2023-03-01,27,025,MN,Chisago County,30181,28885,1296,4.3
CN2702700000000,2023-03-01,27,027,MN,Clay County,38109,37194,915,2.4
CN2702900000000,2023-03-01,27,029,MN,Clearwater County,4556,4151,405,8.9
CN2703100000000,2023-03-01,27,031,MN,Cook County,2594,2456,138,5.3
CN2703300000000,2023-03-01,27,033,MN,Cottonwood County,6818,6634,184,2.7
CN2703500000000,2023-03-01,27,035,MN,Crow Wing County,32811,31382,1429,4.4
CN2703700000000,2023-03-01,27,037,MN,Dakota County,242271,235833,6438,2.7
CN2703900000000,2023-03-01,27,039,MN,Dodge County,12169,11726,443,3.6
CN2704100000000,2023-03-01,27,041,MN,Douglas County,21190,20522,668,3.2
CN2704300000000,2023-03-01,27,043,MN,Faribault County,6991,6723,268,3.8
CN2704500000000,2023-03-01,27,045,MN,Fillmore County,11663,11213,450,3.9
CN2704700000000,2023-03-01,27,047,MN,Freeborn County,15923,15434,489,3.1
CN2704900000000,2023-03-01,27,049,MN,Goodhue County,26635,25791,844,3.2
CN2705100000000,2023-03-01,27,051,MN,Grant County,3229,3097,132,4.1
CN2705300000000,2023-03-01,27,053,MN,Hennepin County,701598,684152,17446,2.5
CN2705500000000,2023-03-01,27,055,MN,Houston County,10703,10354,349,3.3
CN2705700000000,2023-03-01,27,057,MN,Hubbard County,9874,9326,548,5.5
CN2705900000000,2023-03-01,27,059,MN,Isanti County,22058,20932,1126,5.1
CN2706100000000,2023-03-01,27,061,MN,Itasca County,21562,20346,1216,5.6
CN2706300000000,2023-03-01,27,063,MN,Jackson County,5358,5196,162,3
CN2706500000000,2023-03-01,27,065,MN,Kanabec County,9426,8683,743,7.9
CN2706700000000,2023-03-01,27,067,MN,Kandiyohi County,22972,22101,871,3.8
CN2706900000000,2023-03-01,27,069,MN,Kittson County,2203,2128,75,3.4
CN2707100000000,2023-03-01,27,071,MN,Koochiching County,5677,5430,247,4.4
CN2707300000000,2023-03-01,27,073,MN,Lac qui Parle County,3409,3293,116,3.4
CN2707500000000,2023-03-01,27,075,MN,Lake County,5015,4763,252,5
CN2707700000000,2023-03-01,27,077,MN,Lake of the Woods County,2484,2401,83,3.3
CN2707900000000,2023-03-01,27,079,MN,Le Sueur County,16195,15256,939,5.8
CN2708100000000,2023-03-01,27,081,MN,Lincoln County,2972,2830,142,4.8
CN2708300000000,2023-03-01,27,083,MN,Lyon County,14427,13993,434,3
CN2708500000000,2023-03-01,27,085,MN,McLeod County,19351,18554,797,4.1
CN2708700000000,2023-03-01,27,087,MN,Mahnomen County,2313,2168,145,6.3
CN2708900000000,2023-03-01,27,089,MN,Marshall County,5413,5095,318,5.9
CN2709100000000,2023-03-01,27,091,MN,Martin County,9481,9175,306,3.2
CN2709300000000,2023-03-01,27,093,MN,Meeker County,13707,13124,583,4.3
CN2709500000000,2023-03-01,27,095,MN,Mille Lacs County,13001,12052,949,7.3
CN2709700000000,2023-03-01,27,097,MN,Morrison County,17445,16284,1161,6.7
CN2709900000000,2023-03-01,27,099,MN,Mower County,20907,20287,620,3
CN2710100000000,2023-03-01,27,101,MN,Murray County,4618,4366,252,5.5
CN2710300000000,2023-03-01,27,103,MN,Nicollet County,21377,20854,523,2.4
CN2710500000000,2023-03-01,27,105,MN,Nobles County,10913,10621,292,2.7
CN2710700000000,2023-03-01,27,107,MN,Norman County,3200,3053,147,4.6
CN2710900000000,2023-03-01,27,109,MN,Olmsted County,92476,90348,2128,2.3
CN2711100000000,2023-03-01,27,111,MN,Otter Tail County,30696,29357,1339,4.4
CN2711300000000,2023-03-01,27,113,MN,Pennington County,8917,8518,399,4.5
CN2711500000000,2023-03-01,27,115,MN,Pine County,14422,13369,1053,7.3
CN2711700000000,2023-03-01,27,117,MN,Pipestone County,4599,4394,205,4.5
CN2711900000000,2023-03-01,27,119,MN,Polk County,16361,15840,521,3.2
CN2712100000000,2023-03-01,27,121,MN,Pope County,6397,6182,215,3.4
CN2712300000000,2023-03-01,27,123,MN,Ramsey County,284401,276748,7653,2.7
CN2712500000000,2023-03-01,27,125,MN,Red Lake County,2174,2064,110,5.1
CN2712700000000,2023-03-01,27,127,MN,Redwood County,7561,7321,240,3.2
CN2712900000000,2023-03-01,27,129,MN,Renville County,7961,7596,365,4.6
CN2713100000000,2023-03-01,27,131,MN,Rice County,37651,36470,1181,3.1
CN2713300000000,2023-03-01,27,133,MN,Rock County,6012,5890,122,2
CN2713500000000,2023-03-01,27,135,MN,Roseau County,7876,7667,209,2.7
CN2713700000000,2023-03-01,27,137,MN,St. Louis County,101028,97434,3594,3.6
CN2713900000000,2023-03-01,27,139,MN,Scott County,84428,82189,2239,2.7
CN2714100000000,2023-03-01,27,141,MN,Sherburne County,53561,51487,2074,3.9
CN2714300000000,2023-03-01,27,143,MN,Sibley County,8131,7771,360,4.4
CN2714500000000,2023-03-01,27,145,MN,Stearns County,90839,87988,2851,3.1
CN2714700000000,2023-03-01,27,147,MN,Steele County,18466,17832,634,3.4
CN2714900000000,2023-03-01,27,149,MN,Stevens County,5248,5102,146,2.8
CN2715100000000,2023-03-01,27,151,MN,Swift County,4739,4566,173,3.7
CN2715300000000,2023-03-01,27,153,MN,Todd County,13664,13052,612,4.5
CN2715500000000,2023-03-01,27,155,MN,Traverse County,1626,1561,65,4
CN2715700000000,2023-03-01,27,157,MN,Wabasha County,12368,11938,430,3.5
CN2715900000000,2023-03-01,27,159,MN,Wadena County,6219,5845,374,6
CN2716100000000,2023-03-01,27,161,MN,Waseca County,8401,7981,420,5
CN2716300000000,2023-03-01,27,163,MN,Washington County,144839,141196,3643,2.5
CN2716500000000,2023-03-01,27,165,MN,Watonwan County,6579,6346,233,3.5
CN2716700000000,2023-03-01,27,167,MN,Wilkin County,3404,3317,87,2.6
CN2716900000000,2023-03-01,27,169,MN,Winona County,28615,27919,696,2.4
CN2717100000000,2023-03-01,27,171,MN,Wright County,77097,74294,2803,3.6
CN2717300000000,2023-03-01,27,173,MN,Yellow Medicine County,4960,4792,168,3.4
CN2800100000000,2023-03-01,28,001,MS,Adams County,10400,9947,453,4.4
CN2800300000000,2023-03-01,28,003,MS,Alcorn County,15125,14681,444,2.9
CN2800500000000,2023-03-01,28,005,MS,Amite County,4208,4044,164,3.9
CN2800700000000,2023-03-01,28,007,MS,Attala County,6851,6619,232,3.4
CN2800900000000,2023-03-01,28,009,MS,Benton County,3037,2923,114,3.8
CN2801100000000,2023-03-01,28,011,MS,Bolivar County,10999,10597,402,3.7
CN2801300000000,2023-03-01,28,013,MS,Calhoun County,5290,5111,179,3.4
CN2801500000000,2023-03-01,28,015,MS,Carroll County,3214,3079,135,4.2
CN2801700000000,2023-03-01,28,017,MS,Chickasaw County,6368,6117,251,3.9
CN2801900000000,2023-03-01,28,019,MS,Choctaw County,3535,3438,97,2.7
CN2802100000000,2023-03-01,28,021,MS,Claiborne County,2822,2649,173,6.1
CN2802300000000,2023-03-01,28,023,MS,Clarke County,5549,5358,191,3.4
CN2802500000000,2023-03-01,28,025,MS,Clay County,8984,8718,266,3
CN2802700000000,2023-03-01,28,027,MS,Coahoma County,7410,7067,343,4.6
CN2802900000000,2023-03-01,28,029,MS,Copiah County,10790,10416,374,3.5
CN2803100000000,2023-03-01,28,031,MS,Covington County,8103,7884,219,2.7
CN2803300000000,2023-03-01,28,033,MS,DeSoto County,93689,91212,2477,2.6
CN2803500000000,2023-03-01,28,035,MS,Forrest County,33277,32295,982,3
CN2803700000000,2023-03-01,28,037,MS,Franklin County,2593,2484,109,4.2
CN2803900000000,2023-03-01,28,039,MS,George County,8653,8353,300,3.5
CN2804100000000,2023-03-01,28,041,MS,Greene County,4133,3965,168,4.1
CN2804300000000,2023-03-01,28,043,MS,Grenada County,8579,8171,408,4.8
CN2804500000000,2023-03-01,28,045,MS,Hancock County,18954,18334,620,3.3
CN2804700000000,2023-03-01,28,047,MS,Harrison County,87342,84839,2503,2.9
CN2804900000000,2023-03-01,28,049,MS,Hinds County,101998,98977,3021,3
CN2805100000000,2023-03-01,28,051,MS,Holmes County,5046,4785,261,5.2
CN2805300000000,2023-03-01,28,053,MS,Humphreys County,1916,1807,109,5.7
CN2805500000000,2023-03-01,28,055,MS,Issaquena County,304,283,21,6.9
CN2805700000000,2023-03-01,28,057,MS,Itawamba County,10120,9817,303,3
CN2805900000000,2023-03-01,28,059,MS,Jackson County,58483,56638,1845,3.2
CN2806100000000,2023-03-01,28,061,MS,Jasper County,5835,5617,218,3.7
CN2806300000000,2023-03-01,28,063,MS,Jefferson County,1760,1607,153,8.7
CN2806500000000,2023-03-01,28,065,MS,Jefferson Davis County,3866,3723,143,3.7
CN2806700000000,2023-03-01,28,067,MS,Jones County,24960,24161,799,3.2
CN2806900000000,2023-03-01,28,069,MS,Kemper County,3200,3066,134,4.2
CN2807100000000,2023-03-01,28,071,MS,Lafayette County,28241,27546,695,2.5
CN2807300000000,2023-03-01,28,073,MS,Lamar County,31704,30949,755,2.4
CN2807500000000,2023-03-01,28,075,MS,Lauderdale County,28703,27817,886,3.1
CN2807700000000,2023-03-01,28,077,MS,Lawrence County,4809,4634,175,3.6
CN2807900000000,2023-03-01,28,079,MS,Leake County,7907,7670,237,3
CN2808100000000,2023-03-01,28,081,MS,Lee County,40087,39064,1023,2.6
CN2808300000000,2023-03-01,28,083,MS,Leflore County,9022,8593,429,4.8
CN2808500000000,2023-03-01,28,085,MS,Lincoln County,14400,13961,439,3
CN2808700000000,2023-03-01,28,087,MS,Lowndes County,24577,23810,767,3.1
CN2808900000000,2023-03-01,28,089,MS,Madison County,53593,52290,1303,2.4
CN2809100000000,2023-03-01,28,091,MS,Marion County,9866,9564,302,3.1
CN2809300000000,2023-03-01,28,093,MS,Marshall County,14178,13727,451,3.2
CN2809500000000,2023-03-01,28,095,MS,Monroe County,15260,14620,640,4.2
CN2809700000000,2023-03-01,28,097,MS,Montgomery County,3895,3728,167,4.3
CN2809900000000,2023-03-01,28,099,MS,Neshoba County,9657,9335,322,3.3
CN2810100000000,2023-03-01,28,101,MS,Newton County,7842,7585,257,3.3
CN2810300000000,2023-03-01,28,103,MS,Noxubee County,3319,3172,147,4.4
CN2810500000000,2023-03-01,28,105,MS,Oktibbeha County,22307,21599,708,3.2
CN2810700000000,2023-03-01,28,107,MS,Panola County,12121,11661,460,3.8
CN2810900000000,2023-03-01,28,109,MS,Pearl River County,23423,22712,711,3
CN2811100000000,2023-03-01,28,111,MS,Perry County,4219,4073,146,3.5
CN2811300000000,2023-03-01,28,113,MS,Pike County,13778,13275,503,3.7
CN2811500000000,2023-03-01,28,115,MS,Pontotoc County,14610,14234,376,2.6
CN2811700000000,2023-03-01,28,117,MS,Prentiss County,11221,10916,305,2.7
CN2811900000000,2023-03-01,28,119,MS,Quitman County,2253,2152,101,4.5
CN2812100000000,2023-03-01,28,121,MS,Rankin County,77012,75252,1760,2.3
CN2812300000000,2023-03-01,28,123,MS,Scott County,12163,11855,308,2.5
CN2812500000000,2023-03-01,28,125,MS,Sharkey County,1271,1220,51,4
CN2812700000000,2023-03-01,28,127,MS,Simpson County,10606,10304,302,2.8
CN2812900000000,2023-03-01,28,129,MS,Smith County,6588,6413,175,2.7
CN2813100000000,2023-03-01,28,131,MS,Stone County,7053,6826,227,3.2
CN2813300000000,2023-03-01,28,133,MS,Sunflower County,7104,6763,341,4.8
CN2813500000000,2023-03-01,28,135,MS,Tallahatchie County,4552,4369,183,4
CN2813700000000,2023-03-01,28,137,MS,Tate County,12101,11715,386,3.2
CN2813900000000,2023-03-01,28,139,MS,Tippah County,9862,9606,256,2.6
CN2814100000000,2023-03-01,28,141,MS,Tishomingo County,8691,8437,254,2.9
CN2814300000000,2023-03-01,28,143,MS,Tunica County,4138,3998,140,3.4
CN2814500000000,2023-03-01,28,145,MS,Union County,14685,14361,324,2.2
CN2814700000000,2023-03-01,28,147,MS,Walthall County,4846,4651,195,4
CN2814900000000,2023-03-01,28,149,MS,Warren County,18965,18360,605,3.2
CN2815100000000,2023-03-01,28,151,MS,Washington County,14238,13570,668,4.7
CN2815300000000,2023-03-01,28,153,MS,Wayne County,6882,6644,238,3.5
CN2815500000000,2023-03-01,28,155,MS,Webster County,3847,3729,118,3.1
CN2815700000000,2023-03-01,28,157,MS,Wilkinson County,2562,2436,126,4.9
CN2815900000000,2023-03-01,28,159,MS,Winston County,7066,6845,221,3.1
CN2816100000000,2023-03-01,28,161,MS,Yalobusha County,4653,4465,188,4
CN2816300000000,2023-03-01,28,163,MS,Yazoo County,8826,8544,282,3.2
CN2900100000000,2023-03-01,29,001,MO,Adair County,9825,9491,334,3.4
CN2900300000000,2023-03-01,29,003,MO,Andrew County,9474,9259,215,2.3
CN2900500000000,2023-03-01,29,005,MO,Atchison County,2505,2448,57,2.3
CN2900700000000,2023-03-01,29,007,MO,Audrain County,9725,9426,299,3.1
CN2900900000000,2023-03-01,29,009,MO,Barry County,14074,13669,405,2.9
CN2901100000000,2023-03-01,29,011,MO,Barton County,5222,5071,151,2.9
CN2901300000000,2023-03-01,29,013,MO,Bates County,7756,7528,228,2.9
CN2901500000000,2023-03-01,29,015,MO,Benton County,7266,6982,284,3.9
CN2901700000000,2023-03-01,29,017,MO,Bollinger County,5339,5206,133,2.5
CN2901900000000,2023-03-01,29,019,MO,Boone County,102319,100102,2217,2.2
CN2902100000000,2023-03-01,29,021,MO,Buchanan County,42612,41464,1148,2.7
CN2902300000000,2023-03-01,29,023,MO,Butler County,17961,17005,956,5.3
CN2902500000000,2023-03-01,29,025,MO,Caldwell County,4293,4177,116,2.7
CN2902700000000,2023-03-01,29,027,MO,Callaway County,22136,21589,547,2.5
CN2902900000000,2023-03-01,29,029,MO,Camden County,18533,17869,664,3.6
CN2903100000000,2023-03-01,29,031,MO,Cape Girardeau County,41204,40208,996,2.4
CN2903300000000,2023-03-01,29,033,MO,Carroll County,4343,4228,115,2.6
CN2903500000000,2023-03-01,29,035,MO,Carter County,2456,2335,121,4.9
CN2903700000000,2023-03-01,29,037,MO,Cass County,56261,54794,1467,2.6
CN2903900000000,2023-03-01,29,039,MO,Cedar County,5736,5548,188,3.3
CN2904100000000,2023-03-01,29,041,MO,Chariton County,3737,3647,90,2.4
CN2904300000000,2023-03-01,29,043,MO,Christian County,48407,47276,1131,2.3
CN2904500000000,2023-03-01,29,045,MO,Clark County,2945,2840,105,3.6
CN2904700000000,2023-03-01,29,047,MO,Clay County,141718,138388,3330,2.3
CN2904900000000,2023-03-01,29,049,MO,Clinton County,10786,10503,283,2.6
CN2905100000000,2023-03-01,29,051,MO,Cole County,40263,39400,863,2.1
CN2905300000000,2023-03-01,29,053,MO,Cooper County,7145,6957,188,2.6
CN2905500000000,2023-03-01,29,055,MO,Crawford County,10794,10477,317,2.9
CN2905700000000,2023-03-01,29,057,MO,Dade County,3383,3293,90,2.7
CN2905900000000,2023-03-01,29,059,MO,Dallas County,7287,7093,194,2.7
CN2906100000000,2023-03-01,29,061,MO,Daviess County,3991,3895,96,2.4
CN2906300000000,2023-03-01,29,063,MO,DeKalb County,4037,3925,112,2.8
CN2906500000000,2023-03-01,29,065,MO,Dent County,6124,5933,191,3.1
CN2906700000000,2023-03-01,29,067,MO,Douglas County,5332,5104,228,4.3
CN2906900000000,2023-03-01,29,069,MO,Dunklin County,10919,10402,517,4.7
CN2907100000000,2023-03-01,29,071,MO,Franklin County,53721,52352,1369,2.5
CN2907300000000,2023-03-01,29,073,MO,Gasconade County,7596,7418,178,2.3
CN2907500000000,2023-03-01,29,075,MO,Gentry County,3132,3053,79,2.5
CN2907700000000,2023-03-01,29,077,MO,Greene County,158120,154479,3641,2.3
CN2907900000000,2023-03-01,29,079,MO,Grundy County,4028,3913,115,2.9
CN2908100000000,2023-03-01,29,081,MO,Harrison County,3670,3562,108,2.9
CN2908300000000,2023-03-01,29,083,MO,Henry County,10459,10188,271,2.6
CN2908500000000,2023-03-01,29,085,MO,Hickory County,3957,3825,132,3.3
CN2908700000000,2023-03-01,29,087,MO,Holt County,2422,2366,56,2.3
CN2908900000000,2023-03-01,29,089,MO,Howard County,4755,4629,126,2.6
CN2909100000000,2023-03-01,29,091,MO,Howell County,16210,15665,545,3.4
CN2909300000000,2023-03-01,29,093,MO,Iron County,3455,3300,155,4.5
CN2909500000000,2023-03-01,29,095,MO,Jackson County,368952,358009,10943,3
CN2909700000000,2023-03-01,29,097,MO,Jasper County,57870,56354,1516,2.6
CN2909900000000,2023-03-01,29,099,MO,Jefferson County,119988,116981,3007,2.5
CN2910100000000,2023-03-01,29,101,MO,Johnson County,23131,22449,682,2.9
CN2910300000000,2023-03-01,29,103,MO,Knox County,1682,1636,46,2.7
CN2910500000000,2023-03-01,29,105,MO,Laclede County,16857,16401,456,2.7
CN2910700000000,2023-03-01,29,107,MO,Lafayette County,17015,16576,439,2.6
CN2910900000000,2023-03-01,29,109,MO,Lawrence County,17266,16800,466,2.7
CN2911100000000,2023-03-01,29,111,MO,Lewis County,4731,4602,129,2.7
CN2911300000000,2023-03-01,29,113,MO,Lincoln County,29646,28842,804,2.7
CN2911500000000,2023-03-01,29,115,MO,Linn County,5149,4970,179,3.5
CN2911700000000,2023-03-01,29,117,MO,Livingston County,7078,6934,144,2
CN2911900000000,2023-03-01,29,119,MO,McDonald County,11431,11160,271,2.4
CN2912100000000,2023-03-01,29,121,MO,Macon County,7070,6833,237,3.4
CN2912300000000,2023-03-01,29,123,MO,Madison County,5391,5220,171,3.2
CN2912500000000,2023-03-01,29,125,MO,Maries County,3872,3763,109,2.8
CN2912700000000,2023-03-01,29,127,MO,Marion County,13623,13228,395,2.9
CN2912900000000,2023-03-01,29,129,MO,Mercer County,1667,1624,43,2.6
CN2913100000000,2023-03-01,29,131,MO,Miller County,12876,12491,385,3
CN2913300000000,2023-03-01,29,133,MO,Mississippi County,5088,4913,175,3.4
CN2913500000000,2023-03-01,29,135,MO,Moniteau County,7171,7013,158,2.2
CN2913700000000,2023-03-01,29,137,MO,Monroe County,3754,3632,122,3.2
CN2913900000000,2023-03-01,29,139,MO,Montgomery County,5833,5668,165,2.8
CN2914100000000,2023-03-01,29,141,MO,Morgan County,8354,8063,291,3.5
CN2914300000000,2023-03-01,29,143,MO,New Madrid County,8092,7837,255,3.2
CN2914500000000,2023-03-01,29,145,MO,Newton County,27292,26599,693,2.5
CN2914700000000,2023-03-01,29,147,MO,Nodaway County,11202,10928,274,2.4
CN2914900000000,2023-03-01,29,149,MO,Oregon County,3817,3695,122,3.2
CN2915100000000,2023-03-01,29,151,MO,Osage County,7199,7040,159,2.2
CN2915300000000,2023-03-01,29,153,MO,Ozark County,3419,3258,161,4.7
CN2915500000000,2023-03-01,29,155,MO,Pemiscot County,5696,5475,221,3.9
CN2915700000000,2023-03-01,29,157,MO,Perry County,9397,9183,214,2.3
CN2915900000000,2023-03-01,29,159,MO,Pettis County,20061,19533,528,2.6
CN2916100000000,2023-03-01,29,161,MO,Phelps County,20415,19862,553,2.7
CN2916300000000,2023-03-01,29,163,MO,Pike County,7284,7076,208,2.9
CN2916500000000,2023-03-01,29,165,MO,Platte County,61352,59984,1368,2.2
CN2916700000000,2023-03-01,29,167,MO,Polk County,14945,14559,386,2.6
CN2916900000000,2023-03-01,29,169,MO,Pulaski County,14888,14419,469,3.2
CN2917100000000,2023-03-01,29,171,MO,Putnam County,2093,2033,60,2.9
CN2917300000000,2023-03-01,29,173,MO,Ralls County,5340,5198,142,2.7
CN2917500000000,2023-03-01,29,175,MO,Randolph County,10490,10186,304,2.9
CN2917700000000,2023-03-01,29,177,MO,Ray County,11047,10750,297,2.7
CN2917900000000,2023-03-01,29,179,MO,Reynolds County,2780,2688,92,3.3
CN2918100000000,2023-03-01,29,181,MO,Ripley County,5116,4894,222,4.3
CN2918300000000,2023-03-01,29,183,MO,St. Charles County,232562,227403,5159,2.2
CN2918500000000,2023-03-01,29,185,MO,St. Clair County,3817,3696,121,3.2
CN2918600000000,2023-03-01,29,186,MO,Ste. Genevieve County,9284,9060,224,2.4
CN2918700000000,2023-03-01,29,187,MO,St. Francois County,25579,24671,908,3.5
CN2918900000000,2023-03-01,29,189,MO,St. Louis County,534726,520941,13785,2.6
CN2919500000000,2023-03-01,29,195,MO,Saline County,10464,10194,270,2.6
CN2919700000000,2023-03-01,29,197,MO,Schuyler County,1784,1718,66,3.7
CN2919900000000,2023-03-01,29,199,MO,Scotland County,2223,2174,49,2.2
CN2920100000000,2023-03-01,29,201,MO,Scott County,19925,19398,527,2.6
CN2920300000000,2023-03-01,29,203,MO,Shannon County,3249,3093,156,4.8
CN2920500000000,2023-03-01,29,205,MO,Shelby County,2985,2902,83,2.8
CN2920700000000,2023-03-01,29,207,MO,Stoddard County,13137,12669,468,3.6
CN2920900000000,2023-03-01,29,209,MO,Stone County,13227,12670,557,4.2
CN2921100000000,2023-03-01,29,211,MO,Sullivan County,2551,2471,80,3.1
CN2921300000000,2023-03-01,29,213,MO,Taney County,25395,24264,1131,4.5
CN2921500000000,2023-03-01,29,215,MO,Texas County,9155,8865,290,3.2
CN2921700000000,2023-03-01,29,217,MO,Vernon County,9221,8940,281,3
CN2921900000000,2023-03-01,29,219,MO,Warren County,18996,18521,475,2.5
CN2922100000000,2023-03-01,29,221,MO,Washington County,10117,9761,356,3.5
CN2922300000000,2023-03-01,29,223,MO,Wayne County,4684,4460,224,4.8
CN2922500000000,2023-03-01,29,225,MO,Webster County,17892,17441,451,2.5
CN2922700000000,2023-03-01,29,227,MO,Worth County,1128,1101,27,2.4
CN2922900000000,2023-03-01,29,229,MO,Wright County,7788,7521,267,3.4
CN2951000000000,2023-03-01,29,510,MO,St. Louis city,151023,146209,4814,3.2
CN3000100000000,2023-03-01,30,001,MT,Beaverhead County,5847,5722,125,2.1
CN3000300000000,2023-03-01,30,003,MT,Big Horn County,4662,4455,207,4.4
CN3000500000000,2023-03-01,30,005,MT,Blaine County,2354,2266,88,3.7
CN3000700000000,2023-03-01,30,007,MT,Broadwater County,2861,2756,105,3.7
CN3000900000000,2023-03-01,30,009,MT,Carbon County,5823,5668,155,2.7
CN3001100000000,2023-03-01,30,011,MT,Carter County,742,730,12,1.6
CN3001300000000,2023-03-01,30,013,MT,Cascade County,39787,38722,1065,2.7
CN3001500000000,2023-03-01,30,015,MT,Chouteau County,2596,2526,70,2.7
CN3001700000000,2023-03-01,30,017,MT,Custer County,6493,6295,198,3
CN3001900000000,2023-03-01,30,019,MT,Daniels County,901,885,16,1.8
CN3002100000000,2023-03-01,30,021,MT,Dawson County,4601,4507,94,2
CN3002300000000,2023-03-01,30,023,MT,Deer Lodge County,5540,5379,161,2.9
CN3002500000000,2023-03-01,30,025,MT,Fallon County,1704,1676,28,1.6
CN3002700000000,2023-03-01,30,027,MT,Fergus County,5946,5754,192,3.2
CN3002900000000,2023-03-01,30,029,MT,Flathead County,52981,51054,1927,3.6
CN3003100000000,2023-03-01,30,031,MT,Gallatin County,79638,78134,1504,1.9
CN3003300000000,2023-03-01,30,033,MT,Garfield County,804,774,30,3.7
CN3003500000000,2023-03-01,30,035,MT,Glacier County,5571,5252,319,5.7
CN3003700000000,2023-03-01,30,037,MT,Golden Valley County,384,374,10,2.6
CN3003900000000,2023-03-01,30,039,MT,Granite County,1842,1763,79,4.3
CN3004100000000,2023-03-01,30,041,MT,Hill County,7756,7603,153,2
CN3004300000000,2023-03-01,30,043,MT,Jefferson County,6241,6072,169,2.7
CN3004500000000,2023-03-01,30,045,MT,Judith Basin County,1057,1028,29,2.7
CN3004700000000,2023-03-01,30,047,MT,Lake County,14417,13916,501,3.5
CN3004900000000,2023-03-01,30,049,MT,Lewis and Clark County,39284,38324,960,2.4
CN3005100000000,2023-03-01,30,051,MT,Liberty County,1044,1024,20,1.9
CN3005300000000,2023-03-01,30,053,MT,Lincoln County,8835,8298,537,6.1
CN3005500000000,2023-03-01,30,055,MT,McCone County,1049,1029,20,1.9
CN3005700000000,2023-03-01,30,057,MT,Madison County,5963,5837,126,2.1
CN3005900000000,2023-03-01,30,059,MT,Meagher County,1084,1055,29,2.7
CN3006100000000,2023-03-01,30,061,MT,Mineral County,1865,1753,112,6
CN3006300000000,2023-03-01,30,063,MT,Missoula County,68355,66434,1921,2.8
CN3006500000000,2023-03-01,30,065,MT,Musselshell County,2407,2339,68,2.8
CN3006700000000,2023-03-01,30,067,MT,Park County,9725,9387,338,3.5
CN3006900000000,2023-03-01,30,069,MT,Petroleum County,289,281,8,2.8
CN3007100000000,2023-03-01,30,071,MT,Phillips County,1894,1813,81,4.3
CN3007300000000,2023-03-01,30,073,MT,Pondera County,2736,2672,64,2.3
CN3007500000000,2023-03-01,30,075,MT,Powder River County,1052,1022,30,2.9
CN3007700000000,2023-03-01,30,077,MT,Powell County,2867,2771,96,3.3
CN3007900000000,2023-03-01,30,079,MT,Prairie County,535,514,21,3.9
CN3008100000000,2023-03-01,30,081,MT,Ravalli County,22422,21750,672,3
CN3008300000000,2023-03-01,30,083,MT,Richland County,5868,5742,126,2.1
CN3008500000000,2023-03-01,30,085,MT,Roosevelt County,4405,4241,164,3.7
CN3008700000000,2023-03-01,30,087,MT,Rosebud County,3563,3455,108,3
CN3008900000000,2023-03-01,30,089,MT,Sanders County,5533,5227,306,5.5
CN3009100000000,2023-03-01,30,091,MT,Sheridan County,1792,1746,46,2.6
CN3009300000000,2023-03-01,30,093,MT,Silver Bow County,17963,17346,617,3.4
CN3009500000000,2023-03-01,30,095,MT,Stillwater County,5386,5260,126,2.3
CN3009700000000,2023-03-01,30,097,MT,Sweet Grass County,1973,1934,39,2
CN3009900000000,2023-03-01,30,099,MT,Teton County,2863,2782,81,2.8
CN3010100000000,2023-03-01,30,101,MT,Toole County,2106,2069,37,1.8
CN3010300000000,2023-03-01,30,103,MT,Treasure County,373,365,8,2.1
CN3010500000000,2023-03-01,30,105,MT,Valley County,4060,3948,112,2.8
CN3010700000000,2023-03-01,30,107,MT,Wheatland County,815,780,35,4.3
CN3010900000000,2023-03-01,30,109,MT,Wibaux County,453,445,8,1.8
CN3011100000000,2023-03-01,30,111,MT,Yellowstone County,86195,84079,2116,2.5
CN3100100000000,2023-03-01,31,001,NE,Adams County,17196,16873,323,1.9
CN3100300000000,2023-03-01,31,003,NE,Antelope County,3567,3497,70,2
CN3100500000000,2023-03-01,31,005,NE,Arthur County,216,211,5,2.3
CN3100700000000,2023-03-01,31,007,NE,Banner County,373,365,8,2.1
CN3100900000000,2023-03-01,31,009,NE,Blaine County,237,227,10,4.2
CN3101100000000,2023-03-01,31,011,NE,Boone County,2953,2904,49,1.7
CN3101300000000,2023-03-01,31,013,NE,Box Butte County,5309,5220,89,1.7
CN3101500000000,2023-03-01,31,015,NE,Boyd County,1012,988,24,2.4
CN3101700000000,2023-03-01,31,017,NE,Brown County,1376,1347,29,2.1
CN3101900000000,2023-03-01,31,019,NE,Buffalo County,28487,28028,459,1.6
CN3102100000000,2023-03-01,31,021,NE,Burt County,3555,3469,86,2.4
CN3102300000000,2023-03-01,31,023,NE,Butler County,4698,4635,63,1.3
CN3102500000000,2023-03-01,31,025,NE,Cass County,13808,13509,299,2.2
CN3102700000000,2023-03-01,31,027,NE,Cedar County,4622,4541,81,1.8
CN3102900000000,2023-03-01,31,029,NE,Chase County,2215,2183,32,1.4
CN3103100000000,2023-03-01,31,031,NE,Cherry County,3203,3145,58,1.8
CN3103300000000,2023-03-01,31,033,NE,Cheyenne County,4221,4135,86,2
CN3103500000000,2023-03-01,31,035,NE,Clay County,2957,2889,68,2.3
CN3103700000000,2023-03-01,31,037,NE,Colfax County,5749,5663,86,1.5
CN3103900000000,2023-03-01,31,039,NE,Cuming County,4793,4713,80,1.7
CN3104100000000,2023-03-01,31,041,NE,Custer County,6265,6172,93,1.5
CN3104300000000,2023-03-01,31,043,NE,Dakota County,11208,10900,308,2.7
CN3104500000000,2023-03-01,31,045,NE,Dawes County,4950,4870,80,1.6
CN3104700000000,2023-03-01,31,047,NE,Dawson County,13657,13355,302,2.2
CN3104900000000,2023-03-01,31,049,NE,Deuel County,1028,1007,21,2
CN3105100000000,2023-03-01,31,051,NE,Dixon County,3033,2965,68,2.2
CN3105300000000,2023-03-01,31,053,NE,Dodge County,21074,20671,403,1.9
CN3105500000000,2023-03-01,31,055,NE,Douglas County,310303,303097,7206,2.3
CN3105700000000,2023-03-01,31,057,NE,Dundy County,1152,1134,18,1.6
CN3105900000000,2023-03-01,31,059,NE,Fillmore County,3311,3248,63,1.9
CN3106100000000,2023-03-01,31,061,NE,Franklin County,1511,1482,29,1.9
CN3106300000000,2023-03-01,31,063,NE,Frontier County,1480,1451,29,2
CN3106500000000,2023-03-01,31,065,NE,Furnas County,2469,2432,37,1.5
CN3106700000000,2023-03-01,31,067,NE,Gage County,10865,10628,237,2.2
CN3106900000000,2023-03-01,31,069,NE,Garden County,1069,1048,21,2
CN3107100000000,2023-03-01,31,071,NE,Garfield County,1124,1105,19,1.7
CN3107300000000,2023-03-01,31,073,NE,Gosper County,1179,1153,26,2.2
CN3107500000000,2023-03-01,31,075,NE,Grant County,409,404,5,1.2
CN3107700000000,2023-03-01,31,077,NE,Greeley County,1212,1186,26,2.1
CN3107900000000,2023-03-01,31,079,NE,Hall County,33343,32614,729,2.2
CN3108100000000,2023-03-01,31,081,NE,Hamilton County,4917,4836,81,1.6
CN3108300000000,2023-03-01,31,083,NE,Harlan County,1798,1766,32,1.8
CN3108500000000,2023-03-01,31,085,NE,Hayes County,573,565,8,1.4
CN3108700000000,2023-03-01,31,087,NE,Hitchcock County,1293,1264,29,2.2
CN3108900000000,2023-03-01,31,089,NE,Holt County,5524,5422,102,1.8
CN3109100000000,2023-03-01,31,091,NE,Hooker County,340,334,6,1.8
CN3109300000000,2023-03-01,31,093,NE,Howard County,3498,3435,63,1.8
CN3109500000000,2023-03-01,31,095,NE,Jefferson County,4197,4127,70,1.7
CN3109700000000,2023-03-01,31,097,NE,Johnson County,2046,1976,70,3.4
CN3109900000000,2023-03-01,31,099,NE,Kearney County,3706,3659,47,1.3
CN3110100000000,2023-03-01,31,101,NE,Keith County,4553,4483,70,1.5
CN3110300000000,2023-03-01,31,103,NE,Keya Paha County,540,530,10,1.9
CN3110500000000,2023-03-01,31,105,NE,Kimball County,1942,1910,32,1.6
CN3110700000000,2023-03-01,31,107,NE,Knox County,4518,4429,89,2
CN3110900000000,2023-03-01,31,109,NE,Lancaster County,183755,180308,3447,1.9
CN3111100000000,2023-03-01,31,111,NE,Lincoln County,18323,17979,344,1.9
CN3111300000000,2023-03-01,31,113,NE,Logan County,478,465,13,2.7
CN3111500000000,2023-03-01,31,115,NE,Loup County,394,384,10,2.5
CN3111700000000,2023-03-01,31,117,NE,McPherson County,435,427,8,1.8
CN3111900000000,2023-03-01,31,119,NE,Madison County,19896,19505,391,2
CN3112100000000,2023-03-01,31,121,NE,Merrick County,4201,4128,73,1.7
CN3112300000000,2023-03-01,31,123,NE,Morrill County,2589,2542,47,1.8
CN3112500000000,2023-03-01,31,125,NE,Nance County,1921,1890,31,1.6
CN3112700000000,2023-03-01,31,127,NE,Nemaha County,3664,3599,65,1.8
CN3112900000000,2023-03-01,31,129,NE,Nuckolls County,2453,2403,50,2
CN3113100000000,2023-03-01,31,131,NE,Otoe County,8626,8454,172,2
CN3113300000000,2023-03-01,31,133,NE,Pawnee County,1476,1448,28,1.9
CN3113500000000,2023-03-01,31,135,NE,Perkins County,1803,1775,28,1.6
CN3113700000000,2023-03-01,31,137,NE,Phelps County,5001,4926,75,1.5
CN3113900000000,2023-03-01,31,139,NE,Pierce County,4146,4079,67,1.6
CN3114100000000,2023-03-01,31,141,NE,Platte County,18681,18373,308,1.6
CN3114300000000,2023-03-01,31,143,NE,Polk County,2842,2792,50,1.8
CN3114500000000,2023-03-01,31,145,NE,Red Willow County,5892,5803,89,1.5
CN3114700000000,2023-03-01,31,147,NE,Richardson County,4176,4114,62,1.5
CN3114900000000,2023-03-01,31,149,NE,Rock County,886,876,10,1.1
CN3115100000000,2023-03-01,31,151,NE,Saline County,7239,7056,183,2.5
CN3115300000000,2023-03-01,31,153,NE,Sarpy County,101147,99200,1947,1.9
CN3115500000000,2023-03-01,31,155,NE,Saunders County,11604,11409,195,1.7
CN3115700000000,2023-03-01,31,157,NE,Scotts Bluff County,17827,17389,438,2.5
CN3115900000000,2023-03-01,31,159,NE,Seward County,8937,8786,151,1.7
CN3116100000000,2023-03-01,31,161,NE,Sheridan County,2757,2705,52,1.9
CN3116300000000,2023-03-01,31,163,NE,Sherman County,1649,1620,29,1.8
CN3116500000000,2023-03-01,31,165,NE,Sioux County,732,717,15,2
CN3116700000000,2023-03-01,31,167,NE,Stanton County,3523,3456,67,1.9
CN3116900000000,2023-03-01,31,169,NE,Thayer County,2683,2642,41,1.5
CN3117100000000,2023-03-01,31,171,NE,Thomas County,439,423,16,3.6
CN3117300000000,2023-03-01,31,173,NE,Thurston County,3278,3198,80,2.4
CN3117500000000,2023-03-01,31,175,NE,Valley County,2097,2055,42,2
CN3117700000000,2023-03-01,31,177,NE,Washington County,11590,11377,213,1.8
CN3117900000000,2023-03-01,31,179,NE,Wayne County,5847,5756,91,1.6
CN3118100000000,2023-03-01,31,181,NE,Webster County,1643,1607,36,2.2
CN3118300000000,2023-03-01,31,183,NE,Wheeler County,542,531,11,2
CN3118500000000,2023-03-01,31,185,NE,York County,7337,7193,144,2
CN3200100000000,2023-03-01,32,001,NV,Churchill County,10923,10437,486,4.4
CN3200300000000,2023-03-01,32,003,NV,Clark County,1164280,1097955,66325,5.7
CN3200500000000,2023-03-01,32,005,NV,Douglas County,22193,21132,1061,4.8
CN3200700000000,2023-03-01,32,007,NV,Elko County,25396,24437,959,3.8
CN3200900000000,2023-03-01,32,009,NV,Esmeralda County,423,407,16,3.8
CN3201100000000,2023-03-01,32,011,NV,Eureka County,1039,1005,34,3.3
CN3201300000000,2023-03-01,32,013,NV,Humboldt County,7757,7461,296,3.8
CN3201500000000,2023-03-01,32,015,NV,Lander County,3074,2961,113,3.7
CN3201700000000,2023-03-01,32,017,NV,Lincoln County,2047,1953,94,4.6
CN3201900000000,2023-03-01,32,019,NV,Lyon County,23773,22239,1534,6.5
CN3202100000000,2023-03-01,32,021,NV,Mineral County,2001,1899,102,5.1
CN3202300000000,2023-03-01,32,023,NV,Nye County,17982,16858,1124,6.3
CN3202700000000,2023-03-01,32,027,NV,Pershing County,2451,2326,125,5.1
CN3202900000000,2023-03-01,32,029,NV,Storey County,2121,2030,91,4.3
CN3203100000000,2023-03-01,32,031,NV,Washoe County,262596,251049,11547,4.4
CN3203300000000,2023-03-01,32,033,NV,White Pine County,4409,4241,168,3.8
CN3251000000000,2023-03-01,32,510,NV,Carson City,25834,24515,1319,5.1
CN3300100000000,2023-03-01,33,001,NH,Belknap County,29846,29199,647,2.2
CN3300300000000,2023-03-01,33,003,NH,Carroll County,22326,21824,502,2.2
CN3300500000000,2023-03-01,33,005,NH,Cheshire County,38823,37937,886,2.3
CN3300700000000,2023-03-01,33,007,NH,Coos County,13673,13262,411,3
CN3300900000000,2023-03-01,33,009,NH,Grafton County,47884,47013,871,1.8
CN3301100000000,2023-03-01,33,011,NH,Hillsborough County,240944,235342,5602,2.3
CN3301300000000,2023-03-01,33,013,NH,Merrimack County,81770,80331,1439,1.8
CN3301500000000,2023-03-01,33,015,NH,Rockingham County,187253,182700,4553,2.4
CN3301700000000,2023-03-01,33,017,NH,Strafford County,73861,72510,1351,1.8
CN3301900000000,2023-03-01,33,019,NH,Sullivan County,22504,22114,390,1.7
CN3400100000000,2023-03-01,34,001,NJ,Atlantic County,126118,119550,6568,5.2
CN3400300000000,2023-03-01,34,003,NJ,Bergen County,519223,502312,16911,3.3
CN3400500000000,2023-03-01,34,005,NJ,Burlington County,254163,245544,8619,3.4
CN3400700000000,2023-03-01,34,007,NJ,Camden County,278368,266922,11446,4.1
CN3400900000000,2023-03-01,34,009,NJ,Cape May County,43331,39082,4249,9.8
CN3401100000000,2023-03-01,34,011,NJ,Cumberland County,70217,66147,4070,5.8
CN3401300000000,2023-03-01,34,013,NJ,Essex County,399045,380102,18943,4.7
CN3401500000000,2023-03-01,34,015,NJ,Gloucester County,165667,159538,6129,3.7
CN3401700000000,2023-03-01,34,017,NJ,Hudson County,389514,375289,14225,3.7
CN3401900000000,2023-03-01,34,019,NJ,Hunterdon County,69457,67289,2168,3.1
CN3402100000000,2023-03-01,34,021,NJ,Mercer County,224541,217305,7236,3.2
CN3402300000000,2023-03-01,34,023,NJ,Middlesex County,474445,458329,16116,3.4
CN3402500000000,2023-03-01,34,025,NJ,Monmouth County,355433,343560,11873,3.3
CN3402700000000,2023-03-01,34,027,NJ,Morris County,275837,267034,8803,3.2
CN3402900000000,2023-03-01,34,029,NJ,Ocean County,305247,293560,11687,3.8
CN3403100000000,2023-03-01,34,031,NJ,Passaic County,261396,248972,12424,4.8
CN3403300000000,2023-03-01,34,033,NJ,Salem County,31253,29729,1524,4.9
CN3403500000000,2023-03-01,34,035,NJ,Somerset County,184069,178035,6034,3.3
CN3403700000000,2023-03-01,34,037,NJ,Sussex County,79405,76283,3122,3.9
CN3403900000000,2023-03-01,34,039,NJ,Union County,297906,285566,12340,4.1
CN3404100000000,2023-03-01,34,041,NJ,Warren County,60323,58130,2193,3.6
CN3500100000000,2023-03-01,35,001,NM,Bernalillo County,339209,329890,9319,2.7
CN3500300000000,2023-03-01,35,003,NM,Catron County,1051,1001,50,4.8
CN3500500000000,2023-03-01,35,005,NM,Chaves County,27262,26440,822,3
CN3500600000000,2023-03-01,35,006,NM,Cibola County,8250,7889,361,4.4
CN3500700000000,2023-03-01,35,007,NM,Colfax County,5063,4923,140,2.8
CN3500900000000,2023-03-01,35,009,NM,Curry County,22033,21537,496,2.3
CN3501100000000,2023-03-01,35,011,NM,De Baca County,704,685,19,2.7
CN3501300000000,2023-03-01,35,013,NM,Dona Ana County,101119,97153,3966,3.9
CN3501500000000,2023-03-01,35,015,NM,Eddy County,32181,31512,669,2.1
CN3501700000000,2023-03-01,35,017,NM,Grant County,11700,11351,349,3
CN3501900000000,2023-03-01,35,019,NM,Guadalupe County,1375,1324,51,3.7
CN3502100000000,2023-03-01,35,021,NM,Harding County,286,276,10,3.5
CN3502300000000,2023-03-01,35,023,NM,Hidalgo County,1845,1796,49,2.7
CN3502500000000,2023-03-01,35,025,NM,Lea County,28799,27988,811,2.8
CN3502700000000,2023-03-01,35,027,NM,Lincoln County,8551,8308,243,2.8
CN3502800000000,2023-03-01,35,028,NM,Los Alamos County,11036,10882,154,1.4
CN3502900000000,2023-03-01,35,029,NM,Luna County,9817,8669,1148,11.7
CN3503100000000,2023-03-01,35,031,NM,McKinley County,23765,22837,928,3.9
CN3503300000000,2023-03-01,35,033,NM,Mora County,2002,1919,83,4.1
CN3503500000000,2023-03-01,35,035,NM,Otero County,25782,24961,821,3.2
CN3503700000000,2023-03-01,35,037,NM,Quay County,2892,2792,100,3.5
CN3503900000000,2023-03-01,35,039,NM,Rio Arriba County,16499,16004,495,3
CN3504100000000,2023-03-01,35,041,NM,Roosevelt County,8588,8361,227,2.6
CN3504300000000,2023-03-01,35,043,NM,Sandoval County,68422,66479,1943,2.8
CN3504500000000,2023-03-01,35,045,NM,San Juan County,49885,48065,1820,3.6
CN3504700000000,2023-03-01,35,047,NM,San Miguel County,10709,10314,395,3.7
CN3504900000000,2023-03-01,35,049,NM,Santa Fe County,72378,70461,1917,2.6
CN3505100000000,2023-03-01,35,051,NM,Sierra County,3847,3601,246,6.4
CN3505300000000,2023-03-01,35,053,NM,Socorro County,6075,5878,197,3.2
CN3505500000000,2023-03-01,35,055,NM,Taos County,14589,14030,559,3.8
CN3505700000000,2023-03-01,35,057,NM,Torrance County,5352,5120,232,4.3
CN3505900000000,2023-03-01,35,059,NM,Union County,1548,1512,36,2.3
CN3506100000000,2023-03-01,35,061,NM,Valencia County,31120,30092,1028,3.3
CN3600100000000,2023-03-01,36,001,NY,Albany County,160363,155792,4571,2.9
CN3600300000000,2023-03-01,36,003,NY,Allegany County,19594,18780,814,4.2
CN3600500000000,2023-03-01,36,005,NY,Bronx County,610623,568319,42304,6.9
CN3600700000000,2023-03-01,36,007,NY,Broome County,82622,79550,3072,3.7
CN3600900000000,2023-03-01,36,009,NY,Cattaraugus County,33356,31942,1414,4.2
CN3601100000000,2023-03-01,36,011,NY,Cayuga County,35400,34142,1258,3.6
CN3601300000000,2023-03-01,36,013,NY,Chautauqua County,53882,51630,2252,4.2
CN3601500000000,2023-03-01,36,015,NY,Chemung County,34516,33246,1270,3.7
CN3601700000000,2023-03-01,36,017,NY,Chenango County,21761,20995,766,3.5
CN3601900000000,2023-03-01,36,019,NY,Clinton County,35058,33858,1200,3.4
CN3602100000000,2023-03-01,36,021,NY,Columbia County,30091,29226,865,2.9
CN3602300000000,2023-03-01,36,023,NY,Cortland County,23399,22435,964,4.1
CN3602500000000,2023-03-01,36,025,NY,Delaware County,18547,17820,727,3.9
CN3602700000000,2023-03-01,36,027,NY,Dutchess County,143735,139604,4131,2.9
CN3602900000000,2023-03-01,36,029,NY,Erie County,445514,429809,15705,3.5
CN3603100000000,2023-03-01,36,031,NY,Essex County,16468,15754,714,4.3
CN3603300000000,2023-03-01,36,033,NY,Franklin County,18941,18228,713,3.8
CN3603500000000,2023-03-01,36,035,NY,Fulton County,22540,21554,986,4.4
CN3603700000000,2023-03-01,36,037,NY,Genesee County,29554,28529,1025,3.5
CN3603900000000,2023-03-01,36,039,NY,Greene County,20432,19702,730,3.6
CN3604100000000,2023-03-01,36,041,NY,Hamilton County,2083,1953,130,6.2
CN3604300000000,2023-03-01,36,043,NY,Herkimer County,27431,26260,1171,4.3
CN3604500000000,2023-03-01,36,045,NY,Jefferson County,43650,41689,1961,4.5
CN3604700000000,2023-03-01,36,047,NY,Kings County,1228893,1162225,66668,5.4
CN3604900000000,2023-03-01,36,049,NY,Lewis County,11674,11057,617,5.3
CN3605100000000,2023-03-01,36,051,NY,Livingston County,30315,29268,1047,3.5
CN3605300000000,2023-03-01,36,053,NY,Madison County,33022,31803,1219,3.7
CN3605500000000,2023-03-01,36,055,NY,Monroe County,364503,352785,11718,3.2
CN3605700000000,2023-03-01,36,057,NY,Montgomery County,22310,21323,987,4.4
CN3605900000000,2023-03-01,36,059,NY,Nassau County,730332,710835,19497,2.7
CN3606100000000,2023-03-01,36,061,NY,New York County,938019,895824,42195,4.5
CN3606300000000,2023-03-01,36,063,NY,Niagara County,98524,94605,3919,4
CN3606500000000,2023-03-01,36,065,NY,Oneida County,99979,96534,3445,3.4
CN3606700000000,2023-03-01,36,067,NY,Onondaga County,224491,217420,7071,3.1
CN3606900000000,2023-03-01,36,069,NY,Ontario County,55990,54168,1822,3.3
CN3607100000000,2023-03-01,36,071,NY,Orange County,190318,184547,5771,3
CN3607300000000,2023-03-01,36,073,NY,Orleans County,17144,16457,687,4
CN3607500000000,2023-03-01,36,075,NY,Oswego County,53085,50881,2204,4.2
CN3607700000000,2023-03-01,36,077,NY,Otsego County,26846,25818,1028,3.8
CN3607900000000,2023-03-01,36,079,NY,Putnam County,51029,49640,1389,2.7
CN3608100000000,2023-03-01,36,081,NY,Queens County,1157934,1104457,53477,4.6
CN3608300000000,2023-03-01,36,083,NY,Rensselaer County,82847,80342,2505,3
CN3608500000000,2023-03-01,36,085,NY,Richmond County,230248,219069,11179,4.9
CN3608700000000,2023-03-01,36,087,NY,Rockland County,159365,155222,4143,2.6
CN3608900000000,2023-03-01,36,089,NY,St. Lawrence County,42954,41216,1738,4
CN3609100000000,2023-03-01,36,091,NY,Saratoga County,122681,119376,3305,2.7
CN3609300000000,2023-03-01,36,093,NY,Schenectady County,78405,75950,2455,3.1
CN3609500000000,2023-03-01,36,095,NY,Schoharie County,14985,14324,661,4.4
CN3609700000000,2023-03-01,36,097,NY,Schuyler County,7853,7502,351,4.5
CN3609900000000,2023-03-01,36,099,NY,Seneca County,14632,14110,522,3.6
CN3610100000000,2023-03-01,36,101,NY,Steuben County,40994,39333,1661,4.1
CN3610300000000,2023-03-01,36,103,NY,Suffolk County,802768,778014,24754,3.1
CN3610500000000,2023-03-01,36,105,NY,Sullivan County,37159,35967,1192,3.2
CN3610700000000,2023-03-01,36,107,NY,Tioga County,22356,21616,740,3.3
CN3610900000000,2023-03-01,36,109,NY,Tompkins County,51009,49767,1242,2.4
CN3611100000000,2023-03-01,36,111,NY,Ulster County,87618,84907,2711,3.1
CN3611300000000,2023-03-01,36,113,NY,Warren County,31144,29923,1221,3.9
CN3611500000000,2023-03-01,36,115,NY,Washington County,27292,26342,950,3.5
CN3611700000000,2023-03-01,36,117,NY,Wayne County,43470,41979,1491,3.4
CN3611900000000,2023-03-01,36,119,NY,Westchester County,496805,482385,14420,2.9
CN3612100000000,2023-03-01,36,121,NY,Wyoming County,17230,16480,750,4.4
CN3612300000000,2023-03-01,36,123,NY,Yates County,11637,11265,372,3.2
CN3700100000000,2023-03-01,37,001,NC,Alamance County,84106,81092,3014,3.6
CN3700300000000,2023-03-01,37,003,NC,Alexander County,18251,17700,551,3
CN3700500000000,2023-03-01,37,005,NC,Alleghany County,4642,4474,168,3.6
CN3700700000000,2023-03-01,37,007,NC,Anson County,10417,10009,408,3.9
CN3700900000000,2023-03-01,37,009,NC,Ashe County,12867,12448,419,3.3
CN3701100000000,2023-03-01,37,011,NC,Avery County,7691,7440,251,3.3
CN3701300000000,2023-03-01,37,013,NC,Beaufort County,20309,19507,802,3.9
CN3701500000000,2023-03-01,37,015,NC,Bertie County,7229,6912,317,4.4
CN3701700000000,2023-03-01,37,017,NC,Bladen County,15093,14455,638,4.2
CN3701900000000,2023-03-01,37,019,NC,Brunswick County,57733,55143,2590,4.5
CN3702100000000,2023-03-01,37,021,NC,Buncombe County,143725,139712,4013,2.8
CN3702300000000,2023-03-01,37,023,NC,Burke County,41269,39943,1326,3.2
CN3702500000000,2023-03-01,37,025,NC,Cabarrus County,118075,114130,3945,3.3
CN3702700000000,2023-03-01,37,027,NC,Caldwell County,36737,35506,1231,3.4
CN3702900000000,2023-03-01,37,029,NC,Camden County,4753,4596,157,3.3
CN3703100000000,2023-03-01,37,031,NC,Carteret County,32110,31008,1102,3.4
CN3703300000000,2023-03-01,37,033,NC,Caswell County,9775,9417,358,3.7
CN3703500000000,2023-03-01,37,035,NC,Catawba County,80321,77679,2642,3.3
CN3703700000000,2023-03-01,37,037,NC,Chatham County,37828,36701,1127,3
CN3703900000000,2023-03-01,37,039,NC,Cherokee County,11363,10932,431,3.8
CN3704100000000,2023-03-01,37,041,NC,Chowan County,5956,5728,228,3.8
CN3704300000000,2023-03-01,37,043,NC,Clay County,4376,4225,151,3.5
CN3704500000000,2023-03-01,37,045,NC,Cleveland County,50185,48385,1800,3.6
CN3704700000000,2023-03-01,37,047,NC,Columbus County,24457,23500,957,3.9
CN3704900000000,2023-03-01,37,049,NC,Craven County,42360,40827,1533,3.6
CN3705100000000,2023-03-01,37,051,NC,Cumberland County,127957,121595,6362,5
CN3705300000000,2023-03-01,37,053,NC,Currituck County,14667,14180,487,3.3
CN3705500000000,2023-03-01,37,055,NC,Dare County,18605,17598,1007,5.4
CN3705700000000,2023-03-01,37,057,NC,Davidson County,82884,80046,2838,3.4
CN3705900000000,2023-03-01,37,059,NC,Davie County,21133,20468,665,3.1
CN3706100000000,2023-03-01,37,061,NC,Duplin County,25633,24777,856,3.3
CN3706300000000,2023-03-01,37,063,NC,Durham County,181172,175528,5644,3.1
CN3706500000000,2023-03-01,37,065,NC,Edgecombe County,20294,19082,1212,6
CN3706700000000,2023-03-01,37,067,NC,Forsyth County,191795,185018,6777,3.5
CN3706900000000,2023-03-01,37,069,NC,Franklin County,34565,33312,1253,3.6
CN3707100000000,2023-03-01,37,071,NC,Gaston County,116482,112361,4121,3.5
CN3707300000000,2023-03-01,37,073,NC,Gates County,5145,4973,172,3.3
CN3707500000000,2023-03-01,37,075,NC,Graham County,2904,2773,131,4.5
CN3707700000000,2023-03-01,37,077,NC,Granville County,30707,29773,934,3
CN3707900000000,2023-03-01,37,079,NC,Greene County,9771,9464,307,3.1
CN3708100000000,2023-03-01,37,081,NC,Guilford County,262497,252068,10429,4
CN3708300000000,2023-03-01,37,083,NC,Halifax County,19463,18464,999,5.1
CN3708500000000,2023-03-01,37,085,NC,Harnett County,56005,53799,2206,3.9
CN3708700000000,2023-03-01,37,087,NC,Haywood County,30593,29675,918,3
CN3708900000000,2023-03-01,37,089,NC,Henderson County,56265,54612,1653,2.9
CN3709100000000,2023-03-01,37,091,NC,Hertford County,8589,8166,423,4.9
CN3709300000000,2023-03-01,37,093,NC,Hoke County,20319,19376,943,4.6
CN3709500000000,2023-03-01,37,095,NC,Hyde County,1716,1565,151,8.8
CN3709700000000,2023-03-01,37,097,NC,Iredell County,96229,93016,3213,3.3
CN3709900000000,2023-03-01,37,099,NC,Jackson County,19570,18806,764,3.9
CN3710100000000,2023-03-01,37,101,NC,Johnston County,109878,106329,3549,3.2
CN3710300000000,2023-03-01,37,103,NC,Jones County,4388,4247,141,3.2
CN3710500000000,2023-03-01,37,105,NC,Lee County,26687,25641,1046,3.9
CN3710700000000,2023-03-01,37,107,NC,Lenoir County,27789,26805,984,3.5
CN3710900000000,2023-03-01,37,109,NC,Lincoln County,47114,45668,1446,3.1
CN3711100000000,2023-03-01,37,111,NC,McDowell County,20610,19947,663,3.2
CN3711300000000,2023-03-01,37,113,NC,Macon County,15999,15440,559,3.5
CN3711500000000,2023-03-01,37,115,NC,Madison County,10213,9888,325,3.2
CN3711700000000,2023-03-01,37,117,NC,Martin County,8716,8345,371,4.3
CN3711900000000,2023-03-01,37,119,NC,Mecklenburg County,663081,639736,23345,3.5
CN3712100000000,2023-03-01,37,121,NC,Mitchell County,6145,5925,220,3.6
CN3712300000000,2023-03-01,37,123,NC,Montgomery County,11221,10829,392,3.5
CN3712500000000,2023-03-01,37,125,NC,Moore County,42732,41232,1500,3.5
CN3712700000000,2023-03-01,37,127,NC,Nash County,42454,40436,2018,4.8
CN3712900000000,2023-03-01,37,129,NC,New Hanover County,132288,128008,4280,3.2
CN3713100000000,2023-03-01,37,131,NC,Northampton County,7368,7028,340,4.6
CN3713300000000,2023-03-01,37,133,NC,Onslow County,70273,67480,2793,4
CN3713500000000,2023-03-01,37,135,NC,Orange County,82341,79942,2399,2.9
CN3713700000000,2023-03-01,37,137,NC,Pamlico County,5547,5361,186,3.4
CN3713900000000,2023-03-01,37,139,NC,Pasquotank County,16967,16236,731,4.3
CN3714100000000,2023-03-01,37,141,NC,Pender County,31431,30418,1013,3.2
CN3714300000000,2023-03-01,37,143,NC,Perquimans County,5048,4843,205,4.1
CN3714500000000,2023-03-01,37,145,NC,Person County,19062,18387,675,3.5
CN3714700000000,2023-03-01,37,147,NC,Pitt County,89415,85852,3563,4
CN3714900000000,2023-03-01,37,149,NC,Polk County,9381,9056,325,3.5
CN3715100000000,2023-03-01,37,151,NC,Randolph County,66045,63712,2333,3.5
CN3715300000000,2023-03-01,37,153,NC,Richmond County,17179,16365,814,4.7
CN3715500000000,2023-03-01,37,155,NC,Robeson County,48541,46092,2449,5
CN3715700000000,2023-03-01,37,157,NC,Rockingham County,39864,38256,1608,4
CN3715900000000,2023-03-01,37,159,NC,Rowan County,68787,66400,2387,3.5
CN3716100000000,2023-03-01,37,161,NC,Rutherford County,24992,23846,1146,4.6
CN3716300000000,2023-03-01,37,163,NC,Sampson County,29967,28952,1015,3.4
CN3716500000000,2023-03-01,37,165,NC,Scotland County,11432,10699,733,6.4
CN3716700000000,2023-03-01,37,167,NC,Stanly County,31267,30273,994,3.2
CN3716900000000,2023-03-01,37,169,NC,Stokes County,21978,21301,677,3.1
CN3717100000000,2023-03-01,37,171,NC,Surry County,33025,31939,1086,3.3
CN3717300000000,2023-03-01,37,173,NC,Swain County,7074,6832,242,3.4
CN3717500000000,2023-03-01,37,175,NC,Transylvania County,14735,14271,464,3.1
CN3717700000000,2023-03-01,37,177,NC,Tyrrell County,1268,1181,87,6.9
CN3717900000000,2023-03-01,37,179,NC,Union County,132438,128377,4061,3.1
CN3718100000000,2023-03-01,37,181,NC,Vance County,16883,15934,949,5.6
CN3718300000000,2023-03-01,37,183,NC,Wake County,641115,621503,19612,3.1
CN3718500000000,2023-03-01,37,185,NC,Warren County,6380,6015,365,5.7
CN3718700000000,2023-03-01,37,187,NC,Washington County,4273,4066,207,4.8
CN3718900000000,2023-03-01,37,189,NC,Watauga County,29409,28487,922,3.1
CN3719100000000,2023-03-01,37,191,NC,Wayne County,51370,49418,1952,3.8
CN3719300000000,2023-03-01,37,193,NC,Wilkes County,27057,26079,978,3.6
CN3719500000000,2023-03-01,37,195,NC,Wilson County,34151,32425,1726,5.1
CN3719700000000,2023-03-01,37,197,NC,Yadkin County,17989,17425,564,3.1
CN3719900000000,2023-03-01,37,199,NC,Yancey County,8246,7968,278,3.4
CN3800100000000,2023-03-01,38,001,ND,Adams County,954,931,23,2.4
CN3800300000000,2023-03-01,38,003,ND,Barnes County,5266,5111,155,2.9
CN3800500000000,2023-03-01,38,005,ND,Benson County,2312,2232,80,3.5
CN3800700000000,2023-03-01,38,007,ND,Billings County,392,382,10,2.6
CN3800900000000,2023-03-01,38,009,ND,Bottineau County,3016,2916,100,3.3
CN3801100000000,2023-03-01,38,011,ND,Bowman County,1536,1515,21,1.4
CN3801300000000,2023-03-01,38,013,ND,Burke County,1055,1032,23,2.2
CN3801500000000,2023-03-01,38,015,ND,Burleigh County,51775,50571,1204,2.3
CN3801700000000,2023-03-01,38,017,ND,Cass County,111438,108904,2534,2.3
CN3801900000000,2023-03-01,38,019,ND,Cavalier County,1861,1792,69,3.7
CN3802100000000,2023-03-01,38,021,ND,Dickey County,2233,2186,47,2.1
CN3802300000000,2023-03-01,38,023,ND,Divide County,1416,1393,23,1.6
CN3802500000000,2023-03-01,38,025,ND,Dunn County,3206,3163,43,1.3
CN3802700000000,2023-03-01,38,027,ND,Eddy County,1241,1191,50,4
CN3802900000000,2023-03-01,38,029,ND,Emmons County,1501,1399,102,6.8
CN3803100000000,2023-03-01,38,031,ND,Foster County,1516,1479,37,2.4
CN3803300000000,2023-03-01,38,033,ND,Golden Valley County,869,849,20,2.3
CN3803500000000,2023-03-01,38,035,ND,Grand Forks County,38461,37621,840,2.2
CN3803700000000,2023-03-01,38,037,ND,Grant County,1250,1227,23,1.8
CN3803900000000,2023-03-01,38,039,ND,Griggs County,1048,1019,29,2.8
CN3804100000000,2023-03-01,38,041,ND,Hettinger County,1383,1356,27,2
CN3804300000000,2023-03-01,38,043,ND,Kidder County,1375,1301,74,5.4
CN3804500000000,2023-03-01,38,045,ND,LaMoure County,2171,2121,50,2.3
CN3804700000000,2023-03-01,38,047,ND,Logan County,891,861,30,3.4
CN3804900000000,2023-03-01,38,049,ND,McHenry County,3198,3052,146,4.6
CN3805100000000,2023-03-01,38,051,ND,McIntosh County,1061,1035,26,2.5
CN3805300000000,2023-03-01,38,053,ND,McKenzie County,9442,9292,150,1.6
CN3805500000000,2023-03-01,38,055,ND,McLean County,4784,4627,157,3.3
CN3805700000000,2023-03-01,38,057,ND,Mercer County,3511,3391,120,3.4
CN3805900000000,2023-03-01,38,059,ND,Morton County,17177,16620,557,3.2
CN3806100000000,2023-03-01,38,061,ND,Mountrail County,6430,6334,96,1.5
CN3806300000000,2023-03-01,38,063,ND,Nelson County,1485,1425,60,4
CN3806500000000,2023-03-01,38,065,ND,Oliver County,898,855,43,4.8
CN3806700000000,2023-03-01,38,067,ND,Pembina County,3202,3073,129,4
CN3806900000000,2023-03-01,38,069,ND,Pierce County,1707,1645,62,3.6
CN3807100000000,2023-03-01,38,071,ND,Ramsey County,5663,5497,166,2.9
CN3807300000000,2023-03-01,38,073,ND,Ransom County,2665,2609,56,2.1
CN3807500000000,2023-03-01,38,075,ND,Renville County,1220,1194,26,2.1
CN3807700000000,2023-03-01,38,077,ND,Richland County,9014,8818,196,2.2
CN3807900000000,2023-03-01,38,079,ND,Rolette County,4765,4484,281,5.9
CN3808100000000,2023-03-01,38,081,ND,Sargent County,2297,2254,43,1.9
CN3808300000000,2023-03-01,38,083,ND,Sheridan County,652,628,24,3.7
CN3808500000000,2023-03-01,38,085,ND,Sioux County,1214,1184,30,2.5
CN3808700000000,2023-03-01,38,087,ND,Slope County,340,330,10,2.9
CN3808900000000,2023-03-01,38,089,ND,Stark County,18135,17773,362,2
CN3809100000000,2023-03-01,38,091,ND,Steele County,943,919,24,2.5
CN3809300000000,2023-03-01,38,093,ND,Stutsman County,10787,10515,272,2.5
CN3809500000000,2023-03-01,38,095,ND,Towner County,1150,1117,33,2.9
CN3809700000000,2023-03-01,38,097,ND,Traill County,4570,4474,96,2.1
CN3809900000000,2023-03-01,38,099,ND,Walsh County,5275,5050,225,4.3
CN3810100000000,2023-03-01,38,101,ND,Ward County,31926,30985,941,2.9
CN3810300000000,2023-03-01,38,103,ND,Wells County,1939,1853,86,4.4
CN3810500000000,2023-03-01,38,105,ND,Williams County,22576,22111,465,2.1
CN3900100000000,2023-03-01,39,001,OH,Adams County,11351,10572,779,6.9
CN3900300000000,2023-03-01,39,003,OH,Allen County,46247,44368,1879,4.1
CN3900500000000,2023-03-01,39,005,OH,Ashland County,25536,24426,1110,4.3
CN3900700000000,2023-03-01,39,007,OH,Ashtabula County,43093,41050,2043,4.7
CN3900900000000,2023-03-01,39,009,OH,Athens County,27147,25812,1335,4.9
CN3901100000000,2023-03-01,39,011,OH,Auglaize County,23810,23138,672,2.8
CN3901300000000,2023-03-01,39,013,OH,Belmont County,26987,25469,1518,5.6
CN3901500000000,2023-03-01,39,015,OH,Brown County,19930,18943,987,5
CN3901700000000,2023-03-01,39,017,OH,Butler County,201423,194494,6929,3.4
CN3901900000000,2023-03-01,39,019,OH,Carroll County,12607,12030,577,4.6
CN3902100000000,2023-03-01,39,021,OH,Champaign County,19114,18442,672,3.5
CN3902300000000,2023-03-01,39,023,OH,Clark County,62937,60493,2444,3.9
CN3902500000000,2023-03-01,39,025,OH,Clermont County,110382,106560,3822,3.5
CN3902700000000,2023-03-01,39,027,OH,Clinton County,18138,17280,858,4.7
CN3902900000000,2023-03-01,39,029,OH,Columbiana County,44783,42577,2206,4.9
CN3903100000000,2023-03-01,39,031,OH,Coshocton County,13619,12896,723,5.3
CN3903300000000,2023-03-01,39,033,OH,Crawford County,17608,16736,872,5
CN3903500000000,2023-03-01,39,035,OH,Cuyahoga County,601624,575735,25889,4.3
CN3903700000000,2023-03-01,39,037,OH,Darke County,25248,24290,958,3.8
CN3903900000000,2023-03-01,39,039,OH,Defiance County,17054,16332,722,4.2
CN3904100000000,2023-03-01,39,041,OH,Delaware County,116157,112715,3442,3
CN3904300000000,2023-03-01,39,043,OH,Erie County,34879,32795,2084,6
CN3904500000000,2023-03-01,39,045,OH,Fairfield County,80578,77809,2769,3.4
CN3904700000000,2023-03-01,39,047,OH,Fayette County,13454,12874,580,4.3
CN3904900000000,2023-03-01,39,049,OH,Franklin County,713222,688997,24225,3.4
CN3905100000000,2023-03-01,39,051,OH,Fulton County,21742,20800,942,4.3
CN3905300000000,2023-03-01,39,053,OH,Gallia County,12331,11728,603,4.9
CN3905500000000,2023-03-01,39,055,OH,Geauga County,48457,46615,1842,3.8
CN3905700000000,2023-03-01,39,057,OH,Greene County,83432,80653,2779,3.3
CN3905900000000,2023-03-01,39,059,OH,Guernsey County,17834,16843,991,5.6
CN3906100000000,2023-03-01,39,061,OH,Hamilton County,426302,411915,14387,3.4
CN3906300000000,2023-03-01,39,063,OH,Hancock County,39997,38754,1243,3.1
CN3906500000000,2023-03-01,39,065,OH,Hardin County,12933,12389,544,4.2
CN3906700000000,2023-03-01,39,067,OH,Harrison County,6441,6108,333,5.2
CN3906900000000,2023-03-01,39,069,OH,Henry County,12643,11945,698,5.5
CN3907100000000,2023-03-01,39,071,OH,Highland County,17541,16493,1048,6
CN3907300000000,2023-03-01,39,073,OH,Hocking County,13065,12499,566,4.3
CN3907500000000,2023-03-01,39,075,OH,Holmes County,21398,20645,753,3.5
CN3907700000000,2023-03-01,39,077,OH,Huron County,27576,25823,1753,6.4
CN3907900000000,2023-03-01,39,079,OH,Jackson County,12444,11789,655,5.3
CN3908100000000,2023-03-01,39,081,OH,Jefferson County,27072,25553,1519,5.6
CN3908300000000,2023-03-01,39,083,OH,Knox County,31080,29965,1115,3.6
CN3908500000000,2023-03-01,39,085,OH,Lake County,125385,120295,5090,4.1
CN3908700000000,2023-03-01,39,087,OH,Lawrence County,23473,22380,1093,4.7
CN3908900000000,2023-03-01,39,089,OH,Licking County,92367,89185,3182,3.4
CN3909100000000,2023-03-01,39,091,OH,Logan County,22522,21723,799,3.5
CN3909300000000,2023-03-01,39,093,OH,Lorain County,154082,147271,6811,4.4
CN3909500000000,2023-03-01,39,095,OH,Lucas County,205072,195727,9345,4.6
CN3909700000000,2023-03-01,39,097,OH,Madison County,20992,20275,717,3.4
CN3909900000000,2023-03-01,39,099,OH,Mahoning County,98226,93325,4901,5
CN3910100000000,2023-03-01,39,101,OH,Marion County,27122,26093,1029,3.8
CN3910300000000,2023-03-01,39,103,OH,Medina County,97994,94398,3596,3.7
CN3910500000000,2023-03-01,39,105,OH,Meigs County,8690,8130,560,6.4
CN3910700000000,2023-03-01,39,107,OH,Mercer County,22308,21745,563,2.5
CN3910900000000,2023-03-01,39,109,OH,Miami County,54405,52442,1963,3.6
CN3911100000000,2023-03-01,39,111,OH,Monroe County,5134,4774,360,7
CN3911300000000,2023-03-01,39,113,OH,Montgomery County,250680,240518,10162,4.1
CN3911500000000,2023-03-01,39,115,OH,Morgan County,6962,6535,427,6.1
CN3911700000000,2023-03-01,39,117,OH,Morrow County,17105,16406,699,4.1
CN3911900000000,2023-03-01,39,119,OH,Muskingum County,40780,38797,1983,4.9
CN3912100000000,2023-03-01,39,121,OH,Noble County,4574,4296,278,6.1
CN3912300000000,2023-03-01,39,123,OH,Ottawa County,20006,18710,1296,6.5
CN3912500000000,2023-03-01,39,125,OH,Paulding County,8543,8253,290,3.4
CN3912700000000,2023-03-01,39,127,OH,Perry County,16105,15309,796,4.9
CN3912900000000,2023-03-01,39,129,OH,Pickaway County,26903,25871,1032,3.8
CN3913100000000,2023-03-01,39,131,OH,Pike County,11335,10677,658,5.8
CN3913300000000,2023-03-01,39,133,OH,Portage County,85163,81707,3456,4.1
CN3913500000000,2023-03-01,39,135,OH,Preble County,21916,21167,749,3.4
CN3913700000000,2023-03-01,39,137,OH,Putnam County,18650,18052,598,3.2
CN3913900000000,2023-03-01,39,139,OH,Richland County,50845,48342,2503,4.9
CN3914100000000,2023-03-01,39,141,OH,Ross County,35497,34032,1465,4.1
CN3914300000000,2023-03-01,39,143,OH,Sandusky County,29607,28308,1299,4.4
CN3914500000000,2023-03-01,39,145,OH,Scioto County,29991,28277,1714,5.7
CN3914700000000,2023-03-01,39,147,OH,Seneca County,26438,25318,1120,4.2
CN3914900000000,2023-03-01,39,149,OH,Shelby County,23513,22674,839,3.6
CN3915100000000,2023-03-01,39,151,OH,Stark County,181781,174130,7651,4.2
CN3915300000000,2023-03-01,39,153,OH,Summit County,265303,253979,11324,4.3
CN3915500000000,2023-03-01,39,155,OH,Trumbull County,82972,78721,4251,5.1
CN3915700000000,2023-03-01,39,157,OH,Tuscarawas County,44449,42482,1967,4.4
CN3915900000000,2023-03-01,39,159,OH,Union County,30162,29269,893,3
CN3916100000000,2023-03-01,39,161,OH,Van Wert County,14385,13943,442,3.1
CN3916300000000,2023-03-01,39,163,OH,Vinton County,5446,5119,327,6
CN3916500000000,2023-03-01,39,165,OH,Warren County,125226,121234,3992,3.2
CN3916700000000,2023-03-01,39,167,OH,Washington County,26656,25278,1378,5.2
CN3916900000000,2023-03-01,39,169,OH,Wayne County,59722,57719,2003,3.4
CN3917100000000,2023-03-01,39,171,OH,Williams County,18170,17540,630,3.5
CN3917300000000,2023-03-01,39,173,OH,Wood County,69810,67352,2458,3.5
CN3917500000000,2023-03-01,39,175,OH,Wyandot County,13159,12777,382,2.9
CN4000100000000,2023-03-01,40,001,OK,Adair County,8663,8382,281,3.2
CN4000300000000,2023-03-01,40,003,OK,Alfalfa County,2696,2630,66,2.4
CN4000500000000,2023-03-01,40,005,OK,Atoka County,5124,4949,175,3.4
CN4000700000000,2023-03-01,40,007,OK,Beaver County,2762,2708,54,2
CN4000900000000,2023-03-01,40,009,OK,Beckham County,10194,9913,281,2.8
CN4001100000000,2023-03-01,40,011,OK,Blaine County,4302,4220,82,1.9
CN4001300000000,2023-03-01,40,013,OK,Bryan County,23740,23066,674,2.8
CN4001500000000,2023-03-01,40,015,OK,Caddo County,11831,11439,392,3.3
CN4001700000000,2023-03-01,40,017,OK,Canadian County,82508,80465,2043,2.5
CN4001900000000,2023-03-01,40,019,OK,Carter County,21877,21136,741,3.4
CN4002100000000,2023-03-01,40,021,OK,Cherokee County,20577,19936,641,3.1
CN4002300000000,2023-03-01,40,023,OK,Choctaw County,6118,5855,263,4.3
CN4002500000000,2023-03-01,40,025,OK,Cimarron County,1554,1529,25,1.6
CN4002700000000,2023-03-01,40,027,OK,Cleveland County,152407,148620,3787,2.5
CN4002900000000,2023-03-01,40,029,OK,Coal County,2409,2329,80,3.3
CN4003100000000,2023-03-01,40,031,OK,Comanche County,48170,46539,1631,3.4
CN4003300000000,2023-03-01,40,033,OK,Cotton County,2692,2623,69,2.6
CN4003500000000,2023-03-01,40,035,OK,Craig County,5888,5691,197,3.3
CN4003700000000,2023-03-01,40,037,OK,Creek County,31923,30915,1008,3.2
CN4003900000000,2023-03-01,40,039,OK,Custer County,15333,14965,368,2.4
CN4004100000000,2023-03-01,40,041,OK,Delaware County,19925,19340,585,2.9
CN4004300000000,2023-03-01,40,043,OK,Dewey County,3049,2997,52,1.7
CN4004500000000,2023-03-01,40,045,OK,Ellis County,2125,2080,45,2.1
CN4004700000000,2023-03-01,40,047,OK,Garfield County,26554,25825,729,2.7
CN4004900000000,2023-03-01,40,049,OK,Garvin County,12805,12440,365,2.9
CN4005100000000,2023-03-01,40,051,OK,Grady County,28004,27246,758,2.7
CN4005300000000,2023-03-01,40,053,OK,Grant County,2667,2610,57,2.1
CN4005500000000,2023-03-01,40,055,OK,Greer County,1821,1756,65,3.6
CN4005700000000,2023-03-01,40,057,OK,Harmon County,1188,1160,28,2.4
CN4005900000000,2023-03-01,40,059,OK,Harper County,1804,1769,35,1.9
CN4006100000000,2023-03-01,40,061,OK,Haskell County,4239,4067,172,4.1
CN4006300000000,2023-03-01,40,063,OK,Hughes County,5182,5000,182,3.5
CN4006500000000,2023-03-01,40,065,OK,Jackson County,10889,10600,289,2.7
CN4006700000000,2023-03-01,40,067,OK,Jefferson County,2509,2435,74,2.9
CN4006900000000,2023-03-01,40,069,OK,Johnston County,4101,3961,140,3.4
CN4007100000000,2023-03-01,40,071,OK,Kay County,18700,18097,603,3.2
CN4007300000000,2023-03-01,40,073,OK,Kingfisher County,9031,8845,186,2.1
CN4007500000000,2023-03-01,40,075,OK,Kiowa County,3689,3566,123,3.3
CN4007700000000,2023-03-01,40,077,OK,Latimer County,3167,3005,162,5.1
CN4007900000000,2023-03-01,40,079,OK,Le Flore County,19804,19101,703,3.5
CN4008100000000,2023-03-01,40,081,OK,Lincoln County,16652,16129,523,3.1
CN4008300000000,2023-03-01,40,083,OK,Logan County,23984,23307,677,2.8
CN4008500000000,2023-03-01,40,085,OK,Love County,5993,5845,148,2.5
CN4008700000000,2023-03-01,40,087,OK,McClain County,21411,20863,548,2.6
CN4008900000000,2023-03-01,40,089,OK,McCurtain County,16180,15602,578,3.6
CN4009100000000,2023-03-01,40,091,OK,McIntosh County,7416,7051,365,4.9
CN4009300000000,2023-03-01,40,093,OK,Major County,3793,3699,94,2.5
CN4009500000000,2023-03-01,40,095,OK,Marshall County,7430,7216,214,2.9
CN4009700000000,2023-03-01,40,097,OK,Mayes County,20338,19707,631,3.1
CN4009900000000,2023-03-01,40,099,OK,Murray County,6249,6064,185,3
CN4010100000000,2023-03-01,40,101,OK,Muskogee County,29478,28466,1012,3.4
CN4010300000000,2023-03-01,40,103,OK,Noble County,5993,5855,138,2.3
CN4010500000000,2023-03-01,40,105,OK,Nowata County,4793,4658,135,2.8
CN4010700000000,2023-03-01,40,107,OK,Okfuskee County,4516,4339,177,3.9
CN4010900000000,2023-03-01,40,109,OK,Oklahoma County,409165,397436,11729,2.9
CN4011100000000,2023-03-01,40,111,OK,Okmulgee County,15807,15176,631,4
CN4011300000000,2023-03-01,40,113,OK,Osage County,20804,20098,706,3.4
CN4011500000000,2023-03-01,40,115,OK,Ottawa County,15238,14815,423,2.8
CN4011700000000,2023-03-01,40,117,OK,Pawnee County,7478,7221,257,3.4
CN4011900000000,2023-03-01,40,119,OK,Payne County,39614,38500,1114,2.8
CN4012100000000,2023-03-01,40,121,OK,Pittsburg County,16436,15758,678,4.1
CN4012300000000,2023-03-01,40,123,OK,Pontotoc County,19837,19322,515,2.6
CN4012500000000,2023-03-01,40,125,OK,Pottawatomie County,33757,32646,1111,3.3
CN4012700000000,2023-03-01,40,127,OK,Pushmataha County,4570,4393,177,3.9
CN4012900000000,2023-03-01,40,129,OK,Roger Mills County,1810,1773,37,2
CN4013100000000,2023-03-01,40,131,OK,Rogers County,46191,44913,1278,2.8
CN4013300000000,2023-03-01,40,133,OK,Seminole County,9481,9098,383,4
CN4013500000000,2023-03-01,40,135,OK,Sequoyah County,17044,16489,555,3.3
CN4013700000000,2023-03-01,40,137,OK,Stephens County,19731,19117,614,3.1
CN4013900000000,2023-03-01,40,139,OK,Texas County,11908,11682,226,1.9
CN4014100000000,2023-03-01,40,141,OK,Tillman County,2934,2788,146,5
CN4014300000000,2023-03-01,40,143,OK,Tulsa County,332300,322628,9672,2.9
CN4014500000000,2023-03-01,40,145,OK,Wagoner County,39831,38674,1157,2.9
CN4014700000000,2023-03-01,40,147,OK,Washington County,22681,21947,734,3.2
CN4014900000000,2023-03-01,40,149,OK,Washita County,5306,5161,145,2.7
CN4015100000000,2023-03-01,40,151,OK,Woods County,4480,4402,78,1.7
CN4015300000000,2023-03-01,40,153,OK,Woodward County,8918,8680,238,2.7
CN4100100000000,2023-03-01,41,001,OR,Baker County,7280,6945,335,4.6
CN4100300000000,2023-03-01,41,003,OR,Benton County,49706,48403,1303,2.6
CN4100500000000,2023-03-01,41,005,OR,Clackamas County,225178,218037,7141,3.2
CN4100700000000,2023-03-01,41,007,OR,Clatsop County,18871,18138,733,3.9
CN4100900000000,2023-03-01,41,009,OR,Columbia County,24988,23954,1034,4.1
CN4101100000000,2023-03-01,41,011,OR,Coos County,26373,25056,1317,5
CN4101300000000,2023-03-01,41,013,OR,Crook County,11143,10523,620,5.6
CN4101500000000,2023-03-01,41,015,OR,Curry County,8953,8529,424,4.7
CN4101700000000,2023-03-01,41,017,OR,Deschutes County,101585,97695,3890,3.8
CN4101900000000,2023-03-01,41,019,OR,Douglas County,46349,44076,2273,4.9
CN4102100000000,2023-03-01,41,021,OR,Gilliam County,1137,1102,35,3.1
CN4102300000000,2023-03-01,41,023,OR,Grant County,3143,2944,199,6.3
CN4102500000000,2023-03-01,41,025,OR,Harney County,3741,3567,174,4.7
CN4102700000000,2023-03-01,41,027,OR,Hood River County,13794,13389,405,2.9
CN4102900000000,2023-03-01,41,029,OR,Jackson County,105168,100496,4672,4.4
CN4103100000000,2023-03-01,41,031,OR,Jefferson County,10107,9599,508,5
CN4103300000000,2023-03-01,41,033,OR,Josephine County,36206,34363,1843,5.1
CN4103500000000,2023-03-01,41,035,OR,Klamath County,29281,27547,1734,5.9
CN4103700000000,2023-03-01,41,037,OR,Lake County,3584,3393,191,5.3
CN4103900000000,2023-03-01,41,039,OR,Lane County,179477,172416,7061,3.9
CN4104100000000,2023-03-01,41,041,OR,Lincoln County,20447,19539,908,4.4
CN4104300000000,2023-03-01,41,043,OR,Linn County,60582,58188,2394,4
CN4104500000000,2023-03-01,41,045,OR,Malheur County,12521,12077,444,3.5
CN4104700000000,2023-03-01,41,047,OR,Marion County,168550,162463,6087,3.6
CN4104900000000,2023-03-01,41,049,OR,Morrow County,5838,5653,185,3.2
CN4105100000000,2023-03-01,41,051,OR,Multnomah County,465668,449885,15783,3.4
CN4105300000000,2023-03-01,41,053,OR,Polk County,42457,40872,1585,3.7
CN4105500000000,2023-03-01,41,055,OR,Sherman County,969,934,35,3.6
CN4105700000000,2023-03-01,41,057,OR,Tillamook County,11984,11511,473,3.9
CN4105900000000,2023-03-01,41,059,OR,Umatilla County,36918,35508,1410,3.8
CN4106100000000,2023-03-01,41,061,OR,Union County,11943,11421,522,4.4
CN4106300000000,2023-03-01,41,063,OR,Wallowa County,3461,3270,191,5.5
CN4106500000000,2023-03-01,41,065,OR,Wasco County,12590,12033,557,4.4
CN4106700000000,2023-03-01,41,067,OR,Washington County,333204,323304,9900,3
CN4106900000000,2023-03-01,41,069,OR,Wheeler County,729,707,22,3
CN4107100000000,2023-03-01,41,071,OR,Yamhill County,56028,54166,1862,3.3
CN4200100000000,2023-03-01,42,001,PA,Adams County,54461,53032,1429,2.6
CN4200300000000,2023-03-01,42,003,PA,Allegheny County,630666,607806,22860,3.6
CN4200500000000,2023-03-01,42,005,PA,Armstrong County,31043,29524,1519,4.9
CN4200700000000,2023-03-01,42,007,PA,Beaver County,81796,77801,3995,4.9
CN4200900000000,2023-03-01,42,009,PA,Bedford County,23888,22833,1055,4.4
CN4201100000000,2023-03-01,42,011,PA,Berks County,212707,204861,7846,3.7
CN4201300000000,2023-03-01,42,013,PA,Blair County,58512,56321,2191,3.7
CN4201500000000,2023-03-01,42,015,PA,Bradford County,27390,26339,1051,3.8
CN4201700000000,2023-03-01,42,017,PA,Bucks County,352209,340887,11322,3.2
CN4201900000000,2023-03-01,42,019,PA,Butler County,98354,94803,3551,3.6
CN4202100000000,2023-03-01,42,021,PA,Cambria County,55271,52639,2632,4.8
CN4202300000000,2023-03-01,42,023,PA,Cameron County,1850,1753,97,5.2
CN4202500000000,2023-03-01,42,025,PA,Carbon County,32505,31019,1486,4.6
CN4202700000000,2023-03-01,42,027,PA,Centre County,79437,77158,2279,2.9
CN4202900000000,2023-03-01,42,029,PA,Chester County,293932,286220,7712,2.6
CN4203100000000,2023-03-01,42,031,PA,Clarion County,15746,14931,815,5.2
CN4203300000000,2023-03-01,42,033,PA,Clearfield County,34691,32924,1767,5.1
CN4203500000000,2023-03-01,42,035,PA,Clinton County,16754,15892,862,5.1
CN4203700000000,2023-03-01,42,037,PA,Columbia County,34137,32677,1460,4.3
CN4203900000000,2023-03-01,42,039,PA,Crawford County,36984,35364,1620,4.4
CN4204100000000,2023-03-01,42,041,PA,Cumberland County,135371,131693,3678,2.7
CN4204300000000,2023-03-01,42,043,PA,Dauphin County,146894,142000,4894,3.3
CN4204500000000,2023-03-01,42,045,PA,Delaware County,303084,293021,10063,3.3
CN4204700000000,2023-03-01,42,047,PA,Elk County,14009,13476,533,3.8
CN4204900000000,2023-03-01,42,049,PA,Erie County,125615,119942,5673,4.5
CN4205100000000,2023-03-01,42,051,PA,Fayette County,54877,51857,3020,5.5
CN4205300000000,2023-03-01,42,053,PA,Forest County,1615,1506,109,6.7
CN4205500000000,2023-03-01,42,055,PA,Franklin County,76655,74234,2421,3.2
CN4205700000000,2023-03-01,42,057,PA,Fulton County,7056,6776,280,4
CN4205900000000,2023-03-01,42,059,PA,Greene County,15204,14538,666,4.4
CN4206100000000,2023-03-01,42,061,PA,Huntingdon County,19040,17919,1121,5.9
CN4206300000000,2023-03-01,42,063,PA,Indiana County,35671,33943,1728,4.8
CN4206500000000,2023-03-01,42,065,PA,Jefferson County,18978,18116,862,4.5
CN4206700000000,2023-03-01,42,067,PA,Juniata County,12117,11631,486,4
CN4206900000000,2023-03-01,42,069,PA,Lackawanna County,105591,101092,4499,4.3
CN4207100000000,2023-03-01,42,071,PA,Lancaster County,287179,279455,7724,2.7
CN4207300000000,2023-03-01,42,073,PA,Lawrence County,38590,36417,2173,5.6
CN4207500000000,2023-03-01,42,075,PA,Lebanon County,73602,71485,2117,2.9
CN4207700000000,2023-03-01,42,077,PA,Lehigh County,197193,189567,7626,3.9
CN4207900000000,2023-03-01,42,079,PA,Luzerne County,159279,151206,8073,5.1
CN4208100000000,2023-03-01,42,081,PA,Lycoming County,54926,52544,2382,4.3
CN4208300000000,2023-03-01,42,083,PA,McKean County,16493,15640,853,5.2
CN4208500000000,2023-03-01,42,085,PA,Mercer County,46778,44784,1994,4.3
CN4208700000000,2023-03-01,42,087,PA,Mifflin County,20736,19864,872,4.2
CN4208900000000,2023-03-01,42,089,PA,Monroe County,82202,77888,4314,5.2
CN4209100000000,2023-03-01,42,091,PA,Montgomery County,468703,455494,13209,2.8
CN4209300000000,2023-03-01,42,093,PA,Montour County,9265,8985,280,3
CN4209500000000,2023-03-01,42,095,PA,Northampton County,164369,158162,6207,3.8
CN4209700000000,2023-03-01,42,097,PA,Northumberland County,41259,39251,2008,4.9
CN4209900000000,2023-03-01,42,099,PA,Perry County,24599,23840,759,3.1
CN4210100000000,2023-03-01,42,101,PA,Philadelphia County/city,740638,707919,32719,4.4
CN4210300000000,2023-03-01,42,103,PA,Pike County,25592,24164,1428,5.6
CN4210500000000,2023-03-01,42,105,PA,Potter County,6651,6210,441,6.6
CN4210700000000,2023-03-01,42,107,PA,Schuylkill County,64961,62090,2871,4.4
CN4210900000000,2023-03-01,42,109,PA,Snyder County,19368,18540,828,4.3
CN4211100000000,2023-03-01,42,111,PA,Somerset County,31693,30114,1579,5
CN4211300000000,2023-03-01,42,113,PA,Sullivan County,2464,2349,115,4.7
CN4211500000000,2023-03-01,42,115,PA,Susquehanna County,19904,19059,845,4.2
CN4211700000000,2023-03-01,42,117,PA,Tioga County,18633,17708,925,5
CN4211900000000,2023-03-01,42,119,PA,Union County,19225,18603,622,3.2
CN4212100000000,2023-03-01,42,121,PA,Venango County,20534,19527,1007,4.9
CN4212300000000,2023-03-01,42,123,PA,Warren County,17116,16300,816,4.8
CN4212500000000,2023-03-01,42,125,PA,Washington County,104279,100201,4078,3.9
CN4212700000000,2023-03-01,42,127,PA,Wayne County,21941,20766,1175,5.4
CN4212900000000,2023-03-01,42,129,PA,Westmoreland County,175235,168168,7067,4
CN4213100000000,2023-03-01,42,131,PA,Wyoming County,13514,12889,625,4.6
CN4213300000000,2023-03-01,42,133,PA,York County,237862,230580,7282,3.1
CN4400100000000,2023-03-01,44,001,RI,Bristol County,26258,25483,775,3
CN4400300000000,2023-03-01,44,003,RI,Kent County,92635,89687,2948,3.2
CN4400500000000,2023-03-01,44,005,RI,Newport County,44825,43240,1585,3.5
CN4400700000000,2023-03-01,44,007,RI,Providence County,331317,318376,12941,3.9
CN4400900000000,2023-03-01,44,009,RI,Washington County,69343,67233,2110,3
CN4500100000000,2023-03-01,45,001,SC,Abbeville County,9487,9107,380,4
CN4500300000000,2023-03-01,45,003,SC,Aiken County,73176,70729,2447,3.3
CN4500500000000,2023-03-01,45,005,SC,Allendale County,2401,2255,146,6.1
CN4500700000000,2023-03-01,45,007,SC,Anderson County,93517,90694,2823,3
CN4500900000000,2023-03-01,45,009,SC,Bamberg County,4558,4300,258,5.7
CN4501100000000,2023-03-01,45,011,SC,Barnwell County,7795,7441,354,4.5
CN4501300000000,2023-03-01,45,013,SC,Beaufort County,77225,74808,2417,3.1
CN4501500000000,2023-03-01,45,015,SC,Berkeley County,114458,111060,3398,3
CN4501700000000,2023-03-01,45,017,SC,Calhoun County,6474,6218,256,4
CN4501900000000,2023-03-01,45,019,SC,Charleston County,224476,218253,6223,2.8
CN4502100000000,2023-03-01,45,021,SC,Cherokee County,23846,22832,1014,4.3
CN4502300000000,2023-03-01,45,023,SC,Chester County,13671,13069,602,4.4
CN4502500000000,2023-03-01,45,025,SC,Chesterfield County,21461,20748,713,3.3
CN4502700000000,2023-03-01,45,027,SC,Clarendon County,12044,11473,571,4.7
CN4502900000000,2023-03-01,45,029,SC,Colleton County,15998,15417,581,3.6
CN4503100000000,2023-03-01,45,031,SC,Darlington County,30340,29198,1142,3.8
CN4503300000000,2023-03-01,45,033,SC,Dillon County,13088,12358,730,5.6
CN4503500000000,2023-03-01,45,035,SC,Dorchester County,83005,80615,2390,2.9
CN4503700000000,2023-03-01,45,037,SC,Edgefield County,10221,9863,358,3.5
CN4503900000000,2023-03-01,45,039,SC,Fairfield County,9301,8852,449,4.8
CN4504100000000,2023-03-01,45,041,SC,Florence County,67301,65092,2209,3.3
CN4504300000000,2023-03-01,45,043,SC,Georgetown County,25964,24966,998,3.8
CN4504500000000,2023-03-01,45,045,SC,Greenville County,266329,258409,7920,3
CN4504700000000,2023-03-01,45,047,SC,Greenwood County,29844,28637,1207,4
CN4504900000000,2023-03-01,45,049,SC,Hampton County,7945,7705,240,3
CN4505100000000,2023-03-01,45,051,SC,Horry County,154470,147982,6488,4.2
CN4505300000000,2023-03-01,45,053,SC,Jasper County,13239,12869,370,2.8
CN4505500000000,2023-03-01,45,055,SC,Kershaw County,29612,28620,992,3.3
CN4505700000000,2023-03-01,45,057,SC,Lancaster County,44682,42991,1691,3.8
CN4505900000000,2023-03-01,45,059,SC,Laurens County,30756,29677,1079,3.5
CN4506100000000,2023-03-01,45,061,SC,Lee County,6410,6105,305,4.8
CN4506300000000,2023-03-01,45,063,SC,Lexington County,152736,148429,4307,2.8
CN4506500000000,2023-03-01,45,065,SC,McCormick County,3451,3313,138,4
CN4506700000000,2023-03-01,45,067,SC,Marion County,12772,12099,673,5.3
CN4506900000000,2023-03-01,45,069,SC,Marlboro County,7513,6820,693,9.2
CN4507100000000,2023-03-01,45,071,SC,Newberry County,19265,18515,750,3.9
CN4507300000000,2023-03-01,45,073,SC,Oconee County,35058,33981,1077,3.1
CN4507500000000,2023-03-01,45,075,SC,Orangeburg County,33143,31474,1669,5
CN4507700000000,2023-03-01,45,077,SC,Pickens County,59350,57429,1921,3.2
CN4507900000000,2023-03-01,45,079,SC,Richland County,199542,192778,6764,3.4
CN4508100000000,2023-03-01,45,081,SC,Saluda County,8405,8120,285,3.4
CN4508300000000,2023-03-01,45,083,SC,Spartanburg County,157668,152709,4959,3.1
CN4508500000000,2023-03-01,45,085,SC,Sumter County,42586,40751,1835,4.3
CN4508700000000,2023-03-01,45,087,SC,Union County,11470,10907,563,4.9
CN4508900000000,2023-03-01,45,089,SC,Williamsburg County,10652,10083,569,5.3
CN4509100000000,2023-03-01,45,091,SC,York County,151849,146973,4876,3.2
CN4600300000000,2023-03-01,46,003,SD,Aurora County,1547,1524,23,1.5
CN4600500000000,2023-03-01,46,005,SD,Beadle County,9189,9037,152,1.7
CN4600700000000,2023-03-01,46,007,SD,Bennett County,1058,1032,26,2.5
CN4600900000000,2023-03-01,46,009,SD,Bon Homme County,2943,2886,57,1.9
CN4601100000000,2023-03-01,46,011,SD,Brookings County,19463,19181,282,1.4
CN4601300000000,2023-03-01,46,013,SD,Brown County,19966,19596,370,1.9
CN4601500000000,2023-03-01,46,015,SD,Brule County,2666,2629,37,1.4
CN4601700000000,2023-03-01,46,017,SD,Buffalo County,688,662,26,3.8
CN4601900000000,2023-03-01,46,019,SD,Butte County,5178,5090,88,1.7
CN4602100000000,2023-03-01,46,021,SD,Campbell County,786,771,15,1.9
CN4602300000000,2023-03-01,46,023,SD,Charles Mix County,3803,3730,73,1.9
CN4602500000000,2023-03-01,46,025,SD,Clark County,2020,1969,51,2.5
CN4602700000000,2023-03-01,46,027,SD,Clay County,7544,7438,106,1.4
CN4602900000000,2023-03-01,46,029,SD,Codington County,16131,15859,272,1.7
CN4603100000000,2023-03-01,46,031,SD,Corson County,1313,1294,19,1.4
CN4603300000000,2023-03-01,46,033,SD,Custer County,4271,4167,104,2.4
CN4603500000000,2023-03-01,46,035,SD,Davison County,11146,10968,178,1.6
CN4603700000000,2023-03-01,46,037,SD,Day County,2683,2593,90,3.4
CN4603900000000,2023-03-01,46,039,SD,Deuel County,2279,2199,80,3.5
CN4604100000000,2023-03-01,46,041,SD,Dewey County,2282,2213,69,3
CN4604300000000,2023-03-01,46,043,SD,Douglas County,1517,1492,25,1.6
CN4604500000000,2023-03-01,46,045,SD,Edmunds County,2021,1988,33,1.6
CN4604700000000,2023-03-01,46,047,SD,Fall River County,2942,2873,69,2.3
CN4604900000000,2023-03-01,46,049,SD,Faulk County,1102,1088,14,1.3
CN4605100000000,2023-03-01,46,051,SD,Grant County,4497,4339,158,3.5
CN4605300000000,2023-03-01,46,053,SD,Gregory County,2169,2134,35,1.6
CN4605500000000,2023-03-01,46,055,SD,Haakon County,1084,1069,15,1.4
CN4605700000000,2023-03-01,46,057,SD,Hamlin County,3654,3582,72,2
CN4605900000000,2023-03-01,46,059,SD,Hand County,1861,1832,29,1.6
CN4606100000000,2023-03-01,46,061,SD,Hanson County,1832,1786,46,2.5
CN4606300000000,2023-03-01,46,063,SD,Harding County,775,765,10,1.3
CN4606500000000,2023-03-01,46,065,SD,Hughes County,9809,9667,142,1.4
CN4606700000000,2023-03-01,46,067,SD,Hutchinson County,3688,3602,86,2.3
CN4606900000000,2023-03-01,46,069,SD,Hyde County,675,665,10,1.5
CN4607100000000,2023-03-01,46,071,SD,Jackson County,1176,1140,36,3.1
CN4607300000000,2023-03-01,46,073,SD,Jerauld County,1245,1230,15,1.2
CN4607500000000,2023-03-01,46,075,SD,Jones County,503,492,11,2.2
CN4607700000000,2023-03-01,46,077,SD,Kingsbury County,2765,2712,53,1.9
CN4607900000000,2023-03-01,46,079,SD,Lake County,6830,6726,104,1.5
CN4608100000000,2023-03-01,46,081,SD,Lawrence County,14020,13824,196,1.4
CN4608300000000,2023-03-01,46,083,SD,Lincoln County,37922,37358,564,1.5
CN4608500000000,2023-03-01,46,085,SD,Lyman County,1672,1625,47,2.8
CN4608700000000,2023-03-01,46,087,SD,McCook County,3180,3126,54,1.7
CN4608900000000,2023-03-01,46,089,SD,McPherson County,1023,1001,22,2.2
CN4609100000000,2023-03-01,46,091,SD,Marshall County,2487,2412,75,3
CN4609300000000,2023-03-01,46,093,SD,Meade County,14535,14277,258,1.8
CN4609500000000,2023-03-01,46,095,SD,Mellette County,770,753,17,2.2
CN4609700000000,2023-03-01,46,097,SD,Miner County,1290,1273,17,1.3
CN4609900000000,2023-03-01,46,099,SD,Minnehaha County,117793,115724,2069,1.8
CN4610100000000,2023-03-01,46,101,SD,Moody County,4074,4005,69,1.7
CN4610200000000,2023-03-01,46,102,SD,Oglala Lakota County,3781,3666,115,3
CN4610300000000,2023-03-01,46,103,SD,Pennington County,59846,58921,925,1.5
CN4610500000000,2023-03-01,46,105,SD,Perkins County,1469,1446,23,1.6
CN4610700000000,2023-03-01,46,107,SD,Potter County,1012,989,23,2.3
CN4610900000000,2023-03-01,46,109,SD,Roberts County,4655,4495,160,3.4
CN4611100000000,2023-03-01,46,111,SD,Sanborn County,1248,1226,22,1.8
CN4611500000000,2023-03-01,46,115,SD,Spink County,3031,2961,70,2.3
CN4611700000000,2023-03-01,46,117,SD,Stanley County,1948,1909,39,2
CN4611900000000,2023-03-01,46,119,SD,Sully County,836,828,8,1
CN4612100000000,2023-03-01,46,121,SD,Todd County,2912,2850,62,2.1
CN4612300000000,2023-03-01,46,123,SD,Tripp County,3128,3087,41,1.3
CN4612500000000,2023-03-01,46,125,SD,Turner County,4828,4738,90,1.9
CN4612700000000,2023-03-01,46,127,SD,Union County,8859,8708,151,1.7
CN4612900000000,2023-03-01,46,129,SD,Walworth County,2078,2008,70,3.4
CN4613500000000,2023-03-01,46,135,SD,Yankton County,11771,11597,174,1.5
CN4613700000000,2023-03-01,46,137,SD,Ziebach County,973,948,25,2.6
CN4700100000000,2023-03-01,47,001,TN,Anderson County,35513,34418,1095,3.1
CN4700300000000,2023-03-01,47,003,TN,Bedford County,21512,20860,652,3
CN4700500000000,2023-03-01,47,005,TN,Benton County,6729,6445,284,4.2
CN4700700000000,2023-03-01,47,007,TN,Bledsoe County,4378,4146,232,5.3
CN4700900000000,2023-03-01,47,009,TN,Blount County,65866,63955,1911,2.9
CN4701100000000,2023-03-01,47,011,TN,Bradley County,50336,48589,1747,3.5
CN4701300000000,2023-03-01,47,013,TN,Campbell County,15015,14433,582,3.9
CN4701500000000,2023-03-01,47,015,TN,Cannon County,6909,6732,177,2.6
CN4701700000000,2023-03-01,47,017,TN,Carroll County,11640,11216,424,3.6
CN4701900000000,2023-03-01,47,019,TN,Carter County,24157,23296,861,3.6
CN4702100000000,2023-03-01,47,021,TN,Cheatham County,22720,22176,544,2.4
CN4702300000000,2023-03-01,47,023,TN,Chester County,8478,8231,247,2.9
CN4702500000000,2023-03-01,47,025,TN,Claiborne County,12709,12234,475,3.7
CN4702700000000,2023-03-01,47,027,TN,Clay County,2789,2662,127,4.6
CN4702900000000,2023-03-01,47,029,TN,Cocke County,14407,13764,643,4.5
CN4703100000000,2023-03-01,47,031,TN,Coffee County,25019,24223,796,3.2
CN4703300000000,2023-03-01,47,033,TN,Crockett County,6734,6517,217,3.2
CN4703500000000,2023-03-01,47,035,TN,Cumberland County,23115,22264,851,3.7
CN4703700000000,2023-03-01,47,037,TN,Davidson County,417601,407140,10461,2.5
CN4703900000000,2023-03-01,47,039,TN,Decatur County,4416,4217,199,4.5
CN4704100000000,2023-03-01,47,041,TN,DeKalb County,8019,7719,300,3.7
CN4704300000000,2023-03-01,47,043,TN,Dickson County,28202,27470,732,2.6
CN4704500000000,2023-03-01,47,045,TN,Dyer County,16401,15892,509,3.1
CN4704700000000,2023-03-01,47,047,TN,Fayette County,19016,18369,647,3.4
CN4704900000000,2023-03-01,47,049,TN,Fentress County,7751,7460,291,3.8
CN4705100000000,2023-03-01,47,051,TN,Franklin County,18919,18298,621,3.3
CN4705300000000,2023-03-01,47,053,TN,Gibson County,21439,20707,732,3.4
CN4705500000000,2023-03-01,47,055,TN,Giles County,14731,14274,457,3.1
CN4705700000000,2023-03-01,47,057,TN,Grainger County,9701,9356,345,3.6
CN4705900000000,2023-03-01,47,059,TN,Greene County,28558,27463,1095,3.8
CN4706100000000,2023-03-01,47,061,TN,Grundy County,4952,4735,217,4.4
CN4706300000000,2023-03-01,47,063,TN,Hamblen County,28180,27207,973,3.5
CN4706500000000,2023-03-01,47,065,TN,Hamilton County,184936,179446,5490,3
CN4706700000000,2023-03-01,47,067,TN,Hancock County,2268,2180,88,3.9
CN4706900000000,2023-03-01,47,069,TN,Hardeman County,8843,8465,378,4.3
CN4707100000000,2023-03-01,47,071,TN,Hardin County,9903,9542,361,3.6
CN4707300000000,2023-03-01,47,073,TN,Hawkins County,23344,22483,861,3.7
CN4707500000000,2023-03-01,47,075,TN,Haywood County,7497,7119,378,5
CN4707700000000,2023-03-01,47,077,TN,Henderson County,11684,11268,416,3.6
CN4707900000000,2023-03-01,47,079,TN,Henry County,13346,12832,514,3.9
CN4708100000000,2023-03-01,47,081,TN,Hickman County,11806,11484,322,2.7
CN4708300000000,2023-03-01,47,083,TN,Houston County,3201,3061,140,4.4
CN4708500000000,2023-03-01,47,085,TN,Humphreys County,8580,8296,284,3.3
CN4708700000000,2023-03-01,47,087,TN,Jackson County,4774,4590,184,3.9
CN4708900000000,2023-03-01,47,089,TN,Jefferson County,24999,24170,829,3.3
CN4709100000000,2023-03-01,47,091,TN,Johnson County,7498,7249,249,3.3
CN4709300000000,2023-03-01,47,093,TN,Knox County,252560,246081,6479,2.6
CN4709500000000,2023-03-01,47,095,TN,Lake County,1572,1495,77,4.9
CN4709700000000,2023-03-01,47,097,TN,Lauderdale County,9326,8908,418,4.5
CN4709900000000,2023-03-01,47,099,TN,Lawrence County,19075,18458,617,3.2
CN4710100000000,2023-03-01,47,101,TN,Lewis County,5489,5319,170,3.1
CN4710300000000,2023-03-01,47,103,TN,Lincoln County,16632,16149,483,2.9
CN4710500000000,2023-03-01,47,105,TN,Loudon County,24411,23681,730,3
CN4710700000000,2023-03-01,47,107,TN,McMinn County,21251,20339,912,4.3
CN4710900000000,2023-03-01,47,109,TN,McNairy County,8349,7984,365,4.4
CN4711100000000,2023-03-01,47,111,TN,Macon County,11651,11305,346,3
CN4711300000000,2023-03-01,47,113,TN,Madison County,48860,47272,1588,3.3
CN4711500000000,2023-03-01,47,115,TN,Marion County,12383,11952,431,3.5
CN4711700000000,2023-03-01,47,117,TN,Marshall County,15726,15256,470,3
CN4711900000000,2023-03-01,47,119,TN,Maury County,53467,52052,1415,2.6
CN4712100000000,2023-03-01,47,121,TN,Meigs County,5250,4961,289,5.5
CN4712300000000,2023-03-01,47,123,TN,Monroe County,20813,20126,687,3.3
CN4712500000000,2023-03-01,47,125,TN,Montgomery County,89314,86229,3085,3.5
CN4712700000000,2023-03-01,47,127,TN,Moore County,3776,3689,87,2.3
CN4712900000000,2023-03-01,47,129,TN,Morgan County,7923,7615,308,3.9
CN4713100000000,2023-03-01,47,131,TN,Obion County,12795,12332,463,3.6
CN4713300000000,2023-03-01,47,133,TN,Overton County,9828,9467,361,3.7
CN4713500000000,2023-03-01,47,135,TN,Perry County,2729,2609,120,4.4
CN4713700000000,2023-03-01,47,137,TN,Pickett County,2091,2014,77,3.7
CN4713900000000,2023-03-01,47,139,TN,Polk County,7052,6785,267,3.8
CN4714100000000,2023-03-01,47,141,TN,Putnam County,35317,34167,1150,3.3
CN4714300000000,2023-03-01,47,143,TN,Rhea County,13873,13281,592,4.3
CN4714500000000,2023-03-01,47,145,TN,Roane County,23901,23096,805,3.4
CN4714700000000,2023-03-01,47,147,TN,Robertson County,39516,38523,993,2.5
CN4714900000000,2023-03-01,47,149,TN,Rutherford County,198206,193382,4824,2.4
CN4715100000000,2023-03-01,47,151,TN,Scott County,7994,7624,370,4.6
CN4715300000000,2023-03-01,47,153,TN,Sequatchie County,6172,5953,219,3.5
CN4715500000000,2023-03-01,47,155,TN,Sevier County,53593,51977,1616,3
CN4715700000000,2023-03-01,47,157,TN,Shelby County,436308,418066,18242,4.2
CN4715900000000,2023-03-01,47,159,TN,Smith County,9831,9547,284,2.9
CN4716100000000,2023-03-01,47,161,TN,Stewart County,5575,5389,186,3.3
CN4716300000000,2023-03-01,47,163,TN,Sullivan County,69248,66998,2250,3.2
CN4716500000000,2023-03-01,47,165,TN,Sumner County,109895,107151,2744,2.5
CN4716700000000,2023-03-01,47,167,TN,Tipton County,27455,26532,923,3.4
CN4716900000000,2023-03-01,47,169,TN,Trousdale County,5795,5616,179,3.1
CN4717100000000,2023-03-01,47,171,TN,Unicoi County,7035,6762,273,3.9
CN4717300000000,2023-03-01,47,173,TN,Union County,7832,7574,258,3.3
CN4717500000000,2023-03-01,47,175,TN,Van Buren County,2086,1994,92,4.4
CN4717700000000,2023-03-01,47,177,TN,Warren County,16193,15546,647,4
CN4717900000000,2023-03-01,47,179,TN,Washington County,61824,59915,1909,3.1
CN4718100000000,2023-03-01,47,181,TN,Wayne County,6421,6185,236,3.7
CN4718300000000,2023-03-01,47,183,TN,Weakley County,15306,14849,457,3
CN4718500000000,2023-03-01,47,185,TN,White County,11942,11537,405,3.4
CN4718700000000,2023-03-01,47,187,TN,Williamson County,139557,136277,3280,2.4
CN4718900000000,2023-03-01,47,189,TN,Wilson County,83004,80889,2115,2.5
CN4800100000000,2023-03-01,48,001,TX,Anderson County,23602,22739,863,3.7
CN4800300000000,2023-03-01,48,003,TX,Andrews County,9883,9598,285,2.9
CN4800500000000,2023-03-01,48,005,TX,Angelina County,36027,34370,1657,4.6
CN4800700000000,2023-03-01,48,007,TX,Aransas County,9519,9002,517,5.4
CN4800900000000,2023-03-01,48,009,TX,Archer County,4111,3958,153,3.7
CN4801100000000,2023-03-01,48,011,TX,Armstrong County,971,938,33,3.4
CN4801300000000,2023-03-01,48,013,TX,Atascosa County,23145,22242,903,3.9
CN4801500000000,2023-03-01,48,015,TX,Austin County,14553,13989,564,3.9
CN4801700000000,2023-03-01,48,017,TX,Bailey County,2501,2371,130,5.2
CN4801900000000,2023-03-01,48,019,TX,Bandera County,10961,10539,422,3.9
CN4802100000000,2023-03-01,48,021,TX,Bastrop County,49786,47852,1934,3.9
CN4802300000000,2023-03-01,48,023,TX,Baylor County,2044,1994,50,2.4
CN4802500000000,2023-03-01,48,025,TX,Bee County,9400,8881,519,5.5
CN4802700000000,2023-03-01,48,027,TX,Bell County,153355,145754,7601,5
CN4802900000000,2023-03-01,48,029,TX,Bexar County,1007456,967737,39719,3.9
CN4803100000000,2023-03-01,48,031,TX,Blanco County,7357,7123,234,3.2
CN4803300000000,2023-03-01,48,033,TX,Borden County,801,789,12,1.5
CN4803500000000,2023-03-01,48,035,TX,Bosque County,8896,8552,344,3.9
CN4803700000000,2023-03-01,48,037,TX,Bowie County,39084,37288,1796,4.6
CN4803900000000,2023-03-01,48,039,TX,Brazoria County,189924,181188,8736,4.6
CN4804100000000,2023-03-01,48,041,TX,Brazos County,133883,129689,4194,3.1
CN4804300000000,2023-03-01,48,043,TX,Brewster County,4406,4260,146,3.3
CN4804500000000,2023-03-01,48,045,TX,Briscoe County,642,619,23,3.6
CN4804700000000,2023-03-01,48,047,TX,Brooks County,2410,2281,129,5.4
CN4804900000000,2023-03-01,48,049,TX,Brown County,15599,14903,696,4.5
CN4805100000000,2023-03-01,48,051,TX,Burleson County,9248,8904,344,3.7
CN4805300000000,2023-03-01,48,053,TX,Burnet County,26611,25738,873,3.3
CN4805500000000,2023-03-01,48,055,TX,Caldwell County,21966,21112,854,3.9
CN4805700000000,2023-03-01,48,057,TX,Calhoun County,12677,12241,436,3.4
CN4805900000000,2023-03-01,48,059,TX,Callahan County,6423,6183,240,3.7
CN4806100000000,2023-03-01,48,061,TX,Cameron County,182410,171645,10765,5.9
CN4806300000000,2023-03-01,48,063,TX,Camp County,5240,5007,233,4.4
CN4806500000000,2023-03-01,48,065,TX,Carson County,3098,3001,97,3.1
CN4806700000000,2023-03-01,48,067,TX,Cass County,12140,11550,590,4.9
CN4806900000000,2023-03-01,48,069,TX,Castro County,3392,3286,106,3.1
CN4807100000000,2023-03-01,48,071,TX,Chambers County,21704,20475,1229,5.7
CN4807300000000,2023-03-01,48,073,TX,Cherokee County,20818,19868,950,4.6
CN4807500000000,2023-03-01,48,075,TX,Childress County,3328,3243,85,2.6
CN4807700000000,2023-03-01,48,077,TX,Clay County,4977,4779,198,4
CN4807900000000,2023-03-01,48,079,TX,Cochran County,1177,1128,49,4.2
CN4808100000000,2023-03-01,48,081,TX,Coke County,1607,1551,56,3.5
CN4808300000000,2023-03-01,48,083,TX,Coleman County,3179,3021,158,5
CN4808500000000,2023-03-01,48,085,TX,Collin County,646795,623526,23269,3.6
CN4808700000000,2023-03-01,48,087,TX,Collingsworth County,1087,1049,38,3.5
CN4808900000000,2023-03-01,48,089,TX,Colorado County,10455,10090,365,3.5
CN4809100000000,2023-03-01,48,091,TX,Comal County,84952,81608,3344,3.9
CN4809300000000,2023-03-01,48,093,TX,Comanche County,6713,6479,234,3.5
CN4809500000000,2023-03-01,48,095,TX,Concho County,1376,1331,45,3.3
CN4809700000000,2023-03-01,48,097,TX,Cooke County,20618,19897,721,3.5
CN4809900000000,2023-03-01,48,099,TX,Coryell County,25284,24082,1202,4.8
CN4810100000000,2023-03-01,48,101,TX,Cottle County,1034,1010,24,2.3
CN4810300000000,2023-03-01,48,103,TX,Crane County,1730,1650,80,4.6
CN4810500000000,2023-03-01,48,105,TX,Crockett County,1449,1399,50,3.5
CN4810700000000,2023-03-01,48,107,TX,Crosby County,2523,2398,125,5
CN4810900000000,2023-03-01,48,109,TX,Culberson County,1244,1208,36,2.9
CN4811100000000,2023-03-01,48,111,TX,Dallam County,3925,3823,102,2.6
CN4811300000000,2023-03-01,48,113,TX,Dallas County,1468368,1408832,59536,4.1
CN4811500000000,2023-03-01,48,115,TX,Dawson County,4669,4466,203,4.3
CN4811700000000,2023-03-01,48,117,TX,Deaf Smith County,9365,9070,295,3.2
CN4811900000000,2023-03-01,48,119,TX,Delta County,2612,2482,130,5
CN4812100000000,2023-03-01,48,121,TX,Denton County,570684,549659,21025,3.7
CN4812300000000,2023-03-01,48,123,TX,DeWitt County,9300,8984,316,3.4
CN4812500000000,2023-03-01,48,125,TX,Dickens County,734,701,33,4.5
CN4812700000000,2023-03-01,48,127,TX,Dimmit County,6168,5935,233,3.8
CN4812900000000,2023-03-01,48,129,TX,Donley County,1524,1472,52,3.4
CN4813100000000,2023-03-01,48,131,TX,Duval County,5190,4959,231,4.5
CN4813300000000,2023-03-01,48,133,TX,Eastland County,6770,6452,318,4.7
CN4813500000000,2023-03-01,48,135,TX,Ector County,86815,83745,3070,3.5
CN4813700000000,2023-03-01,48,137,TX,Edwards County,1156,1123,33,2.9
CN4813900000000,2023-03-01,48,139,TX,Ellis County,106944,102731,4213,3.9
CN4814100000000,2023-03-01,48,141,TX,El Paso County,379141,361618,17523,4.6
CN4814300000000,2023-03-01,48,143,TX,Erath County,22419,21658,761,3.4
CN4814500000000,2023-03-01,48,145,TX,Falls County,7073,6753,320,4.5
CN4814700000000,2023-03-01,48,147,TX,Fannin County,17922,17154,768,4.3
CN4814900000000,2023-03-01,48,149,TX,Fayette County,12188,11756,432,3.5
CN4815100000000,2023-03-01,48,151,TX,Fisher County,1693,1630,63,3.7
CN4815300000000,2023-03-01,48,153,TX,Floyd County,2497,2379,118,4.7
CN4815500000000,2023-03-01,48,155,TX,Foard County,555,536,19,3.4
CN4815700000000,2023-03-01,48,157,TX,Fort Bend County,431924,413785,18139,4.2
CN4815900000000,2023-03-01,48,159,TX,Franklin County,5558,5360,198,3.6
CN4816100000000,2023-03-01,48,161,TX,Freestone County,6500,6142,358,5.5
CN4816300000000,2023-03-01,48,163,TX,Frio County,9553,9225,328,3.4
CN4816500000000,2023-03-01,48,165,TX,Gaines County,10503,10190,313,3
CN4816700000000,2023-03-01,48,167,TX,Galveston County,174132,166330,7802,4.5
CN4816900000000,2023-03-01,48,169,TX,Garza County,1973,1902,71,3.6
CN4817100000000,2023-03-01,48,171,TX,Gillespie County,15224,14821,403,2.6
CN4817300000000,2023-03-01,48,173,TX,Glasscock County,942,918,24,2.5
CN4817500000000,2023-03-01,48,175,TX,Goliad County,3255,3125,130,4
CN4817700000000,2023-03-01,48,177,TX,Gonzales County,9836,9492,344,3.5
CN4817900000000,2023-03-01,48,179,TX,Gray County,7839,7490,349,4.5
CN4818100000000,2023-03-01,48,181,TX,Grayson County,67940,65198,2742,4
CN4818300000000,2023-03-01,48,183,TX,Gregg County,58212,55678,2534,4.4
CN4818500000000,2023-03-01,48,185,TX,Grimes County,11919,11342,577,4.8
CN4818700000000,2023-03-01,48,187,TX,Guadalupe County,88126,84964,3162,3.6
CN4818900000000,2023-03-01,48,189,TX,Hale County,11811,11177,634,5.4
CN4819100000000,2023-03-01,48,191,TX,Hall County,1104,1059,45,4.1
CN4819300000000,2023-03-01,48,193,TX,Hamilton County,3992,3844,148,3.7
CN4819500000000,2023-03-01,48,195,TX,Hansford County,2987,2912,75,2.5
CN4819700000000,2023-03-01,48,197,TX,Hardeman County,1837,1766,71,3.9
CN4819900000000,2023-03-01,48,199,TX,Hardin County,25637,24286,1351,5.3
CN4820100000000,2023-03-01,48,201,TX,Harris County,2413797,2305536,108261,4.5
CN4820300000000,2023-03-01,48,203,TX,Harrison County,29688,28314,1374,4.6
CN4820500000000,2023-03-01,48,205,TX,Hartley County,2633,2577,56,2.1
CN4820700000000,2023-03-01,48,207,TX,Haskell County,2859,2767,92,3.2
CN4820900000000,2023-03-01,48,209,TX,Hays County,142875,138022,4853,3.4
CN4821100000000,2023-03-01,48,211,TX,Hemphill County,1653,1594,59,3.6
CN4821300000000,2023-03-01,48,213,TX,Henderson County,40297,38290,2007,5
CN4821500000000,2023-03-01,48,215,TX,Hidalgo County,385694,360921,24773,6.4
CN4821700000000,2023-03-01,48,217,TX,Hill County,18816,17962,854,4.5
CN4821900000000,2023-03-01,48,219,TX,Hockley County,11045,10628,417,3.8
CN4822100000000,2023-03-01,48,221,TX,Hood County,30887,29675,1212,3.9
CN4822300000000,2023-03-01,48,223,TX,Hopkins County,19127,18292,835,4.4
CN4822500000000,2023-03-01,48,225,TX,Houston County,10848,10471,377,3.5
CN4822700000000,2023-03-01,48,227,TX,Howard County,13066,12456,610,4.7
CN4822900000000,2023-03-01,48,229,TX,Hudspeth County,1945,1867,78,4
CN4823100000000,2023-03-01,48,231,TX,Hunt County,48422,46354,2068,4.3
CN4823300000000,2023-03-01,48,233,TX,Hutchinson County,8509,8132,377,4.4
CN4823500000000,2023-03-01,48,235,TX,Irion County,822,792,30,3.6
CN4823700000000,2023-03-01,48,237,TX,Jack County,3508,3383,125,3.6
CN4823900000000,2023-03-01,48,239,TX,Jackson County,7220,6966,254,3.5
CN4824100000000,2023-03-01,48,241,TX,Jasper County,13085,12278,807,6.2
CN4824300000000,2023-03-01,48,243,TX,Jeff Davis County,1017,982,35,3.4
CN4824500000000,2023-03-01,48,245,TX,Jefferson County,104412,97537,6875,6.6
CN4824700000000,2023-03-01,48,247,TX,Jim Hogg County,1789,1707,82,4.6
CN4824900000000,2023-03-01,48,249,TX,Jim Wells County,15995,15066,929,5.8
CN4825100000000,2023-03-01,48,251,TX,Johnson County,91969,88442,3527,3.8
CN4825300000000,2023-03-01,48,253,TX,Jones County,6007,5703,304,5.1
CN4825500000000,2023-03-01,48,255,TX,Karnes County,6825,6599,226,3.3
CN4825700000000,2023-03-01,48,257,TX,Kaufman County,77774,74443,3331,4.3
CN4825900000000,2023-03-01,48,259,TX,Kendall County,24557,23701,856,3.5
CN4826100000000,2023-03-01,48,261,TX,Kenedy County,138,129,9,6.5
CN4826300000000,2023-03-01,48,263,TX,Kent County,769,752,17,2.2
CN4826500000000,2023-03-01,48,265,TX,Kerr County,22744,21897,847,3.7
CN4826700000000,2023-03-01,48,267,TX,Kimble County,1845,1777,68,3.7
CN4826900000000,2023-03-01,48,269,TX,King County,642,637,5,0.8
CN4827100000000,2023-03-01,48,271,TX,Kinney County,1297,1231,66,5.1
CN4827300000000,2023-03-01,48,273,TX,Kleberg County,13451,12788,663,4.9
CN4827500000000,2023-03-01,48,275,TX,Knox County,1543,1491,52,3.4
CN4827700000000,2023-03-01,48,277,TX,Lamar County,24870,23707,1163,4.7
CN4827900000000,2023-03-01,48,279,TX,Lamb County,5387,5163,224,4.2
CN4828100000000,2023-03-01,48,281,TX,Lampasas County,9672,9292,380,3.9
CN4828300000000,2023-03-01,48,283,TX,La Salle County,4309,4194,115,2.7
CN4828500000000,2023-03-01,48,285,TX,Lavaca County,9313,8974,339,3.6
CN4828700000000,2023-03-01,48,287,TX,Lee County,8482,8156,326,3.8
CN4828900000000,2023-03-01,48,289,TX,Leon County,6175,5855,320,5.2
CN4829100000000,2023-03-01,48,291,TX,Liberty County,36297,34213,2084,5.7
CN4829300000000,2023-03-01,48,293,TX,Limestone County,8589,8183,406,4.7
CN4829500000000,2023-03-01,48,295,TX,Lipscomb County,1485,1440,45,3
CN4829700000000,2023-03-01,48,297,TX,Live Oak County,4895,4694,201,4.1
CN4829900000000,2023-03-01,48,299,TX,Llano County,9576,9206,370,3.9
CN4830100000000,2023-03-01,48,301,TX,Loving County,1409,1404,5,0.4
CN4830300000000,2023-03-01,48,303,TX,Lubbock County,167326,161101,6225,3.7
CN4830500000000,2023-03-01,48,305,TX,Lynn County,2962,2856,106,3.6
CN4830700000000,2023-03-01,48,307,TX,McCulloch County,3237,3102,135,4.2
CN4830900000000,2023-03-01,48,309,TX,McLennan County,130865,125602,5263,4
CN4831100000000,2023-03-01,48,311,TX,McMullen County,896,880,16,1.8
CN4831300000000,2023-03-01,48,313,TX,Madison County,4868,4654,214,4.4
CN4831500000000,2023-03-01,48,315,TX,Marion County,4224,4014,210,5
CN4831700000000,2023-03-01,48,317,TX,Martin County,2949,2874,75,2.5
CN4831900000000,2023-03-01,48,319,TX,Mason County,1900,1831,69,3.6
CN4832100000000,2023-03-01,48,321,TX,Matagorda County,18161,17173,988,5.4
CN4832300000000,2023-03-01,48,323,TX,Maverick County,24378,22009,2369,9.7
CN4832500000000,2023-03-01,48,325,TX,Medina County,23387,22463,924,4
CN4832700000000,2023-03-01,48,327,TX,Menard County,870,835,35,4
CN4832900000000,2023-03-01,48,329,TX,Midland County,111629,108684,2945,2.6
CN4833100000000,2023-03-01,48,331,TX,Milam County,10461,9977,484,4.6
CN4833300000000,2023-03-01,48,333,TX,Mills County,1984,1902,82,4.1
CN4833500000000,2023-03-01,48,335,TX,Mitchell County,2345,2246,99,4.2
CN4833700000000,2023-03-01,48,337,TX,Montague County,9456,9091,365,3.9
CN4833900000000,2023-03-01,48,339,TX,Montgomery County,311398,298510,12888,4.1
CN4834100000000,2023-03-01,48,341,TX,Moore County,11535,11210,325,2.8
CN4834300000000,2023-03-01,48,343,TX,Morris County,4558,4265,293,6.4
CN4834500000000,2023-03-01,48,345,TX,Motley County,559,535,24,4.3
CN4834700000000,2023-03-01,48,347,TX,Nacogdoches County,28645,27409,1236,4.3
CN4834900000000,2023-03-01,48,349,TX,Navarro County,23901,22750,1151,4.8
CN4835100000000,2023-03-01,48,351,TX,Newton County,5038,4682,356,7.1
CN4835300000000,2023-03-01,48,353,TX,Nolan County,6860,6608,252,3.7
CN4835500000000,2023-03-01,48,355,TX,Nueces County,167194,159524,7670,4.6
CN4835700000000,2023-03-01,48,357,TX,Ochiltree County,3969,3830,139,3.5
CN4835900000000,2023-03-01,48,359,TX,Oldham County,967,937,30,3.1
CN4836100000000,2023-03-01,48,361,TX,Orange County,35898,33790,2108,5.9
CN4836300000000,2023-03-01,48,363,TX,Palo Pinto County,13421,12905,516,3.8
CN4836500000000,2023-03-01,48,365,TX,Panola County,9785,9351,434,4.4
CN4836700000000,2023-03-01,48,367,TX,Parker County,77092,74324,2768,3.6
CN4836900000000,2023-03-01,48,369,TX,Parmer County,5310,5159,151,2.8
CN4837100000000,2023-03-01,48,371,TX,Pecos County,6556,6308,248,3.8
CN4837300000000,2023-03-01,48,373,TX,Polk County,19246,18152,1094,5.7
CN4837500000000,2023-03-01,48,375,TX,Potter County,56228,54412,1816,3.2
CN4837700000000,2023-03-01,48,377,TX,Presidio County,3142,2944,198,6.3
CN4837900000000,2023-03-01,48,379,TX,Rains County,6737,6480,257,3.8
CN4838100000000,2023-03-01,48,381,TX,Randall County,77773,75451,2322,3
CN4838300000000,2023-03-01,48,383,TX,Reagan County,1632,1578,54,3.3
CN4838500000000,2023-03-01,48,385,TX,Real County,1148,1091,57,5
CN4838700000000,2023-03-01,48,387,TX,Red River County,5094,4844,250,4.9
CN4838900000000,2023-03-01,48,389,TX,Reeves County,8611,8224,387,4.5
CN4839100000000,2023-03-01,48,391,TX,Refugio County,2963,2836,127,4.3
CN4839300000000,2023-03-01,48,393,TX,Roberts County,407,391,16,3.9
CN4839500000000,2023-03-01,48,395,TX,Robertson County,8311,8000,311,3.7
CN4839700000000,2023-03-01,48,397,TX,Rockwall County,61246,58976,2270,3.7
CN4839900000000,2023-03-01,48,399,TX,Runnels County,4853,4657,196,4
CN4840100000000,2023-03-01,48,401,TX,Rusk County,22945,21976,969,4.2
CN4840300000000,2023-03-01,48,403,TX,Sabine County,4016,3738,278,6.9
CN4840500000000,2023-03-01,48,405,TX,San Augustine County,3203,3033,170,5.3
CN4840700000000,2023-03-01,48,407,TX,San Jacinto County,12406,11765,641,5.2
CN4840900000000,2023-03-01,48,409,TX,San Patricio County,29714,28096,1618,5.4
CN4841100000000,2023-03-01,48,411,TX,San Saba County,2269,2187,82,3.6
CN4841300000000,2023-03-01,48,413,TX,Schleicher County,1297,1255,42,3.2
CN4841500000000,2023-03-01,48,415,TX,Scurry County,6488,6221,267,4.1
CN4841700000000,2023-03-01,48,417,TX,Shackelford County,1871,1819,52,2.8
CN4841900000000,2023-03-01,48,419,TX,Shelby County,11277,10852,425,3.8
CN4842100000000,2023-03-01,48,421,TX,Sherman County,1448,1405,43,3
CN4842300000000,2023-03-01,48,423,TX,Smith County,114480,110083,4397,3.8
CN4842500000000,2023-03-01,48,425,TX,Somervell County,4710,4528,182,3.9
CN4842700000000,2023-03-01,48,427,TX,Starr County,25137,22353,2784,11.1
CN4842900000000,2023-03-01,48,429,TX,Stephens County,4202,4032,170,4
CN4843100000000,2023-03-01,48,431,TX,Sterling County,546,525,21,3.8
CN4843300000000,2023-03-01,48,433,TX,Stonewall County,808,785,23,2.8
CN4843500000000,2023-03-01,48,435,TX,Sutton County,995,931,64,6.4
CN4843700000000,2023-03-01,48,437,TX,Swisher County,2626,2504,122,4.6
CN4843900000000,2023-03-01,48,439,TX,Tarrant County,1177412,1131202,46210,3.9
CN4844100000000,2023-03-01,48,441,TX,Taylor County,70270,67816,2454,3.5
CN4844300000000,2023-03-01,48,443,TX,Terrell County,430,414,16,3.7
CN4844500000000,2023-03-01,48,445,TX,Terry County,4719,4525,194,4.1
CN4844700000000,2023-03-01,48,447,TX,Throckmorton County,675,651,24,3.6
CN4844900000000,2023-03-01,48,449,TX,Titus County,14277,13621,656,4.6
CN4845100000000,2023-03-01,48,451,TX,Tom Green County,57025,55000,2025,3.6
CN4845300000000,2023-03-01,48,453,TX,Travis County,850224,821072,29152,3.4
CN4845500000000,2023-03-01,48,455,TX,Trinity County,5546,5259,287,5.2
CN4845700000000,2023-03-01,48,457,TX,Tyler County,7365,6891,474,6.4
CN4845900000000,2023-03-01,48,459,TX,Upshur County,18246,17452,794,4.4
CN4846100000000,2023-03-01,48,461,TX,Upton County,2407,2339,68,2.8
CN4846300000000,2023-03-01,48,463,TX,Uvalde County,11444,10921,523,4.6
CN4846500000000,2023-03-01,48,465,TX,Val Verde County,22866,21387,1479,6.5
CN4846700000000,2023-03-01,48,467,TX,Van Zandt County,28682,27637,1045,3.6
CN4846900000000,2023-03-01,48,469,TX,Victoria County,42209,40422,1787,4.2
CN4847100000000,2023-03-01,48,471,TX,Walker County,24587,23413,1174,4.8
CN4847300000000,2023-03-01,48,473,TX,Waller County,26280,25094,1186,4.5
CN4847500000000,2023-03-01,48,475,TX,Ward County,6327,6115,212,3.4
CN4847700000000,2023-03-01,48,477,TX,Washington County,15519,14854,665,4.3
CN4847900000000,2023-03-01,48,479,TX,Webb County,120090,114846,5244,4.4
CN4848100000000,2023-03-01,48,481,TX,Wharton County,22064,21161,903,4.1
CN4848300000000,2023-03-01,48,483,TX,Wheeler County,1986,1906,80,4
CN4848500000000,2023-03-01,48,485,TX,Wichita County,56619,54191,2428,4.3
CN4848700000000,2023-03-01,48,487,TX,Wilbarger County,4886,4615,271,5.5
CN4848900000000,2023-03-01,48,489,TX,Willacy County,7658,7000,658,8.6
CN4849100000000,2023-03-01,48,491,TX,Williamson County,376889,363379,13510,3.6
CN4849300000000,2023-03-01,48,493,TX,Wilson County,26770,25850,920,3.4
CN4849500000000,2023-03-01,48,495,TX,Winkler County,4279,4135,144,3.4
CN4849700000000,2023-03-01,48,497,TX,Wise County,35499,34105,1394,3.9
CN4849900000000,2023-03-01,48,499,TX,Wood County,18737,17870,867,4.6
CN4850100000000,2023-03-01,48,501,TX,Yoakum County,3357,3235,122,3.6
CN4850300000000,2023-03-01,48,503,TX,Young County,8158,7861,297,3.6
CN4850500000000,2023-03-01,48,505,TX,Zapata County,4590,4277,313,6.8
CN4850700000000,2023-03-01,48,507,TX,Zavala County,3617,3327,290,8
CN4900100000000,2023-03-01,49,001,UT,Beaver County,3064,2982,82,2.7
CN4900300000000,2023-03-01,49,003,UT,Box Elder County,28439,27777,662,2.3
CN4900500000000,2023-03-01,49,005,UT,Cache County,73679,72148,1531,2.1
CN4900700000000,2023-03-01,49,007,UT,Carbon County,8518,8230,288,3.4
CN4900900000000,2023-03-01,49,009,UT,Daggett County,367,347,20,5.4
CN4901100000000,2023-03-01,49,011,UT,Davis County,187606,183481,4125,2.2
CN4901300000000,2023-03-01,49,013,UT,Duchesne County,8305,8069,236,2.8
CN4901500000000,2023-03-01,49,015,UT,Emery County,4614,4473,141,3.1
CN4901700000000,2023-03-01,49,017,UT,Garfield County,2737,2497,240,8.8
CN4901900000000,2023-03-01,49,019,UT,Grand County,7139,6916,223,3.1
CN4902100000000,2023-03-01,49,021,UT,Iron County,29460,28747,713,2.4
CN4902300000000,2023-03-01,49,023,UT,Juab County,6593,6445,148,2.2
CN4902500000000,2023-03-01,49,025,UT,Kane County,4128,4014,114,2.8
CN4902700000000,2023-03-01,49,027,UT,Millard County,6674,6531,143,2.1
CN4902900000000,2023-03-01,49,029,UT,Morgan County,6072,5957,115,1.9
CN4903100000000,2023-03-01,49,031,UT,Piute County,524,499,25,4.8
CN4903300000000,2023-03-01,49,033,UT,Rich County,1114,1075,39,3.5
CN4903500000000,2023-03-01,49,035,UT,Salt Lake County,698643,681542,17101,2.4
CN4903700000000,2023-03-01,49,037,UT,San Juan County,5657,5442,215,3.8
CN4903900000000,2023-03-01,49,039,UT,Sanpete County,14330,13933,397,2.8
CN4904100000000,2023-03-01,49,041,UT,Sevier County,10646,10333,313,2.9
CN4904300000000,2023-03-01,49,043,UT,Summit County,29005,28481,524,1.8
CN4904500000000,2023-03-01,49,045,UT,Tooele County,39316,38281,1035,2.6
CN4904700000000,2023-03-01,49,047,UT,Uintah County,14822,14345,477,3.2
CN4904900000000,2023-03-01,49,049,UT,Utah County,354747,346547,8200,2.3
CN4905100000000,2023-03-01,49,051,UT,Wasatch County,18546,18125,421,2.3
CN4905300000000,2023-03-01,49,053,UT,Washington County,89923,87658,2265,2.5
CN4905500000000,2023-03-01,49,055,UT,Wayne County,1567,1485,82,5.2
CN4905700000000,2023-03-01,49,057,UT,Weber County,137909,134214,3695,2.7
CN5000100000000,2023-03-01,50,001,VT,Addison County,20896,20456,440,2.1
CN5000300000000,2023-03-01,50,003,VT,Bennington County,17945,17428,517,2.9
CN5000500000000,2023-03-01,50,005,VT,Caledonia County,14815,14354,461,3.1
CN5000700000000,2023-03-01,50,007,VT,Chittenden County,97809,96212,1597,1.6
CN5000900000000,2023-03-01,50,009,VT,Essex County,2671,2573,98,3.7
CN5001100000000,2023-03-01,50,011,VT,Franklin County,27903,27222,681,2.4
CN5001300000000,2023-03-01,50,013,VT,Grand Isle County,4179,4037,142,3.4
CN5001500000000,2023-03-01,50,015,VT,Lamoille County,14458,13997,461,3.2
CN5001700000000,2023-03-01,50,017,VT,Orange County,15824,15395,429,2.7
CN5001900000000,2023-03-01,50,019,VT,Orleans County,13672,12973,699,5.1
CN5002100000000,2023-03-01,50,021,VT,Rutland County,29735,28895,840,2.8
CN5002300000000,2023-03-01,50,023,VT,Washington County,34356,33603,753,2.2
CN5002500000000,2023-03-01,50,025,VT,Windham County,21412,20901,511,2.4
CN5002700000000,2023-03-01,50,027,VT,Windsor County,30512,29968,544,1.8
CN5100100000000,2023-03-01,51,001,VA,Accomack County,16109,15489,620,3.8
CN5100300000000,2023-03-01,51,003,VA,Albemarle County,60420,58891,1529,2.5
CN5100500000000,2023-03-01,51,005,VA,Alleghany County,6950,6715,235,3.4
CN5100700000000,2023-03-01,51,007,VA,Amelia County,6467,6278,189,2.9
CN5100900000000,2023-03-01,51,009,VA,Amherst County,15268,14780,488,3.2
CN5101100000000,2023-03-01,51,011,VA,Appomattox County,7348,7086,262,3.6
CN5101300000000,2023-03-01,51,013,VA,Arlington County,162451,159024,3427,2.1
CN5101500000000,2023-03-01,51,015,VA,Augusta County,39475,38503,972,2.5
CN5101700000000,2023-03-01,51,017,VA,Bath County,2673,2608,65,2.4
CN5101900000000,2023-03-01,51,019,VA,Bedford County,39677,38556,1121,2.8
CN5102100000000,2023-03-01,51,021,VA,Bland County,2956,2862,94,3.2
CN5102300000000,2023-03-01,51,023,VA,Botetourt County,18311,17854,457,2.5
CN5102500000000,2023-03-01,51,025,VA,Brunswick County,6116,5829,287,4.7
CN5102700000000,2023-03-01,51,027,VA,Buchanan County,6534,6245,289,4.4
CN5102900000000,2023-03-01,51,029,VA,Buckingham County,6695,6418,277,4.1
CN5103100000000,2023-03-01,51,031,VA,Campbell County,26661,25783,878,3.3
CN5103300000000,2023-03-01,51,033,VA,Caroline County,15920,15421,499,3.1
CN5103500000000,2023-03-01,51,035,VA,Carroll County,13371,12921,450,3.4
CN5103600000000,2023-03-01,51,036,VA,Charles City County,3707,3586,121,3.3
CN5103700000000,2023-03-01,51,037,VA,Charlotte County,5745,5571,174,3
CN5104100000000,2023-03-01,51,041,VA,Chesterfield County,201361,195640,5721,2.8
CN5104300000000,2023-03-01,51,043,VA,Clarke County,7860,7671,189,2.4
CN5104500000000,2023-03-01,51,045,VA,Craig County,2397,2326,71,3
CN5104700000000,2023-03-01,51,047,VA,Culpeper County,26364,25627,737,2.8
CN5104900000000,2023-03-01,51,049,VA,Cumberland County,5007,4829,178,3.6
CN5105100000000,2023-03-01,51,051,VA,Dickenson County,4668,4467,201,4.3
CN5105300000000,2023-03-01,51,053,VA,Dinwiddie County,14289,13820,469,3.3
CN5105700000000,2023-03-01,51,057,VA,Essex County,5712,5511,201,3.5
CN5105900000000,2023-03-01,51,059,VA,Fairfax County,661450,645316,16134,2.4
CN5106100000000,2023-03-01,51,061,VA,Fauquier County,38759,37783,976,2.5
CN5106300000000,2023-03-01,51,063,VA,Floyd County,8775,8545,230,2.6
CN5106500000000,2023-03-01,51,065,VA,Fluvanna County,14839,14466,373,2.5
CN5106700000000,2023-03-01,51,067,VA,Franklin County,27419,26612,807,2.9
CN5106900000000,2023-03-01,51,069,VA,Frederick County,53142,51852,1290,2.4
CN5107100000000,2023-03-01,51,071,VA,Giles County,8458,8221,237,2.8
CN5107300000000,2023-03-01,51,073,VA,Gloucester County,19985,19442,543,2.7
CN5107500000000,2023-03-01,51,075,VA,Goochland County,12300,11948,352,2.9
CN5107700000000,2023-03-01,51,077,VA,Grayson County,8459,8243,216,2.6
CN5107900000000,2023-03-01,51,079,VA,Greene County,11099,10827,272,2.5
CN5108100000000,2023-03-01,51,081,VA,Greensville County,4476,4313,163,3.6
CN5108300000000,2023-03-01,51,083,VA,Halifax County,15948,15347,601,3.8
CN5108500000000,2023-03-01,51,085,VA,Hanover County,62324,60801,1523,2.4
CN5108700000000,2023-03-01,51,087,VA,Henrico County,192718,187290,5428,2.8
CN5108900000000,2023-03-01,51,089,VA,Henry County,24440,23592,848,3.5
CN5109100000000,2023-03-01,51,091,VA,Highland County,1474,1438,36,2.4
CN5109300000000,2023-03-01,51,093,VA,Isle of Wight County,20156,19601,555,2.8
CN5109500000000,2023-03-01,51,095,VA,James City County,37989,36910,1079,2.8
CN5109700000000,2023-03-01,51,097,VA,King and Queen County,4102,3995,107,2.6
CN5109900000000,2023-03-01,51,099,VA,King George County,14872,14480,392,2.6
CN5110100000000,2023-03-01,51,101,VA,King William County,9936,9664,272,2.7
CN5110300000000,2023-03-01,51,103,VA,Lancaster County,5693,5396,297,5.2
CN5110500000000,2023-03-01,51,105,VA,Lee County,8455,8114,341,4
CN5110700000000,2023-03-01,51,107,VA,Loudoun County,240259,234362,5897,2.5
CN5110900000000,2023-03-01,51,109,VA,Louisa County,21799,21210,589,2.7
CN5111100000000,2023-03-01,51,111,VA,Lunenburg County,5304,5136,168,3.2
CN5111300000000,2023-03-01,51,113,VA,Madison County,7754,7576,178,2.3
CN5111500000000,2023-03-01,51,115,VA,Mathews County,4204,4080,124,2.9
CN5111700000000,2023-03-01,51,117,VA,Mecklenburg County,13686,13202,484,3.5
CN5111900000000,2023-03-01,51,119,VA,Middlesex County,5526,5377,149,2.7
CN5112100000000,2023-03-01,51,121,VA,Montgomery County,54480,53001,1479,2.7
CN5112500000000,2023-03-01,51,125,VA,Nelson County,7651,7442,209,2.7
CN5112700000000,2023-03-01,51,127,VA,New Kent County,13763,13405,358,2.6
CN5113100000000,2023-03-01,51,131,VA,Northampton County,5530,5318,212,3.8
CN5113300000000,2023-03-01,51,133,VA,Northumberland County,5830,5505,325,5.6
CN5113500000000,2023-03-01,51,135,VA,Nottoway County,7484,7272,212,2.8
CN5113700000000,2023-03-01,51,137,VA,Orange County,17986,17441,545,3
CN5113900000000,2023-03-01,51,139,VA,Page County,12565,12050,515,4.1
CN5114100000000,2023-03-01,51,141,VA,Patrick County,7249,6996,253,3.5
CN5114300000000,2023-03-01,51,143,VA,Pittsylvania County,31074,30092,982,3.2
CN5114500000000,2023-03-01,51,145,VA,Powhatan County,15245,14862,383,2.5
CN5114700000000,2023-03-01,51,147,VA,Prince Edward County,10380,9990,390,3.8
CN5114900000000,2023-03-01,51,149,VA,Prince George County,15955,15435,520,3.3
CN5115300000000,2023-03-01,51,153,VA,Prince William County,259597,252542,7055,2.7
CN5115500000000,2023-03-01,51,155,VA,Pulaski County,17401,16934,467,2.7
CN5115700000000,2023-03-01,51,157,VA,Rappahannock County,3832,3723,109,2.8
CN5115900000000,2023-03-01,51,159,VA,Richmond County,4117,3977,140,3.4
CN5116100000000,2023-03-01,51,161,VA,Roanoke County,51829,50516,1313,2.5
CN5116300000000,2023-03-01,51,163,VA,Rockbridge County,11433,11144,289,2.5
CN5116500000000,2023-03-01,51,165,VA,Rockingham County,44420,43337,1083,2.4
CN5116700000000,2023-03-01,51,167,VA,Russell County,11205,10792,413,3.7
CN5116900000000,2023-03-01,51,169,VA,Scott County,9607,9291,316,3.3
CN5117100000000,2023-03-01,51,171,VA,Shenandoah County,22577,21976,601,2.7
CN5117300000000,2023-03-01,51,173,VA,Smyth County,13616,13176,440,3.2
CN5117500000000,2023-03-01,51,175,VA,Southampton County,8973,8743,230,2.6
CN5117700000000,2023-03-01,51,177,VA,Spotsylvania County,71881,69654,2227,3.1
CN5117900000000,2023-03-01,51,179,VA,Stafford County,78229,75983,2246,2.9
CN5118100000000,2023-03-01,51,181,VA,Surry County,3721,3618,103,2.8
CN5118300000000,2023-03-01,51,183,VA,Sussex County,3724,3567,157,4.2
CN5118500000000,2023-03-01,51,185,VA,Tazewell County,15863,15232,631,4
CN5118700000000,2023-03-01,51,187,VA,Warren County,21450,20845,605,2.8
CN5119100000000,2023-03-01,51,191,VA,Washington County,27547,26749,798,2.9
CN5119300000000,2023-03-01,51,193,VA,Westmoreland County,9741,9414,327,3.4
CN5119500000000,2023-03-01,51,195,VA,Wise County,13135,12599,536,4.1
CN5119700000000,2023-03-01,51,197,VA,Wythe County,14529,14127,402,2.8
CN5119900000000,2023-03-01,51,199,VA,York County,34078,33167,911,2.7
CN5151000000000,2023-03-01,51,510,VA,Alexandria city,104289,101884,2405,2.3
CN5152000000000,2023-03-01,51,520,VA,Bristol city,7953,7679,274,3.4
CN5153000000000,2023-03-01,51,530,VA,Buena Vista city,3176,3088,88,2.8
CN5154000000000,2023-03-01,51,540,VA,Charlottesville city,26815,26157,658,2.5
CN5155000000000,2023-03-01,51,550,VA,Chesapeake city,127246,123580,3666,2.9
CN5157000000000,2023-03-01,51,570,VA,Colonial Heights city,8859,8589,270,3
CN5158000000000,2023-03-01,51,580,VA,Covington city,2363,2281,82,3.5
CN5159000000000,2023-03-01,51,590,VA,Danville city,19116,18253,863,4.5
CN5159500000000,2023-03-01,51,595,VA,Emporia city,2403,2286,117,4.9
CN5160000000000,2023-03-01,51,600,VA,Fairfax city,13380,13053,327,2.4
CN5161000000000,2023-03-01,51,610,VA,Falls Church city,8887,8678,209,2.4
CN5162000000000,2023-03-01,51,620,VA,Franklin city,3538,3400,138,3.9
CN5163000000000,2023-03-01,51,630,VA,Fredericksburg city,14885,14376,509,3.4
CN5164000000000,2023-03-01,51,640,VA,Galax city,2958,2864,94,3.2
CN5165000000000,2023-03-01,51,650,VA,Hampton city,66156,63659,2497,3.8
CN5166000000000,2023-03-01,51,660,VA,Harrisonburg city,26019,25145,874,3.4
CN5167000000000,2023-03-01,51,670,VA,Hopewell city,10007,9569,438,4.4
CN5167800000000,2023-03-01,51,678,VA,Lexington city,2464,2366,98,4
CN5168000000000,2023-03-01,51,680,VA,Lynchburg city,36833,35383,1450,3.9
CN5168300000000,2023-03-01,51,683,VA,Manassas city,22505,21931,574,2.6
CN5168500000000,2023-03-01,51,685,VA,Manassas Park city,10146,9895,251,2.5
CN5169000000000,2023-03-01,51,690,VA,Martinsville city,5742,5478,264,4.6
CN5170000000000,2023-03-01,51,700,VA,Newport News city,90744,87600,3144,3.5
CN5171000000000,2023-03-01,51,710,VA,Norfolk city,113125,109277,3848,3.4
CN5172000000000,2023-03-01,51,720,VA,Norton city,1638,1577,61,3.7
CN5173000000000,2023-03-01,51,730,VA,Petersburg city,13084,12380,704,5.4
CN5173500000000,2023-03-01,51,735,VA,Poquoson city,6514,6355,159,2.4
CN5174000000000,2023-03-01,51,740,VA,Portsmouth city,45255,43596,1659,3.7
CN5175000000000,2023-03-01,51,750,VA,Radford city,9422,9099,323,3.4
CN5176000000000,2023-03-01,51,760,VA,Richmond city,125626,121321,4305,3.4
CN5177000000000,2023-03-01,51,770,VA,Roanoke city,51027,49408,1619,3.2
CN5177500000000,2023-03-01,51,775,VA,Salem city,13411,13030,381,2.8
CN5179000000000,2023-03-01,51,790,VA,Staunton city,12916,12577,339,2.6
CN5180000000000,2023-03-01,51,800,VA,Suffolk city,46830,45366,1464,3.1
CN5181000000000,2023-03-01,51,810,VA,Virginia Beach city,238443,231819,6624,2.8
CN5182000000000,2023-03-01,51,820,VA,Waynesboro city,11241,10916,325,2.9
CN5183000000000,2023-03-01,51,830,VA,Williamsburg city,7000,6726,274,3.9
CN5184000000000,2023-03-01,51,840,VA,Winchester city,15568,15113,455,2.9
CN5300100000000,2023-03-01,53,001,WA,Adams County,9386,8847,539,5.7
CN5300300000000,2023-03-01,53,003,WA,Asotin County,10784,10376,408,3.8
CN5300500000000,2023-03-01,53,005,WA,Benton County,108416,102789,5627,5.2
CN5300700000000,2023-03-01,53,007,WA,Chelan County,44467,42155,2312,5.2
CN5300900000000,2023-03-01,53,009,WA,Clallam County,30018,28148,1870,6.2
CN5301100000000,2023-03-01,53,011,WA,Clark County,257036,244795,12241,4.8
CN5301300000000,2023-03-01,53,013,WA,Columbia County,1816,1718,98,5.4
CN5301500000000,2023-03-01,53,015,WA,Cowlitz County,50350,47460,2890,5.7
CN5301700000000,2023-03-01,53,017,WA,Douglas County,21765,20527,1238,5.7
CN5301900000000,2023-03-01,53,019,WA,Ferry County,2334,2086,248,10.6
CN5302100000000,2023-03-01,53,021,WA,Franklin County,44162,41020,3142,7.1
CN5302300000000,2023-03-01,53,023,WA,Garfield County,827,770,57,6.9
CN5302500000000,2023-03-01,53,025,WA,Grant County,47536,44511,3025,6.4
CN5302700000000,2023-03-01,53,027,WA,Grays Harbor County,29936,27646,2290,7.6
CN5302900000000,2023-03-01,53,029,WA,Island County,37588,35761,1827,4.9
CN5303100000000,2023-03-01,53,031,WA,Jefferson County,12917,12142,775,6
CN5303300000000,2023-03-01,53,033,WA,King County,1355458,1319553,35905,2.6
CN5303500000000,2023-03-01,53,035,WA,Kitsap County,132977,126913,6064,4.6
CN5303700000000,2023-03-01,53,037,WA,Kittitas County,22837,21393,1444,6.3
CN5303900000000,2023-03-01,53,039,WA,Klickitat County,9946,9350,596,6
CN5304100000000,2023-03-01,53,041,WA,Lewis County,36006,33735,2271,6.3
CN5304300000000,2023-03-01,53,043,WA,Lincoln County,4843,4554,289,6
CN5304500000000,2023-03-01,53,045,WA,Mason County,26571,24914,1657,6.2
CN5304700000000,2023-03-01,53,047,WA,Okanogan County,19562,18180,1382,7.1
CN5304900000000,2023-03-01,53,049,WA,Pacific County,8929,8331,598,6.7
CN5305100000000,2023-03-01,53,051,WA,Pend Oreille County,5323,4913,410,7.7
CN5305300000000,2023-03-01,53,053,WA,Pierce County,468213,443762,24451,5.2
CN5305500000000,2023-03-01,53,055,WA,San Juan County,8526,8152,374,4.4
CN5305700000000,2023-03-01,53,057,WA,Skagit County,62920,59704,3216,5.1
CN5305900000000,2023-03-01,53,059,WA,Skamania County,5746,5409,337,5.9
CN5306100000000,2023-03-01,53,061,WA,Snohomish County,461093,448198,12895,2.8
CN5306300000000,2023-03-01,53,063,WA,Spokane County,270402,257045,13357,4.9
CN5306500000000,2023-03-01,53,065,WA,Stevens County,19915,18327,1588,8
CN5306700000000,2023-03-01,53,067,WA,Thurston County,155577,148367,7210,4.6
CN5306900000000,2023-03-01,53,069,WA,Wahkiakum County,1446,1340,106,7.3
CN5307100000000,2023-03-01,53,071,WA,Walla Walla County,30988,29590,1398,4.5
CN5307300000000,2023-03-01,53,073,WA,Whatcom County,118133,112511,5622,4.8
CN5307500000000,2023-03-01,53,075,WA,Whitman County,24118,23151,967,4
CN5307700000000,2023-03-01,53,077,WA,Yakima County,128731,119532,9199,7.1
CN5400100000000,2023-03-01,54,001,WV,Barbour County,7394,7082,312,4.2
CN5400300000000,2023-03-01,54,003,WV,Berkeley County,58699,56999,1700,2.9
CN5400500000000,2023-03-01,54,005,WV,Boone County,6895,6645,250,3.6
CN5400700000000,2023-03-01,54,007,WV,Braxton County,4879,4620,259,5.3
CN5400900000000,2023-03-01,54,009,WV,Brooke County,9742,9327,415,4.3
CN5401100000000,2023-03-01,54,011,WV,Cabell County,41324,40040,1284,3.1
CN5401300000000,2023-03-01,54,013,WV,Calhoun County,2509,2314,195,7.8
CN5401500000000,2023-03-01,54,015,WV,Clay County,2901,2731,170,5.9
CN5401700000000,2023-03-01,54,017,WV,Doddridge County,3809,3702,107,2.8
CN5401900000000,2023-03-01,54,019,WV,Fayette County,15575,14905,670,4.3
CN5402100000000,2023-03-01,54,021,WV,Gilmer County,2351,2239,112,4.8
CN5402300000000,2023-03-01,54,023,WV,Grant County,5981,5763,218,3.6
CN5402500000000,2023-03-01,54,025,WV,Greenbrier County,14562,14025,537,3.7
CN5402700000000,2023-03-01,54,027,WV,Hampshire County,11115,10822,293,2.6
CN5402900000000,2023-03-01,54,029,WV,Hancock County,12983,12305,678,5.2
CN5403100000000,2023-03-01,54,031,WV,Hardy County,5619,5386,233,4.1
CN5403300000000,2023-03-01,54,033,WV,Harrison County,33088,32103,985,3
CN5403500000000,2023-03-01,54,035,WV,Jackson County,11565,11084,481,4.2
CN5403700000000,2023-03-01,54,037,WV,Jefferson County,30361,29674,687,2.3
CN5403900000000,2023-03-01,54,039,WV,Kanawha County,78201,75577,2624,3.4
CN5404100000000,2023-03-01,54,041,WV,Lewis County,6347,6075,272,4.3
CN5404300000000,2023-03-01,54,043,WV,Lincoln County,7016,6707,309,4.4
CN5404500000000,2023-03-01,54,045,WV,Logan County,10829,10443,386,3.6
CN5404700000000,2023-03-01,54,047,WV,McDowell County,4103,3880,223,5.4
CN5404900000000,2023-03-01,54,049,WV,Marion County,25335,24421,914,3.6
CN5405100000000,2023-03-01,54,051,WV,Marshall County,12824,12147,677,5.3
CN5405300000000,2023-03-01,54,053,WV,Mason County,10356,9987,369,3.6
CN5405500000000,2023-03-01,54,055,WV,Mercer County,20602,19814,788,3.8
CN5405700000000,2023-03-01,54,057,WV,Mineral County,12530,12065,465,3.7
CN5405900000000,2023-03-01,54,059,WV,Mingo County,6457,6179,278,4.3
CN5406100000000,2023-03-01,54,061,WV,Monongalia County,55338,53881,1457,2.6
CN5406300000000,2023-03-01,54,063,WV,Monroe County,5985,5832,153,2.6
CN5406500000000,2023-03-01,54,065,WV,Morgan County,8349,8103,246,2.9
CN5406700000000,2023-03-01,54,067,WV,Nicholas County,8778,8397,381,4.3
CN5406900000000,2023-03-01,54,069,WV,Ohio County,19390,18710,680,3.5
CN5407100000000,2023-03-01,54,071,WV,Pendleton County,3685,3606,79,2.1
CN5407300000000,2023-03-01,54,073,WV,Pleasants County,2667,2514,153,5.7
CN5407500000000,2023-03-01,54,075,WV,Pocahontas County,4184,4024,160,3.8
CN5407700000000,2023-03-01,54,077,WV,Preston County,15420,14832,588,3.8
CN5407900000000,2023-03-01,54,079,WV,Putnam County,26930,26124,806,3
CN5408100000000,2023-03-01,54,081,WV,Raleigh County,29450,28420,1030,3.5
CN5408300000000,2023-03-01,54,083,WV,Randolph County,11662,11100,562,4.8
CN5408500000000,2023-03-01,54,085,WV,Ritchie County,4182,4026,156,3.7
CN5408700000000,2023-03-01,54,087,WV,Roane County,4793,4464,329,6.9
CN5408900000000,2023-03-01,54,089,WV,Summers County,4680,4507,173,3.7
CN5409100000000,2023-03-01,54,091,WV,Taylor County,7875,7587,288,3.7
CN5409300000000,2023-03-01,54,093,WV,Tucker County,3415,3266,149,4.4
CN5409500000000,2023-03-01,54,095,WV,Tyler County,2894,2729,165,5.7
CN5409700000000,2023-03-01,54,097,WV,Upshur County,9577,9169,408,4.3
CN5409900000000,2023-03-01,54,099,WV,Wayne County,15534,14990,544,3.5
CN5410100000000,2023-03-01,54,101,WV,Webster County,2931,2795,136,4.6
CN5410300000000,2023-03-01,54,103,WV,Wetzel County,6454,6056,398,6.2
CN5410500000000,2023-03-01,54,105,WV,Wirt County,2215,2093,122,5.5
CN5410700000000,2023-03-01,54,107,WV,Wood County,36063,34656,1407,3.9
CN5410900000000,2023-03-01,54,109,WV,Wyoming County,7265,7003,262,3.6
CN5500100000000,2023-03-01,55,001,WI,Adams County,7539,7134,405,5.4
CN5500300000000,2023-03-01,55,003,WI,Ashland County,7182,6931,251,3.5
CN5500500000000,2023-03-01,55,005,WI,Barron County,23579,22723,856,3.6
CN5500700000000,2023-03-01,55,007,WI,Bayfield County,7165,6804,361,5
CN5500900000000,2023-03-01,55,009,WI,Brown County,142106,139171,2935,2.1
CN5501100000000,2023-03-01,55,011,WI,Buffalo County,6192,5937,255,4.1
CN5501300000000,2023-03-01,55,013,WI,Burnett County,7073,6709,364,5.1
CN5501500000000,2023-03-01,55,015,WI,Calumet County,27742,27269,473,1.7
CN5501700000000,2023-03-01,55,017,WI,Chippewa County,34016,32745,1271,3.7
CN5501900000000,2023-03-01,55,019,WI,Clark County,17732,17291,441,2.5
CN5502100000000,2023-03-01,55,021,WI,Columbia County,32174,31522,652,2
CN5502300000000,2023-03-01,55,023,WI,Crawford County,6846,6589,257,3.8
CN5502500000000,2023-03-01,55,025,WI,Dane County,333191,327851,5340,1.6
CN5502700000000,2023-03-01,55,027,WI,Dodge County,47117,46063,1054,2.2
CN5502900000000,2023-03-01,55,029,WI,Door County,13736,13250,486,3.5
CN5503100000000,2023-03-01,55,031,WI,Douglas County,22830,21866,964,4.2
CN5503300000000,2023-03-01,55,033,WI,Dunn County,24643,23875,768,3.1
CN5503500000000,2023-03-01,55,035,WI,Eau Claire County,59683,58426,1257,2.1
CN5503700000000,2023-03-01,55,037,WI,Florence County,2095,2030,65,3.1
CN5503900000000,2023-03-01,55,039,WI,Fond du Lac County,56538,55376,1162,2.1
CN5504100000000,2023-03-01,55,041,WI,Forest County,3894,3712,182,4.7
CN5504300000000,2023-03-01,55,043,WI,Grant County,27605,26937,668,2.4
CN5504500000000,2023-03-01,55,045,WI,Green County,21167,20750,417,2
CN5504700000000,2023-03-01,55,047,WI,Green Lake County,8876,8622,254,2.9
CN5504900000000,2023-03-01,55,049,WI,Iowa County,13900,13579,321,2.3
CN5505100000000,2023-03-01,55,051,WI,Iron County,2514,2386,128,5.1
CN5505300000000,2023-03-01,55,053,WI,Jackson County,9375,9011,364,3.9
CN5505500000000,2023-03-01,55,055,WI,Jefferson County,45920,44880,1040,2.3
CN5505700000000,2023-03-01,55,057,WI,Juneau County,13254,12880,374,2.8
CN5505900000000,2023-03-01,55,059,WI,Kenosha County,89336,86801,2535,2.8
CN5506100000000,2023-03-01,55,061,WI,Kewaunee County,11014,10773,241,2.2
CN5506300000000,2023-03-01,55,063,WI,La Crosse County,67263,65955,1308,1.9
CN5506500000000,2023-03-01,55,065,WI,Lafayette County,10276,10063,213,2.1
CN5506700000000,2023-03-01,55,067,WI,Langlade County,9234,8951,283,3.1
CN5506900000000,2023-03-01,55,069,WI,Lincoln County,14685,14283,402,2.7
CN5507100000000,2023-03-01,55,071,WI,Manitowoc County,40037,39001,1036,2.6
CN5507300000000,2023-03-01,55,073,WI,Marathon County,73141,71604,1537,2.1
CN5507500000000,2023-03-01,55,075,WI,Marinette County,18691,18037,654,3.5
CN5507700000000,2023-03-01,55,077,WI,Marquette County,7618,7352,266,3.5
CN5507800000000,2023-03-01,55,078,WI,Menominee County,1479,1421,58,3.9
CN5507900000000,2023-03-01,55,079,WI,Milwaukee County,451462,438553,12909,2.9
CN5508100000000,2023-03-01,55,081,WI,Monroe County,23175,22646,529,2.3
CN5508300000000,2023-03-01,55,083,WI,Oconto County,20940,20303,637,3
CN5508500000000,2023-03-01,55,085,WI,Oneida County,17349,16725,624,3.6
CN5508700000000,2023-03-01,55,087,WI,Outagamie County,104537,102519,2018,1.9
CN5508900000000,2023-03-01,55,089,WI,Ozaukee County,48249,47360,889,1.8
CN5509100000000,2023-03-01,55,091,WI,Pepin County,4018,3873,145,3.6
CN5509300000000,2023-03-01,55,093,WI,Pierce County,24539,23725,814,3.3
CN5509500000000,2023-03-01,55,095,WI,Polk County,24691,23565,1126,4.6
CN5509700000000,2023-03-01,55,097,WI,Portage County,37850,36917,933,2.5
CN5509900000000,2023-03-01,55,099,WI,Price County,6154,5969,185,3
CN5510100000000,2023-03-01,55,101,WI,Racine County,97847,95019,2828,2.9
CN5510300000000,2023-03-01,55,103,WI,Richland County,8845,8615,230,2.6
CN5510500000000,2023-03-01,55,105,WI,Rock County,86021,83550,2471,2.9
CN5510700000000,2023-03-01,55,107,WI,Rusk County,6533,6295,238,3.6
CN5510900000000,2023-03-01,55,109,WI,St. Croix County,49804,48127,1677,3.4
CN5511100000000,2023-03-01,55,111,WI,Sauk County,33867,33070,797,2.4
CN5511300000000,2023-03-01,55,113,WI,Sawyer County,7660,7333,327,4.3
CN5511500000000,2023-03-01,55,115,WI,Shawano County,20368,19843,525,2.6
CN5511700000000,2023-03-01,55,117,WI,Sheboygan County,61181,60085,1096,1.8
CN5511900000000,2023-03-01,55,119,WI,Taylor County,10649,10211,438,4.1
CN5512100000000,2023-03-01,55,121,WI,Trempealeau County,14824,14344,480,3.2
CN5512300000000,2023-03-01,55,123,WI,Vernon County,15399,14983,416,2.7
CN5512500000000,2023-03-01,55,125,WI,Vilas County,9711,9320,391,4
CN5512700000000,2023-03-01,55,127,WI,Walworth County,57363,55905,1458,2.5
CN5512900000000,2023-03-01,55,129,WI,Washburn County,7512,7236,276,3.7
CN5513100000000,2023-03-01,55,131,WI,Washington County,75523,74020,1503,2
CN5513300000000,2023-03-01,55,133,WI,Waukesha County,220298,215956,4342,2
CN5513500000000,2023-03-01,55,135,WI,Waupaca County,24817,24165,652,2.6
CN5513700000000,2023-03-01,55,137,WI,Waushara County,11026,10662,364,3.3
CN5513900000000,2023-03-01,55,139,WI,Winnebago County,92373,90624,1749,1.9
CN5514100000000,2023-03-01,55,141,WI,Wood County,33133,32150,983,3
CN5600100000000,2023-03-01,56,001,WY,Albany County,22660,21901,759,3.3
CN5600300000000,2023-03-01,56,003,WY,Big Horn County,5075,4831,244,4.8
CN5600500000000,2023-03-01,56,005,WY,Campbell County,23368,22511,857,3.7
CN5600700000000,2023-03-01,56,007,WY,Carbon County,7192,6872,320,4.4
CN5600900000000,2023-03-01,56,009,WY,Converse County,7854,7605,249,3.2
CN5601100000000,2023-03-01,56,011,WY,Crook County,3911,3775,136,3.5
CN5601300000000,2023-03-01,56,013,WY,Fremont County,19453,18498,955,4.9
CN5601500000000,2023-03-01,56,015,WY,Goshen County,6628,6406,222,3.3
CN5601700000000,2023-03-01,56,017,WY,Hot Springs County,2320,2230,90,3.9
CN5601900000000,2023-03-01,56,019,WY,Johnson County,4245,4063,182,4.3
CN5602100000000,2023-03-01,56,021,WY,Laramie County,50592,48603,1989,3.9
CN5602300000000,2023-03-01,56,023,WY,Lincoln County,9715,9297,418,4.3
CN5602500000000,2023-03-01,56,025,WY,Natrona County,40762,38936,1826,4.5
CN5602700000000,2023-03-01,56,027,WY,Niobrara County,1198,1156,42,3.5
CN5602900000000,2023-03-01,56,029,WY,Park County,15098,14402,696,4.6
CN5603100000000,2023-03-01,56,031,WY,Platte County,4461,4281,180,4
CN5603300000000,2023-03-01,56,033,WY,Sheridan County,16467,15786,681,4.1
CN5603500000000,2023-03-01,56,035,WY,Sublette County,3870,3684,186,4.8
CN5603700000000,2023-03-01,56,037,WY,Sweetwater County,20277,19257,1020,5
CN5603900000000,2023-03-01,56,039,WY,Teton County,16859,16412,447,2.7
CN5604100000000,2023-03-01,56,041,WY,Uinta County,9354,8942,412,4.4
CN5604300000000,2023-03-01,56,043,WY,Washakie County,3922,3698,224,5.7
CN5604500000000,2023-03-01,56,045,WY,Weston County,3867,3763,104,2.7
CN7200100000000,2023-03-01,72,001,PR,Adjuntas Municipio,4528,4111,417,9.2
CN7200300000000,2023-03-01,72,003,PR,Aguada Municipio,13608,12654,954,7
CN7200500000000,2023-03-01,72,005,PR,Aguadilla Municipio,16524,15232,1292,7.8
CN7200700000000,2023-03-01,72,007,PR,Aguas Buenas Municipio,7070,6659,411,5.8
CN7200900000000,2023-03-01,72,009,PR,Aibonito Municipio,6845,6372,473,6.9
CN7201100000000,2023-03-01,72,011,PR,Anasco Municipio,10278,9598,680,6.6
CN7201300000000,2023-03-01,72,013,PR,Arecibo Municipio,26179,24451,1728,6.6
CN7201500000000,2023-03-01,72,015,PR,Arroyo Municipio,5032,4564,468,9.3
CN7201700000000,2023-03-01,72,017,PR,Barceloneta Municipio,6401,5920,481,7.5
CN7201900000000,2023-03-01,72,019,PR,Barranquitas Municipio,7956,7366,590,7.4
CN7202100000000,2023-03-01,72,021,PR,Bayamon Municipio,70417,67224,3193,4.5
CN7202300000000,2023-03-01,72,023,PR,Cabo Rojo Municipio,15432,14425,1007,6.5
CN7202500000000,2023-03-01,72,025,PR,Caguas Municipio,51950,49617,2333,4.5
CN7202700000000,2023-03-01,72,027,PR,Camuy Municipio,10501,9859,642,6.1
CN7202900000000,2023-03-01,72,029,PR,Canovanas Municipio,17732,16936,796,4.5
CN7203100000000,2023-03-01,72,031,PR,Carolina Municipio,66480,63659,2821,4.2
CN7203300000000,2023-03-01,72,033,PR,Catano Municipio,8393,8010,383,4.6
CN7203500000000,2023-03-01,72,035,PR,Cayey Municipio,17581,16747,834,4.7
CN7203700000000,2023-03-01,72,037,PR,Ceiba Municipio,3927,3638,289,7.4
CN7203900000000,2023-03-01,72,039,PR,Ciales Municipio,3950,3653,297,7.5
CN7204100000000,2023-03-01,72,041,PR,Cidra Municipio,16826,16050,776,4.6
CN7204300000000,2023-03-01,72,043,PR,Coamo Municipio,11311,10449,862,7.6
CN7204500000000,2023-03-01,72,045,PR,Comerio Municipio,5352,4978,374,7
CN7204700000000,2023-03-01,72,047,PR,Corozal Municipio,9533,8896,637,6.7
CN7204900000000,2023-03-01,72,049,PR,Culebra Municipio,1007,988,19,1.9
CN7205100000000,2023-03-01,72,051,PR,Dorado Municipio,14760,14076,684,4.6
CN7205300000000,2023-03-01,72,053,PR,Fajardo Municipio,11475,10709,766,6.7
CN7205400000000,2023-03-01,72,054,PR,Florida Municipio,3571,3276,295,8.3
CN7205500000000,2023-03-01,72,055,PR,Guanica Municipio,4232,3719,513,12.1
CN7205700000000,2023-03-01,72,057,PR,Guayama Municipio,11678,10912,766,6.6
CN7205900000000,2023-03-01,72,059,PR,Guayanilla Municipio,5279,4680,599,11.3
CN7206100000000,2023-03-01,72,061,PR,Guaynabo Municipio,41347,40156,1191,2.9
CN7206300000000,2023-03-01,72,063,PR,Gurabo Municipio,20504,19683,821,4
CN7206500000000,2023-03-01,72,065,PR,Hatillo Municipio,14844,13706,1138,7.7
CN7206700000000,2023-03-01,72,067,PR,Hormigueros Municipio,6072,5781,291,4.8
CN7206900000000,2023-03-01,72,069,PR,Humacao Municipio,19034,17779,1255,6.6
CN7207100000000,2023-03-01,72,071,PR,Isabela Municipio,13531,12622,909,6.7
CN7207300000000,2023-03-01,72,073,PR,Jayuya Municipio,4840,4391,449,9.3
CN7207500000000,2023-03-01,72,075,PR,Juana Diaz Municipio,17182,15956,1226,7.1
CN7207700000000,2023-03-01,72,077,PR,Juncos Municipio,13544,12710,834,6.2
CN7207900000000,2023-03-01,72,079,PR,Lajas Municipio,5771,5230,541,9.4
CN7208100000000,2023-03-01,72,081,PR,Lares Municipio,7787,6994,793,10.2
CN7208300000000,2023-03-01,72,083,PR,Las Marias Municipio,2693,2387,306,11.4
CN7208500000000,2023-03-01,72,085,PR,Las Piedras Municipio,12452,11725,727,5.8
CN7208700000000,2023-03-01,72,087,PR,Loiza Municipio,8979,8517,462,5.1
CN7208900000000,2023-03-01,72,089,PR,Luquillo Municipio,6685,6266,419,6.3
CN7209100000000,2023-03-01,72,091,PR,Manati Municipio,12188,11478,710,5.8
CN7209300000000,2023-03-01,72,093,PR,Maricao Municipio,2219,1990,229,10.3
CN7209500000000,2023-03-01,72,095,PR,Maunabo Municipio,3195,2754,441,13.8
CN7209700000000,2023-03-01,72,097,PR,Mayaguez Municipio,24649,22908,1741,7.1
CN7209900000000,2023-03-01,72,099,PR,Moca Municipio,11980,11056,924,7.7
CN7210100000000,2023-03-01,72,101,PR,Morovis Municipio,8790,8200,590,6.7
CN7210300000000,2023-03-01,72,103,PR,Naguabo Municipio,8936,8440,496,5.6
CN7210500000000,2023-03-01,72,105,PR,Naranjito Municipio,7661,7165,496,6.5
CN7210700000000,2023-03-01,72,107,PR,Orocovis Municipio,5349,4842,507,9.5
CN7210900000000,2023-03-01,72,109,PR,Patillas Municipio,4478,4040,438,9.8
CN7211100000000,2023-03-01,72,111,PR,Penuelas Municipio,6223,5596,627,10.1
CN7211300000000,2023-03-01,72,113,PR,Ponce Municipio,49080,45791,3289,6.7
CN7211500000000,2023-03-01,72,115,PR,Quebradillas Municipio,6608,6129,479,7.2
CN7211700000000,2023-03-01,72,117,PR,Rincon Municipio,5530,4873,657,11.9
CN7211900000000,2023-03-01,72,119,PR,Rio Grande Municipio,18350,17492,858,4.7
CN7212100000000,2023-03-01,72,121,PR,Sabana Grande Municipio,6566,6029,537,8.2
CN7212300000000,2023-03-01,72,123,PR,Salinas Municipio,7506,6860,646,8.6
CN7212500000000,2023-03-01,72,125,PR,San German Municipio,10681,9853,828,7.8
CN7212700000000,2023-03-01,72,127,PR,San Juan Municipio,145344,139236,6108,4.2
CN7212900000000,2023-03-01,72,129,PR,San Lorenzo Municipio,12575,11844,731,5.8
CN7213100000000,2023-03-01,72,131,PR,San Sebastian Municipio,11454,10370,1084,9.5
CN7213300000000,2023-03-01,72,133,PR,Santa Isabel Municipio,8432,7752,680,8.1
CN7213500000000,2023-03-01,72,135,PR,Toa Alta Municipio,30368,29068,1300,4.3
CN7213700000000,2023-03-01,72,137,PR,Toa Baja Municipio,31519,30178,1341,4.3
CN7213900000000,2023-03-01,72,139,PR,Trujillo Alto Municipio,29376,28518,858,2.9
CN7214100000000,2023-03-01,72,141,PR,Utuado Municipio,7480,6890,590,7.9
CN7214300000000,2023-03-01,72,143,PR,Vega Alta Municipio,10582,9977,605,5.7
CN7214500000000,2023-03-01,72,145,PR,Vega Baja Municipio,14267,13253,1014,7.1
CN7214700000000,2023-03-01,72,147,PR,Vieques Municipio,2736,2638,98,3.6
CN7214900000000,2023-03-01,72,149,PR,Villalba Municipio,7782,6997,785,10.1
CN7215100000000,2023-03-01,72,151,PR,Yabucoa Municipio,9306,8532,774,8.3
CN7215300000000,2023-03-01,72,153,PR,Yauco Municipio,10626,9353,1273,12
CN0100100000000,2023-04-01,01,001,AL,Autauga County,26828,26409,419,1.6
CN0100300000000,2023-04-01,01,003,AL,Baldwin County,104101,102443,1658,1.6
CN0100500000000,2023-04-01,01,005,AL,Barbour County,7934,7670,264,3.3
CN0100700000000,2023-04-01,01,007,AL,Bibb County,8675,8535,140,1.6
CN0100900000000,2023-04-01,01,009,AL,Blount County,25504,25119,385,1.5
CN0101100000000,2023-04-01,01,011,AL,Bullock County,4172,4104,68,1.6
CN0101300000000,2023-04-01,01,013,AL,Butler County,8987,8793,194,2.2
CN0101500000000,2023-04-01,01,015,AL,Calhoun County,46318,45432,886,1.9
CN0101700000000,2023-04-01,01,017,AL,Chambers County,15849,15588,261,1.6
CN0101900000000,2023-04-01,01,019,AL,Cherokee County,11637,11387,250,2.1
CN0102100000000,2023-04-01,01,021,AL,Chilton County,20001,19688,313,1.6
CN0102300000000,2023-04-01,01,023,AL,Choctaw County,4147,4025,122,2.9
CN0102500000000,2023-04-01,01,025,AL,Clarke County,7614,7335,279,3.7
CN0102700000000,2023-04-01,01,027,AL,Clay County,5898,5798,100,1.7
CN0102900000000,2023-04-01,01,029,AL,Cleburne County,6078,5977,101,1.7
CN0103100000000,2023-04-01,01,031,AL,Coffee County,21738,21366,372,1.7
CN0103300000000,2023-04-01,01,033,AL,Colbert County,23853,23369,484,2
CN0103500000000,2023-04-01,01,035,AL,Conecuh County,4180,4087,93,2.2
CN0103700000000,2023-04-01,01,037,AL,Coosa County,4535,4456,79,1.7
CN0103900000000,2023-04-01,01,039,AL,Covington County,14545,14265,280,1.9
CN0104100000000,2023-04-01,01,041,AL,Crenshaw County,5718,5620,98,1.7
CN0104300000000,2023-04-01,01,043,AL,Cullman County,39820,39261,559,1.4
CN0104500000000,2023-04-01,01,045,AL,Dale County,21630,21244,386,1.8
CN0104700000000,2023-04-01,01,047,AL,Dallas County,13419,12953,466,3.5
CN0104900000000,2023-04-01,01,049,AL,DeKalb County,30419,29915,504,1.7
CN0105100000000,2023-04-01,01,051,AL,Elmore County,38420,37854,566,1.5
CN0105300000000,2023-04-01,01,053,AL,Escambia County,14345,14033,312,2.2
CN0105500000000,2023-04-01,01,055,AL,Etowah County,38974,38222,752,1.9
CN0105700000000,2023-04-01,01,057,AL,Fayette County,6545,6431,114,1.7
CN0105900000000,2023-04-01,01,059,AL,Franklin County,14635,14342,293,2
CN0106100000000,2023-04-01,01,061,AL,Geneva County,11072,10877,195,1.8
CN0106300000000,2023-04-01,01,063,AL,Greene County,2759,2650,109,4
CN0106500000000,2023-04-01,01,065,AL,Hale County,5758,5624,134,2.3
CN0106700000000,2023-04-01,01,067,AL,Henry County,7036,6911,125,1.8
CN0106900000000,2023-04-01,01,069,AL,Houston County,48637,47765,872,1.8
CN0107100000000,2023-04-01,01,071,AL,Jackson County,23160,22768,392,1.7
CN0107300000000,2023-04-01,01,073,AL,Jefferson County,323294,317754,5540,1.7
CN0107500000000,2023-04-01,01,075,AL,Lamar County,5647,5538,109,1.9
CN0107700000000,2023-04-01,01,077,AL,Lauderdale County,42980,42215,765,1.8
CN0107900000000,2023-04-01,01,079,AL,Lawrence County,14758,14537,221,1.5
CN0108100000000,2023-04-01,01,081,AL,Lee County,81031,79749,1282,1.6
CN0108300000000,2023-04-01,01,083,AL,Limestone County,49200,48466,734,1.5
CN0108500000000,2023-04-01,01,085,AL,Lowndes County,3425,3316,109,3.2
CN0108700000000,2023-04-01,01,087,AL,Macon County,7845,7667,178,2.3
CN0108900000000,2023-04-01,01,089,AL,Madison County,203670,200753,2917,1.4
CN0109100000000,2023-04-01,01,091,AL,Marengo County,7664,7485,179,2.3
CN0109300000000,2023-04-01,01,093,AL,Marion County,13664,13374,290,2.1
CN0109500000000,2023-04-01,01,095,AL,Marshall County,45965,45304,661,1.4
CN0109700000000,2023-04-01,01,097,AL,Mobile County,193913,189905,4008,2.1
CN0109900000000,2023-04-01,01,099,AL,Monroe County,6979,6768,211,3
CN0110100000000,2023-04-01,01,101,AL,Montgomery County,107488,105329,2159,2
CN0110300000000,2023-04-01,01,103,AL,Morgan County,61611,60745,866,1.4
CN0110500000000,2023-04-01,01,105,AL,Perry County,2856,2758,98,3.4
CN0110700000000,2023-04-01,01,107,AL,Pickens County,7651,7490,161,2.1
CN0110900000000,2023-04-01,01,109,AL,Pike County,16137,15831,306,1.9
CN0111100000000,2023-04-01,01,111,AL,Randolph County,9436,9281,155,1.6
CN0111300000000,2023-04-01,01,113,AL,Russell County,24226,23790,436,1.8
CN0111500000000,2023-04-01,01,115,AL,St. Clair County,42144,41524,620,1.5
CN0111700000000,2023-04-01,01,117,AL,Shelby County,121709,120133,1576,1.3
CN0111900000000,2023-04-01,01,119,AL,Sumter County,4480,4371,109,2.4
CN0112100000000,2023-04-01,01,121,AL,Talladega County,37185,36493,692,1.9
CN0112300000000,2023-04-01,01,123,AL,Tallapoosa County,16790,16480,310,1.8
CN0112500000000,2023-04-01,01,125,AL,Tuscaloosa County,105614,103923,1691,1.6
CN0112700000000,2023-04-01,01,127,AL,Walker County,25444,24965,479,1.9
CN0112900000000,2023-04-01,01,129,AL,Washington County,6390,6233,157,2.5
CN0113100000000,2023-04-01,01,131,AL,Wilcox County,2405,2260,145,6
CN0113300000000,2023-04-01,01,133,AL,Winston County,9946,9755,191,1.9
CN0201300000000,2023-04-01,02,013,AK,Aleutians East Borough,2393,2350,43,1.8
CN0201600000000,2023-04-01,02,016,AK,Aleutians West Census Area,3564,3469,95,2.7
CN0202000000000,2023-04-01,02,020,AK,Anchorage Borough/municipality,151727,147096,4631,3.1
CN0205000000000,2023-04-01,02,050,AK,Bethel Census Area,6553,5985,568,8.7
CN0206000000000,2023-04-01,02,060,AK,Bristol Bay Borough,393,377,16,4.1
CN0206300000000,2023-04-01,02,063,AK,Chugach Census Area,3201,3050,151,4.7
CN0206600000000,2023-04-01,02,066,AK,Copper River Census Area,1293,1182,111,8.6
CN0206800000000,2023-04-01,02,068,AK,Denali Borough,713,653,60,8.4
CN0207000000000,2023-04-01,02,070,AK,Dillingham Census Area,1614,1521,93,5.8
CN0209000000000,2023-04-01,02,090,AK,Fairbanks North Star Borough,45721,44126,1595,3.5
CN0210000000000,2023-04-01,02,100,AK,Haines Borough,975,910,65,6.7
CN0210500000000,2023-04-01,02,105,AK,Hoonah-Angoon Census Area,1193,1133,60,5
CN0211000000000,2023-04-01,02,110,AK,Juneau Borough/city,17253,16817,436,2.5
CN0212200000000,2023-04-01,02,122,AK,Kenai Peninsula Borough,26947,25746,1201,4.5
CN0213000000000,2023-04-01,02,130,AK,Ketchikan Gateway Borough,6412,6177,235,3.7
CN0215000000000,2023-04-01,02,150,AK,Kodiak Island Borough,5681,5482,199,3.5
CN0215800000000,2023-04-01,02,158,AK,Kusilvak Census Area,2337,2040,297,12.7
CN0216400000000,2023-04-01,02,164,AK,Lake and Peninsula Borough,572,539,33,5.8
CN0217000000000,2023-04-01,02,170,AK,Matanuska-Susitna Borough,49984,47799,2185,4.4
CN0218000000000,2023-04-01,02,180,AK,Nome Census Area,4152,3874,278,6.7
CN0218500000000,2023-04-01,02,185,AK,North Slope Borough,2965,2830,135,4.6
CN0218800000000,2023-04-01,02,188,AK,Northwest Arctic Borough,2740,2483,257,9.4
CN0219500000000,2023-04-01,02,195,AK,Petersburg Borough,1340,1277,63,4.7
CN0219800000000,2023-04-01,02,198,AK,Prince of Wales-Hyder Census Area,2701,2532,169,6.3
CN0222000000000,2023-04-01,02,220,AK,Sitka Borough/city,4417,4301,116,2.6
CN0223000000000,2023-04-01,02,230,AK,Skagway Municipality,670,637,33,4.9
CN0224000000000,2023-04-01,02,240,AK,Southeast Fairbanks Census Area,3144,2991,153,4.9
CN0227500000000,2023-04-01,02,275,AK,Wrangell Borough/city,857,816,41,4.8
CN0228200000000,2023-04-01,02,282,AK,Yakutat Borough/city,304,289,15,4.9
CN0229000000000,2023-04-01,02,290,AK,Yukon-Koyukuk Census Area,2373,2163,210,8.8
CN0400100000000,2023-04-01,04,001,AZ,Apache County,18471,17295,1176,6.4
CN0400300000000,2023-04-01,04,003,AZ,Cochise County,48458,46522,1936,4
CN0400500000000,2023-04-01,04,005,AZ,Coconino County,74775,72410,2365,3.2
CN0400700000000,2023-04-01,04,007,AZ,Gila County,20168,19394,774,3.8
CN0400900000000,2023-04-01,04,009,AZ,Graham County,16442,15960,482,2.9
CN0401100000000,2023-04-01,04,011,AZ,Greenlee County,5017,4906,111,2.2
CN0401200000000,2023-04-01,04,012,AZ,La Paz County,8612,8206,406,4.7
CN0401300000000,2023-04-01,04,013,AZ,Maricopa County,2414387,2345534,68853,2.9
CN0401500000000,2023-04-01,04,015,AZ,Mohave County,90185,86568,3617,4
CN0401700000000,2023-04-01,04,017,AZ,Navajo County,38972,37098,1874,4.8
CN0401900000000,2023-04-01,04,019,AZ,Pima County,495114,479419,15695,3.2
CN0402100000000,2023-04-01,04,021,AZ,Pinal County,200985,193990,6995,3.5
CN0402300000000,2023-04-01,04,023,AZ,Santa Cruz County,18596,17547,1049,5.6
CN0402500000000,2023-04-01,04,025,AZ,Yavapai County,108335,104847,3488,3.2
CN0402700000000,2023-04-01,04,027,AZ,Yuma County,92106,83576,8530,9.3
CN0500100000000,2023-04-01,05,001,AR,Arkansas County,9150,8953,197,2.2
CN0500300000000,2023-04-01,05,003,AR,Ashley County,6540,6254,286,4.4
CN0500500000000,2023-04-01,05,005,AR,Baxter County,16622,16169,453,2.7
CN0500700000000,2023-04-01,05,007,AR,Benton County,156821,153872,2949,1.9
CN0500900000000,2023-04-01,05,009,AR,Boone County,16177,15794,383,2.4
CN0501100000000,2023-04-01,05,011,AR,Bradley County,4023,3870,153,3.8
CN0501300000000,2023-04-01,05,013,AR,Calhoun County,2395,2342,53,2.2
CN0501500000000,2023-04-01,05,015,AR,Carroll County,12483,12204,279,2.2
CN0501700000000,2023-04-01,05,017,AR,Chicot County,2977,2849,128,4.3
CN0501900000000,2023-04-01,05,019,AR,Clark County,8664,8386,278,3.2
CN0502100000000,2023-04-01,05,021,AR,Clay County,5557,5393,164,3
CN0502300000000,2023-04-01,05,023,AR,Cleburne County,8994,8716,278,3.1
CN0502500000000,2023-04-01,05,025,AR,Cleveland County,3117,3037,80,2.6
CN0502700000000,2023-04-01,05,027,AR,Columbia County,8849,8561,288,3.3
CN0502900000000,2023-04-01,05,029,AR,Conway County,8378,8132,246,2.9
CN0503100000000,2023-04-01,05,031,AR,Craighead County,58457,57271,1186,2
CN0503300000000,2023-04-01,05,033,AR,Crawford County,26590,25958,632,2.4
CN0503500000000,2023-04-01,05,035,AR,Crittenden County,20563,19919,644,3.1
CN0503700000000,2023-04-01,05,037,AR,Cross County,6954,6767,187,2.7
CN0503900000000,2023-04-01,05,039,AR,Dallas County,2661,2572,89,3.3
CN0504100000000,2023-04-01,05,041,AR,Desha County,4944,4761,183,3.7
CN0504300000000,2023-04-01,05,043,AR,Drew County,7423,7172,251,3.4
CN0504500000000,2023-04-01,05,045,AR,Faulkner County,63913,62445,1468,2.3
CN0504700000000,2023-04-01,05,047,AR,Franklin County,7567,7384,183,2.4
CN0504900000000,2023-04-01,05,049,AR,Fulton County,5070,4934,136,2.7
CN0505100000000,2023-04-01,05,051,AR,Garland County,42720,41505,1215,2.8
CN0505300000000,2023-04-01,05,053,AR,Grant County,8561,8369,192,2.2
CN0505500000000,2023-04-01,05,055,AR,Greene County,20042,19555,487,2.4
CN0505700000000,2023-04-01,05,057,AR,Hempstead County,9475,9251,224,2.4
CN0505900000000,2023-04-01,05,059,AR,Hot Spring County,14056,13689,367,2.6
CN0506100000000,2023-04-01,05,061,AR,Howard County,5360,5217,143,2.7
CN0506300000000,2023-04-01,05,063,AR,Independence County,17003,16580,423,2.5
CN0506500000000,2023-04-01,05,065,AR,Izard County,4527,4363,164,3.6
CN0506700000000,2023-04-01,05,067,AR,Jackson County,5485,5274,211,3.8
CN0506900000000,2023-04-01,05,069,AR,Jefferson County,25596,24689,907,3.5
CN0507100000000,2023-04-01,05,071,AR,Johnson County,10144,9844,300,3
CN0507300000000,2023-04-01,05,073,AR,Lafayette County,2353,2271,82,3.5
CN0507500000000,2023-04-01,05,075,AR,Lawrence County,7048,6882,166,2.4
CN0507700000000,2023-04-01,05,077,AR,Lee County,2676,2565,111,4.1
CN0507900000000,2023-04-01,05,079,AR,Lincoln County,3742,3623,119,3.2
CN0508100000000,2023-04-01,05,081,AR,Little River County,5201,5069,132,2.5
CN0508300000000,2023-04-01,05,083,AR,Logan County,8316,8074,242,2.9
CN0508500000000,2023-04-01,05,085,AR,Lonoke County,34730,33987,743,2.1
CN0508700000000,2023-04-01,05,087,AR,Madison County,8105,7945,160,2
CN0508900000000,2023-04-01,05,089,AR,Marion County,6270,6099,171,2.7
CN0509100000000,2023-04-01,05,091,AR,Miller County,18825,18280,545,2.9
CN0509300000000,2023-04-01,05,093,AR,Mississippi County,16556,15949,607,3.7
CN0509500000000,2023-04-01,05,095,AR,Monroe County,2529,2455,74,2.9
CN0509700000000,2023-04-01,05,097,AR,Montgomery County,2980,2872,108,3.6
CN0509900000000,2023-04-01,05,099,AR,Nevada County,3461,3373,88,2.5
CN0510100000000,2023-04-01,05,101,AR,Newton County,3272,3192,80,2.4
CN0510300000000,2023-04-01,05,103,AR,Ouachita County,9707,9403,304,3.1
CN0510500000000,2023-04-01,05,105,AR,Perry County,4274,4162,112,2.6
CN0510700000000,2023-04-01,05,107,AR,Phillips County,5547,5276,271,4.9
CN0510900000000,2023-04-01,05,109,AR,Pike County,4101,3990,111,2.7
CN0511100000000,2023-04-01,05,111,AR,Poinsett County,10144,9905,239,2.4
CN0511300000000,2023-04-01,05,113,AR,Polk County,7959,7749,210,2.6
CN0511500000000,2023-04-01,05,115,AR,Pope County,27944,27165,779,2.8
CN0511700000000,2023-04-01,05,117,AR,Prairie County,3629,3548,81,2.2
CN0511900000000,2023-04-01,05,119,AR,Pulaski County,191025,186322,4703,2.5
CN0512100000000,2023-04-01,05,121,AR,Randolph County,7317,7130,187,2.6
CN0512300000000,2023-04-01,05,123,AR,St. Francis County,7651,7373,278,3.6
CN0512500000000,2023-04-01,05,125,AR,Saline County,60748,59434,1314,2.2
CN0512700000000,2023-04-01,05,127,AR,Scott County,4349,4253,96,2.2
CN0512900000000,2023-04-01,05,129,AR,Searcy County,2890,2794,96,3.3
CN0513100000000,2023-04-01,05,131,AR,Sebastian County,55894,54565,1329,2.4
CN0513300000000,2023-04-01,05,133,AR,Sevier County,5450,5294,156,2.9
CN0513500000000,2023-04-01,05,135,AR,Sharp County,5982,5805,177,3
CN0513700000000,2023-04-01,05,137,AR,Stone County,4589,4444,145,3.2
CN0513900000000,2023-04-01,05,139,AR,Union County,14753,14240,513,3.5
CN0514100000000,2023-04-01,05,141,AR,Van Buren County,6094,5906,188,3.1
CN0514300000000,2023-04-01,05,143,AR,Washington County,138497,136060,2437,1.8
CN0514500000000,2023-04-01,05,145,AR,White County,34593,33687,906,2.6
CN0514700000000,2023-04-01,05,147,AR,Woodruff County,2911,2831,80,2.7
CN0514900000000,2023-04-01,05,149,AR,Yell County,8061,7832,229,2.8
CN0600100000000,2023-04-01,06,001,CA,Alameda County,825417,796830,28587,3.5
CN0600300000000,2023-04-01,06,003,CA,Alpine County,561,529,32,5.7
CN0600500000000,2023-04-01,06,005,CA,Amador County,14230,13536,694,4.9
CN0600700000000,2023-04-01,06,007,CA,Butte County,92102,87547,4555,4.9
CN0600900000000,2023-04-01,06,009,CA,Calaveras County,21991,21135,856,3.9
CN0601100000000,2023-04-01,06,011,CA,Colusa County,10241,8713,1528,14.9
CN0601300000000,2023-04-01,06,013,CA,Contra Costa County,550293,530646,19647,3.6
CN0601500000000,2023-04-01,06,015,CA,Del Norte County,9037,8541,496,5.5
CN0601700000000,2023-04-01,06,017,CA,El Dorado County,93872,90513,3359,3.6
CN0601900000000,2023-04-01,06,019,CA,Fresno County,462352,427877,34475,7.5
CN0602100000000,2023-04-01,06,021,CA,Glenn County,12506,11731,775,6.2
CN0602300000000,2023-04-01,06,023,CA,Humboldt County,59503,57010,2493,4.2
CN0602500000000,2023-04-01,06,025,CA,Imperial County,69263,59404,9859,14.2
CN0602700000000,2023-04-01,06,027,CA,Inyo County,8203,7914,289,3.5
CN0602900000000,2023-04-01,06,029,CA,Kern County,395530,362705,32825,8.3
CN0603100000000,2023-04-01,06,031,CA,Kings County,57613,52823,4790,8.3
CN0603300000000,2023-04-01,06,033,CA,Lake County,27788,26278,1510,5.4
CN0603500000000,2023-04-01,06,035,CA,Lassen County,8729,8282,447,5.1
CN0603700000000,2023-04-01,06,037,CA,Los Angeles County,4990245,4765110,225135,4.5
CN0603900000000,2023-04-01,06,039,CA,Madera County,63751,58862,4889,7.7
CN0604100000000,2023-04-01,06,041,CA,Marin County,130836,127088,3748,2.9
CN0604300000000,2023-04-01,06,043,CA,Mariposa County,7141,6775,366,5.1
CN0604500000000,2023-04-01,06,045,CA,Mendocino County,35743,34082,1661,4.6
CN0604700000000,2023-04-01,06,047,CA,Merced County,116729,105340,11389,9.8
CN0604900000000,2023-04-01,06,049,CA,Modoc County,3151,2933,218,6.9
CN0605100000000,2023-04-01,06,051,CA,Mono County,8443,8134,309,3.7
CN0605300000000,2023-04-01,06,053,CA,Monterey County,232746,215588,17158,7.4
CN0605500000000,2023-04-01,06,055,CA,Napa County,71420,69127,2293,3.2
CN0605700000000,2023-04-01,06,057,CA,Nevada County,47232,45475,1757,3.7
CN0605900000000,2023-04-01,06,059,CA,Orange County,1596707,1548074,48633,3
CN0606100000000,2023-04-01,06,061,CA,Placer County,195042,188674,6368,3.3
CN0606300000000,2023-04-01,06,063,CA,Plumas County,7067,6447,620,8.8
CN0606500000000,2023-04-01,06,065,CA,Riverside County,1141670,1094188,47482,4.2
CN0606700000000,2023-04-01,06,067,CA,Sacramento County,732132,703159,28973,4
CN0606900000000,2023-04-01,06,069,CA,San Benito County,32740,30834,1906,5.8
CN0607100000000,2023-04-01,06,071,CA,San Bernardino County,999743,958881,40862,4.1
CN0607300000000,2023-04-01,06,073,CA,San Diego County,1598923,1546146,52777,3.3
CN0607500000000,2023-04-01,06,075,CA,San Francisco County/city,575444,559708,15736,2.7
CN0607700000000,2023-04-01,06,077,CA,San Joaquin County,346468,326294,20174,5.8
CN0607900000000,2023-04-01,06,079,CA,San Luis Obispo County,139398,135208,4190,3
CN0608100000000,2023-04-01,06,081,CA,San Mateo County,455041,443510,11531,2.5
CN0608300000000,2023-04-01,06,083,CA,Santa Barbara County,228951,220465,8486,3.7
CN0608500000000,2023-04-01,06,085,CA,Santa Clara County,1045493,1014463,31030,3
CN0608700000000,2023-04-01,06,087,CA,Santa Cruz County,134451,126346,8105,6
CN0608900000000,2023-04-01,06,089,CA,Shasta County,73503,69845,3658,5
CN0609100000000,2023-04-01,06,091,CA,Sierra County,1270,1196,74,5.8
CN0609300000000,2023-04-01,06,093,CA,Siskiyou County,16243,15226,1017,6.3
CN0609500000000,2023-04-01,06,095,CA,Solano County,201735,193245,8490,4.2
CN0609700000000,2023-04-01,06,097,CA,Sonoma County,249198,241286,7912,3.2
CN0609900000000,2023-04-01,06,099,CA,Stanislaus County,243290,228109,15181,6.2
CN0610100000000,2023-04-01,06,101,CA,Sutter County,47220,43354,3866,8.2
CN0610300000000,2023-04-01,06,103,CA,Tehama County,25184,23711,1473,5.8
CN0610500000000,2023-04-01,06,105,CA,Trinity County,4346,4085,261,6
CN0610700000000,2023-04-01,06,107,CA,Tulare County,213956,193006,20950,9.8
CN0610900000000,2023-04-01,06,109,CA,Tuolumne County,19297,18356,941,4.9
CN0611100000000,2023-04-01,06,111,CA,Ventura County,417060,402178,14882,3.6
CN0611300000000,2023-04-01,06,113,CA,Yolo County,110100,105318,4782,4.3
CN0611500000000,2023-04-01,06,115,CA,Yuba County,32174,30099,2075,6.4
CN0800100000000,2023-04-01,08,001,CO,Adams County,282465,274895,7570,2.7
CN0800300000000,2023-04-01,08,003,CO,Alamosa County,8296,8094,202,2.4
CN0800500000000,2023-04-01,08,005,CO,Arapahoe County,376295,367206,9089,2.4
CN0800700000000,2023-04-01,08,007,CO,Archuleta County,6941,6756,185,2.7
CN0800900000000,2023-04-01,08,009,CO,Baca County,2017,1988,29,1.4
CN0801100000000,2023-04-01,08,011,CO,Bent County,1755,1711,44,2.5
CN0801300000000,2023-04-01,08,013,CO,Boulder County,203404,199146,4258,2.1
CN0801400000000,2023-04-01,08,014,CO,Broomfield County/city,42757,41763,994,2.3
CN0801500000000,2023-04-01,08,015,CO,Chaffee County,9930,9702,228,2.3
CN0801700000000,2023-04-01,08,017,CO,Cheyenne County,999,984,15,1.5
CN0801900000000,2023-04-01,08,019,CO,Clear Creek County,6158,6032,126,2
CN0802100000000,2023-04-01,08,021,CO,Conejos County,4001,3907,94,2.3
CN0802300000000,2023-04-01,08,023,CO,Costilla County,1770,1706,64,3.6
CN0802500000000,2023-04-01,08,025,CO,Crowley County,1375,1325,50,3.6
CN0802700000000,2023-04-01,08,027,CO,Custer County,2337,2287,50,2.1
CN0802900000000,2023-04-01,08,029,CO,Delta County,13080,12691,389,3
CN0803100000000,2023-04-01,08,031,CO,Denver County/city,438378,426842,11536,2.6
CN0803300000000,2023-04-01,08,033,CO,Dolores County,1176,1144,32,2.7
CN0803500000000,2023-04-01,08,035,CO,Douglas County,208982,204414,4568,2.2
CN0803700000000,2023-04-01,08,037,CO,Eagle County,36551,35870,681,1.9
CN0803900000000,2023-04-01,08,039,CO,Elbert County,15990,15685,305,1.9
CN0804100000000,2023-04-01,08,041,CO,El Paso County,362600,353331,9269,2.6
CN0804300000000,2023-04-01,08,043,CO,Fremont County,14234,13680,554,3.9
CN0804500000000,2023-04-01,08,045,CO,Garfield County,31492,30781,711,2.3
CN0804700000000,2023-04-01,08,047,CO,Gilpin County,3940,3859,81,2.1
CN0804900000000,2023-04-01,08,049,CO,Grand County,9308,9110,198,2.1
CN0805100000000,2023-04-01,08,051,CO,Gunnison County,11856,11587,269,2.3
CN0805300000000,2023-04-01,08,053,CO,Hinsdale County,416,408,8,1.9
CN0805500000000,2023-04-01,08,055,CO,Huerfano County,2371,2259,112,4.7
CN0805700000000,2023-04-01,08,057,CO,Jackson County,989,971,18,1.8
CN0805900000000,2023-04-01,08,059,CO,Jefferson County,344486,336648,7838,2.3
CN0806100000000,2023-04-01,08,061,CO,Kiowa County,866,852,14,1.6
CN0806300000000,2023-04-01,08,063,CO,Kit Carson County,4091,4034,57,1.4
CN0806500000000,2023-04-01,08,065,CO,Lake County,5229,5142,87,1.7
CN0806700000000,2023-04-01,08,067,CO,La Plata County,31898,31204,694,2.2
CN0806900000000,2023-04-01,08,069,CO,Larimer County,212745,208234,4511,2.1
CN0807100000000,2023-04-01,08,071,CO,Las Animas County,5985,5754,231,3.9
CN0807300000000,2023-04-01,08,073,CO,Lincoln County,2157,2106,51,2.4
CN0807500000000,2023-04-01,08,075,CO,Logan County,10144,9942,202,2
CN0807700000000,2023-04-01,08,077,CO,Mesa County,76648,74615,2033,2.7
CN0807900000000,2023-04-01,08,079,CO,Mineral County,468,460,8,1.7
CN0808100000000,2023-04-01,08,081,CO,Moffat County,6828,6641,187,2.7
CN0808300000000,2023-04-01,08,083,CO,Montezuma County,12362,11959,403,3.3
CN0808500000000,2023-04-01,08,085,CO,Montrose County,21212,20669,543,2.6
CN0808700000000,2023-04-01,08,087,CO,Morgan County,15442,15077,365,2.4
CN0808900000000,2023-04-01,08,089,CO,Otero County,7769,7511,258,3.3
CN0809100000000,2023-04-01,08,091,CO,Ouray County,2333,2265,68,2.9
CN0809300000000,2023-04-01,08,093,CO,Park County,11686,11422,264,2.3
CN0809500000000,2023-04-01,08,095,CO,Phillips County,2344,2310,34,1.5
CN0809700000000,2023-04-01,08,097,CO,Pitkin County,10804,10535,269,2.5
CN0809900000000,2023-04-01,08,099,CO,Prowers County,6187,6060,127,2.1
CN0810100000000,2023-04-01,08,101,CO,Pueblo County,75809,73132,2677,3.5
CN0810300000000,2023-04-01,08,103,CO,Rio Blanco County,2851,2785,66,2.3
CN0810500000000,2023-04-01,08,105,CO,Rio Grande County,5184,5038,146,2.8
CN0810700000000,2023-04-01,08,107,CO,Routt County,15689,15370,319,2
CN0810900000000,2023-04-01,08,109,CO,Saguache County,3335,3251,84,2.5
CN0811100000000,2023-04-01,08,111,CO,San Juan County,493,480,13,2.6
CN0811300000000,2023-04-01,08,113,CO,San Miguel County,5091,4825,266,5.2
CN0811500000000,2023-04-01,08,115,CO,Sedgwick County,966,941,25,2.6
CN0811700000000,2023-04-01,08,117,CO,Summit County,23036,22656,380,1.6
CN0811900000000,2023-04-01,08,119,CO,Teller County,13571,13252,319,2.4
CN0812100000000,2023-04-01,08,121,CO,Washington County,2692,2651,41,1.5
CN0812300000000,2023-04-01,08,123,CO,Weld County,169453,165268,4185,2.5
CN0812500000000,2023-04-01,08,125,CO,Yuma County,5394,5317,77,1.4
CN0900100000000,2023-04-01,09,001,CT,Fairfield County,472869,458460,14409,3
CN0900300000000,2023-04-01,09,003,CT,Hartford County,466974,452570,14404,3.1
CN0900500000000,2023-04-01,09,005,CT,Litchfield County,102376,99502,2874,2.8
CN0900700000000,2023-04-01,09,007,CT,Middlesex County,92004,89635,2369,2.6
CN0900900000000,2023-04-01,09,009,CT,New Haven County,458014,443495,14519,3.2
CN0901100000000,2023-04-01,09,011,CT,New London County,129891,125972,3919,3
CN0901300000000,2023-04-01,09,013,CT,Tolland County,84313,82160,2153,2.6
CN0901500000000,2023-04-01,09,015,CT,Windham County,62531,60577,1954,3.1
CN1000100000000,2023-04-01,10,001,DE,Kent County,80930,77297,3633,4.5
CN1000300000000,2023-04-01,10,003,DE,New Castle County,309295,297721,11574,3.7
CN1000500000000,2023-04-01,10,005,DE,Sussex County,111492,107032,4460,4
CN1100100000000,2023-04-01,11,001,DC,District of Columbia,386532,369245,17287,4.5
CN1200100000000,2023-04-01,12,001,FL,Alachua County,147018,143556,3462,2.4
CN1200300000000,2023-04-01,12,003,FL,Baker County,13022,12732,290,2.2
CN1200500000000,2023-04-01,12,005,FL,Bay County,89959,88099,1860,2.1
CN1200700000000,2023-04-01,12,007,FL,Bradford County,11243,10983,260,2.3
CN1200900000000,2023-04-01,12,009,FL,Brevard County,301611,294518,7093,2.4
CN1201100000000,2023-04-01,12,011,FL,Broward County,1082552,1057893,24659,2.3
CN1201300000000,2023-04-01,12,013,FL,Calhoun County,4957,4830,127,2.6
CN1201500000000,2023-04-01,12,015,FL,Charlotte County,78522,76447,2075,2.6
CN1201700000000,2023-04-01,12,017,FL,Citrus County,50579,48866,1713,3.4
CN1201900000000,2023-04-01,12,019,FL,Clay County,116570,114039,2531,2.2
CN1202100000000,2023-04-01,12,021,FL,Collier County,191132,187080,4052,2.1
CN1202300000000,2023-04-01,12,023,FL,Columbia County,29749,28970,779,2.6
CN1202700000000,2023-04-01,12,027,FL,DeSoto County,14091,13724,367,2.6
CN1202900000000,2023-04-01,12,029,FL,Dixie County,5895,5731,164,2.8
CN1203100000000,2023-04-01,12,031,FL,Duval County,527247,514456,12791,2.4
CN1203300000000,2023-04-01,12,033,FL,Escambia County,151688,148085,3603,2.4
CN1203500000000,2023-04-01,12,035,FL,Flagler County,52070,50583,1487,2.9
CN1203700000000,2023-04-01,12,037,FL,Franklin County,5015,4911,104,2.1
CN1203900000000,2023-04-01,12,039,FL,Gadsden County,19412,18815,597,3.1
CN1204100000000,2023-04-01,12,041,FL,Gilchrist County,7605,7412,193,2.5
CN1204300000000,2023-04-01,12,043,FL,Glades County,5431,5290,141,2.6
CN1204500000000,2023-04-01,12,045,FL,Gulf County,5552,5444,108,1.9
CN1204700000000,2023-04-01,12,047,FL,Hamilton County,4160,4029,131,3.1
CN1204900000000,2023-04-01,12,049,FL,Hardee County,8938,8662,276,3.1
CN1205100000000,2023-04-01,12,051,FL,Hendry County,15571,15052,519,3.3
CN1205300000000,2023-04-01,12,053,FL,Hernando County,79250,76935,2315,2.9
CN1205500000000,2023-04-01,12,055,FL,Highlands County,36824,35630,1194,3.2
CN1205700000000,2023-04-01,12,057,FL,Hillsborough County,829990,811129,18861,2.3
CN1205900000000,2023-04-01,12,059,FL,Holmes County,7199,7028,171,2.4
CN1206100000000,2023-04-01,12,061,FL,Indian River County,68638,66778,1860,2.7
CN1206300000000,2023-04-01,12,063,FL,Jackson County,16796,16340,456,2.7
CN1206500000000,2023-04-01,12,065,FL,Jefferson County,5847,5704,143,2.4
CN1206700000000,2023-04-01,12,067,FL,Lafayette County,2867,2798,69,2.4
CN1206900000000,2023-04-01,12,069,FL,Lake County,175787,171534,4253,2.4
CN1207100000000,2023-04-01,12,071,FL,Lee County,389096,379656,9440,2.4
CN1207300000000,2023-04-01,12,073,FL,Leon County,163008,159045,3963,2.4
CN1207500000000,2023-04-01,12,075,FL,Levy County,17308,16849,459,2.7
CN1207700000000,2023-04-01,12,077,FL,Liberty County,2704,2637,67,2.5
CN1207900000000,2023-04-01,12,079,FL,Madison County,7917,7723,194,2.5
CN1208100000000,2023-04-01,12,081,FL,Manatee County,191556,187059,4497,2.3
CN1208300000000,2023-04-01,12,083,FL,Marion County,151228,146926,4302,2.8
CN1208500000000,2023-04-01,12,085,FL,Martin County,78030,76338,1692,2.2
CN1208600000000,2023-04-01,12,086,FL,Miami-Dade County,1387286,1362196,25090,1.8
CN1208700000000,2023-04-01,12,087,FL,Monroe County,51494,50749,745,1.4
CN1208900000000,2023-04-01,12,089,FL,Nassau County,46083,45076,1007,2.2
CN1209100000000,2023-04-01,12,091,FL,Okaloosa County,105580,103512,2068,2
CN1209300000000,2023-04-01,12,093,FL,Okeechobee County,18067,17615,452,2.5
CN1209500000000,2023-04-01,12,095,FL,Orange County,813664,795248,18416,2.3
CN1209700000000,2023-04-01,12,097,FL,Osceola County,202430,196990,5440,2.7
CN1209900000000,2023-04-01,12,099,FL,Palm Beach County,776369,758518,17851,2.3
CN1210100000000,2023-04-01,12,101,FL,Pasco County,266404,259558,6846,2.6
CN1210300000000,2023-04-01,12,103,FL,Pinellas County,526349,515187,11162,2.1
CN1210500000000,2023-04-01,12,105,FL,Polk County,346038,336329,9709,2.8
CN1210700000000,2023-04-01,12,107,FL,Putnam County,27660,26784,876,3.2
CN1210900000000,2023-04-01,12,109,FL,St. Johns County,154153,150999,3154,2
CN1211100000000,2023-04-01,12,111,FL,St. Lucie County,159860,155475,4385,2.7
CN1211300000000,2023-04-01,12,113,FL,Santa Rosa County,89176,87242,1934,2.2
CN1211500000000,2023-04-01,12,115,FL,Sarasota County,200910,196330,4580,2.3
CN1211700000000,2023-04-01,12,117,FL,Seminole County,271311,265373,5938,2.2
CN1211900000000,2023-04-01,12,119,FL,Sumter County,38754,37553,1201,3.1
CN1212100000000,2023-04-01,12,121,FL,Suwannee County,17709,17234,475,2.7
CN1212300000000,2023-04-01,12,123,FL,Taylor County,8161,7956,205,2.5
CN1212500000000,2023-04-01,12,125,FL,Union County,4590,4488,102,2.2
CN1212700000000,2023-04-01,12,127,FL,Volusia County,274136,267287,6849,2.5
CN1212900000000,2023-04-01,12,129,FL,Wakulla County,16329,15985,344,2.1
CN1213100000000,2023-04-01,12,131,FL,Walton County,35736,34977,759,2.1
CN1213300000000,2023-04-01,12,133,FL,Washington County,10045,9794,251,2.5
CN1300100000000,2023-04-01,13,001,GA,Appling County,9363,9083,280,3
CN1300300000000,2023-04-01,13,003,GA,Atkinson County,4340,4217,123,2.8
CN1300500000000,2023-04-01,13,005,GA,Bacon County,4900,4779,121,2.5
CN1300700000000,2023-04-01,13,007,GA,Baker County,1091,1054,37,3.4
CN1300900000000,2023-04-01,13,009,GA,Baldwin County,18183,17603,580,3.2
CN1301100000000,2023-04-01,13,011,GA,Banks County,10783,10589,194,1.8
CN1301300000000,2023-04-01,13,013,GA,Barrow County,43661,42614,1047,2.4
CN1301500000000,2023-04-01,13,015,GA,Bartow County,52892,51523,1369,2.6
CN1301700000000,2023-04-01,13,017,GA,Ben Hill County,5562,5344,218,3.9
CN1301900000000,2023-04-01,13,019,GA,Berrien County,7576,7367,209,2.8
CN1302100000000,2023-04-01,13,021,GA,Bibb County,65999,63695,2304,3.5
CN1302300000000,2023-04-01,13,023,GA,Bleckley County,4493,4345,148,3.3
CN1302500000000,2023-04-01,13,025,GA,Brantley County,7506,7292,214,2.9
CN1302700000000,2023-04-01,13,027,GA,Brooks County,6644,6452,192,2.9
CN1302900000000,2023-04-01,13,029,GA,Bryan County,20260,19802,458,2.3
CN1303100000000,2023-04-01,13,031,GA,Bulloch County,38494,37491,1003,2.6
CN1303300000000,2023-04-01,13,033,GA,Burke County,9014,8578,436,4.8
CN1303500000000,2023-04-01,13,035,GA,Butts County,11449,11174,275,2.4
CN1303700000000,2023-04-01,13,037,GA,Calhoun County,2140,2089,51,2.4
CN1303900000000,2023-04-01,13,039,GA,Camden County,22284,21706,578,2.6
CN1304300000000,2023-04-01,13,043,GA,Candler County,6192,6071,121,2
CN1304500000000,2023-04-01,13,045,GA,Carroll County,57847,56332,1515,2.6
CN1304700000000,2023-04-01,13,047,GA,Catoosa County,33988,33199,789,2.3
CN1304900000000,2023-04-01,13,049,GA,Charlton County,5042,4914,128,2.5
CN1305100000000,2023-04-01,13,051,GA,Chatham County,144814,141131,3683,2.5
CN1305300000000,2023-04-01,13,053,GA,Chattahoochee County,1935,1860,75,3.9
CN1305500000000,2023-04-01,13,055,GA,Chattooga County,9047,8683,364,4
CN1305700000000,2023-04-01,13,057,GA,Cherokee County,144657,141595,3062,2.1
CN1305900000000,2023-04-01,13,059,GA,Clarke County,59033,57503,1530,2.6
CN1306100000000,2023-04-01,13,061,GA,Clay County,782,733,49,6.3
CN1306300000000,2023-04-01,13,063,GA,Clayton County,141931,136717,5214,3.7
CN1306500000000,2023-04-01,13,065,GA,Clinch County,2974,2908,66,2.2
CN1306700000000,2023-04-01,13,067,GA,Cobb County,437492,426942,10550,2.4
CN1306900000000,2023-04-01,13,069,GA,Coffee County,19001,18379,622,3.3
CN1307100000000,2023-04-01,13,071,GA,Colquitt County,21828,21330,498,2.3
CN1307300000000,2023-04-01,13,073,GA,Columbia County,76308,74397,1911,2.5
CN1307500000000,2023-04-01,13,075,GA,Cook County,8234,8020,214,2.6
CN1307700000000,2023-04-01,13,077,GA,Coweta County,78722,76791,1931,2.5
CN1307900000000,2023-04-01,13,079,GA,Crawford County,5390,5242,148,2.7
CN1308100000000,2023-04-01,13,081,GA,Crisp County,9695,9377,318,3.3
CN1308300000000,2023-04-01,13,083,GA,Dade County,8173,8003,170,2.1
CN1308500000000,2023-04-01,13,085,GA,Dawson County,13595,13291,304,2.2
CN1308700000000,2023-04-01,13,087,GA,Decatur County,11731,11392,339,2.9
CN1308900000000,2023-04-01,13,089,GA,DeKalb County,410523,398657,11866,2.9
CN1309100000000,2023-04-01,13,091,GA,Dodge County,6787,6566,221,3.3
CN1309300000000,2023-04-01,13,093,GA,Dooly County,4912,4747,165,3.4
CN1309500000000,2023-04-01,13,095,GA,Dougherty County,36288,34928,1360,3.7
CN1309700000000,2023-04-01,13,097,GA,Douglas County,76185,73824,2361,3.1
CN1309900000000,2023-04-01,13,099,GA,Early County,4403,4268,135,3.1
CN1310100000000,2023-04-01,13,101,GA,Echols County,1845,1799,46,2.5
CN1310300000000,2023-04-01,13,103,GA,Effingham County,33874,33094,780,2.3
CN1310500000000,2023-04-01,13,105,GA,Elbert County,7964,7730,234,2.9
CN1310700000000,2023-04-01,13,107,GA,Emanuel County,8912,8623,289,3.2
CN1310900000000,2023-04-01,13,109,GA,Evans County,4946,4831,115,2.3
CN1311100000000,2023-04-01,13,111,GA,Fannin County,12052,11766,286,2.4
CN1311300000000,2023-04-01,13,113,GA,Fayette County,60307,58901,1406,2.3
CN1311500000000,2023-04-01,13,115,GA,Floyd County,45326,43843,1483,3.3
CN1311700000000,2023-04-01,13,117,GA,Forsyth County,131818,129140,2678,2
CN1311900000000,2023-04-01,13,119,GA,Franklin County,9723,9463,260,2.7
CN1312100000000,2023-04-01,13,121,GA,Fulton County,583167,565915,17252,3
CN1312300000000,2023-04-01,13,123,GA,Gilmer County,12452,12123,329,2.6
CN1312500000000,2023-04-01,13,125,GA,Glascock County,1244,1211,33,2.7
CN1312700000000,2023-04-01,13,127,GA,Glynn County,40384,39408,976,2.4
CN1312900000000,2023-04-01,13,129,GA,Gordon County,28685,27997,688,2.4
CN1313100000000,2023-04-01,13,131,GA,Grady County,10845,10589,256,2.4
CN1313300000000,2023-04-01,13,133,GA,Greene County,7281,7065,216,3
CN1313500000000,2023-04-01,13,135,GA,Gwinnett County,507641,495437,12204,2.4
CN1313700000000,2023-04-01,13,137,GA,Habersham County,18850,18369,481,2.6
CN1313900000000,2023-04-01,13,139,GA,Hall County,108195,106019,2176,2
CN1314100000000,2023-04-01,13,141,GA,Hancock County,2546,2434,112,4.4
CN1314300000000,2023-04-01,13,143,GA,Haralson County,13193,12827,366,2.8
CN1314500000000,2023-04-01,13,145,GA,Harris County,17151,16759,392,2.3
CN1314700000000,2023-04-01,13,147,GA,Hart County,12543,12239,304,2.4
CN1314900000000,2023-04-01,13,149,GA,Heard County,5385,5240,145,2.7
CN1315100000000,2023-04-01,13,151,GA,Henry County,122176,118569,3607,3
CN1315300000000,2023-04-01,13,153,GA,Houston County,70804,69111,1693,2.4
CN1315500000000,2023-04-01,13,155,GA,Irwin County,3470,3358,112,3.2
CN1315700000000,2023-04-01,13,157,GA,Jackson County,45430,44597,833,1.8
CN1315900000000,2023-04-01,13,159,GA,Jasper County,7278,7110,168,2.3
CN1316100000000,2023-04-01,13,161,GA,Jeff Davis County,6139,5910,229,3.7
CN1316300000000,2023-04-01,13,163,GA,Jefferson County,6601,6385,216,3.3
CN1316500000000,2023-04-01,13,165,GA,Jenkins County,3450,3305,145,4.2
CN1316700000000,2023-04-01,13,167,GA,Johnson County,3907,3808,99,2.5
CN1316900000000,2023-04-01,13,169,GA,Jones County,13401,13055,346,2.6
CN1317100000000,2023-04-01,13,171,GA,Lamar County,8477,8243,234,2.8
CN1317300000000,2023-04-01,13,173,GA,Lanier County,3784,3663,121,3.2
CN1317500000000,2023-04-01,13,175,GA,Laurens County,18799,18080,719,3.8
CN1317700000000,2023-04-01,13,177,GA,Lee County,14978,14628,350,2.3
CN1317900000000,2023-04-01,13,179,GA,Liberty County,26326,25570,756,2.9
CN1318100000000,2023-04-01,13,181,GA,Lincoln County,3512,3395,117,3.3
CN1318300000000,2023-04-01,13,183,GA,Long County,8492,8265,227,2.7
CN1318500000000,2023-04-01,13,185,GA,Lowndes County,50510,49062,1448,2.9
CN1318700000000,2023-04-01,13,187,GA,Lumpkin County,18649,18285,364,2
CN1318900000000,2023-04-01,13,189,GA,McDuffie County,8451,8094,357,4.2
CN1319100000000,2023-04-01,13,191,GA,McIntosh County,6277,6118,159,2.5
CN1319300000000,2023-04-01,13,193,GA,Macon County,4452,4298,154,3.5
CN1319500000000,2023-04-01,13,195,GA,Madison County,13646,13324,322,2.4
CN1319700000000,2023-04-01,13,197,GA,Marion County,3310,3206,104,3.1
CN1319900000000,2023-04-01,13,199,GA,Meriwether County,9091,8763,328,3.6
CN1320100000000,2023-04-01,13,201,GA,Miller County,2894,2832,62,2.1
CN1320500000000,2023-04-01,13,205,GA,Mitchell County,8322,8066,256,3.1
CN1320700000000,2023-04-01,13,207,GA,Monroe County,12885,12561,324,2.5
CN1320900000000,2023-04-01,13,209,GA,Montgomery County,3994,3870,124,3.1
CN1321100000000,2023-04-01,13,211,GA,Morgan County,9779,9552,227,2.3
CN1321300000000,2023-04-01,13,213,GA,Murray County,15443,14815,628,4.1
CN1321500000000,2023-04-01,13,215,GA,Muscogee County,77071,74291,2780,3.6
CN1321700000000,2023-04-01,13,217,GA,Newton County,54924,53215,1709,3.1
CN1321900000000,2023-04-01,13,219,GA,Oconee County,20448,20051,397,1.9
CN1322100000000,2023-04-01,13,221,GA,Oglethorpe County,7039,6869,170,2.4
CN1322300000000,2023-04-01,13,223,GA,Paulding County,92532,90350,2182,2.4
CN1322500000000,2023-04-01,13,225,GA,Peach County,11826,11465,361,3.1
CN1322700000000,2023-04-01,13,227,GA,Pickens County,16109,15747,362,2.2
CN1322900000000,2023-04-01,13,229,GA,Pierce County,8905,8685,220,2.5
CN1323100000000,2023-04-01,13,231,GA,Pike County,9289,9086,203,2.2
CN1323300000000,2023-04-01,13,233,GA,Polk County,18427,17810,617,3.3
CN1323500000000,2023-04-01,13,235,GA,Pulaski County,4010,3889,121,3
CN1323700000000,2023-04-01,13,237,GA,Putnam County,8665,8401,264,3
CN1323900000000,2023-04-01,13,239,GA,Quitman County,721,679,42,5.8
CN1324100000000,2023-04-01,13,241,GA,Rabun County,7778,7573,205,2.6
CN1324300000000,2023-04-01,13,243,GA,Randolph County,2363,2279,84,3.6
CN1324500000000,2023-04-01,13,245,GA,Richmond County,83251,79810,3441,4.1
CN1324700000000,2023-04-01,13,247,GA,Rockdale County,45820,44356,1464,3.2
CN1324900000000,2023-04-01,13,249,GA,Schley County,2202,2147,55,2.5
CN1325100000000,2023-04-01,13,251,GA,Screven County,5084,4852,232,4.6
CN1325300000000,2023-04-01,13,253,GA,Seminole County,3015,2922,93,3.1
CN1325500000000,2023-04-01,13,255,GA,Spalding County,29757,28792,965,3.2
CN1325700000000,2023-04-01,13,257,GA,Stephens County,10586,10266,320,3
CN1325900000000,2023-04-01,13,259,GA,Stewart County,2660,2579,81,3
CN1326100000000,2023-04-01,13,261,GA,Sumter County,12627,12127,500,4
CN1326300000000,2023-04-01,13,263,GA,Talbot County,2806,2729,77,2.7
CN1326500000000,2023-04-01,13,265,GA,Taliaferro County,531,515,16,3
CN1326700000000,2023-04-01,13,267,GA,Tattnall County,8973,8722,251,2.8
CN1326900000000,2023-04-01,13,269,GA,Taylor County,2617,2522,95,3.6
CN1327100000000,2023-04-01,13,271,GA,Telfair County,3440,3244,196,5.7
CN1327300000000,2023-04-01,13,273,GA,Terrell County,3473,3325,148,4.3
CN1327500000000,2023-04-01,13,275,GA,Thomas County,16672,16158,514,3.1
CN1327700000000,2023-04-01,13,277,GA,Tift County,20492,19992,500,2.4
CN1327900000000,2023-04-01,13,279,GA,Toombs County,12602,12170,432,3.4
CN1328100000000,2023-04-01,13,281,GA,Towns County,4167,4032,135,3.2
CN1328300000000,2023-04-01,13,283,GA,Treutlen County,2681,2591,90,3.4
CN1328500000000,2023-04-01,13,285,GA,Troup County,35974,35084,890,2.5
CN1328700000000,2023-04-01,13,287,GA,Turner County,3138,3017,121,3.9
CN1328900000000,2023-04-01,13,289,GA,Twiggs County,2736,2621,115,4.2
CN1329100000000,2023-04-01,13,291,GA,Union County,11483,11212,271,2.4
CN1329300000000,2023-04-01,13,293,GA,Upson County,11824,11487,337,2.9
CN1329500000000,2023-04-01,13,295,GA,Walker County,31724,30899,825,2.6
CN1329700000000,2023-04-01,13,297,GA,Walton County,48587,47375,1212,2.5
CN1329900000000,2023-04-01,13,299,GA,Ware County,15866,15443,423,2.7
CN1330100000000,2023-04-01,13,301,GA,Warren County,2684,2594,90,3.4
CN1330300000000,2023-04-01,13,303,GA,Washington County,7068,6826,242,3.4
CN1330500000000,2023-04-01,13,305,GA,Wayne County,12161,11855,306,2.5
CN1330700000000,2023-04-01,13,307,GA,Webster County,965,934,31,3.2
CN1330900000000,2023-04-01,13,309,GA,Wheeler County,1716,1635,81,4.7
CN1331100000000,2023-04-01,13,311,GA,White County,16936,16607,329,1.9
CN1331300000000,2023-04-01,13,313,GA,Whitfield County,43503,41718,1785,4.1
CN1331500000000,2023-04-01,13,315,GA,Wilcox County,2659,2582,77,2.9
CN1331700000000,2023-04-01,13,317,GA,Wilkes County,3626,3518,108,3
CN1331900000000,2023-04-01,13,319,GA,Wilkinson County,3961,3851,110,2.8
CN1332100000000,2023-04-01,13,321,GA,Worth County,8696,8462,234,2.7
CN1500100000000,2023-04-01,15,001,HI,Hawaii County,94370,91549,2821,3
CN1500300000000,2023-04-01,15,003,HI,Honolulu County/city,460911,448852,12059,2.6
CN1500700000000,2023-04-01,15,007,HI,Kauai County,36881,35936,945,2.6
CN1500900000000,2023-04-01,15,009,HI,Maui County,87391,84926,2465,2.8
CN1600100000000,2023-04-01,16,001,ID,Ada County,280089,273962,6127,2.2
CN1600300000000,2023-04-01,16,003,ID,Adams County,1854,1705,149,8
CN1600500000000,2023-04-01,16,005,ID,Bannock County,45281,44229,1052,2.3
CN1600700000000,2023-04-01,16,007,ID,Bear Lake County,2933,2864,69,2.4
CN1600900000000,2023-04-01,16,009,ID,Benewah County,4121,3852,269,6.5
CN1601100000000,2023-04-01,16,011,ID,Bingham County,24384,23811,573,2.3
CN1601300000000,2023-04-01,16,013,ID,Blaine County,12964,12639,325,2.5
CN1601500000000,2023-04-01,16,015,ID,Boise County,3838,3687,151,3.9
CN1601700000000,2023-04-01,16,017,ID,Bonner County,22539,21613,926,4.1
CN1601900000000,2023-04-01,16,019,ID,Bonneville County,63784,62367,1417,2.2
CN1602100000000,2023-04-01,16,021,ID,Boundary County,5984,5701,283,4.7
CN1602300000000,2023-04-01,16,023,ID,Butte County,1431,1383,48,3.4
CN1602500000000,2023-04-01,16,025,ID,Camas County,745,730,15,2
CN1602700000000,2023-04-01,16,027,ID,Canyon County,115568,112441,3127,2.7
CN1602900000000,2023-04-01,16,029,ID,Caribou County,4255,4136,119,2.8
CN1603100000000,2023-04-01,16,031,ID,Cassia County,12822,12556,266,2.1
CN1603300000000,2023-04-01,16,033,ID,Clark County,390,375,15,3.8
CN1603500000000,2023-04-01,16,035,ID,Clearwater County,3333,3096,237,7.1
CN1603700000000,2023-04-01,16,037,ID,Custer County,2061,1997,64,3.1
CN1603900000000,2023-04-01,16,039,ID,Elmore County,12678,12335,343,2.7
CN1604100000000,2023-04-01,16,041,ID,Franklin County,7751,7597,154,2
CN1604300000000,2023-04-01,16,043,ID,Fremont County,7884,7695,189,2.4
CN1604500000000,2023-04-01,16,045,ID,Gem County,9336,9036,300,3.2
CN1604700000000,2023-04-01,16,047,ID,Gooding County,8581,8371,210,2.4
CN1604900000000,2023-04-01,16,049,ID,Idaho County,7166,6874,292,4.1
CN1605100000000,2023-04-01,16,051,ID,Jefferson County,15927,15600,327,2.1
CN1605300000000,2023-04-01,16,053,ID,Jerome County,11997,11693,304,2.5
CN1605500000000,2023-04-01,16,055,ID,Kootenai County,84838,82330,2508,3
CN1605700000000,2023-04-01,16,057,ID,Latah County,21186,20719,467,2.2
CN1605900000000,2023-04-01,16,059,ID,Lemhi County,3912,3778,134,3.4
CN1606100000000,2023-04-01,16,061,ID,Lewis County,1692,1640,52,3.1
CN1606300000000,2023-04-01,16,063,ID,Lincoln County,2900,2806,94,3.2
CN1606500000000,2023-04-01,16,065,ID,Madison County,23637,23201,436,1.8
CN1606700000000,2023-04-01,16,067,ID,Minidoka County,12415,12148,267,2.2
CN1606900000000,2023-04-01,16,069,ID,Nez Perce County,21548,21062,486,2.3
CN1607100000000,2023-04-01,16,071,ID,Oneida County,2646,2589,57,2.2
CN1607300000000,2023-04-01,16,073,ID,Owyhee County,5631,5442,189,3.4
CN1607500000000,2023-04-01,16,075,ID,Payette County,11962,11571,391,3.3
CN1607700000000,2023-04-01,16,077,ID,Power County,4477,4340,137,3.1
CN1607900000000,2023-04-01,16,079,ID,Shoshone County,5327,5064,263,4.9
CN1608100000000,2023-04-01,16,081,ID,Teton County,7415,7252,163,2.2
CN1608300000000,2023-04-01,16,083,ID,Twin Falls County,43797,42648,1149,2.6
CN1608500000000,2023-04-01,16,085,ID,Valley County,5369,5135,234,4.4
CN1608700000000,2023-04-01,16,087,ID,Washington County,5021,4851,170,3.4
CN1700100000000,2023-04-01,17,001,IL,Adams County,30452,29497,955,3.1
CN1700300000000,2023-04-01,17,003,IL,Alexander County,1787,1693,94,5.3
CN1700500000000,2023-04-01,17,005,IL,Bond County,7635,7221,414,5.4
CN1700700000000,2023-04-01,17,007,IL,Boone County,24845,23074,1771,7.1
CN1700900000000,2023-04-01,17,009,IL,Brown County,3191,3129,62,1.9
CN1701100000000,2023-04-01,17,011,IL,Bureau County,16033,15293,740,4.6
CN1701300000000,2023-04-01,17,013,IL,Calhoun County,2175,2091,84,3.9
CN1701500000000,2023-04-01,17,015,IL,Carroll County,7196,6915,281,3.9
CN1701700000000,2023-04-01,17,017,IL,Cass County,5712,5484,228,4
CN1701900000000,2023-04-01,17,019,IL,Champaign County,111939,107898,4041,3.6
CN1702100000000,2023-04-01,17,021,IL,Christian County,13276,12665,611,4.6
CN1702300000000,2023-04-01,17,023,IL,Clark County,7286,7005,281,3.9
CN1702500000000,2023-04-01,17,025,IL,Clay County,5627,5365,262,4.7
CN1702700000000,2023-04-01,17,027,IL,Clinton County,19952,19359,593,3
CN1702900000000,2023-04-01,17,029,IL,Coles County,22793,21934,859,3.8
CN1703100000000,2023-04-01,17,031,IL,Cook County,2670609,2579996,90613,3.4
CN1703300000000,2023-04-01,17,033,IL,Crawford County,8361,8071,290,3.5
CN1703500000000,2023-04-01,17,035,IL,Cumberland County,6023,5850,173,2.9
CN1703700000000,2023-04-01,17,037,IL,DeKalb County,53654,51419,2235,4.2
CN1703900000000,2023-04-01,17,039,IL,De Witt County,7434,7131,303,4.1
CN1704100000000,2023-04-01,17,041,IL,Douglas County,10074,9757,317,3.1
CN1704300000000,2023-04-01,17,043,IL,DuPage County,524092,510622,13470,2.6
CN1704500000000,2023-04-01,17,045,IL,Edgar County,9346,9065,281,3
CN1704700000000,2023-04-01,17,047,IL,Edwards County,2387,2277,110,4.6
CN1704900000000,2023-04-01,17,049,IL,Effingham County,19807,19271,536,2.7
CN1705100000000,2023-04-01,17,051,IL,Fayette County,9805,9341,464,4.7
CN1705300000000,2023-04-01,17,053,IL,Ford County,6463,6224,239,3.7
CN1705500000000,2023-04-01,17,055,IL,Franklin County,15578,14832,746,4.8
CN1705700000000,2023-04-01,17,057,IL,Fulton County,14722,13989,733,5
CN1705900000000,2023-04-01,17,059,IL,Gallatin County,1996,1907,89,4.5
CN1706100000000,2023-04-01,17,061,IL,Greene County,5919,5687,232,3.9
CN1706300000000,2023-04-01,17,063,IL,Grundy County,26430,25518,912,3.5
CN1706500000000,2023-04-01,17,065,IL,Hamilton County,4400,4264,136,3.1
CN1706700000000,2023-04-01,17,067,IL,Hancock County,7927,7646,281,3.5
CN1706900000000,2023-04-01,17,069,IL,Hardin County,1462,1393,69,4.7
CN1707100000000,2023-04-01,17,071,IL,Henderson County,3566,3445,121,3.4
CN1707300000000,2023-04-01,17,073,IL,Henry County,23494,22433,1061,4.5
CN1707500000000,2023-04-01,17,075,IL,Iroquois County,12251,11716,535,4.4
CN1707700000000,2023-04-01,17,077,IL,Jackson County,26893,25872,1021,3.8
CN1707900000000,2023-04-01,17,079,IL,Jasper County,5012,4865,147,2.9
CN1708100000000,2023-04-01,17,081,IL,Jefferson County,16224,15556,668,4.1
CN1708300000000,2023-04-01,17,083,IL,Jersey County,10566,10197,369,3.5
CN1708500000000,2023-04-01,17,085,IL,Jo Daviess County,10303,9919,384,3.7
CN1708700000000,2023-04-01,17,087,IL,Johnson County,4135,3935,200,4.8
CN1708900000000,2023-04-01,17,089,IL,Kane County,263823,251432,12391,4.7
CN1709100000000,2023-04-01,17,091,IL,Kankakee County,51480,48718,2762,5.4
CN1709300000000,2023-04-01,17,093,IL,Kendall County,73372,71233,2139,2.9
CN1709500000000,2023-04-01,17,095,IL,Knox County,19671,18672,999,5.1
CN1709700000000,2023-04-01,17,097,IL,Lake County,360152,343132,17020,4.7
CN1709900000000,2023-04-01,17,099,IL,LaSalle County,51477,48812,2665,5.2
CN1710100000000,2023-04-01,17,101,IL,Lawrence County,4948,4723,225,4.5
CN1710300000000,2023-04-01,17,103,IL,Lee County,16503,15822,681,4.1
CN1710500000000,2023-04-01,17,105,IL,Livingston County,15628,15055,573,3.7
CN1710700000000,2023-04-01,17,107,IL,Logan County,11494,11017,477,4.1
CN1710900000000,2023-04-01,17,109,IL,McDonough County,13129,12623,506,3.9
CN1711100000000,2023-04-01,17,111,IL,McHenry County,171455,166392,5063,3
CN1711300000000,2023-04-01,17,113,IL,McLean County,89377,86406,2971,3.3
CN1711500000000,2023-04-01,17,115,IL,Macon County,45023,42527,2496,5.5
CN1711700000000,2023-04-01,17,117,IL,Macoupin County,22066,21287,779,3.5
CN1711900000000,2023-04-01,17,119,IL,Madison County,130541,125949,4592,3.5
CN1712100000000,2023-04-01,17,121,IL,Marion County,16445,15750,695,4.2
CN1712300000000,2023-04-01,17,123,IL,Marshall County,5128,4887,241,4.7
CN1712500000000,2023-04-01,17,125,IL,Mason County,5948,5675,273,4.6
CN1712700000000,2023-04-01,17,127,IL,Massac County,5316,5084,232,4.4
CN1712900000000,2023-04-01,17,129,IL,Menard County,6142,5939,203,3.3
CN1713100000000,2023-04-01,17,131,IL,Mercer County,7487,7183,304,4.1
CN1713300000000,2023-04-01,17,133,IL,Monroe County,18622,18130,492,2.6
CN1713500000000,2023-04-01,17,135,IL,Montgomery County,11154,10602,552,4.9
CN1713700000000,2023-04-01,17,137,IL,Morgan County,15795,15231,564,3.6
CN1713900000000,2023-04-01,17,139,IL,Moultrie County,7425,7204,221,3
CN1714100000000,2023-04-01,17,141,IL,Ogle County,24344,23099,1245,5.1
CN1714300000000,2023-04-01,17,143,IL,Peoria County,82116,77958,4158,5.1
CN1714500000000,2023-04-01,17,145,IL,Perry County,7724,7372,352,4.6
CN1714700000000,2023-04-01,17,147,IL,Piatt County,8831,8540,291,3.3
CN1714900000000,2023-04-01,17,149,IL,Pike County,6773,6531,242,3.6
CN1715100000000,2023-04-01,17,151,IL,Pope County,1793,1730,63,3.5
CN1715300000000,2023-04-01,17,153,IL,Pulaski County,1653,1545,108,6.5
CN1715500000000,2023-04-01,17,155,IL,Putnam County,2980,2842,138,4.6
CN1715700000000,2023-04-01,17,157,IL,Randolph County,13463,13007,456,3.4
CN1715900000000,2023-04-01,17,159,IL,Richland County,7252,6994,258,3.6
CN1716100000000,2023-04-01,17,161,IL,Rock Island County,66328,63444,2884,4.3
CN1716300000000,2023-04-01,17,163,IL,St. Clair County,122578,117557,5021,4.1
CN1716500000000,2023-04-01,17,165,IL,Saline County,9351,8937,414,4.4
CN1716700000000,2023-04-01,17,167,IL,Sangamon County,96483,92889,3594,3.7
CN1716900000000,2023-04-01,17,169,IL,Schuyler County,3088,2984,104,3.4
CN1717100000000,2023-04-01,17,171,IL,Scott County,2315,2201,114,4.9
CN1717300000000,2023-04-01,17,173,IL,Shelby County,9812,9453,359,3.7
CN1717500000000,2023-04-01,17,175,IL,Stark County,2405,2287,118,4.9
CN1717700000000,2023-04-01,17,177,IL,Stephenson County,20551,19583,968,4.7
CN1717900000000,2023-04-01,17,179,IL,Tazewell County,61754,59295,2459,4
CN1718100000000,2023-04-01,17,181,IL,Union County,7097,6765,332,4.7
CN1718300000000,2023-04-01,17,183,IL,Vermilion County,31828,30229,1599,5
CN1718500000000,2023-04-01,17,185,IL,Wabash County,5689,5525,164,2.9
CN1718700000000,2023-04-01,17,187,IL,Warren County,7786,7512,274,3.5
CN1718900000000,2023-04-01,17,189,IL,Washington County,10055,9836,219,2.2
CN1719100000000,2023-04-01,17,191,IL,Wayne County,7161,6901,260,3.6
CN1719300000000,2023-04-01,17,193,IL,White County,6075,5840,235,3.9
CN1719500000000,2023-04-01,17,195,IL,Whiteside County,27665,26568,1097,4
CN1719700000000,2023-04-01,17,197,IL,Will County,371139,359085,12054,3.2
CN1719900000000,2023-04-01,17,199,IL,Williamson County,30772,29568,1204,3.9
CN1720100000000,2023-04-01,17,201,IL,Winnebago County,131101,123138,7963,6.1
CN1720300000000,2023-04-01,17,203,IL,Woodford County,18227,17590,637,3.5
CN1800100000000,2023-04-01,18,001,IN,Adams County,16803,16461,342,2
CN1800300000000,2023-04-01,18,003,IN,Allen County,191358,186603,4755,2.5
CN1800500000000,2023-04-01,18,005,IN,Bartholomew County,44787,43814,973,2.2
CN1800700000000,2023-04-01,18,007,IN,Benton County,4292,4197,95,2.2
CN1800900000000,2023-04-01,18,009,IN,Blackford County,4782,4627,155,3.2
CN1801100000000,2023-04-01,18,011,IN,Boone County,38939,38197,742,1.9
CN1801300000000,2023-04-01,18,013,IN,Brown County,7918,7718,200,2.5
CN1801500000000,2023-04-01,18,015,IN,Carroll County,9701,9469,232,2.4
CN1801700000000,2023-04-01,18,017,IN,Cass County,17257,16762,495,2.9
CN1801900000000,2023-04-01,18,019,IN,Clark County,63344,61811,1533,2.4
CN1802100000000,2023-04-01,18,021,IN,Clay County,11784,11462,322,2.7
CN1802300000000,2023-04-01,18,023,IN,Clinton County,17185,16812,373,2.2
CN1802500000000,2023-04-01,18,025,IN,Crawford County,4783,4650,133,2.8
CN1802700000000,2023-04-01,18,027,IN,Daviess County,16626,16318,308,1.9
CN1802900000000,2023-04-01,18,029,IN,Dearborn County,26496,25789,707,2.7
CN1803100000000,2023-04-01,18,031,IN,Decatur County,14438,14128,310,2.1
CN1803300000000,2023-04-01,18,033,IN,DeKalb County,22598,22081,517,2.3
CN1803500000000,2023-04-01,18,035,IN,Delaware County,51911,50358,1553,3
CN1803700000000,2023-04-01,18,037,IN,Dubois County,21798,21361,437,2
CN1803900000000,2023-04-01,18,039,IN,Elkhart County,115352,112085,3267,2.8
CN1804100000000,2023-04-01,18,041,IN,Fayette County,8289,7999,290,3.5
CN1804300000000,2023-04-01,18,043,IN,Floyd County,42648,41731,917,2.2
CN1804500000000,2023-04-01,18,045,IN,Fountain County,8014,7822,192,2.4
CN1804700000000,2023-04-01,18,047,IN,Franklin County,11312,11037,275,2.4
CN1804900000000,2023-04-01,18,049,IN,Fulton County,9360,9112,248,2.6
CN1805100000000,2023-04-01,18,051,IN,Gibson County,19823,19453,370,1.9
CN1805300000000,2023-04-01,18,053,IN,Grant County,31880,30988,892,2.8
CN1805500000000,2023-04-01,18,055,IN,Greene County,13527,13109,418,3.1
CN1805700000000,2023-04-01,18,057,IN,Hamilton County,200134,196156,3978,2
CN1805900000000,2023-04-01,18,059,IN,Hancock County,43591,42658,933,2.1
CN1806100000000,2023-04-01,18,061,IN,Harrison County,20617,20164,453,2.2
CN1806300000000,2023-04-01,18,063,IN,Hendricks County,97499,95476,2023,2.1
CN1806500000000,2023-04-01,18,065,IN,Henry County,22225,21592,633,2.8
CN1806700000000,2023-04-01,18,067,IN,Howard County,32742,31314,1428,4.4
CN1806900000000,2023-04-01,18,069,IN,Huntington County,18484,18047,437,2.4
CN1807100000000,2023-04-01,18,071,IN,Jackson County,23320,22795,525,2.3
CN1807300000000,2023-04-01,18,073,IN,Jasper County,15961,15508,453,2.8
CN1807500000000,2023-04-01,18,075,IN,Jay County,8818,8586,232,2.6
CN1807700000000,2023-04-01,18,077,IN,Jefferson County,15280,14890,390,2.6
CN1807900000000,2023-04-01,18,079,IN,Jennings County,13622,13244,378,2.8
CN1808100000000,2023-04-01,18,081,IN,Johnson County,88840,87035,1805,2
CN1808300000000,2023-04-01,18,083,IN,Knox County,17634,17226,408,2.3
CN1808500000000,2023-04-01,18,085,IN,Kosciusko County,40792,39780,1012,2.5
CN1808700000000,2023-04-01,18,087,IN,LaGrange County,21171,20718,453,2.1
CN1808900000000,2023-04-01,18,089,IN,Lake County,229316,220339,8977,3.9
CN1809100000000,2023-04-01,18,091,IN,LaPorte County,46929,45422,1507,3.2
CN1809300000000,2023-04-01,18,093,IN,Lawrence County,20485,19853,632,3.1
CN1809500000000,2023-04-01,18,095,IN,Madison County,61409,59674,1735,2.8
CN1809700000000,2023-04-01,18,097,IN,Marion County,518439,504897,13542,2.6
CN1809900000000,2023-04-01,18,099,IN,Marshall County,23134,22492,642,2.8
CN1810100000000,2023-04-01,18,101,IN,Martin County,5345,5217,128,2.4
CN1810300000000,2023-04-01,18,103,IN,Miami County,14162,13694,468,3.3
CN1810500000000,2023-04-01,18,105,IN,Monroe County,72693,70931,1762,2.4
CN1810700000000,2023-04-01,18,107,IN,Montgomery County,19026,18623,403,2.1
CN1810900000000,2023-04-01,18,109,IN,Morgan County,38053,37140,913,2.4
CN1811100000000,2023-04-01,18,111,IN,Newton County,6729,6512,217,3.2
CN1811300000000,2023-04-01,18,113,IN,Noble County,21639,21059,580,2.7
CN1811500000000,2023-04-01,18,115,IN,Ohio County,3282,3204,78,2.4
CN1811700000000,2023-04-01,18,117,IN,Orange County,8161,7944,217,2.7
CN1811900000000,2023-04-01,18,119,IN,Owen County,9531,9251,280,2.9
CN1812100000000,2023-04-01,18,121,IN,Parke County,7000,6808,192,2.7
CN1812300000000,2023-04-01,18,123,IN,Perry County,8891,8678,213,2.4
CN1812500000000,2023-04-01,18,125,IN,Pike County,5880,5738,142,2.4
CN1812700000000,2023-04-01,18,127,IN,Porter County,86655,84092,2563,3
CN1812900000000,2023-04-01,18,129,IN,Posey County,13119,12826,293,2.2
CN1813100000000,2023-04-01,18,131,IN,Pulaski County,6732,6579,153,2.3
CN1813300000000,2023-04-01,18,133,IN,Putnam County,17175,16755,420,2.4
CN1813500000000,2023-04-01,18,135,IN,Randolph County,12184,11879,305,2.5
CN1813700000000,2023-04-01,18,137,IN,Ripley County,12833,12486,347,2.7
CN1813900000000,2023-04-01,18,139,IN,Rush County,8900,8707,193,2.2
CN1814100000000,2023-04-01,18,141,IN,St. Joseph County,132156,128138,4018,3
CN1814300000000,2023-04-01,18,143,IN,Scott County,10630,10343,287,2.7
CN1814500000000,2023-04-01,18,145,IN,Shelby County,24162,23655,507,2.1
CN1814700000000,2023-04-01,18,147,IN,Spencer County,10491,10251,240,2.3
CN1814900000000,2023-04-01,18,149,IN,Starke County,9718,9401,317,3.3
CN1815100000000,2023-04-01,18,151,IN,Steuben County,20913,20486,427,2
CN1815300000000,2023-04-01,18,153,IN,Sullivan County,8075,7825,250,3.1
CN1815500000000,2023-04-01,18,155,IN,Switzerland County,4758,4635,123,2.6
CN1815700000000,2023-04-01,18,157,IN,Tippecanoe County,96361,94129,2232,2.3
CN1815900000000,2023-04-01,18,159,IN,Tipton County,9002,8762,240,2.7
CN1816100000000,2023-04-01,18,161,IN,Union County,3642,3560,82,2.3
CN1816300000000,2023-04-01,18,163,IN,Vanderburgh County,93562,91229,2333,2.5
CN1816500000000,2023-04-01,18,165,IN,Vermillion County,6642,6430,212,3.2
CN1816700000000,2023-04-01,18,167,IN,Vigo County,46621,45274,1347,2.9
CN1816900000000,2023-04-01,18,169,IN,Wabash County,14786,14423,363,2.5
CN1817100000000,2023-04-01,18,171,IN,Warren County,4107,4004,103,2.5
CN1817300000000,2023-04-01,18,173,IN,Warrick County,32747,31992,755,2.3
CN1817500000000,2023-04-01,18,175,IN,Washington County,13736,13411,325,2.4
CN1817700000000,2023-04-01,18,177,IN,Wayne County,30096,29276,820,2.7
CN1817900000000,2023-04-01,18,179,IN,Wells County,14411,14119,292,2
CN1818100000000,2023-04-01,18,181,IN,White County,13184,12892,292,2.2
CN1818300000000,2023-04-01,18,183,IN,Whitley County,18045,17672,373,2.1
CN1900100000000,2023-04-01,19,001,IA,Adair County,4409,4324,85,1.9
CN1900300000000,2023-04-01,19,003,IA,Adams County,2166,2130,36,1.7
CN1900500000000,2023-04-01,19,005,IA,Allamakee County,7127,6909,218,3.1
CN1900700000000,2023-04-01,19,007,IA,Appanoose County,6277,6121,156,2.5
CN1900900000000,2023-04-01,19,009,IA,Audubon County,3103,3044,59,1.9
CN1901100000000,2023-04-01,19,011,IA,Benton County,13304,12976,328,2.5
CN1901300000000,2023-04-01,19,013,IA,Black Hawk County,69026,67227,1799,2.6
CN1901500000000,2023-04-01,19,015,IA,Boone County,15089,14803,286,1.9
CN1901700000000,2023-04-01,19,017,IA,Bremer County,14254,13976,278,2
CN1901900000000,2023-04-01,19,019,IA,Buchanan County,11598,11340,258,2.2
CN1902100000000,2023-04-01,19,021,IA,Buena Vista County,12084,11849,235,1.9
CN1902300000000,2023-04-01,19,023,IA,Butler County,8450,8238,212,2.5
CN1902500000000,2023-04-01,19,025,IA,Calhoun County,4267,4176,91,2.1
CN1902700000000,2023-04-01,19,027,IA,Carroll County,10984,10767,217,2
CN1902900000000,2023-04-01,19,029,IA,Cass County,7067,6911,156,2.2
CN1903100000000,2023-04-01,19,031,IA,Cedar County,10608,10356,252,2.4
CN1903300000000,2023-04-01,19,033,IA,Cerro Gordo County,22280,21731,549,2.5
CN1903500000000,2023-04-01,19,035,IA,Cherokee County,6213,6075,138,2.2
CN1903700000000,2023-04-01,19,037,IA,Chickasaw County,6701,6562,139,2.1
CN1903900000000,2023-04-01,19,039,IA,Clarke County,5003,4893,110,2.2
CN1904100000000,2023-04-01,19,041,IA,Clay County,8597,8388,209,2.4
CN1904300000000,2023-04-01,19,043,IA,Clayton County,9581,9253,328,3.4
CN1904500000000,2023-04-01,19,045,IA,Clinton County,22544,21866,678,3
CN1904700000000,2023-04-01,19,047,IA,Crawford County,8002,7648,354,4.4
CN1904900000000,2023-04-01,19,049,IA,Dallas County,55090,54154,936,1.7
CN1905100000000,2023-04-01,19,051,IA,Davis County,4389,4305,84,1.9
CN1905300000000,2023-04-01,19,053,IA,Decatur County,4464,4380,84,1.9
CN1905500000000,2023-04-01,19,055,IA,Delaware County,10664,10460,204,1.9
CN1905700000000,2023-04-01,19,057,IA,Des Moines County,18291,17661,630,3.4
CN1905900000000,2023-04-01,19,059,IA,Dickinson County,10364,10109,255,2.5
CN1906100000000,2023-04-01,19,061,IA,Dubuque County,56545,55232,1313,2.3
CN1906300000000,2023-04-01,19,063,IA,Emmet County,4897,4764,133,2.7
CN1906500000000,2023-04-01,19,065,IA,Fayette County,10618,10343,275,2.6
CN1906700000000,2023-04-01,19,067,IA,Floyd County,8424,8198,226,2.7
CN1906900000000,2023-04-01,19,069,IA,Franklin County,5748,5615,133,2.3
CN1907100000000,2023-04-01,19,071,IA,Fremont County,3722,3655,67,1.8
CN1907300000000,2023-04-01,19,073,IA,Greene County,5498,5407,91,1.7
CN1907500000000,2023-04-01,19,075,IA,Grundy County,6544,6409,135,2.1
CN1907700000000,2023-04-01,19,077,IA,Guthrie County,5806,5664,142,2.4
CN1907900000000,2023-04-01,19,079,IA,Hamilton County,7095,6933,162,2.3
CN1908100000000,2023-04-01,19,081,IA,Hancock County,5708,5598,110,1.9
CN1908300000000,2023-04-01,19,083,IA,Hardin County,7918,7714,204,2.6
CN1908500000000,2023-04-01,19,085,IA,Harrison County,7265,7110,155,2.1
CN1908700000000,2023-04-01,19,087,IA,Henry County,9511,9271,240,2.5
CN1908900000000,2023-04-01,19,089,IA,Howard County,5322,5181,141,2.6
CN1909100000000,2023-04-01,19,091,IA,Humboldt County,4928,4814,114,2.3
CN1909300000000,2023-04-01,19,093,IA,Ida County,4033,3973,60,1.5
CN1909500000000,2023-04-01,19,095,IA,Iowa County,9985,9787,198,2
CN1909700000000,2023-04-01,19,097,IA,Jackson County,10813,10504,309,2.9
CN1909900000000,2023-04-01,19,099,IA,Jasper County,18892,18443,449,2.4
CN1910100000000,2023-04-01,19,101,IA,Jefferson County,10377,10171,206,2
CN1910300000000,2023-04-01,19,103,IA,Johnson County,88129,86431,1698,1.9
CN1910500000000,2023-04-01,19,105,IA,Jones County,10618,10316,302,2.8
CN1910700000000,2023-04-01,19,107,IA,Keokuk County,5332,5185,147,2.8
CN1910900000000,2023-04-01,19,109,IA,Kossuth County,8340,8176,164,2
CN1911100000000,2023-04-01,19,111,IA,Lee County,14740,14264,476,3.2
CN1911300000000,2023-04-01,19,113,IA,Linn County,122857,119609,3248,2.6
CN1911500000000,2023-04-01,19,115,IA,Louisa County,5964,5805,159,2.7
CN1911700000000,2023-04-01,19,117,IA,Lucas County,4639,4552,87,1.9
CN1911900000000,2023-04-01,19,119,IA,Lyon County,7163,7038,125,1.7
CN1912100000000,2023-04-01,19,121,IA,Madison County,8962,8725,237,2.6
CN1912300000000,2023-04-01,19,123,IA,Mahaska County,12453,12201,252,2
CN1912500000000,2023-04-01,19,125,IA,Marion County,19561,19218,343,1.8
CN1912700000000,2023-04-01,19,127,IA,Marshall County,17581,16574,1007,5.7
CN1912900000000,2023-04-01,19,129,IA,Mills County,7230,7089,141,2
CN1913100000000,2023-04-01,19,131,IA,Mitchell County,5896,5791,105,1.8
CN1913300000000,2023-04-01,19,133,IA,Monona County,4460,4376,84,1.9
CN1913500000000,2023-04-01,19,135,IA,Monroe County,4073,3986,87,2.1
CN1913700000000,2023-04-01,19,137,IA,Montgomery County,5066,4959,107,2.1
CN1913900000000,2023-04-01,19,139,IA,Muscatine County,20899,20378,521,2.5
CN1914100000000,2023-04-01,19,141,IA,O'Brien County,8397,8225,172,2
CN1914300000000,2023-04-01,19,143,IA,Osceola County,3716,3665,51,1.4
CN1914500000000,2023-04-01,19,145,IA,Page County,6524,6394,130,2
CN1914700000000,2023-04-01,19,147,IA,Palo Alto County,4484,4400,84,1.9
CN1914900000000,2023-04-01,19,149,IA,Plymouth County,15218,14972,246,1.6
CN1915100000000,2023-04-01,19,151,IA,Pocahontas County,4156,4082,74,1.8
CN1915300000000,2023-04-01,19,153,IA,Polk County,281538,275190,6348,2.3
CN1915500000000,2023-04-01,19,155,IA,Pottawattamie County,48430,47360,1070,2.2
CN1915700000000,2023-04-01,19,157,IA,Poweshiek County,10714,10459,255,2.4
CN1915900000000,2023-04-01,19,159,IA,Ringgold County,2376,2333,43,1.8
CN1916100000000,2023-04-01,19,161,IA,Sac County,5392,5296,96,1.8
CN1916300000000,2023-04-01,19,163,IA,Scott County,88818,86478,2340,2.6
CN1916500000000,2023-04-01,19,165,IA,Shelby County,6518,6376,142,2.2
CN1916700000000,2023-04-01,19,167,IA,Sioux County,23160,22803,357,1.5
CN1916900000000,2023-04-01,19,169,IA,Story County,61520,60411,1109,1.8
CN1917100000000,2023-04-01,19,171,IA,Tama County,9375,9084,291,3.1
CN1917300000000,2023-04-01,19,173,IA,Taylor County,3250,3197,53,1.6
CN1917500000000,2023-04-01,19,175,IA,Union County,6239,6103,136,2.2
CN1917700000000,2023-04-01,19,177,IA,Van Buren County,3772,3678,94,2.5
CN1917900000000,2023-04-01,19,179,IA,Wapello County,16771,16307,464,2.8
CN1918100000000,2023-04-01,19,181,IA,Warren County,29959,29354,605,2
CN1918300000000,2023-04-01,19,183,IA,Washington County,12001,11769,232,1.9
CN1918500000000,2023-04-01,19,185,IA,Wayne County,3037,2966,71,2.3
CN1918700000000,2023-04-01,19,187,IA,Webster County,19157,18667,490,2.6
CN1918900000000,2023-04-01,19,189,IA,Winnebago County,5062,4943,119,2.4
CN1919100000000,2023-04-01,19,191,IA,Winneshiek County,11667,11345,322,2.8
CN1919300000000,2023-04-01,19,193,IA,Woodbury County,57205,55892,1313,2.3
CN1919500000000,2023-04-01,19,195,IA,Worth County,4044,3945,99,2.4
CN1919700000000,2023-04-01,19,197,IA,Wright County,6844,6692,152,2.2
CN2000100000000,2023-04-01,20,001,KS,Allen County,6263,6087,176,2.8
CN2000300000000,2023-04-01,20,003,KS,Anderson County,4342,4247,95,2.2
CN2000500000000,2023-04-01,20,005,KS,Atchison County,6566,6345,221,3.4
CN2000700000000,2023-04-01,20,007,KS,Barber County,2153,2094,59,2.7
CN2000900000000,2023-04-01,20,009,KS,Barton County,12746,12385,361,2.8
CN2001100000000,2023-04-01,20,011,KS,Bourbon County,6171,5943,228,3.7
CN2001300000000,2023-04-01,20,013,KS,Brown County,4824,4675,149,3.1
CN2001500000000,2023-04-01,20,015,KS,Butler County,33091,32165,926,2.8
CN2001700000000,2023-04-01,20,017,KS,Chase County,1339,1310,29,2.2
CN2001900000000,2023-04-01,20,019,KS,Chautauqua County,1378,1340,38,2.8
CN2002100000000,2023-04-01,20,021,KS,Cherokee County,9757,9489,268,2.7
CN2002300000000,2023-04-01,20,023,KS,Cheyenne County,1155,1121,34,2.9
CN2002500000000,2023-04-01,20,025,KS,Clark County,1085,1060,25,2.3
CN2002700000000,2023-04-01,20,027,KS,Clay County,3574,3475,99,2.8
CN2002900000000,2023-04-01,20,029,KS,Cloud County,3659,3551,108,3
CN2003100000000,2023-04-01,20,031,KS,Coffey County,3818,3685,133,3.5
CN2003300000000,2023-04-01,20,033,KS,Comanche County,819,799,20,2.4
CN2003500000000,2023-04-01,20,035,KS,Cowley County,16146,15659,487,3
CN2003700000000,2023-04-01,20,037,KS,Crawford County,19289,18728,561,2.9
CN2003900000000,2023-04-01,20,039,KS,Decatur County,1116,1080,36,3.2
CN2004100000000,2023-04-01,20,041,KS,Dickinson County,8467,8215,252,3
CN2004300000000,2023-04-01,20,043,KS,Doniphan County,4000,3892,108,2.7
CN2004500000000,2023-04-01,20,045,KS,Douglas County,69260,67479,1781,2.6
CN2004700000000,2023-04-01,20,047,KS,Edwards County,1294,1262,32,2.5
CN2004900000000,2023-04-01,20,049,KS,Elk County,1173,1144,29,2.5
CN2005100000000,2023-04-01,20,051,KS,Ellis County,16886,16530,356,2.1
CN2005300000000,2023-04-01,20,053,KS,Ellsworth County,2564,2501,63,2.5
CN2005500000000,2023-04-01,20,055,KS,Finney County,20404,19962,442,2.2
CN2005700000000,2023-04-01,20,057,KS,Ford County,17925,17531,394,2.2
CN2005900000000,2023-04-01,20,059,KS,Franklin County,14774,14411,363,2.5
CN2006100000000,2023-04-01,20,061,KS,Geary County,11523,11047,476,4.1
CN2006300000000,2023-04-01,20,063,KS,Gove County,1283,1249,34,2.7
CN2006500000000,2023-04-01,20,065,KS,Graham County,1172,1143,29,2.5
CN2006700000000,2023-04-01,20,067,KS,Grant County,2578,2506,72,2.8
CN2006900000000,2023-04-01,20,069,KS,Gray County,3056,2988,68,2.2
CN2007100000000,2023-04-01,20,071,KS,Greeley County,714,703,11,1.5
CN2007300000000,2023-04-01,20,073,KS,Greenwood County,3052,2964,88,2.9
CN2007500000000,2023-04-01,20,075,KS,Hamilton County,1547,1515,32,2.1
CN2007700000000,2023-04-01,20,077,KS,Harper County,2851,2783,68,2.4
CN2007900000000,2023-04-01,20,079,KS,Harvey County,17289,16809,480,2.8
CN2008100000000,2023-04-01,20,081,KS,Haskell County,2044,2003,41,2
CN2008300000000,2023-04-01,20,083,KS,Hodgeman County,954,927,27,2.8
CN2008500000000,2023-04-01,20,085,KS,Jackson County,7325,7138,187,2.6
CN2008700000000,2023-04-01,20,087,KS,Jefferson County,10369,10108,261,2.5
CN2008900000000,2023-04-01,20,089,KS,Jewell County,1120,1082,38,3.4
CN2009100000000,2023-04-01,20,091,KS,Johnson County,355632,346567,9065,2.5
CN2009300000000,2023-04-01,20,093,KS,Kearny County,1906,1861,45,2.4
CN2009500000000,2023-04-01,20,095,KS,Kingman County,3241,3144,97,3
CN2009700000000,2023-04-01,20,097,KS,Kiowa County,1156,1118,38,3.3
CN2009900000000,2023-04-01,20,099,KS,Labette County,10312,9987,325,3.2
CN2010100000000,2023-04-01,20,101,KS,Lane County,694,674,20,2.9
CN2010300000000,2023-04-01,20,103,KS,Leavenworth County,37994,36903,1091,2.9
CN2010500000000,2023-04-01,20,105,KS,Lincoln County,1573,1537,36,2.3
CN2010700000000,2023-04-01,20,107,KS,Linn County,4391,4208,183,4.2
CN2010900000000,2023-04-01,20,109,KS,Logan County,1612,1580,32,2
CN2011100000000,2023-04-01,20,111,KS,Lyon County,17048,16595,453,2.7
CN2011300000000,2023-04-01,20,113,KS,McPherson County,17552,17198,354,2
CN2011500000000,2023-04-01,20,115,KS,Marion County,5787,5659,128,2.2
CN2011700000000,2023-04-01,20,117,KS,Marshall County,5087,4968,119,2.3
CN2011900000000,2023-04-01,20,119,KS,Meade County,2006,1961,45,2.2
CN2012100000000,2023-04-01,20,121,KS,Miami County,18297,17819,478,2.6
CN2012300000000,2023-04-01,20,123,KS,Mitchell County,3247,3184,63,1.9
CN2012500000000,2023-04-01,20,125,KS,Montgomery County,14666,14179,487,3.3
CN2012700000000,2023-04-01,20,127,KS,Morris County,2813,2734,79,2.8
CN2012900000000,2023-04-01,20,129,KS,Morton County,1120,1091,29,2.6
CN2013100000000,2023-04-01,20,131,KS,Nemaha County,5561,5460,101,1.8
CN2013300000000,2023-04-01,20,133,KS,Neosho County,6197,5963,234,3.8
CN2013500000000,2023-04-01,20,135,KS,Ness County,1249,1220,29,2.3
CN2013700000000,2023-04-01,20,137,KS,Norton County,2497,2443,54,2.2
CN2013900000000,2023-04-01,20,139,KS,Osage County,8022,7792,230,2.9
CN2014100000000,2023-04-01,20,141,KS,Osborne County,1809,1764,45,2.5
CN2014300000000,2023-04-01,20,143,KS,Ottawa County,2962,2885,77,2.6
CN2014500000000,2023-04-01,20,145,KS,Pawnee County,2583,2504,79,3.1
CN2014700000000,2023-04-01,20,147,KS,Phillips County,2540,2486,54,2.1
CN2014900000000,2023-04-01,20,149,KS,Pottawatomie County,13140,12842,298,2.3
CN2015100000000,2023-04-01,20,151,KS,Pratt County,4797,4691,106,2.2
CN2015300000000,2023-04-01,20,153,KS,Rawlins County,1463,1434,29,2
CN2015500000000,2023-04-01,20,155,KS,Reno County,28969,28045,924,3.2
CN2015700000000,2023-04-01,20,157,KS,Republic County,2252,2200,52,2.3
CN2015900000000,2023-04-01,20,159,KS,Rice County,5751,5625,126,2.2
CN2016100000000,2023-04-01,20,161,KS,Riley County,36661,35721,940,2.6
CN2016300000000,2023-04-01,20,163,KS,Rooks County,2329,2264,65,2.8
CN2016500000000,2023-04-01,20,165,KS,Rush County,1580,1544,36,2.3
CN2016700000000,2023-04-01,20,167,KS,Russell County,3218,3135,83,2.6
CN2016900000000,2023-04-01,20,169,KS,Saline County,29900,29149,751,2.5
CN2017100000000,2023-04-01,20,171,KS,Scott County,2505,2442,63,2.5
CN2017300000000,2023-04-01,20,173,KS,Sedgwick County,259031,250989,8042,3.1
CN2017500000000,2023-04-01,20,175,KS,Seward County,9740,9481,259,2.7
CN2017700000000,2023-04-01,20,177,KS,Shawnee County,92817,90164,2653,2.9
CN2017900000000,2023-04-01,20,179,KS,Sheridan County,1374,1340,34,2.5
CN2018100000000,2023-04-01,20,181,KS,Sherman County,2648,2585,63,2.4
CN2018300000000,2023-04-01,20,183,KS,Smith County,1905,1867,38,2
CN2018500000000,2023-04-01,20,185,KS,Stafford County,1854,1804,50,2.7
CN2018700000000,2023-04-01,20,187,KS,Stanton County,1016,993,23,2.3
CN2018900000000,2023-04-01,20,189,KS,Stevens County,2905,2837,68,2.3
CN2019100000000,2023-04-01,20,191,KS,Sumner County,10782,10484,298,2.8
CN2019300000000,2023-04-01,20,193,KS,Thomas County,4039,3962,77,1.9
CN2019500000000,2023-04-01,20,195,KS,Trego County,1327,1286,41,3.1
CN2019700000000,2023-04-01,20,197,KS,Wabaunsee County,3712,3604,108,2.9
CN2019900000000,2023-04-01,20,199,KS,Wallace County,800,780,20,2.5
CN2020100000000,2023-04-01,20,201,KS,Washington County,2872,2798,74,2.6
CN2020300000000,2023-04-01,20,203,KS,Wichita County,1025,1000,25,2.4
CN2020500000000,2023-04-01,20,205,KS,Wilson County,3560,3441,119,3.3
CN2020700000000,2023-04-01,20,207,KS,Woodson County,1477,1425,52,3.5
CN2020900000000,2023-04-01,20,209,KS,Wyandotte County,79573,76681,2892,3.6
CN2100100000000,2023-04-01,21,001,KY,Adair County,7110,6825,285,4
CN2100300000000,2023-04-01,21,003,KY,Allen County,9077,8803,274,3
CN2100500000000,2023-04-01,21,005,KY,Anderson County,11821,11511,310,2.6
CN2100700000000,2023-04-01,21,007,KY,Ballard County,3524,3351,173,4.9
CN2100900000000,2023-04-01,21,009,KY,Barren County,17734,17150,584,3.3
CN2101100000000,2023-04-01,21,011,KY,Bath County,4659,4466,193,4.1
CN2101300000000,2023-04-01,21,013,KY,Bell County,8262,7887,375,4.5
CN2101500000000,2023-04-01,21,015,KY,Boone County,73544,71445,2099,2.9
CN2101700000000,2023-04-01,21,017,KY,Bourbon County,9516,9253,263,2.8
CN2101900000000,2023-04-01,21,019,KY,Boyd County,17265,16438,827,4.8
CN2102100000000,2023-04-01,21,021,KY,Boyle County,13025,12519,506,3.9
CN2102300000000,2023-04-01,21,023,KY,Bracken County,3865,3714,151,3.9
CN2102500000000,2023-04-01,21,025,KY,Breathitt County,3150,2964,186,5.9
CN2102700000000,2023-04-01,21,027,KY,Breckinridge County,8002,7694,308,3.8
CN2102900000000,2023-04-01,21,029,KY,Bullitt County,42898,41604,1294,3
CN2103100000000,2023-04-01,21,031,KY,Butler County,5161,4997,164,3.2
CN2103300000000,2023-04-01,21,033,KY,Caldwell County,6228,6073,155,2.5
CN2103500000000,2023-04-01,21,035,KY,Calloway County,16727,16138,589,3.5
CN2103700000000,2023-04-01,21,037,KY,Campbell County,51716,50222,1494,2.9
CN2103900000000,2023-04-01,21,039,KY,Carlisle County,2360,2281,79,3.3
CN2104100000000,2023-04-01,21,041,KY,Carroll County,5889,5741,148,2.5
CN2104300000000,2023-04-01,21,043,KY,Carter County,9578,8967,611,6.4
CN2104500000000,2023-04-01,21,045,KY,Casey County,6421,6190,231,3.6
CN2104700000000,2023-04-01,21,047,KY,Christian County,25357,24321,1036,4.1
CN2104900000000,2023-04-01,21,049,KY,Clark County,17581,17055,526,3
CN2105100000000,2023-04-01,21,051,KY,Clay County,5060,4806,254,5
CN2105300000000,2023-04-01,21,053,KY,Clinton County,3552,3401,151,4.3
CN2105500000000,2023-04-01,21,055,KY,Crittenden County,3806,3687,119,3.1
CN2105700000000,2023-04-01,21,057,KY,Cumberland County,3358,3257,101,3
CN2105900000000,2023-04-01,21,059,KY,Daviess County,45796,44147,1649,3.6
CN2106100000000,2023-04-01,21,061,KY,Edmonson County,4849,4654,195,4
CN2106300000000,2023-04-01,21,063,KY,Elliott County,1882,1754,128,6.8
CN2106500000000,2023-04-01,21,065,KY,Estill County,5170,4966,204,3.9
CN2106700000000,2023-04-01,21,067,KY,Fayette County,178702,174029,4673,2.6
CN2106900000000,2023-04-01,21,069,KY,Fleming County,5993,5773,220,3.7
CN2107100000000,2023-04-01,21,071,KY,Floyd County,10886,10351,535,4.9
CN2107300000000,2023-04-01,21,073,KY,Franklin County,24797,24116,681,2.7
CN2107500000000,2023-04-01,21,075,KY,Fulton County,2094,2015,79,3.8
CN2107700000000,2023-04-01,21,077,KY,Gallatin County,4060,3932,128,3.2
CN2107900000000,2023-04-01,21,079,KY,Garrard County,8102,7850,252,3.1
CN2108100000000,2023-04-01,21,081,KY,Grant County,11891,11516,375,3.2
CN2108300000000,2023-04-01,21,083,KY,Graves County,15436,14888,548,3.6
CN2108500000000,2023-04-01,21,085,KY,Grayson County,10263,9881,382,3.7
CN2108700000000,2023-04-01,21,087,KY,Green County,4998,4843,155,3.1
CN2108900000000,2023-04-01,21,089,KY,Greenup County,12992,12260,732,5.6
CN2109100000000,2023-04-01,21,091,KY,Hancock County,3820,3660,160,4.2
CN2109300000000,2023-04-01,21,093,KY,Hardin County,47193,45620,1573,3.3
CN2109500000000,2023-04-01,21,095,KY,Harlan County,6475,6140,335,5.2
CN2109700000000,2023-04-01,21,097,KY,Harrison County,8844,8586,258,2.9
CN2109900000000,2023-04-01,21,099,KY,Hart County,7789,7531,258,3.3
CN2110100000000,2023-04-01,21,101,KY,Henderson County,20757,20130,627,3
CN2110300000000,2023-04-01,21,103,KY,Henry County,8091,7880,211,2.6
CN2110500000000,2023-04-01,21,105,KY,Hickman County,1611,1559,52,3.2
CN2110700000000,2023-04-01,21,107,KY,Hopkins County,17686,17075,611,3.5
CN2110900000000,2023-04-01,21,109,KY,Jackson County,4157,3975,182,4.4
CN2111100000000,2023-04-01,21,111,KY,Jefferson County,395286,383474,11812,3
CN2111300000000,2023-04-01,21,113,KY,Jessamine County,27159,26420,739,2.7
CN2111500000000,2023-04-01,21,115,KY,Johnson County,6636,6265,371,5.6
CN2111700000000,2023-04-01,21,117,KY,Kenton County,89391,86782,2609,2.9
CN2111900000000,2023-04-01,21,119,KY,Knott County,4240,4011,229,5.4
CN2112100000000,2023-04-01,21,121,KY,Knox County,10129,9689,440,4.3
CN2112300000000,2023-04-01,21,123,KY,Larue County,5815,5620,195,3.4
CN2112500000000,2023-04-01,21,125,KY,Laurel County,25665,24798,867,3.4
CN2112700000000,2023-04-01,21,127,KY,Lawrence County,5597,5341,256,4.6
CN2112900000000,2023-04-01,21,129,KY,Lee County,2050,1951,99,4.8
CN2113100000000,2023-04-01,21,131,KY,Leslie County,2489,2361,128,5.1
CN2113300000000,2023-04-01,21,133,KY,Letcher County,5813,5503,310,5.3
CN2113500000000,2023-04-01,21,135,KY,Lewis County,4590,4257,333,7.3
CN2113700000000,2023-04-01,21,137,KY,Lincoln County,9500,9087,413,4.3
CN2113900000000,2023-04-01,21,139,KY,Livingston County,3652,3497,155,4.2
CN2114100000000,2023-04-01,21,141,KY,Logan County,12369,11994,375,3
CN2114300000000,2023-04-01,21,143,KY,Lyon County,3198,3090,108,3.4
CN2114500000000,2023-04-01,21,145,KY,McCracken County,30055,29093,962,3.2
CN2114700000000,2023-04-01,21,147,KY,McCreary County,4644,4444,200,4.3
CN2114900000000,2023-04-01,21,149,KY,McLean County,3915,3778,137,3.5
CN2115100000000,2023-04-01,21,151,KY,Madison County,47635,46246,1389,2.9
CN2115300000000,2023-04-01,21,153,KY,Magoffin County,3189,2922,267,8.4
CN2115500000000,2023-04-01,21,155,KY,Marion County,9265,9016,249,2.7
CN2115700000000,2023-04-01,21,157,KY,Marshall County,14342,13848,494,3.4
CN2115900000000,2023-04-01,21,159,KY,Martin County,2178,2032,146,6.7
CN2116100000000,2023-04-01,21,161,KY,Mason County,6543,6269,274,4.2
CN2116300000000,2023-04-01,21,163,KY,Meade County,11619,11199,420,3.6
CN2116500000000,2023-04-01,21,165,KY,Menifee County,2342,2230,112,4.8
CN2116700000000,2023-04-01,21,167,KY,Mercer County,10462,10107,355,3.4
CN2116900000000,2023-04-01,21,169,KY,Metcalfe County,3879,3744,135,3.5
CN2117100000000,2023-04-01,21,171,KY,Monroe County,4632,4499,133,2.9
CN2117300000000,2023-04-01,21,173,KY,Montgomery County,11810,11356,454,3.8
CN2117500000000,2023-04-01,21,175,KY,Morgan County,4012,3846,166,4.1
CN2117700000000,2023-04-01,21,177,KY,Muhlenberg County,10112,9600,512,5.1
CN2117900000000,2023-04-01,21,179,KY,Nelson County,23587,22958,629,2.7
CN2118100000000,2023-04-01,21,181,KY,Nicholas County,3244,3127,117,3.6
CN2118300000000,2023-04-01,21,183,KY,Ohio County,8996,8544,452,5
CN2118500000000,2023-04-01,21,185,KY,Oldham County,33377,32523,854,2.6
CN2118700000000,2023-04-01,21,187,KY,Owen County,5413,5258,155,2.9
CN2118900000000,2023-04-01,21,189,KY,Owsley County,1037,985,52,5
CN2119100000000,2023-04-01,21,191,KY,Pendleton County,7075,6864,211,3
CN2119300000000,2023-04-01,21,193,KY,Perry County,7966,7627,339,4.3
CN2119500000000,2023-04-01,21,195,KY,Pike County,18709,17884,825,4.4
CN2119700000000,2023-04-01,21,197,KY,Powell County,5253,5076,177,3.4
CN2119900000000,2023-04-01,21,199,KY,Pulaski County,24926,23942,984,3.9
CN2120100000000,2023-04-01,21,201,KY,Robertson County,805,771,34,4.2
CN2120300000000,2023-04-01,21,203,KY,Rockcastle County,6579,6336,243,3.7
CN2120500000000,2023-04-01,21,205,KY,Rowan County,10240,9831,409,4
CN2120700000000,2023-04-01,21,207,KY,Russell County,6125,5846,279,4.6
CN2120900000000,2023-04-01,21,209,KY,Scott County,30856,30054,802,2.6
CN2121100000000,2023-04-01,21,211,KY,Shelby County,25800,25133,667,2.6
CN2121300000000,2023-04-01,21,213,KY,Simpson County,8771,8506,265,3
CN2121500000000,2023-04-01,21,215,KY,Spencer County,10565,10291,274,2.6
CN2121700000000,2023-04-01,21,217,KY,Taylor County,12076,11721,355,2.9
CN2121900000000,2023-04-01,21,219,KY,Todd County,5877,5720,157,2.7
CN2122100000000,2023-04-01,21,221,KY,Trigg County,6119,5906,213,3.5
CN2122300000000,2023-04-01,21,223,KY,Trimble County,3807,3686,121,3.2
CN2122500000000,2023-04-01,21,225,KY,Union County,5830,5594,236,4
CN2122700000000,2023-04-01,21,227,KY,Warren County,67355,65270,2085,3.1
CN2122900000000,2023-04-01,21,229,KY,Washington County,6010,5848,162,2.7
CN2123100000000,2023-04-01,21,231,KY,Wayne County,6892,6575,317,4.6
CN2123300000000,2023-04-01,21,233,KY,Webster County,5091,4916,175,3.4
CN2123500000000,2023-04-01,21,235,KY,Whitley County,14183,13659,524,3.7
CN2123700000000,2023-04-01,21,237,KY,Wolfe County,2323,2217,106,4.6
CN2123900000000,2023-04-01,21,239,KY,Woodford County,14995,14633,362,2.4
CN2200100000000,2023-04-01,22,001,LA,Acadia Parish,24140,23391,749,3.1
CN2200300000000,2023-04-01,22,003,LA,Allen Parish,8365,8067,298,3.6
CN2200500000000,2023-04-01,22,005,LA,Ascension Parish,68693,66952,1741,2.5
CN2200700000000,2023-04-01,22,007,LA,Assumption Parish,8876,8521,355,4
CN2200900000000,2023-04-01,22,009,LA,Avoyelles Parish,14368,13840,528,3.7
CN2201100000000,2023-04-01,22,011,LA,Beauregard Parish,14942,14478,464,3.1
CN2201300000000,2023-04-01,22,013,LA,Bienville Parish,5254,5053,201,3.8
CN2201500000000,2023-04-01,22,015,LA,Bossier Parish,58746,57121,1625,2.8
CN2201700000000,2023-04-01,22,017,LA,Caddo Parish,102632,99008,3624,3.5
CN2201900000000,2023-04-01,22,019,LA,Calcasieu Parish,93286,90494,2792,3
CN2202100000000,2023-04-01,22,021,LA,Caldwell Parish,3734,3614,120,3.2
CN2202300000000,2023-04-01,22,023,LA,Cameron Parish,3473,3387,86,2.5
CN2202500000000,2023-04-01,22,025,LA,Catahoula Parish,3458,3325,133,3.8
CN2202700000000,2023-04-01,22,027,LA,Claiborne Parish,5437,5259,178,3.3
CN2202900000000,2023-04-01,22,029,LA,Concordia Parish,6946,6663,283,4.1
CN2203100000000,2023-04-01,22,031,LA,De Soto Parish,11041,10661,380,3.4
CN2203300000000,2023-04-01,22,033,LA,East Baton Rouge Parish,239318,232428,6890,2.9
CN2203500000000,2023-04-01,22,035,LA,East Carroll Parish,1711,1563,148,8.6
CN2203700000000,2023-04-01,22,037,LA,East Feliciana Parish,8115,7876,239,2.9
CN2203900000000,2023-04-01,22,039,LA,Evangeline Parish,12254,11843,411,3.4
CN2204100000000,2023-04-01,22,041,LA,Franklin Parish,7519,7146,373,5
CN2204300000000,2023-04-01,22,043,LA,Grant Parish,8448,8200,248,2.9
CN2204500000000,2023-04-01,22,045,LA,Iberia Parish,27876,26853,1023,3.7
CN2204700000000,2023-04-01,22,047,LA,Iberville Parish,14243,13733,510,3.6
CN2204900000000,2023-04-01,22,049,LA,Jackson Parish,7066,6860,206,2.9
CN2205100000000,2023-04-01,22,051,LA,Jefferson Parish,213165,206717,6448,3
CN2205300000000,2023-04-01,22,053,LA,Jefferson Davis Parish,12545,12142,403,3.2
CN2205500000000,2023-04-01,22,055,LA,Lafayette Parish,117523,114277,3246,2.8
CN2205700000000,2023-04-01,22,057,LA,Lafourche Parish,40545,39423,1122,2.8
CN2205900000000,2023-04-01,22,059,LA,LaSalle Parish,6774,6600,174,2.6
CN2206100000000,2023-04-01,22,061,LA,Lincoln Parish,21712,21046,666,3.1
CN2206300000000,2023-04-01,22,063,LA,Livingston Parish,73687,71838,1849,2.5
CN2206500000000,2023-04-01,22,065,LA,Madison Parish,3500,3327,173,4.9
CN2206700000000,2023-04-01,22,067,LA,Morehouse Parish,9871,9341,530,5.4
CN2206900000000,2023-04-01,22,069,LA,Natchitoches Parish,16909,16269,640,3.8
CN2207100000000,2023-04-01,22,071,LA,Orleans Parish,178703,171744,6959,3.9
CN2207300000000,2023-04-01,22,073,LA,Ouachita Parish,70962,68547,2415,3.4
CN2207500000000,2023-04-01,22,075,LA,Plaquemines Parish,9962,9689,273,2.7
CN2207700000000,2023-04-01,22,077,LA,Pointe Coupee Parish,10032,9736,296,3
CN2207900000000,2023-04-01,22,079,LA,Rapides Parish,57076,55423,1653,2.9
CN2208100000000,2023-04-01,22,081,LA,Red River Parish,3829,3712,117,3.1
CN2208300000000,2023-04-01,22,083,LA,Richland Parish,8257,7916,341,4.1
CN2208500000000,2023-04-01,22,085,LA,Sabine Parish,9242,8933,309,3.3
CN2208700000000,2023-04-01,22,087,LA,St. Bernard Parish,20305,19560,745,3.7
CN2208900000000,2023-04-01,22,089,LA,St. Charles Parish,25119,24426,693,2.8
CN2209100000000,2023-04-01,22,091,LA,St. Helena Parish,4371,4177,194,4.4
CN2209300000000,2023-04-01,22,093,LA,St. James Parish,9020,8675,345,3.8
CN2209500000000,2023-04-01,22,095,LA,St. John the Baptist Parish,19288,18497,791,4.1
CN2209700000000,2023-04-01,22,097,LA,St. Landry Parish,31875,30588,1287,4
CN2209900000000,2023-04-01,22,099,LA,St. Martin Parish,22301,21590,711,3.2
CN2210100000000,2023-04-01,22,101,LA,St. Mary Parish,19830,19100,730,3.7
CN2210300000000,2023-04-01,22,103,LA,St. Tammany Parish,121676,118315,3361,2.8
CN2210500000000,2023-04-01,22,105,LA,Tangipahoa Parish,57671,55506,2165,3.8
CN2210700000000,2023-04-01,22,107,LA,Tensas Parish,1290,1232,58,4.5
CN2210900000000,2023-04-01,22,109,LA,Terrebonne Parish,44556,43192,1364,3.1
CN2211100000000,2023-04-01,22,111,LA,Union Parish,9303,8959,344,3.7
CN2211300000000,2023-04-01,22,113,LA,Vermilion Parish,24350,23560,790,3.2
CN2211500000000,2023-04-01,22,115,LA,Vernon Parish,16603,15826,777,4.7
CN2211700000000,2023-04-01,22,117,LA,Washington Parish,16902,16274,628,3.7
CN2211900000000,2023-04-01,22,119,LA,Webster Parish,14315,13784,531,3.7
CN2212100000000,2023-04-01,22,121,LA,West Baton Rouge Parish,14392,13969,423,2.9
CN2212300000000,2023-04-01,22,123,LA,West Carroll Parish,3511,3294,217,6.2
CN2212500000000,2023-04-01,22,125,LA,West Feliciana Parish,5598,5471,127,2.3
CN2212700000000,2023-04-01,22,127,LA,Winn Parish,4638,4449,189,4.1
CN2300100000000,2023-04-01,23,001,ME,Androscoggin County,52970,51670,1300,2.5
CN2300300000000,2023-04-01,23,003,ME,Aroostook County,28108,26995,1113,4
CN2300500000000,2023-04-01,23,005,ME,Cumberland County,162692,159513,3179,2
CN2300700000000,2023-04-01,23,007,ME,Franklin County,13720,13263,457,3.3
CN2300900000000,2023-04-01,23,009,ME,Hancock County,27236,26436,800,2.9
CN2301100000000,2023-04-01,23,011,ME,Kennebec County,61261,59997,1264,2.1
CN2301300000000,2023-04-01,23,013,ME,Knox County,19468,19014,454,2.3
CN2301500000000,2023-04-01,23,015,ME,Lincoln County,16135,15751,384,2.4
CN2301700000000,2023-04-01,23,017,ME,Oxford County,25528,24878,650,2.5
CN2301900000000,2023-04-01,23,019,ME,Penobscot County,74858,73019,1839,2.5
CN2302100000000,2023-04-01,23,021,ME,Piscataquis County,7233,6948,285,3.9
CN2302300000000,2023-04-01,23,023,ME,Sagadahoc County,18924,18572,352,1.9
CN2302500000000,2023-04-01,23,025,ME,Somerset County,21731,20890,841,3.9
CN2302700000000,2023-04-01,23,027,ME,Waldo County,20096,19602,494,2.5
CN2302900000000,2023-04-01,23,029,ME,Washington County,13056,12556,500,3.8
CN2303100000000,2023-04-01,23,031,ME,York County,112231,109974,2257,2
CN2400100000000,2023-04-01,24,001,MD,Allegany County,31497,30731,766,2.4
CN2400300000000,2023-04-01,24,003,MD,Anne Arundel County,314070,309122,4948,1.6
CN2400500000000,2023-04-01,24,005,MD,Baltimore County,444353,435757,8596,1.9
CN2400900000000,2023-04-01,24,009,MD,Calvert County,49731,48921,810,1.6
CN2401100000000,2023-04-01,24,011,MD,Caroline County,17647,17341,306,1.7
CN2401300000000,2023-04-01,24,013,MD,Carroll County,94444,93099,1345,1.4
CN2401500000000,2023-04-01,24,015,MD,Cecil County,54550,53521,1029,1.9
CN2401700000000,2023-04-01,24,017,MD,Charles County,87000,85370,1630,1.9
CN2401900000000,2023-04-01,24,019,MD,Dorchester County,15617,15286,331,2.1
CN2402100000000,2023-04-01,24,021,MD,Frederick County,137046,134759,2287,1.7
CN2402300000000,2023-04-01,24,023,MD,Garrett County,14758,14468,290,2
CN2402500000000,2023-04-01,24,025,MD,Harford County,139896,137516,2380,1.7
CN2402700000000,2023-04-01,24,027,MD,Howard County,188056,185341,2715,1.4
CN2402900000000,2023-04-01,24,029,MD,Kent County,9765,9564,201,2.1
CN2403100000000,2023-04-01,24,031,MD,Montgomery County,554134,545305,8829,1.6
CN2403300000000,2023-04-01,24,033,MD,Prince George's County,499164,489177,9987,2
CN2403500000000,2023-04-01,24,035,MD,Queen Anne's County,27805,27396,409,1.5
CN2403700000000,2023-04-01,24,037,MD,St. Mary's County,57394,56454,940,1.6
CN2403900000000,2023-04-01,24,039,MD,Somerset County,8707,8455,252,2.9
CN2404100000000,2023-04-01,24,041,MD,Talbot County,17483,17179,304,1.7
CN2404300000000,2023-04-01,24,043,MD,Washington County,70848,69413,1435,2
CN2404500000000,2023-04-01,24,045,MD,Wicomico County,50515,49319,1196,2.4
CN2404700000000,2023-04-01,24,047,MD,Worcester County,24759,24002,757,3.1
CN2451000000000,2023-04-01,24,510,MD,Baltimore city,273165,266011,7154,2.6
CN2500100000000,2023-04-01,25,001,MA,Barnstable County,107833,104243,3590,3.3
CN2500300000000,2023-04-01,25,003,MA,Berkshire County,59409,57770,1639,2.8
CN2500500000000,2023-04-01,25,005,MA,Bristol County,292089,283040,9049,3.1
CN2500700000000,2023-04-01,25,007,MA,Dukes County,8737,8382,355,4.1
CN2500900000000,2023-04-01,25,009,MA,Essex County,417067,406200,10867,2.6
CN2501100000000,2023-04-01,25,011,MA,Franklin County,39633,38797,836,2.1
CN2501300000000,2023-04-01,25,013,MA,Hampden County,220208,213517,6691,3
CN2501500000000,2023-04-01,25,015,MA,Hampshire County,88270,86644,1626,1.8
CN2501700000000,2023-04-01,25,017,MA,Middlesex County,907652,889561,18091,2
CN2501900000000,2023-04-01,25,019,MA,Nantucket County/town,7078,6665,413,5.8
CN2502100000000,2023-04-01,25,021,MA,Norfolk County,392200,383564,8636,2.2
CN2502300000000,2023-04-01,25,023,MA,Plymouth County,281342,273913,7429,2.6
CN2502500000000,2023-04-01,25,025,MA,Suffolk County,452049,441943,10106,2.2
CN2502700000000,2023-04-01,25,027,MA,Worcester County,436338,425229,11109,2.5
CN2600100000000,2023-04-01,26,001,MI,Alcona County,3865,3614,251,6.5
CN2600300000000,2023-04-01,26,003,MI,Alger County,3151,2842,309,9.8
CN2600500000000,2023-04-01,26,005,MI,Allegan County,63322,61556,1766,2.8
CN2600700000000,2023-04-01,26,007,MI,Alpena County,13498,12927,571,4.2
CN2600900000000,2023-04-01,26,009,MI,Antrim County,9862,9327,535,5.4
CN2601100000000,2023-04-01,26,011,MI,Arenac County,5887,5508,379,6.4
CN2601300000000,2023-04-01,26,013,MI,Baraga County,3089,2877,212,6.9
CN2601500000000,2023-04-01,26,015,MI,Barry County,32773,31805,968,3
CN2601700000000,2023-04-01,26,017,MI,Bay County,50187,48010,2177,4.3
CN2601900000000,2023-04-01,26,019,MI,Benzie County,8792,8347,445,5.1
CN2602100000000,2023-04-01,26,021,MI,Berrien County,73537,71045,2492,3.4
CN2602300000000,2023-04-01,26,023,MI,Branch County,19991,19361,630,3.2
CN2602500000000,2023-04-01,26,025,MI,Calhoun County,60842,58602,2240,3.7
CN2602700000000,2023-04-01,26,027,MI,Cass County,23914,23072,842,3.5
CN2602900000000,2023-04-01,26,029,MI,Charlevoix County,12291,11714,577,4.7
CN2603100000000,2023-04-01,26,031,MI,Cheboygan County,9697,8753,944,9.7
CN2603300000000,2023-04-01,26,033,MI,Chippewa County,16078,15070,1008,6.3
CN2603500000000,2023-04-01,26,035,MI,Clare County,11364,10676,688,6.1
CN2603700000000,2023-04-01,26,037,MI,Clinton County,41784,40650,1134,2.7
CN2603900000000,2023-04-01,26,039,MI,Crawford County,5519,5196,323,5.9
CN2604100000000,2023-04-01,26,041,MI,Delta County,16709,15904,805,4.8
CN2604300000000,2023-04-01,26,043,MI,Dickinson County,12018,11570,448,3.7
CN2604500000000,2023-04-01,26,045,MI,Eaton County,58060,56399,1661,2.9
CN2604700000000,2023-04-01,26,047,MI,Emmet County,16151,15092,1059,6.6
CN2604900000000,2023-04-01,26,049,MI,Genesee County,182028,174174,7854,4.3
CN2605100000000,2023-04-01,26,051,MI,Gladwin County,10154,9589,565,5.6
CN2605300000000,2023-04-01,26,053,MI,Gogebic County,5745,5455,290,5
CN2605500000000,2023-04-01,26,055,MI,Grand Traverse County,49435,47947,1488,3
CN2605700000000,2023-04-01,26,057,MI,Gratiot County,17859,17177,682,3.8
CN2605900000000,2023-04-01,26,059,MI,Hillsdale County,20304,19626,678,3.3
CN2606100000000,2023-04-01,26,061,MI,Houghton County,16634,15856,778,4.7
CN2606300000000,2023-04-01,26,063,MI,Huron County,14774,14188,586,4
CN2606500000000,2023-04-01,26,065,MI,Ingham County,151951,147366,4585,3
CN2606700000000,2023-04-01,26,067,MI,Ionia County,31062,30159,903,2.9
CN2606900000000,2023-04-01,26,069,MI,Iosco County,10348,9773,575,5.6
CN2607100000000,2023-04-01,26,071,MI,Iron County,4622,4327,295,6.4
CN2607300000000,2023-04-01,26,073,MI,Isabella County,32321,31154,1167,3.6
CN2607500000000,2023-04-01,26,075,MI,Jackson County,75343,72889,2454,3.3
CN2607700000000,2023-04-01,26,077,MI,Kalamazoo County,135128,131150,3978,2.9
CN2607900000000,2023-04-01,26,079,MI,Kalkaska County,7894,7456,438,5.5
CN2608100000000,2023-04-01,26,081,MI,Kent County,371085,361577,9508,2.6
CN2608300000000,2023-04-01,26,083,MI,Keweenaw County,941,870,71,7.5
CN2608500000000,2023-04-01,26,085,MI,Lake County,4019,3755,264,6.6
CN2608700000000,2023-04-01,26,087,MI,Lapeer County,39700,38747,953,2.4
CN2608900000000,2023-04-01,26,089,MI,Leelanau County,10294,9939,355,3.4
CN2609100000000,2023-04-01,26,091,MI,Lenawee County,45214,43618,1596,3.5
CN2609300000000,2023-04-01,26,093,MI,Livingston County,102149,100609,1540,1.5
CN2609500000000,2023-04-01,26,095,MI,Luce County,1997,1849,148,7.4
CN2609700000000,2023-04-01,26,097,MI,Mackinac County,4462,3863,599,13.4
CN2609900000000,2023-04-01,26,099,MI,Macomb County,436079,427541,8538,2
CN2610100000000,2023-04-01,26,101,MI,Manistee County,9742,9233,509,5.2
CN2610300000000,2023-04-01,26,103,MI,Marquette County,32668,31171,1497,4.6
CN2610500000000,2023-04-01,26,105,MI,Mason County,13183,12621,562,4.3
CN2610700000000,2023-04-01,26,107,MI,Mecosta County,19153,18314,839,4.4
CN2610900000000,2023-04-01,26,109,MI,Menominee County,10791,10377,414,3.8
CN2611100000000,2023-04-01,26,111,MI,Midland County,40867,39490,1377,3.4
CN2611300000000,2023-04-01,26,113,MI,Missaukee County,6880,6538,342,5
CN2611500000000,2023-04-01,26,115,MI,Monroe County,75866,73339,2527,3.3
CN2611700000000,2023-04-01,26,117,MI,Montcalm County,28643,27593,1050,3.7
CN2611900000000,2023-04-01,26,119,MI,Montmorency County,3086,2864,222,7.2
CN2612100000000,2023-04-01,26,121,MI,Muskegon County,77843,74926,2917,3.7
CN2612300000000,2023-04-01,26,123,MI,Newaygo County,23920,23038,882,3.7
CN2612500000000,2023-04-01,26,125,MI,Oakland County,660409,649923,10486,1.6
CN2612700000000,2023-04-01,26,127,MI,Oceana County,11299,10694,605,5.4
CN2612900000000,2023-04-01,26,129,MI,Ogemaw County,8319,7782,537,6.5
CN2613100000000,2023-04-01,26,131,MI,Ontonagon County,2015,1842,173,8.6
CN2613300000000,2023-04-01,26,133,MI,Osceola County,11834,11352,482,4.1
CN2613500000000,2023-04-01,26,135,MI,Oscoda County,2674,2481,193,7.2
CN2613700000000,2023-04-01,26,137,MI,Otsego County,11567,11006,561,4.9
CN2613900000000,2023-04-01,26,139,MI,Ottawa County,166668,162769,3899,2.3
CN2614100000000,2023-04-01,26,141,MI,Presque Isle County,4966,4617,349,7
CN2614300000000,2023-04-01,26,143,MI,Roscommon County,7914,7294,620,7.8
CN2614500000000,2023-04-01,26,145,MI,Saginaw County,84266,80445,3821,4.5
CN2614700000000,2023-04-01,26,147,MI,St. Clair County,73565,71981,1584,2.2
CN2614900000000,2023-04-01,26,149,MI,St. Joseph County,28785,27796,989,3.4
CN2615100000000,2023-04-01,26,151,MI,Sanilac County,18912,18053,859,4.5
CN2615300000000,2023-04-01,26,153,MI,Schoolcraft County,3178,2927,251,7.9
CN2615500000000,2023-04-01,26,155,MI,Shiawassee County,32985,31768,1217,3.7
CN2615700000000,2023-04-01,26,157,MI,Tuscola County,23267,22209,1058,4.5
CN2615900000000,2023-04-01,26,159,MI,Van Buren County,35020,33602,1418,4
CN2616100000000,2023-04-01,26,161,MI,Washtenaw County,204182,199174,5008,2.5
CN2616300000000,2023-04-01,26,163,MI,Wayne County,781500,762741,18759,2.4
CN2616500000000,2023-04-01,26,165,MI,Wexford County,14973,14268,705,4.7
CN2700100000000,2023-04-01,27,001,MN,Aitkin County,7489,7044,445,5.9
CN2700300000000,2023-04-01,27,003,MN,Anoka County,199656,194141,5515,2.8
CN2700500000000,2023-04-01,27,005,MN,Becker County,19577,18867,710,3.6
CN2700700000000,2023-04-01,27,007,MN,Beltrami County,25244,24228,1016,4
CN2700900000000,2023-04-01,27,009,MN,Benton County,21916,21056,860,3.9
CN2701100000000,2023-04-01,27,011,MN,Big Stone County,2294,2209,85,3.7
CN2701300000000,2023-04-01,27,013,MN,Blue Earth County,41564,40586,978,2.4
CN2701500000000,2023-04-01,27,015,MN,Brown County,13518,13069,449,3.3
CN2701700000000,2023-04-01,27,017,MN,Carlton County,17701,16914,787,4.4
CN2701900000000,2023-04-01,27,019,MN,Carver County,59625,58164,1461,2.5
CN2702100000000,2023-04-01,27,021,MN,Cass County,14355,13573,782,5.4
CN2702300000000,2023-04-01,27,023,MN,Chippewa County,6349,6175,174,2.7
CN2702500000000,2023-04-01,27,025,MN,Chisago County,30241,29118,1123,3.7
CN2702700000000,2023-04-01,27,027,MN,Clay County,37828,36962,866,2.3
CN2702900000000,2023-04-01,27,029,MN,Clearwater County,4578,4199,379,8.3
CN2703100000000,2023-04-01,27,031,MN,Cook County,2639,2499,140,5.3
CN2703300000000,2023-04-01,27,033,MN,Cottonwood County,6698,6529,169,2.5
CN2703500000000,2023-04-01,27,035,MN,Crow Wing County,33530,32227,1303,3.9
CN2703700000000,2023-04-01,27,037,MN,Dakota County,243360,237304,6056,2.5
CN2703900000000,2023-04-01,27,039,MN,Dodge County,12026,11647,379,3.2
CN2704100000000,2023-04-01,27,041,MN,Douglas County,21459,20861,598,2.8
CN2704300000000,2023-04-01,27,043,MN,Faribault County,6897,6674,223,3.2
CN2704500000000,2023-04-01,27,045,MN,Fillmore County,11448,11113,335,2.9
CN2704700000000,2023-04-01,27,047,MN,Freeborn County,15749,15358,391,2.5
CN2704900000000,2023-04-01,27,049,MN,Goodhue County,26482,25762,720,2.7
CN2705100000000,2023-04-01,27,051,MN,Grant County,3263,3147,116,3.6
CN2705300000000,2023-04-01,27,053,MN,Hennepin County,707301,689902,17399,2.5
CN2705500000000,2023-04-01,27,055,MN,Houston County,10605,10341,264,2.5
CN2705700000000,2023-04-01,27,057,MN,Hubbard County,10015,9531,484,4.8
CN2705900000000,2023-04-01,27,059,MN,Isanti County,22007,21060,947,4.3
CN2706100000000,2023-04-01,27,061,MN,Itasca County,21442,20250,1192,5.6
CN2706300000000,2023-04-01,27,063,MN,Jackson County,5324,5172,152,2.9
CN2706500000000,2023-04-01,27,065,MN,Kanabec County,9340,8737,603,6.5
CN2706700000000,2023-04-01,27,067,MN,Kandiyohi County,22895,22114,781,3.4
CN2706900000000,2023-04-01,27,069,MN,Kittson County,2175,2104,71,3.3
CN2707100000000,2023-04-01,27,071,MN,Koochiching County,5678,5354,324,5.7
CN2707300000000,2023-04-01,27,073,MN,Lac qui Parle County,3359,3261,98,2.9
CN2707500000000,2023-04-01,27,075,MN,Lake County,5027,4814,213,4.2
CN2707700000000,2023-04-01,27,077,MN,Lake of the Woods County,2293,2203,90,3.9
CN2707900000000,2023-04-01,27,079,MN,Le Sueur County,16140,15335,805,5
CN2708100000000,2023-04-01,27,081,MN,Lincoln County,2941,2826,115,3.9
CN2708300000000,2023-04-01,27,083,MN,Lyon County,14325,13936,389,2.7
CN2708500000000,2023-04-01,27,085,MN,McLeod County,19310,18630,680,3.5
CN2708700000000,2023-04-01,27,087,MN,Mahnomen County,2320,2177,143,6.2
CN2708900000000,2023-04-01,27,089,MN,Marshall County,5307,5035,272,5.1
CN2709100000000,2023-04-01,27,091,MN,Martin County,9459,9186,273,2.9
CN2709300000000,2023-04-01,27,093,MN,Meeker County,13694,13173,521,3.8
CN2709500000000,2023-04-01,27,095,MN,Mille Lacs County,12938,12132,806,6.2
CN2709700000000,2023-04-01,27,097,MN,Morrison County,17296,16348,948,5.5
CN2709900000000,2023-04-01,27,099,MN,Mower County,20766,20217,549,2.6
CN2710100000000,2023-04-01,27,101,MN,Murray County,4595,4390,205,4.5
CN2710300000000,2023-04-01,27,103,MN,Nicollet County,21307,20831,476,2.2
CN2710500000000,2023-04-01,27,105,MN,Nobles County,10779,10521,258,2.4
CN2710700000000,2023-04-01,27,107,MN,Norman County,3120,2999,121,3.9
CN2710900000000,2023-04-01,27,109,MN,Olmsted County,92092,90147,1945,2.1
CN2711100000000,2023-04-01,27,111,MN,Otter Tail County,31047,29831,1216,3.9
CN2711300000000,2023-04-01,27,113,MN,Pennington County,8703,8407,296,3.4
CN2711500000000,2023-04-01,27,115,MN,Pine County,14412,13490,922,6.4
CN2711700000000,2023-04-01,27,117,MN,Pipestone County,4610,4450,160,3.5
CN2711900000000,2023-04-01,27,119,MN,Polk County,16178,15668,510,3.2
CN2712100000000,2023-04-01,27,121,MN,Pope County,6449,6241,208,3.2
CN2712300000000,2023-04-01,27,123,MN,Ramsey County,286323,278848,7475,2.6
CN2712500000000,2023-04-01,27,125,MN,Red Lake County,2171,2063,108,5
CN2712700000000,2023-04-01,27,127,MN,Redwood County,7480,7255,225,3
CN2712900000000,2023-04-01,27,129,MN,Renville County,7824,7492,332,4.2
CN2713100000000,2023-04-01,27,131,MN,Rice County,37710,36714,996,2.6
CN2713300000000,2023-04-01,27,133,MN,Rock County,5956,5851,105,1.8
CN2713500000000,2023-04-01,27,135,MN,Roseau County,7778,7579,199,2.6
CN2713700000000,2023-04-01,27,137,MN,St. Louis County,100334,96874,3460,3.4
CN2713900000000,2023-04-01,27,139,MN,Scott County,84858,82730,2128,2.5
CN2714100000000,2023-04-01,27,141,MN,Sherburne County,53596,51772,1824,3.4
CN2714300000000,2023-04-01,27,143,MN,Sibley County,8035,7729,306,3.8
CN2714500000000,2023-04-01,27,145,MN,Stearns County,90261,87678,2583,2.9
CN2714700000000,2023-04-01,27,147,MN,Steele County,18499,17927,572,3.1
CN2714900000000,2023-04-01,27,149,MN,Stevens County,5239,5099,140,2.7
CN2715100000000,2023-04-01,27,151,MN,Swift County,4721,4561,160,3.4
CN2715300000000,2023-04-01,27,153,MN,Todd County,13598,13027,571,4.2
CN2715500000000,2023-04-01,27,155,MN,Traverse County,1597,1543,54,3.4
CN2715700000000,2023-04-01,27,157,MN,Wabasha County,12200,11856,344,2.8
CN2715900000000,2023-04-01,27,159,MN,Wadena County,6232,5911,321,5.2
CN2716100000000,2023-04-01,27,161,MN,Waseca County,8394,8051,343,4.1
CN2716300000000,2023-04-01,27,163,MN,Washington County,145486,141992,3494,2.4
CN2716500000000,2023-04-01,27,165,MN,Watonwan County,6473,6271,202,3.1
CN2716700000000,2023-04-01,27,167,MN,Wilkin County,3356,3276,80,2.4
CN2716900000000,2023-04-01,27,169,MN,Winona County,28644,28023,621,2.2
CN2717100000000,2023-04-01,27,171,MN,Wright County,77258,74824,2434,3.2
CN2717300000000,2023-04-01,27,173,MN,Yellow Medicine County,4896,4759,137,2.8
CN2800100000000,2023-04-01,28,001,MS,Adams County,10490,10084,406,3.9
CN2800300000000,2023-04-01,28,003,MS,Alcorn County,15130,14743,387,2.6
CN2800500000000,2023-04-01,28,005,MS,Amite County,4233,4093,140,3.3
CN2800700000000,2023-04-01,28,007,MS,Attala County,6851,6647,204,3
CN2800900000000,2023-04-01,28,009,MS,Benton County,3024,2923,101,3.3
CN2801100000000,2023-04-01,28,011,MS,Bolivar County,11010,10659,351,3.2
CN2801300000000,2023-04-01,28,013,MS,Calhoun County,5327,5171,156,2.9
CN2801500000000,2023-04-01,28,015,MS,Carroll County,3204,3104,100,3.1
CN2801700000000,2023-04-01,28,017,MS,Chickasaw County,6344,6107,237,3.7
CN2801900000000,2023-04-01,28,019,MS,Choctaw County,3547,3464,83,2.3
CN2802100000000,2023-04-01,28,021,MS,Claiborne County,2833,2667,166,5.9
CN2802300000000,2023-04-01,28,023,MS,Clarke County,5535,5370,165,3
CN2802500000000,2023-04-01,28,025,MS,Clay County,9117,8871,246,2.7
CN2802700000000,2023-04-01,28,027,MS,Coahoma County,7429,7110,319,4.3
CN2802900000000,2023-04-01,28,029,MS,Copiah County,10874,10537,337,3.1
CN2803100000000,2023-04-01,28,031,MS,Covington County,8182,7981,201,2.5
CN2803300000000,2023-04-01,28,033,MS,DeSoto County,93317,91116,2201,2.4
CN2803500000000,2023-04-01,28,035,MS,Forrest County,33421,32570,851,2.5
CN2803700000000,2023-04-01,28,037,MS,Franklin County,2573,2471,102,4
CN2803900000000,2023-04-01,28,039,MS,George County,8751,8451,300,3.4
CN2804100000000,2023-04-01,28,041,MS,Greene County,4157,4012,145,3.5
CN2804300000000,2023-04-01,28,043,MS,Grenada County,8348,8112,236,2.8
CN2804500000000,2023-04-01,28,045,MS,Hancock County,18910,18361,549,2.9
CN2804700000000,2023-04-01,28,047,MS,Harrison County,87510,85308,2202,2.5
CN2804900000000,2023-04-01,28,049,MS,Hinds County,102718,99999,2719,2.6
CN2805100000000,2023-04-01,28,051,MS,Holmes County,5080,4843,237,4.7
CN2805300000000,2023-04-01,28,053,MS,Humphreys County,1943,1842,101,5.2
CN2805500000000,2023-04-01,28,055,MS,Issaquena County,318,289,29,9.1
CN2805700000000,2023-04-01,28,057,MS,Itawamba County,10158,9893,265,2.6
CN2805900000000,2023-04-01,28,059,MS,Jackson County,58668,57037,1631,2.8
CN2806100000000,2023-04-01,28,061,MS,Jasper County,5885,5698,187,3.2
CN2806300000000,2023-04-01,28,063,MS,Jefferson County,1797,1638,159,8.8
CN2806500000000,2023-04-01,28,065,MS,Jefferson Davis County,3913,3783,130,3.3
CN2806700000000,2023-04-01,28,067,MS,Jones County,25166,24466,700,2.8
CN2806900000000,2023-04-01,28,069,MS,Kemper County,3206,3089,117,3.6
CN2807100000000,2023-04-01,28,071,MS,Lafayette County,28531,27919,612,2.1
CN2807300000000,2023-04-01,28,073,MS,Lamar County,31890,31209,681,2.1
CN2807500000000,2023-04-01,28,075,MS,Lauderdale County,28709,27925,784,2.7
CN2807700000000,2023-04-01,28,077,MS,Lawrence County,4805,4654,151,3.1
CN2807900000000,2023-04-01,28,079,MS,Leake County,7961,7752,209,2.6
CN2808100000000,2023-04-01,28,081,MS,Lee County,40283,39332,951,2.4
CN2808300000000,2023-04-01,28,083,MS,Leflore County,9040,8678,362,4
CN2808500000000,2023-04-01,28,085,MS,Lincoln County,14450,14082,368,2.5
CN2808700000000,2023-04-01,28,087,MS,Lowndes County,24752,24080,672,2.7
CN2808900000000,2023-04-01,28,089,MS,Madison County,53955,52786,1169,2.2
CN2809100000000,2023-04-01,28,091,MS,Marion County,9831,9562,269,2.7
CN2809300000000,2023-04-01,28,093,MS,Marshall County,14124,13699,425,3
CN2809500000000,2023-04-01,28,095,MS,Monroe County,15282,14723,559,3.7
CN2809700000000,2023-04-01,28,097,MS,Montgomery County,3863,3752,111,2.9
CN2809900000000,2023-04-01,28,099,MS,Neshoba County,9670,9386,284,2.9
CN2810100000000,2023-04-01,28,101,MS,Newton County,7959,7723,236,3
CN2810300000000,2023-04-01,28,103,MS,Noxubee County,3327,3195,132,4
CN2810500000000,2023-04-01,28,105,MS,Oktibbeha County,22480,21865,615,2.7
CN2810700000000,2023-04-01,28,107,MS,Panola County,12115,11703,412,3.4
CN2810900000000,2023-04-01,28,109,MS,Pearl River County,23516,22897,619,2.6
CN2811100000000,2023-04-01,28,111,MS,Perry County,4238,4109,129,3
CN2811300000000,2023-04-01,28,113,MS,Pike County,13846,13393,453,3.3
CN2811500000000,2023-04-01,28,115,MS,Pontotoc County,14636,14298,338,2.3
CN2811700000000,2023-04-01,28,117,MS,Prentiss County,11337,11071,266,2.3
CN2811900000000,2023-04-01,28,119,MS,Quitman County,2272,2180,92,4
CN2812100000000,2023-04-01,28,121,MS,Rankin County,77597,76041,1556,2
CN2812300000000,2023-04-01,28,123,MS,Scott County,12158,11888,270,2.2
CN2812500000000,2023-04-01,28,125,MS,Sharkey County,1364,1232,132,9.7
CN2812700000000,2023-04-01,28,127,MS,Simpson County,10688,10418,270,2.5
CN2812900000000,2023-04-01,28,129,MS,Smith County,6632,6474,158,2.4
CN2813100000000,2023-04-01,28,131,MS,Stone County,7044,6840,204,2.9
CN2813300000000,2023-04-01,28,133,MS,Sunflower County,7155,6860,295,4.1
CN2813500000000,2023-04-01,28,135,MS,Tallahatchie County,4541,4401,140,3.1
CN2813700000000,2023-04-01,28,137,MS,Tate County,12060,11714,346,2.9
CN2813900000000,2023-04-01,28,139,MS,Tippah County,9803,9572,231,2.4
CN2814100000000,2023-04-01,28,141,MS,Tishomingo County,8783,8530,253,2.9
CN2814300000000,2023-04-01,28,143,MS,Tunica County,4157,4016,141,3.4
CN2814500000000,2023-04-01,28,145,MS,Union County,14708,14424,284,1.9
CN2814700000000,2023-04-01,28,147,MS,Walthall County,4858,4686,172,3.5
CN2814900000000,2023-04-01,28,149,MS,Warren County,19063,18507,556,2.9
CN2815100000000,2023-04-01,28,151,MS,Washington County,14322,13694,628,4.4
CN2815300000000,2023-04-01,28,153,MS,Wayne County,6893,6681,212,3.1
CN2815500000000,2023-04-01,28,155,MS,Webster County,3865,3763,102,2.6
CN2815700000000,2023-04-01,28,157,MS,Wilkinson County,2569,2455,114,4.4
CN2815900000000,2023-04-01,28,159,MS,Winston County,7115,6920,195,2.7
CN2816100000000,2023-04-01,28,161,MS,Yalobusha County,4686,4536,150,3.2
CN2816300000000,2023-04-01,28,163,MS,Yazoo County,8887,8634,253,2.8
CN2900100000000,2023-04-01,29,001,MO,Adair County,9993,9734,259,2.6
CN2900300000000,2023-04-01,29,003,MO,Andrew County,9529,9342,187,2
CN2900500000000,2023-04-01,29,005,MO,Atchison County,2593,2537,56,2.2
CN2900700000000,2023-04-01,29,007,MO,Audrain County,9821,9552,269,2.7
CN2900900000000,2023-04-01,29,009,MO,Barry County,14360,13985,375,2.6
CN2901100000000,2023-04-01,29,011,MO,Barton County,5326,5211,115,2.2
CN2901300000000,2023-04-01,29,013,MO,Bates County,7871,7672,199,2.5
CN2901500000000,2023-04-01,29,015,MO,Benton County,7421,7168,253,3.4
CN2901700000000,2023-04-01,29,017,MO,Bollinger County,5405,5284,121,2.2
CN2901900000000,2023-04-01,29,019,MO,Boone County,102996,100997,1999,1.9
CN2902100000000,2023-04-01,29,021,MO,Buchanan County,42704,41712,992,2.3
CN2902300000000,2023-04-01,29,023,MO,Butler County,17677,17085,592,3.3
CN2902500000000,2023-04-01,29,025,MO,Caldwell County,4369,4264,105,2.4
CN2902700000000,2023-04-01,29,027,MO,Callaway County,22332,21859,473,2.1
CN2902900000000,2023-04-01,29,029,MO,Camden County,19184,18600,584,3
CN2903100000000,2023-04-01,29,031,MO,Cape Girardeau County,41390,40496,894,2.2
CN2903300000000,2023-04-01,29,033,MO,Carroll County,4505,4399,106,2.4
CN2903500000000,2023-04-01,29,035,MO,Carter County,2448,2365,83,3.4
CN2903700000000,2023-04-01,29,037,MO,Cass County,56630,55320,1310,2.3
CN2903900000000,2023-04-01,29,039,MO,Cedar County,5867,5708,159,2.7
CN2904100000000,2023-04-01,29,041,MO,Chariton County,3792,3716,76,2
CN2904300000000,2023-04-01,29,043,MO,Christian County,48614,47649,965,2
CN2904500000000,2023-04-01,29,045,MO,Clark County,3016,2925,91,3
CN2904700000000,2023-04-01,29,047,MO,Clay County,142601,139569,3032,2.1
CN2904900000000,2023-04-01,29,049,MO,Clinton County,10907,10660,247,2.3
CN2905100000000,2023-04-01,29,051,MO,Cole County,40576,39793,783,1.9
CN2905300000000,2023-04-01,29,053,MO,Cooper County,7259,7094,165,2.3
CN2905500000000,2023-04-01,29,055,MO,Crawford County,10883,10595,288,2.6
CN2905700000000,2023-04-01,29,057,MO,Dade County,3480,3392,88,2.5
CN2905900000000,2023-04-01,29,059,MO,Dallas County,7399,7217,182,2.5
CN2906100000000,2023-04-01,29,061,MO,Daviess County,4139,4053,86,2.1
CN2906300000000,2023-04-01,29,063,MO,DeKalb County,4082,3997,85,2.1
CN2906500000000,2023-04-01,29,065,MO,Dent County,6174,5996,178,2.9
CN2906700000000,2023-04-01,29,067,MO,Douglas County,5324,5186,138,2.6
CN2906900000000,2023-04-01,29,069,MO,Dunklin County,11183,10705,478,4.3
CN2907100000000,2023-04-01,29,071,MO,Franklin County,54000,52774,1226,2.3
CN2907300000000,2023-04-01,29,073,MO,Gasconade County,7724,7565,159,2.1
CN2907500000000,2023-04-01,29,075,MO,Gentry County,3239,3177,62,1.9
CN2907700000000,2023-04-01,29,077,MO,Greene County,159168,155843,3325,2.1
CN2907900000000,2023-04-01,29,079,MO,Grundy County,4118,4027,91,2.2
CN2908100000000,2023-04-01,29,081,MO,Harrison County,3779,3686,93,2.5
CN2908300000000,2023-04-01,29,083,MO,Henry County,10576,10332,244,2.3
CN2908500000000,2023-04-01,29,085,MO,Hickory County,4181,4066,115,2.8
CN2908700000000,2023-04-01,29,087,MO,Holt County,2516,2470,46,1.8
CN2908900000000,2023-04-01,29,089,MO,Howard County,4802,4696,106,2.2
CN2909100000000,2023-04-01,29,091,MO,Howell County,16296,15815,481,3
CN2909300000000,2023-04-01,29,093,MO,Iron County,3495,3355,140,4
CN2909500000000,2023-04-01,29,095,MO,Jackson County,370910,360686,10224,2.8
CN2909700000000,2023-04-01,29,097,MO,Jasper County,58246,56833,1413,2.4
CN2909900000000,2023-04-01,29,099,MO,Jefferson County,120377,117626,2751,2.3
CN2910100000000,2023-04-01,29,101,MO,Johnson County,23548,22959,589,2.5
CN2910300000000,2023-04-01,29,103,MO,Knox County,1747,1706,41,2.3
CN2910500000000,2023-04-01,29,105,MO,Laclede County,17020,16609,411,2.4
CN2910700000000,2023-04-01,29,107,MO,Lafayette County,17231,16846,385,2.2
CN2910900000000,2023-04-01,29,109,MO,Lawrence County,17563,17155,408,2.3
CN2911100000000,2023-04-01,29,111,MO,Lewis County,4839,4724,115,2.4
CN2911300000000,2023-04-01,29,113,MO,Lincoln County,29828,29121,707,2.4
CN2911500000000,2023-04-01,29,115,MO,Linn County,5198,5058,140,2.7
CN2911700000000,2023-04-01,29,117,MO,Livingston County,7249,7112,137,1.9
CN2911900000000,2023-04-01,29,119,MO,McDonald County,11520,11265,255,2.2
CN2912100000000,2023-04-01,29,121,MO,Macon County,7159,6981,178,2.5
CN2912300000000,2023-04-01,29,123,MO,Madison County,5457,5304,153,2.8
CN2912500000000,2023-04-01,29,125,MO,Maries County,3919,3825,94,2.4
CN2912700000000,2023-04-01,29,127,MO,Marion County,13878,13526,352,2.5
CN2912900000000,2023-04-01,29,129,MO,Mercer County,1760,1725,35,2
CN2913100000000,2023-04-01,29,131,MO,Miller County,13224,12902,322,2.4
CN2913300000000,2023-04-01,29,133,MO,Mississippi County,5197,5035,162,3.1
CN2913500000000,2023-04-01,29,135,MO,Moniteau County,7320,7177,143,2
CN2913700000000,2023-04-01,29,137,MO,Monroe County,3866,3767,99,2.6
CN2913900000000,2023-04-01,29,139,MO,Montgomery County,5969,5831,138,2.3
CN2914100000000,2023-04-01,29,141,MO,Morgan County,8570,8320,250,2.9
CN2914300000000,2023-04-01,29,143,MO,New Madrid County,8299,8073,226,2.7
CN2914500000000,2023-04-01,29,145,MO,Newton County,27568,26915,653,2.4
CN2914700000000,2023-04-01,29,147,MO,Nodaway County,11549,11324,225,1.9
CN2914900000000,2023-04-01,29,149,MO,Oregon County,3883,3774,109,2.8
CN2915100000000,2023-04-01,29,151,MO,Osage County,7301,7166,135,1.8
CN2915300000000,2023-04-01,29,153,MO,Ozark County,3478,3364,114,3.3
CN2915500000000,2023-04-01,29,155,MO,Pemiscot County,5788,5585,203,3.5
CN2915700000000,2023-04-01,29,157,MO,Perry County,9522,9338,184,1.9
CN2915900000000,2023-04-01,29,159,MO,Pettis County,20357,19894,463,2.3
CN2916100000000,2023-04-01,29,161,MO,Phelps County,20545,20055,490,2.4
CN2916300000000,2023-04-01,29,163,MO,Pike County,7368,7175,193,2.6
CN2916500000000,2023-04-01,29,165,MO,Platte County,61780,60523,1257,2
CN2916700000000,2023-04-01,29,167,MO,Polk County,15112,14745,367,2.4
CN2916900000000,2023-04-01,29,169,MO,Pulaski County,14983,14560,423,2.8
CN2917100000000,2023-04-01,29,171,MO,Putnam County,2177,2125,52,2.4
CN2917300000000,2023-04-01,29,173,MO,Ralls County,5460,5336,124,2.3
CN2917500000000,2023-04-01,29,175,MO,Randolph County,10550,10283,267,2.5
CN2917700000000,2023-04-01,29,177,MO,Ray County,11126,10868,258,2.3
CN2917900000000,2023-04-01,29,179,MO,Reynolds County,2828,2749,79,2.8
CN2918100000000,2023-04-01,29,181,MO,Ripley County,5140,4973,167,3.2
CN2918300000000,2023-04-01,29,183,MO,St. Charles County,233935,229161,4774,2
CN2918500000000,2023-04-01,29,185,MO,St. Clair County,3943,3811,132,3.3
CN2918600000000,2023-04-01,29,186,MO,Ste. Genevieve County,9435,9226,209,2.2
CN2918700000000,2023-04-01,29,187,MO,St. Francois County,25815,25006,809,3.1
CN2918900000000,2023-04-01,29,189,MO,St. Louis County,537166,524200,12966,2.4
CN2919500000000,2023-04-01,29,195,MO,Saline County,10652,10412,240,2.3
CN2919700000000,2023-04-01,29,197,MO,Schuyler County,1836,1790,46,2.5
CN2919900000000,2023-04-01,29,199,MO,Scotland County,2272,2230,42,1.8
CN2920100000000,2023-04-01,29,201,MO,Scott County,20198,19725,473,2.3
CN2920300000000,2023-04-01,29,203,MO,Shannon County,3355,3226,129,3.8
CN2920500000000,2023-04-01,29,205,MO,Shelby County,3067,3017,50,1.6
CN2920700000000,2023-04-01,29,207,MO,Stoddard County,13371,12978,393,2.9
CN2920900000000,2023-04-01,29,209,MO,Stone County,13583,13123,460,3.4
CN2921100000000,2023-04-01,29,211,MO,Sullivan County,2614,2546,68,2.6
CN2921300000000,2023-04-01,29,213,MO,Taney County,26073,25179,894,3.4
CN2921500000000,2023-04-01,29,215,MO,Texas County,9345,9076,269,2.9
CN2921700000000,2023-04-01,29,217,MO,Vernon County,9432,9179,253,2.7
CN2921900000000,2023-04-01,29,219,MO,Warren County,19121,18690,431,2.3
CN2922100000000,2023-04-01,29,221,MO,Washington County,10213,9916,297,2.9
CN2922300000000,2023-04-01,29,223,MO,Wayne County,4693,4503,190,4
CN2922500000000,2023-04-01,29,225,MO,Webster County,18087,17697,390,2.2
CN2922700000000,2023-04-01,29,227,MO,Worth County,1192,1166,26,2.2
CN2922900000000,2023-04-01,29,229,MO,Wright County,7988,7759,229,2.9
CN2951000000000,2023-04-01,29,510,MO,St. Louis city,151669,147145,4524,3
CN3000100000000,2023-04-01,30,001,MT,Beaverhead County,5833,5734,99,1.7
CN3000300000000,2023-04-01,30,003,MT,Big Horn County,4610,4443,167,3.6
CN3000500000000,2023-04-01,30,005,MT,Blaine County,2360,2290,70,3
CN3000700000000,2023-04-01,30,007,MT,Broadwater County,2830,2745,85,3
CN3000900000000,2023-04-01,30,009,MT,Carbon County,5816,5684,132,2.3
CN3001100000000,2023-04-01,30,011,MT,Carter County,751,740,11,1.5
CN3001300000000,2023-04-01,30,013,MT,Cascade County,39779,38884,895,2.2
CN3001500000000,2023-04-01,30,015,MT,Chouteau County,2636,2575,61,2.3
CN3001700000000,2023-04-01,30,017,MT,Custer County,6425,6280,145,2.3
CN3001900000000,2023-04-01,30,019,MT,Daniels County,915,901,14,1.5
CN3002100000000,2023-04-01,30,021,MT,Dawson County,4612,4518,94,2
CN3002300000000,2023-04-01,30,023,MT,Deer Lodge County,5506,5376,130,2.4
CN3002500000000,2023-04-01,30,025,MT,Fallon County,1722,1697,25,1.5
CN3002700000000,2023-04-01,30,027,MT,Fergus County,6013,5862,151,2.5
CN3002900000000,2023-04-01,30,029,MT,Flathead County,52841,51268,1573,3
CN3003100000000,2023-04-01,30,031,MT,Gallatin County,79335,77950,1385,1.7
CN3003300000000,2023-04-01,30,033,MT,Garfield County,816,797,19,2.3
CN3003500000000,2023-04-01,30,035,MT,Glacier County,5498,5220,278,5.1
CN3003700000000,2023-04-01,30,037,MT,Golden Valley County,385,378,7,1.8
CN3003900000000,2023-04-01,30,039,MT,Granite County,1788,1721,67,3.7
CN3004100000000,2023-04-01,30,041,MT,Hill County,7744,7592,152,2
CN3004300000000,2023-04-01,30,043,MT,Jefferson County,6214,6074,140,2.3
CN3004500000000,2023-04-01,30,045,MT,Judith Basin County,1075,1046,29,2.7
CN3004700000000,2023-04-01,30,047,MT,Lake County,14346,13944,402,2.8
CN3004900000000,2023-04-01,30,049,MT,Lewis and Clark County,39022,38235,787,2
CN3005100000000,2023-04-01,30,051,MT,Liberty County,1065,1044,21,2
CN3005300000000,2023-04-01,30,053,MT,Lincoln County,8803,8371,432,4.9
CN3005500000000,2023-04-01,30,055,MT,McCone County,1066,1052,14,1.3
CN3005700000000,2023-04-01,30,057,MT,Madison County,6051,5954,97,1.6
CN3005900000000,2023-04-01,30,059,MT,Meagher County,1052,1027,25,2.4
CN3006100000000,2023-04-01,30,061,MT,Mineral County,1868,1794,74,4
CN3006300000000,2023-04-01,30,063,MT,Missoula County,68433,66882,1551,2.3
CN3006500000000,2023-04-01,30,065,MT,Musselshell County,2401,2346,55,2.3
CN3006700000000,2023-04-01,30,067,MT,Park County,9790,9519,271,2.8
CN3006900000000,2023-04-01,30,069,MT,Petroleum County,295,289,6,2
CN3007100000000,2023-04-01,30,071,MT,Phillips County,1919,1849,70,3.6
CN3007300000000,2023-04-01,30,073,MT,Pondera County,2752,2697,55,2
CN3007500000000,2023-04-01,30,075,MT,Powder River County,1072,1048,24,2.2
CN3007700000000,2023-04-01,30,077,MT,Powell County,2907,2816,91,3.1
CN3007900000000,2023-04-01,30,079,MT,Prairie County,539,522,17,3.2
CN3008100000000,2023-04-01,30,081,MT,Ravalli County,22484,21941,543,2.4
CN3008300000000,2023-04-01,30,083,MT,Richland County,5789,5673,116,2
CN3008500000000,2023-04-01,30,085,MT,Roosevelt County,4382,4243,139,3.2
CN3008700000000,2023-04-01,30,087,MT,Rosebud County,3598,3507,91,2.5
CN3008900000000,2023-04-01,30,089,MT,Sanders County,5613,5375,238,4.2
CN3009100000000,2023-04-01,30,091,MT,Sheridan County,1794,1757,37,2.1
CN3009300000000,2023-04-01,30,093,MT,Silver Bow County,17825,17306,519,2.9
CN3009500000000,2023-04-01,30,095,MT,Stillwater County,5416,5312,104,1.9
CN3009700000000,2023-04-01,30,097,MT,Sweet Grass County,1950,1915,35,1.8
CN3009900000000,2023-04-01,30,099,MT,Teton County,2893,2823,70,2.4
CN3010100000000,2023-04-01,30,101,MT,Toole County,2114,2084,30,1.4
CN3010300000000,2023-04-01,30,103,MT,Treasure County,381,371,10,2.6
CN3010500000000,2023-04-01,30,105,MT,Valley County,4060,3975,85,2.1
CN3010700000000,2023-04-01,30,107,MT,Wheatland County,836,804,32,3.8
CN3010900000000,2023-04-01,30,109,MT,Wibaux County,468,457,11,2.4
CN3011100000000,2023-04-01,30,111,MT,Yellowstone County,85678,83891,1787,2.1
CN3100100000000,2023-04-01,31,001,NE,Adams County,17248,16971,277,1.6
CN3100300000000,2023-04-01,31,003,NE,Antelope County,3622,3573,49,1.4
CN3100500000000,2023-04-01,31,005,NE,Arthur County,219,215,4,1.8
CN3100700000000,2023-04-01,31,007,NE,Banner County,380,372,8,2.1
CN3100900000000,2023-04-01,31,009,NE,Blaine County,244,236,8,3.3
CN3101100000000,2023-04-01,31,011,NE,Boone County,3000,2964,36,1.2
CN3101300000000,2023-04-01,31,013,NE,Box Butte County,5316,5227,89,1.7
CN3101500000000,2023-04-01,31,015,NE,Boyd County,1017,1002,15,1.5
CN3101700000000,2023-04-01,31,017,NE,Brown County,1387,1362,25,1.8
CN3101900000000,2023-04-01,31,019,NE,Buffalo County,28483,28075,408,1.4
CN3102100000000,2023-04-01,31,021,NE,Burt County,3587,3513,74,2.1
CN3102300000000,2023-04-01,31,023,NE,Butler County,4721,4664,57,1.2
CN3102500000000,2023-04-01,31,025,NE,Cass County,13797,13544,253,1.8
CN3102700000000,2023-04-01,31,027,NE,Cedar County,4639,4574,65,1.4
CN3102900000000,2023-04-01,31,029,NE,Chase County,2229,2204,25,1.1
CN3103100000000,2023-04-01,31,031,NE,Cherry County,3283,3226,57,1.7
CN3103300000000,2023-04-01,31,033,NE,Cheyenne County,4194,4116,78,1.9
CN3103500000000,2023-04-01,31,035,NE,Clay County,2997,2944,53,1.8
CN3103700000000,2023-04-01,31,037,NE,Colfax County,5748,5664,84,1.5
CN3103900000000,2023-04-01,31,039,NE,Cuming County,4811,4746,65,1.4
CN3104100000000,2023-04-01,31,041,NE,Custer County,6262,6175,87,1.4
CN3104300000000,2023-04-01,31,043,NE,Dakota County,11220,10988,232,2.1
CN3104500000000,2023-04-01,31,045,NE,Dawes County,4977,4893,84,1.7
CN3104700000000,2023-04-01,31,047,NE,Dawson County,13710,13393,317,2.3
CN3104900000000,2023-04-01,31,049,NE,Deuel County,1029,1010,19,1.8
CN3105100000000,2023-04-01,31,051,NE,Dixon County,3052,3008,44,1.4
CN3105300000000,2023-04-01,31,053,NE,Dodge County,21118,20770,348,1.6
CN3105500000000,2023-04-01,31,055,NE,Douglas County,310226,303652,6574,2.1
CN3105700000000,2023-04-01,31,057,NE,Dundy County,1170,1155,15,1.3
CN3105900000000,2023-04-01,31,059,NE,Fillmore County,3352,3295,57,1.7
CN3106100000000,2023-04-01,31,061,NE,Franklin County,1522,1497,25,1.6
CN3106300000000,2023-04-01,31,063,NE,Frontier County,1498,1468,30,2
CN3106500000000,2023-04-01,31,065,NE,Furnas County,2511,2479,32,1.3
CN3106700000000,2023-04-01,31,067,NE,Gage County,10828,10636,192,1.8
CN3106900000000,2023-04-01,31,069,NE,Garden County,1076,1057,19,1.8
CN3107100000000,2023-04-01,31,071,NE,Garfield County,1125,1110,15,1.3
CN3107300000000,2023-04-01,31,073,NE,Gosper County,1172,1153,19,1.6
CN3107500000000,2023-04-01,31,075,NE,Grant County,418,414,4,1
CN3107700000000,2023-04-01,31,077,NE,Greeley County,1224,1203,21,1.7
CN3107900000000,2023-04-01,31,079,NE,Hall County,33224,32607,617,1.9
CN3108100000000,2023-04-01,31,081,NE,Hamilton County,4939,4859,80,1.6
CN3108300000000,2023-04-01,31,083,NE,Harlan County,1840,1817,23,1.3
CN3108500000000,2023-04-01,31,085,NE,Hayes County,586,580,6,1
CN3108700000000,2023-04-01,31,087,NE,Hitchcock County,1299,1269,30,2.3
CN3108900000000,2023-04-01,31,089,NE,Holt County,5566,5490,76,1.4
CN3109100000000,2023-04-01,31,091,NE,Hooker County,339,333,6,1.8
CN3109300000000,2023-04-01,31,093,NE,Howard County,3509,3454,55,1.6
CN3109500000000,2023-04-01,31,095,NE,Jefferson County,4204,4147,57,1.4
CN3109700000000,2023-04-01,31,097,NE,Johnson County,2018,1974,44,2.2
CN3109900000000,2023-04-01,31,099,NE,Kearney County,3734,3688,46,1.2
CN3110100000000,2023-04-01,31,101,NE,Keith County,4574,4506,68,1.5
CN3110300000000,2023-04-01,31,103,NE,Keya Paha County,542,531,11,2
CN3110500000000,2023-04-01,31,105,NE,Kimball County,1944,1912,32,1.6
CN3110700000000,2023-04-01,31,107,NE,Knox County,4517,4454,63,1.4
CN3110900000000,2023-04-01,31,109,NE,Lancaster County,182812,179676,3136,1.7
CN3111100000000,2023-04-01,31,111,NE,Lincoln County,18312,18014,298,1.6
CN3111300000000,2023-04-01,31,113,NE,Logan County,480,469,11,2.3
CN3111500000000,2023-04-01,31,115,NE,Loup County,401,393,8,2
CN3111700000000,2023-04-01,31,117,NE,McPherson County,435,427,8,1.8
CN3111900000000,2023-04-01,31,119,NE,Madison County,19876,19557,319,1.6
CN3112100000000,2023-04-01,31,121,NE,Merrick County,4209,4150,59,1.4
CN3112300000000,2023-04-01,31,123,NE,Morrill County,2608,2557,51,2
CN3112500000000,2023-04-01,31,125,NE,Nance County,1946,1916,30,1.5
CN3112700000000,2023-04-01,31,127,NE,Nemaha County,3648,3587,61,1.7
CN3112900000000,2023-04-01,31,129,NE,Nuckolls County,2460,2430,30,1.2
CN3113100000000,2023-04-01,31,131,NE,Otoe County,8647,8512,135,1.6
CN3113300000000,2023-04-01,31,133,NE,Pawnee County,1466,1441,25,1.7
CN3113500000000,2023-04-01,31,135,NE,Perkins County,1819,1792,27,1.5
CN3113700000000,2023-04-01,31,137,NE,Phelps County,5004,4943,61,1.2
CN3113900000000,2023-04-01,31,139,NE,Pierce County,4183,4122,61,1.5
CN3114100000000,2023-04-01,31,141,NE,Platte County,18609,18328,281,1.5
CN3114300000000,2023-04-01,31,143,NE,Polk County,2868,2822,46,1.6
CN3114500000000,2023-04-01,31,145,NE,Red Willow County,5851,5773,78,1.3
CN3114700000000,2023-04-01,31,147,NE,Richardson County,4173,4112,61,1.5
CN3114900000000,2023-04-01,31,149,NE,Rock County,907,894,13,1.4
CN3115100000000,2023-04-01,31,151,NE,Saline County,7205,7061,144,2
CN3115300000000,2023-04-01,31,153,NE,Sarpy County,101157,99430,1727,1.7
CN3115500000000,2023-04-01,31,155,NE,Saunders County,11583,11425,158,1.4
CN3115700000000,2023-04-01,31,157,NE,Scotts Bluff County,17735,17336,399,2.2
CN3115900000000,2023-04-01,31,159,NE,Seward County,8906,8779,127,1.4
CN3116100000000,2023-04-01,31,161,NE,Sheridan County,2785,2722,63,2.3
CN3116300000000,2023-04-01,31,163,NE,Sherman County,1657,1625,32,1.9
CN3116500000000,2023-04-01,31,165,NE,Sioux County,749,732,17,2.3
CN3116700000000,2023-04-01,31,167,NE,Stanton County,3531,3468,63,1.8
CN3116900000000,2023-04-01,31,169,NE,Thayer County,2712,2680,32,1.2
CN3117100000000,2023-04-01,31,171,NE,Thomas County,445,430,15,3.4
CN3117300000000,2023-04-01,31,173,NE,Thurston County,3288,3210,78,2.4
CN3117500000000,2023-04-01,31,175,NE,Valley County,2095,2065,30,1.4
CN3117700000000,2023-04-01,31,177,NE,Washington County,11617,11427,190,1.6
CN3117900000000,2023-04-01,31,179,NE,Wayne County,5843,5750,93,1.6
CN3118100000000,2023-04-01,31,181,NE,Webster County,1668,1632,36,2.2
CN3118300000000,2023-04-01,31,183,NE,Wheeler County,552,544,8,1.4
CN3118500000000,2023-04-01,31,185,NE,York County,7411,7270,141,1.9
CN3200100000000,2023-04-01,32,001,NV,Churchill County,10984,10529,455,4.1
CN3200300000000,2023-04-01,32,003,NV,Clark County,1163636,1099861,63775,5.5
CN3200500000000,2023-04-01,32,005,NV,Douglas County,22319,21318,1001,4.5
CN3200700000000,2023-04-01,32,007,NV,Elko County,25643,24717,926,3.6
CN3200900000000,2023-04-01,32,009,NV,Esmeralda County,428,413,15,3.5
CN3201100000000,2023-04-01,32,011,NV,Eureka County,1058,1023,35,3.3
CN3201300000000,2023-04-01,32,013,NV,Humboldt County,7808,7538,270,3.5
CN3201500000000,2023-04-01,32,015,NV,Lander County,3087,2980,107,3.5
CN3201700000000,2023-04-01,32,017,NV,Lincoln County,2075,1983,92,4.4
CN3201900000000,2023-04-01,32,019,NV,Lyon County,23858,22502,1356,5.7
CN3202100000000,2023-04-01,32,021,NV,Mineral County,1989,1894,95,4.8
CN3202300000000,2023-04-01,32,023,NV,Nye County,18159,17040,1119,6.2
CN3202700000000,2023-04-01,32,027,NV,Pershing County,2452,2342,110,4.5
CN3202900000000,2023-04-01,32,029,NV,Storey County,2135,2046,89,4.2
CN3203100000000,2023-04-01,32,031,NV,Washoe County,263132,252580,10552,4
CN3203300000000,2023-04-01,32,033,NV,White Pine County,4466,4313,153,3.4
CN3251000000000,2023-04-01,32,510,NV,Carson City,25858,24674,1184,4.6
CN3300100000000,2023-04-01,33,001,NH,Belknap County,29834,29474,360,1.2
CN3300300000000,2023-04-01,33,003,NH,Carroll County,22018,21746,272,1.2
CN3300500000000,2023-04-01,33,005,NH,Cheshire County,38664,38186,478,1.2
CN3300700000000,2023-04-01,33,007,NH,Coos County,13382,13130,252,1.9
CN3300900000000,2023-04-01,33,009,NH,Grafton County,46832,46370,462,1
CN3301100000000,2023-04-01,33,011,NH,Hillsborough County,239162,236111,3051,1.3
CN3301300000000,2023-04-01,33,013,NH,Merrimack County,81502,80730,772,0.9
CN3301500000000,2023-04-01,33,015,NH,Rockingham County,185638,183182,2456,1.3
CN3301700000000,2023-04-01,33,017,NH,Strafford County,73282,72524,758,1
CN3301900000000,2023-04-01,33,019,NH,Sullivan County,22360,22143,217,1
CN3400100000000,2023-04-01,34,001,NJ,Atlantic County,125765,120477,5288,4.2
CN3400300000000,2023-04-01,34,003,NJ,Bergen County,515607,502038,13569,2.6
CN3400500000000,2023-04-01,34,005,NJ,Burlington County,253568,246534,7034,2.8
CN3400700000000,2023-04-01,34,007,NJ,Camden County,277295,267873,9422,3.4
CN3400900000000,2023-04-01,34,009,NJ,Cape May County,44604,41623,2981,6.7
CN3401100000000,2023-04-01,34,011,NJ,Cumberland County,70361,67130,3231,4.6
CN3401300000000,2023-04-01,34,013,NJ,Essex County,396533,381108,15425,3.9
CN3401500000000,2023-04-01,34,015,NJ,Gloucester County,165022,160157,4865,2.9
CN3401700000000,2023-04-01,34,017,NJ,Hudson County,386874,375167,11707,3
CN3401900000000,2023-04-01,34,019,NJ,Hunterdon County,69244,67565,1679,2.4
CN3402100000000,2023-04-01,34,021,NJ,Mercer County,222476,216546,5930,2.7
CN3402300000000,2023-04-01,34,023,NJ,Middlesex County,473042,459625,13417,2.8
CN3402500000000,2023-04-01,34,025,NJ,Monmouth County,353802,344296,9506,2.7
CN3402700000000,2023-04-01,34,027,NJ,Morris County,274644,267770,6874,2.5
CN3402900000000,2023-04-01,34,029,NJ,Ocean County,303162,294092,9070,3
CN3403100000000,2023-04-01,34,031,NJ,Passaic County,259043,248978,10065,3.9
CN3403300000000,2023-04-01,34,033,NJ,Salem County,31198,30002,1196,3.8
CN3403500000000,2023-04-01,34,035,NJ,Somerset County,183374,178596,4778,2.6
CN3403700000000,2023-04-01,34,037,NJ,Sussex County,78942,76541,2401,3
CN3403900000000,2023-04-01,34,039,NJ,Union County,296202,286418,9784,3.3
CN3404100000000,2023-04-01,34,041,NJ,Warren County,59692,58029,1663,2.8
CN3500100000000,2023-04-01,35,001,NM,Bernalillo County,337424,328178,9246,2.7
CN3500300000000,2023-04-01,35,003,NM,Catron County,1079,1035,44,4.1
CN3500500000000,2023-04-01,35,005,NM,Chaves County,27384,26560,824,3
CN3500600000000,2023-04-01,35,006,NM,Cibola County,8202,7857,345,4.2
CN3500700000000,2023-04-01,35,007,NM,Colfax County,4998,4844,154,3.1
CN3500900000000,2023-04-01,35,009,NM,Curry County,22166,21668,498,2.2
CN3501100000000,2023-04-01,35,011,NM,De Baca County,726,709,17,2.3
CN3501300000000,2023-04-01,35,013,NM,Dona Ana County,100482,96611,3871,3.9
CN3501500000000,2023-04-01,35,015,NM,Eddy County,31885,31200,685,2.1
CN3501700000000,2023-04-01,35,017,NM,Grant County,11796,11466,330,2.8
CN3501900000000,2023-04-01,35,019,NM,Guadalupe County,1395,1347,48,3.4
CN3502100000000,2023-04-01,35,021,NM,Harding County,281,273,8,2.8
CN3502300000000,2023-04-01,35,023,NM,Hidalgo County,1890,1841,49,2.6
CN3502500000000,2023-04-01,35,025,NM,Lea County,29557,28702,855,2.9
CN3502700000000,2023-04-01,35,027,NM,Lincoln County,8671,8442,229,2.6
CN3502800000000,2023-04-01,35,028,NM,Los Alamos County,10950,10792,158,1.4
CN3502900000000,2023-04-01,35,029,NM,Luna County,9808,8745,1063,10.8
CN3503100000000,2023-04-01,35,031,NM,McKinley County,23865,22943,922,3.9
CN3503300000000,2023-04-01,35,033,NM,Mora County,1965,1883,82,4.2
CN3503500000000,2023-04-01,35,035,NM,Otero County,25572,24766,806,3.2
CN3503700000000,2023-04-01,35,037,NM,Quay County,2959,2858,101,3.4
CN3503900000000,2023-04-01,35,039,NM,Rio Arriba County,16469,15979,490,3
CN3504100000000,2023-04-01,35,041,NM,Roosevelt County,8412,8186,226,2.7
CN3504300000000,2023-04-01,35,043,NM,Sandoval County,68062,66108,1954,2.9
CN3504500000000,2023-04-01,35,045,NM,San Juan County,49922,48175,1747,3.5
CN3504700000000,2023-04-01,35,047,NM,San Miguel County,10645,10249,396,3.7
CN3504900000000,2023-04-01,35,049,NM,Santa Fe County,71869,69984,1885,2.6
CN3505100000000,2023-04-01,35,051,NM,Sierra County,3805,3574,231,6.1
CN3505300000000,2023-04-01,35,053,NM,Socorro County,6057,5855,202,3.3
CN3505500000000,2023-04-01,35,055,NM,Taos County,14850,14275,575,3.9
CN3505700000000,2023-04-01,35,057,NM,Torrance County,5337,5113,224,4.2
CN3505900000000,2023-04-01,35,059,NM,Union County,1513,1475,38,2.5
CN3506100000000,2023-04-01,35,061,NM,Valencia County,31033,29989,1044,3.4
CN3600100000000,2023-04-01,36,001,NY,Albany County,161320,157572,3748,2.3
CN3600300000000,2023-04-01,36,003,NY,Allegany County,19265,18667,598,3.1
CN3600500000000,2023-04-01,36,005,NY,Bronx County,606412,563795,42617,7
CN3600700000000,2023-04-01,36,007,NY,Broome County,82075,79830,2245,2.7
CN3600900000000,2023-04-01,36,009,NY,Cattaraugus County,32196,31158,1038,3.2
CN3601100000000,2023-04-01,36,011,NY,Cayuga County,34839,33921,918,2.6
CN3601300000000,2023-04-01,36,013,NY,Chautauqua County,53253,51561,1692,3.2
CN3601500000000,2023-04-01,36,015,NY,Chemung County,34352,33367,985,2.9
CN3601700000000,2023-04-01,36,017,NY,Chenango County,21491,20949,542,2.5
CN3601900000000,2023-04-01,36,019,NY,Clinton County,33943,32990,953,2.8
CN3602100000000,2023-04-01,36,021,NY,Columbia County,29957,29321,636,2.1
CN3602300000000,2023-04-01,36,023,NY,Cortland County,22630,21941,689,3
CN3602500000000,2023-04-01,36,025,NY,Delaware County,18212,17677,535,2.9
CN3602700000000,2023-04-01,36,027,NY,Dutchess County,144491,141217,3274,2.3
CN3602900000000,2023-04-01,36,029,NY,Erie County,445476,433446,12030,2.7
CN3603100000000,2023-04-01,36,031,NY,Essex County,15162,14636,526,3.5
CN3603300000000,2023-04-01,36,033,NY,Franklin County,18166,17612,554,3
CN3603500000000,2023-04-01,36,035,NY,Fulton County,21988,21256,732,3.3
CN3603700000000,2023-04-01,36,037,NY,Genesee County,29324,28642,682,2.3
CN3603900000000,2023-04-01,36,039,NY,Greene County,19661,19076,585,3
CN3604100000000,2023-04-01,36,041,NY,Hamilton County,1975,1869,106,5.4
CN3604300000000,2023-04-01,36,043,NY,Herkimer County,27297,26433,864,3.2
CN3604500000000,2023-04-01,36,045,NY,Jefferson County,43484,42062,1422,3.3
CN3604700000000,2023-04-01,36,047,NY,Kings County,1219411,1151497,67914,5.6
CN3604900000000,2023-04-01,36,049,NY,Lewis County,11352,10933,419,3.7
CN3605100000000,2023-04-01,36,051,NY,Livingston County,30500,29731,769,2.5
CN3605300000000,2023-04-01,36,053,NY,Madison County,33171,32308,863,2.6
CN3605500000000,2023-04-01,36,055,NY,Monroe County,367278,357950,9328,2.5
CN3605700000000,2023-04-01,36,057,NY,Montgomery County,21939,21179,760,3.5
CN3605900000000,2023-04-01,36,059,NY,Nassau County,730768,714340,16428,2.2
CN3606100000000,2023-04-01,36,061,NY,New York County,929596,887268,42328,4.6
CN3606300000000,2023-04-01,36,063,NY,Niagara County,98426,95440,2986,3
CN3606500000000,2023-04-01,36,065,NY,Oneida County,99912,97187,2725,2.7
CN3606700000000,2023-04-01,36,067,NY,Onondaga County,226226,220657,5569,2.5
CN3606900000000,2023-04-01,36,069,NY,Ontario County,56298,54944,1354,2.4
CN3607100000000,2023-04-01,36,071,NY,Orange County,191484,186877,4607,2.4
CN3607300000000,2023-04-01,36,073,NY,Orleans County,17279,16776,503,2.9
CN3607500000000,2023-04-01,36,075,NY,Oswego County,53256,51626,1630,3.1
CN3607700000000,2023-04-01,36,077,NY,Otsego County,26075,25345,730,2.8
CN3607900000000,2023-04-01,36,079,NY,Putnam County,51288,50184,1104,2.2
CN3608100000000,2023-04-01,36,081,NY,Queens County,1148340,1094725,53615,4.7
CN3608300000000,2023-04-01,36,083,NY,Rensselaer County,83138,81210,1928,2.3
CN3608500000000,2023-04-01,36,085,NY,Richmond County,229201,217605,11596,5.1
CN3608700000000,2023-04-01,36,087,NY,Rockland County,160028,156634,3394,2.1
CN3608900000000,2023-04-01,36,089,NY,St. Lawrence County,42083,40706,1377,3.3
CN3609100000000,2023-04-01,36,091,NY,Saratoga County,123097,120572,2525,2.1
CN3609300000000,2023-04-01,36,093,NY,Schenectady County,78743,76792,1951,2.5
CN3609500000000,2023-04-01,36,095,NY,Schoharie County,14958,14486,472,3.2
CN3609700000000,2023-04-01,36,097,NY,Schuyler County,7777,7533,244,3.1
CN3609900000000,2023-04-01,36,099,NY,Seneca County,14619,14250,369,2.5
CN3610100000000,2023-04-01,36,101,NY,Steuben County,40454,39211,1243,3.1
CN3610300000000,2023-04-01,36,103,NY,Suffolk County,802223,782632,19591,2.4
CN3610500000000,2023-04-01,36,105,NY,Sullivan County,36903,35976,927,2.5
CN3610700000000,2023-04-01,36,107,NY,Tioga County,22256,21733,523,2.3
CN3610900000000,2023-04-01,36,109,NY,Tompkins County,51590,50563,1027,2
CN3611100000000,2023-04-01,36,111,NY,Ulster County,87354,85263,2091,2.4
CN3611300000000,2023-04-01,36,113,NY,Warren County,31056,30133,923,3
CN3611500000000,2023-04-01,36,115,NY,Washington County,27275,26584,691,2.5
CN3611700000000,2023-04-01,36,117,NY,Wayne County,43800,42723,1077,2.5
CN3611900000000,2023-04-01,36,119,NY,Westchester County,497698,486123,11575,2.3
CN3612100000000,2023-04-01,36,121,NY,Wyoming County,17169,16683,486,2.8
CN3612300000000,2023-04-01,36,123,NY,Yates County,11688,11439,249,2.1
CN3700100000000,2023-04-01,37,001,NC,Alamance County,84113,81462,2651,3.2
CN3700300000000,2023-04-01,37,003,NC,Alexander County,18181,17693,488,2.7
CN3700500000000,2023-04-01,37,005,NC,Alleghany County,4678,4456,222,4.7
CN3700700000000,2023-04-01,37,007,NC,Anson County,10287,9920,367,3.6
CN3700900000000,2023-04-01,37,009,NC,Ashe County,12740,12392,348,2.7
CN3701100000000,2023-04-01,37,011,NC,Avery County,7592,7381,211,2.8
CN3701300000000,2023-04-01,37,013,NC,Beaufort County,19998,19309,689,3.4
CN3701500000000,2023-04-01,37,015,NC,Bertie County,7095,6816,279,3.9
CN3701700000000,2023-04-01,37,017,NC,Bladen County,14588,14028,560,3.8
CN3701900000000,2023-04-01,37,019,NC,Brunswick County,58799,56617,2182,3.7
CN3702100000000,2023-04-01,37,021,NC,Buncombe County,144784,141314,3470,2.4
CN3702300000000,2023-04-01,37,023,NC,Burke County,41171,39987,1184,2.9
CN3702500000000,2023-04-01,37,025,NC,Cabarrus County,117895,114449,3446,2.9
CN3702700000000,2023-04-01,37,027,NC,Caldwell County,36648,35551,1097,3
CN3702900000000,2023-04-01,37,029,NC,Camden County,4691,4554,137,2.9
CN3703100000000,2023-04-01,37,031,NC,Carteret County,31740,30811,929,2.9
CN3703300000000,2023-04-01,37,033,NC,Caswell County,9688,9381,307,3.2
CN3703500000000,2023-04-01,37,035,NC,Catawba County,79999,77680,2319,2.9
CN3703700000000,2023-04-01,37,037,NC,Chatham County,37957,36982,975,2.6
CN3703900000000,2023-04-01,37,039,NC,Cherokee County,11104,10717,387,3.5
CN3704100000000,2023-04-01,37,041,NC,Chowan County,5873,5679,194,3.3
CN3704300000000,2023-04-01,37,043,NC,Clay County,4260,4126,134,3.1
CN3704500000000,2023-04-01,37,045,NC,Cleveland County,49637,48007,1630,3.3
CN3704700000000,2023-04-01,37,047,NC,Columbus County,24156,23343,813,3.4
CN3704900000000,2023-04-01,37,049,NC,Craven County,42164,40792,1372,3.3
CN3705100000000,2023-04-01,37,051,NC,Cumberland County,127793,122275,5518,4.3
CN3705300000000,2023-04-01,37,053,NC,Currituck County,14748,14333,415,2.8
CN3705500000000,2023-04-01,37,055,NC,Dare County,18907,18205,702,3.7
CN3705700000000,2023-04-01,37,057,NC,Davidson County,82675,80219,2456,3
CN3705900000000,2023-04-01,37,059,NC,Davie County,21099,20498,601,2.8
CN3706100000000,2023-04-01,37,061,NC,Duplin County,25186,24415,771,3.1
CN3706300000000,2023-04-01,37,063,NC,Durham County,181256,176234,5022,2.8
CN3706500000000,2023-04-01,37,065,NC,Edgecombe County,20161,19103,1058,5.2
CN3706700000000,2023-04-01,37,067,NC,Forsyth County,191374,185325,6049,3.2
CN3706900000000,2023-04-01,37,069,NC,Franklin County,34498,33391,1107,3.2
CN3707100000000,2023-04-01,37,071,NC,Gaston County,116253,112685,3568,3.1
CN3707300000000,2023-04-01,37,073,NC,Gates County,5171,5013,158,3.1
CN3707500000000,2023-04-01,37,075,NC,Graham County,2842,2723,119,4.2
CN3707700000000,2023-04-01,37,077,NC,Granville County,30378,29555,823,2.7
CN3707900000000,2023-04-01,37,079,NC,Greene County,9664,9399,265,2.7
CN3708100000000,2023-04-01,37,081,NC,Guilford County,262674,253426,9248,3.5
CN3708300000000,2023-04-01,37,083,NC,Halifax County,19025,18155,870,4.6
CN3708500000000,2023-04-01,37,085,NC,Harnett County,55612,53657,1955,3.5
CN3708700000000,2023-04-01,37,087,NC,Haywood County,30792,29992,800,2.6
CN3708900000000,2023-04-01,37,089,NC,Henderson County,56670,55200,1470,2.6
CN3709100000000,2023-04-01,37,091,NC,Hertford County,8413,8046,367,4.4
CN3709300000000,2023-04-01,37,093,NC,Hoke County,20311,19493,818,4
CN3709500000000,2023-04-01,37,095,NC,Hyde County,1753,1666,87,5
CN3709700000000,2023-04-01,37,097,NC,Iredell County,96127,93303,2824,2.9
CN3709900000000,2023-04-01,37,099,NC,Jackson County,19440,18761,679,3.5
CN3710100000000,2023-04-01,37,101,NC,Johnston County,109744,106581,3163,2.9
CN3710300000000,2023-04-01,37,103,NC,Jones County,4362,4235,127,2.9
CN3710500000000,2023-04-01,37,105,NC,Lee County,25944,25011,933,3.6
CN3710700000000,2023-04-01,37,107,NC,Lenoir County,27494,26614,880,3.2
CN3710900000000,2023-04-01,37,109,NC,Lincoln County,47150,45865,1285,2.7
CN3711100000000,2023-04-01,37,111,NC,McDowell County,20457,19867,590,2.9
CN3711300000000,2023-04-01,37,113,NC,Macon County,15878,15401,477,3
CN3711500000000,2023-04-01,37,115,NC,Madison County,10291,9992,299,2.9
CN3711700000000,2023-04-01,37,117,NC,Martin County,8595,8263,332,3.9
CN3711900000000,2023-04-01,37,119,NC,Mecklenburg County,662175,641939,20236,3.1
CN3712100000000,2023-04-01,37,121,NC,Mitchell County,6070,5867,203,3.3
CN3712300000000,2023-04-01,37,123,NC,Montgomery County,11010,10644,366,3.3
CN3712500000000,2023-04-01,37,125,NC,Moore County,41662,40326,1336,3.2
CN3712700000000,2023-04-01,37,127,NC,Nash County,42284,40523,1761,4.2
CN3712900000000,2023-04-01,37,129,NC,New Hanover County,132633,128919,3714,2.8
CN3713100000000,2023-04-01,37,131,NC,Northampton County,7217,6915,302,4.2
CN3713300000000,2023-04-01,37,133,NC,Onslow County,69851,67351,2500,3.6
CN3713500000000,2023-04-01,37,135,NC,Orange County,82630,80415,2215,2.7
CN3713700000000,2023-04-01,37,137,NC,Pamlico County,5513,5350,163,3
CN3713900000000,2023-04-01,37,139,NC,Pasquotank County,16719,16100,619,3.7
CN3714100000000,2023-04-01,37,141,NC,Pender County,31518,30613,905,2.9
CN3714300000000,2023-04-01,37,143,NC,Perquimans County,4995,4815,180,3.6
CN3714500000000,2023-04-01,37,145,NC,Person County,19053,18447,606,3.2
CN3714700000000,2023-04-01,37,147,NC,Pitt County,89581,86455,3126,3.5
CN3714900000000,2023-04-01,37,149,NC,Polk County,9327,9036,291,3.1
CN3715100000000,2023-04-01,37,151,NC,Randolph County,66117,64038,2079,3.1
CN3715300000000,2023-04-01,37,153,NC,Richmond County,17045,16348,697,4.1
CN3715500000000,2023-04-01,37,155,NC,Robeson County,47915,45673,2242,4.7
CN3715700000000,2023-04-01,37,157,NC,Rockingham County,39864,38473,1391,3.5
CN3715900000000,2023-04-01,37,159,NC,Rowan County,68772,66651,2121,3.1
CN3716100000000,2023-04-01,37,161,NC,Rutherford County,24626,23569,1057,4.3
CN3716300000000,2023-04-01,37,163,NC,Sampson County,29584,28691,893,3
CN3716500000000,2023-04-01,37,165,NC,Scotland County,11338,10570,768,6.8
CN3716700000000,2023-04-01,37,167,NC,Stanly County,30897,30023,874,2.8
CN3716900000000,2023-04-01,37,169,NC,Stokes County,21963,21372,591,2.7
CN3717100000000,2023-04-01,37,171,NC,Surry County,32644,31694,950,2.9
CN3717300000000,2023-04-01,37,173,NC,Swain County,7071,6886,185,2.6
CN3717500000000,2023-04-01,37,175,NC,Transylvania County,14624,14198,426,2.9
CN3717700000000,2023-04-01,37,177,NC,Tyrrell County,1272,1207,65,5.1
CN3717900000000,2023-04-01,37,179,NC,Union County,132498,128884,3614,2.7
CN3718100000000,2023-04-01,37,181,NC,Vance County,16535,15710,825,5
CN3718300000000,2023-04-01,37,183,NC,Wake County,640609,623115,17494,2.7
CN3718500000000,2023-04-01,37,185,NC,Warren County,6347,6037,310,4.9
CN3718700000000,2023-04-01,37,187,NC,Washington County,4209,4036,173,4.1
CN3718900000000,2023-04-01,37,189,NC,Watauga County,28801,27953,848,2.9
CN3719100000000,2023-04-01,37,191,NC,Wayne County,51305,49546,1759,3.4
CN3719300000000,2023-04-01,37,193,NC,Wilkes County,26611,25732,879,3.3
CN3719500000000,2023-04-01,37,195,NC,Wilson County,33331,31784,1547,4.6
CN3719700000000,2023-04-01,37,197,NC,Yadkin County,17946,17441,505,2.8
CN3719900000000,2023-04-01,37,199,NC,Yancey County,8224,7992,232,2.8
CN3800100000000,2023-04-01,38,001,ND,Adams County,952,933,19,2
CN3800300000000,2023-04-01,38,003,ND,Barnes County,5295,5175,120,2.3
CN3800500000000,2023-04-01,38,005,ND,Benson County,2342,2261,81,3.5
CN3800700000000,2023-04-01,38,007,ND,Billings County,404,394,10,2.5
CN3800900000000,2023-04-01,38,009,ND,Bottineau County,3038,2954,84,2.8
CN3801100000000,2023-04-01,38,011,ND,Bowman County,1535,1518,17,1.1
CN3801300000000,2023-04-01,38,013,ND,Burke County,1057,1040,17,1.6
CN3801500000000,2023-04-01,38,015,ND,Burleigh County,52168,51110,1058,2
CN3801700000000,2023-04-01,38,017,ND,Cass County,111949,109775,2174,1.9
CN3801900000000,2023-04-01,38,019,ND,Cavalier County,1842,1787,55,3
CN3802100000000,2023-04-01,38,021,ND,Dickey County,2236,2197,39,1.7
CN3802300000000,2023-04-01,38,023,ND,Divide County,1431,1414,17,1.2
CN3802500000000,2023-04-01,38,025,ND,Dunn County,3237,3197,40,1.2
CN3802700000000,2023-04-01,38,027,ND,Eddy County,1194,1155,39,3.3
CN3802900000000,2023-04-01,38,029,ND,Emmons County,1507,1417,90,6
CN3803100000000,2023-04-01,38,031,ND,Foster County,1531,1498,33,2.2
CN3803300000000,2023-04-01,38,033,ND,Golden Valley County,853,839,14,1.6
CN3803500000000,2023-04-01,38,035,ND,Grand Forks County,38508,37791,717,1.9
CN3803700000000,2023-04-01,38,037,ND,Grant County,1247,1227,20,1.6
CN3803900000000,2023-04-01,38,039,ND,Griggs County,1044,1018,26,2.5
CN3804100000000,2023-04-01,38,041,ND,Hettinger County,1392,1366,26,1.9
CN3804300000000,2023-04-01,38,043,ND,Kidder County,1349,1296,53,3.9
CN3804500000000,2023-04-01,38,045,ND,LaMoure County,2165,2123,42,1.9
CN3804700000000,2023-04-01,38,047,ND,Logan County,871,846,25,2.9
CN3804900000000,2023-04-01,38,049,ND,McHenry County,3205,3085,120,3.7
CN3805100000000,2023-04-01,38,051,ND,McIntosh County,1053,1034,19,1.8
CN3805300000000,2023-04-01,38,053,ND,McKenzie County,9629,9505,124,1.3
CN3805500000000,2023-04-01,38,055,ND,McLean County,4854,4715,139,2.9
CN3805700000000,2023-04-01,38,057,ND,Mercer County,3701,3604,97,2.6
CN3805900000000,2023-04-01,38,059,ND,Morton County,17248,16777,471,2.7
CN3806100000000,2023-04-01,38,061,ND,Mountrail County,6469,6387,82,1.3
CN3806300000000,2023-04-01,38,063,ND,Nelson County,1488,1439,49,3.3
CN3806500000000,2023-04-01,38,065,ND,Oliver County,883,857,26,2.9
CN3806700000000,2023-04-01,38,067,ND,Pembina County,3170,3073,97,3.1
CN3806900000000,2023-04-01,38,069,ND,Pierce County,1714,1662,52,3
CN3807100000000,2023-04-01,38,071,ND,Ramsey County,5714,5571,143,2.5
CN3807300000000,2023-04-01,38,073,ND,Ransom County,2671,2632,39,1.5
CN3807500000000,2023-04-01,38,075,ND,Renville County,1222,1200,22,1.8
CN3807700000000,2023-04-01,38,077,ND,Richland County,9025,8860,165,1.8
CN3807900000000,2023-04-01,38,079,ND,Rolette County,4779,4529,250,5.2
CN3808100000000,2023-04-01,38,081,ND,Sargent County,2319,2280,39,1.7
CN3808300000000,2023-04-01,38,083,ND,Sheridan County,657,632,25,3.8
CN3808500000000,2023-04-01,38,085,ND,Sioux County,1214,1189,25,2.1
CN3808700000000,2023-04-01,38,087,ND,Slope County,333,326,7,2.1
CN3808900000000,2023-04-01,38,089,ND,Stark County,18357,18028,329,1.8
CN3809100000000,2023-04-01,38,091,ND,Steele County,939,913,26,2.8
CN3809300000000,2023-04-01,38,093,ND,Stutsman County,10874,10631,243,2.2
CN3809500000000,2023-04-01,38,095,ND,Towner County,1133,1106,27,2.4
CN3809700000000,2023-04-01,38,097,ND,Traill County,4603,4524,79,1.7
CN3809900000000,2023-04-01,38,099,ND,Walsh County,5294,5119,175,3.3
CN3810100000000,2023-04-01,38,101,ND,Ward County,32273,31476,797,2.5
CN3810300000000,2023-04-01,38,103,ND,Wells County,1945,1868,77,4
CN3810500000000,2023-04-01,38,105,ND,Williams County,23016,22613,403,1.8
CN3900100000000,2023-04-01,39,001,OH,Adams County,11353,10861,492,4.3
CN3900300000000,2023-04-01,39,003,OH,Allen County,46486,44743,1743,3.7
CN3900500000000,2023-04-01,39,005,OH,Ashland County,25907,25157,750,2.9
CN3900700000000,2023-04-01,39,007,OH,Ashtabula County,43492,41840,1652,3.8
CN3900900000000,2023-04-01,39,009,OH,Athens County,27175,26190,985,3.6
CN3901100000000,2023-04-01,39,011,OH,Auglaize County,24070,23504,566,2.4
CN3901300000000,2023-04-01,39,013,OH,Belmont County,26917,25818,1099,4.1
CN3901500000000,2023-04-01,39,015,OH,Brown County,19890,19166,724,3.6
CN3901700000000,2023-04-01,39,017,OH,Butler County,202350,196804,5546,2.7
CN3901900000000,2023-04-01,39,019,OH,Carroll County,12614,12179,435,3.4
CN3902100000000,2023-04-01,39,021,OH,Champaign County,19338,18838,500,2.6
CN3902300000000,2023-04-01,39,023,OH,Clark County,63613,61634,1979,3.1
CN3902500000000,2023-04-01,39,025,OH,Clermont County,110769,107757,3012,2.7
CN3902700000000,2023-04-01,39,027,OH,Clinton County,18224,17617,607,3.3
CN3902900000000,2023-04-01,39,029,OH,Columbiana County,44899,43249,1650,3.7
CN3903100000000,2023-04-01,39,031,OH,Coshocton County,13726,13172,554,4
CN3903300000000,2023-04-01,39,033,OH,Crawford County,17769,17083,686,3.9
CN3903500000000,2023-04-01,39,035,OH,Cuyahoga County,603324,581780,21544,3.6
CN3903700000000,2023-04-01,39,037,OH,Darke County,25601,24896,705,2.8
CN3903900000000,2023-04-01,39,039,OH,Defiance County,17180,16609,571,3.3
CN3904100000000,2023-04-01,39,041,OH,Delaware County,116896,114121,2775,2.4
CN3904300000000,2023-04-01,39,043,OH,Erie County,36206,34590,1616,4.5
CN3904500000000,2023-04-01,39,045,OH,Fairfield County,81094,78914,2180,2.7
CN3904700000000,2023-04-01,39,047,OH,Fayette County,13558,13132,426,3.1
CN3904900000000,2023-04-01,39,049,OH,Franklin County,718066,697686,20380,2.8
CN3905100000000,2023-04-01,39,051,OH,Fulton County,21687,20998,689,3.2
CN3905300000000,2023-04-01,39,053,OH,Gallia County,12439,12009,430,3.5
CN3905500000000,2023-04-01,39,055,OH,Geauga County,48409,47065,1344,2.8
CN3905700000000,2023-04-01,39,057,OH,Greene County,83641,81356,2285,2.7
CN3905900000000,2023-04-01,39,059,OH,Guernsey County,17998,17269,729,4.1
CN3906100000000,2023-04-01,39,061,OH,Hamilton County,428384,416430,11954,2.8
CN3906300000000,2023-04-01,39,063,OH,Hancock County,40507,39505,1002,2.5
CN3906500000000,2023-04-01,39,065,OH,Hardin County,13019,12586,433,3.3
CN3906700000000,2023-04-01,39,067,OH,Harrison County,6467,6238,229,3.5
CN3906900000000,2023-04-01,39,069,OH,Henry County,12715,12203,512,4
CN3907100000000,2023-04-01,39,071,OH,Highland County,17523,16844,679,3.9
CN3907300000000,2023-04-01,39,073,OH,Hocking County,13091,12647,444,3.4
CN3907500000000,2023-04-01,39,075,OH,Holmes County,21693,21258,435,2
CN3907700000000,2023-04-01,39,077,OH,Huron County,28165,27109,1056,3.7
CN3907900000000,2023-04-01,39,079,OH,Jackson County,12493,11979,514,4.1
CN3908100000000,2023-04-01,39,081,OH,Jefferson County,27006,25821,1185,4.4
CN3908300000000,2023-04-01,39,083,OH,Knox County,31449,30472,977,3.1
CN3908500000000,2023-04-01,39,085,OH,Lake County,125478,121646,3832,3.1
CN3908700000000,2023-04-01,39,087,OH,Lawrence County,23369,22533,836,3.6
CN3908900000000,2023-04-01,39,089,OH,Licking County,92899,90379,2520,2.7
CN3909100000000,2023-04-01,39,091,OH,Logan County,22705,22107,598,2.6
CN3909300000000,2023-04-01,39,093,OH,Lorain County,154387,149025,5362,3.5
CN3909500000000,2023-04-01,39,095,OH,Lucas County,204533,196659,7874,3.8
CN3909700000000,2023-04-01,39,097,OH,Madison County,21202,20642,560,2.6
CN3909900000000,2023-04-01,39,099,OH,Mahoning County,98499,94657,3842,3.9
CN3910100000000,2023-04-01,39,101,OH,Marion County,27416,26586,830,3
CN3910300000000,2023-04-01,39,103,OH,Medina County,98170,95492,2678,2.7
CN3910500000000,2023-04-01,39,105,OH,Meigs County,8703,8302,401,4.6
CN3910700000000,2023-04-01,39,107,OH,Mercer County,22709,22284,425,1.9
CN3910900000000,2023-04-01,39,109,OH,Miami County,54478,52943,1535,2.8
CN3911100000000,2023-04-01,39,111,OH,Monroe County,5166,4908,258,5
CN3911300000000,2023-04-01,39,113,OH,Montgomery County,250835,242342,8493,3.4
CN3911500000000,2023-04-01,39,115,OH,Morgan County,7044,6769,275,3.9
CN3911700000000,2023-04-01,39,117,OH,Morrow County,17154,16626,528,3.1
CN3911900000000,2023-04-01,39,119,OH,Muskingum County,41234,39742,1492,3.6
CN3912100000000,2023-04-01,39,121,OH,Noble County,4609,4418,191,4.1
CN3912300000000,2023-04-01,39,123,OH,Ottawa County,20492,19546,946,4.6
CN3912500000000,2023-04-01,39,125,OH,Paulding County,8689,8445,244,2.8
CN3912700000000,2023-04-01,39,127,OH,Perry County,16107,15540,567,3.5
CN3912900000000,2023-04-01,39,129,OH,Pickaway County,27006,26265,741,2.7
CN3913100000000,2023-04-01,39,131,OH,Pike County,11404,10923,481,4.2
CN3913300000000,2023-04-01,39,133,OH,Portage County,85374,82651,2723,3.2
CN3913500000000,2023-04-01,39,135,OH,Preble County,22096,21493,603,2.7
CN3913700000000,2023-04-01,39,137,OH,Putnam County,18900,18455,445,2.4
CN3913900000000,2023-04-01,39,139,OH,Richland County,50682,48722,1960,3.9
CN3914100000000,2023-04-01,39,141,OH,Ross County,35776,34684,1092,3.1
CN3914300000000,2023-04-01,39,143,OH,Sandusky County,29970,28981,989,3.3
CN3914500000000,2023-04-01,39,145,OH,Scioto County,30021,28661,1360,4.5
CN3914700000000,2023-04-01,39,147,OH,Seneca County,26742,25889,853,3.2
CN3914900000000,2023-04-01,39,149,OH,Shelby County,23666,23028,638,2.7
CN3915100000000,2023-04-01,39,151,OH,Stark County,181910,175960,5950,3.3
CN3915300000000,2023-04-01,39,153,OH,Summit County,265754,256881,8873,3.3
CN3915500000000,2023-04-01,39,155,OH,Trumbull County,83111,79796,3315,4
CN3915700000000,2023-04-01,39,157,OH,Tuscarawas County,44819,43495,1324,3
CN3915900000000,2023-04-01,39,159,OH,Union County,30436,29731,705,2.3
CN3916100000000,2023-04-01,39,161,OH,Van Wert County,14510,14161,349,2.4
CN3916300000000,2023-04-01,39,163,OH,Vinton County,5475,5236,239,4.4
CN3916500000000,2023-04-01,39,165,OH,Warren County,125923,122631,3292,2.6
CN3916700000000,2023-04-01,39,167,OH,Washington County,26707,25717,990,3.7
CN3916900000000,2023-04-01,39,169,OH,Wayne County,60281,58866,1415,2.3
CN3917100000000,2023-04-01,39,171,OH,Williams County,18227,17715,512,2.8
CN3917300000000,2023-04-01,39,173,OH,Wood County,69708,67739,1969,2.8
CN3917500000000,2023-04-01,39,175,OH,Wyandot County,13376,13103,273,2
CN4000100000000,2023-04-01,40,001,OK,Adair County,8639,8424,215,2.5
CN4000300000000,2023-04-01,40,003,OK,Alfalfa County,2712,2659,53,2
CN4000500000000,2023-04-01,40,005,OK,Atoka County,5135,5004,131,2.6
CN4000700000000,2023-04-01,40,007,OK,Beaver County,2759,2723,36,1.3
CN4000900000000,2023-04-01,40,009,OK,Beckham County,10171,9958,213,2.1
CN4001100000000,2023-04-01,40,011,OK,Blaine County,4344,4282,62,1.4
CN4001300000000,2023-04-01,40,013,OK,Bryan County,23461,22990,471,2
CN4001500000000,2023-04-01,40,015,OK,Caddo County,11770,11487,283,2.4
CN4001700000000,2023-04-01,40,017,OK,Canadian County,82285,80770,1515,1.8
CN4001900000000,2023-04-01,40,019,OK,Carter County,21705,21119,586,2.7
CN4002100000000,2023-04-01,40,021,OK,Cherokee County,20527,20072,455,2.2
CN4002300000000,2023-04-01,40,023,OK,Choctaw County,6099,5902,197,3.2
CN4002500000000,2023-04-01,40,025,OK,Cimarron County,1590,1573,17,1.1
CN4002700000000,2023-04-01,40,027,OK,Cleveland County,151883,149062,2821,1.9
CN4002900000000,2023-04-01,40,029,OK,Coal County,2378,2307,71,3
CN4003100000000,2023-04-01,40,031,OK,Comanche County,47905,46665,1240,2.6
CN4003300000000,2023-04-01,40,033,OK,Cotton County,2697,2643,54,2
CN4003500000000,2023-04-01,40,035,OK,Craig County,5880,5736,144,2.4
CN4003700000000,2023-04-01,40,037,OK,Creek County,31831,31071,760,2.4
CN4003900000000,2023-04-01,40,039,OK,Custer County,15297,15025,272,1.8
CN4004100000000,2023-04-01,40,041,OK,Delaware County,20077,19632,445,2.2
CN4004300000000,2023-04-01,40,043,OK,Dewey County,3067,3027,40,1.3
CN4004500000000,2023-04-01,40,045,OK,Ellis County,2152,2122,30,1.4
CN4004700000000,2023-04-01,40,047,OK,Garfield County,26428,25864,564,2.1
CN4004900000000,2023-04-01,40,049,OK,Garvin County,12724,12445,279,2.2
CN4005100000000,2023-04-01,40,051,OK,Grady County,27943,27379,564,2
CN4005300000000,2023-04-01,40,053,OK,Grant County,2724,2682,42,1.5
CN4005500000000,2023-04-01,40,055,OK,Greer County,1833,1784,49,2.7
CN4005700000000,2023-04-01,40,057,OK,Harmon County,1185,1165,20,1.7
CN4005900000000,2023-04-01,40,059,OK,Harper County,1822,1793,29,1.6
CN4006100000000,2023-04-01,40,061,OK,Haskell County,4241,4104,137,3.2
CN4006300000000,2023-04-01,40,063,OK,Hughes County,5166,5029,137,2.7
CN4006500000000,2023-04-01,40,065,OK,Jackson County,10805,10588,217,2
CN4006700000000,2023-04-01,40,067,OK,Jefferson County,2502,2445,57,2.3
CN4006900000000,2023-04-01,40,069,OK,Johnston County,4062,3959,103,2.5
CN4007100000000,2023-04-01,40,071,OK,Kay County,18661,18208,453,2.4
CN4007300000000,2023-04-01,40,073,OK,Kingfisher County,9067,8928,139,1.5
CN4007500000000,2023-04-01,40,075,OK,Kiowa County,3734,3640,94,2.5
CN4007700000000,2023-04-01,40,077,OK,Latimer County,3116,2993,123,3.9
CN4007900000000,2023-04-01,40,079,OK,Le Flore County,19770,19258,512,2.6
CN4008100000000,2023-04-01,40,081,OK,Lincoln County,16598,16203,395,2.4
CN4008300000000,2023-04-01,40,083,OK,Logan County,23902,23408,494,2.1
CN4008500000000,2023-04-01,40,085,OK,Love County,5958,5864,94,1.6
CN4008700000000,2023-04-01,40,087,OK,McClain County,21370,20973,397,1.9
CN4008900000000,2023-04-01,40,089,OK,McCurtain County,16008,15543,465,2.9
CN4009100000000,2023-04-01,40,091,OK,McIntosh County,7403,7121,282,3.8
CN4009300000000,2023-04-01,40,093,OK,Major County,3791,3721,70,1.8
CN4009500000000,2023-04-01,40,095,OK,Marshall County,7427,7270,157,2.1
CN4009700000000,2023-04-01,40,097,OK,Mayes County,20304,19827,477,2.3
CN4009900000000,2023-04-01,40,099,OK,Murray County,6223,6100,123,2
CN4010100000000,2023-04-01,40,101,OK,Muskogee County,29192,28416,776,2.7
CN4010300000000,2023-04-01,40,103,OK,Noble County,6000,5890,110,1.8
CN4010500000000,2023-04-01,40,105,OK,Nowata County,4786,4679,107,2.2
CN4010700000000,2023-04-01,40,107,OK,Okfuskee County,4501,4364,137,3
CN4010900000000,2023-04-01,40,109,OK,Oklahoma County,407611,398654,8957,2.2
CN4011100000000,2023-04-01,40,111,OK,Okmulgee County,15754,15266,488,3.1
CN4011300000000,2023-04-01,40,113,OK,Osage County,20745,20218,527,2.5
CN4011500000000,2023-04-01,40,115,OK,Ottawa County,15325,15014,311,2
CN4011700000000,2023-04-01,40,117,OK,Pawnee County,7455,7266,189,2.5
CN4011900000000,2023-04-01,40,119,OK,Payne County,39798,38994,804,2
CN4012100000000,2023-04-01,40,121,OK,Pittsburg County,16267,15761,506,3.1
CN4012300000000,2023-04-01,40,123,OK,Pontotoc County,19754,19351,403,2
CN4012500000000,2023-04-01,40,125,OK,Pottawatomie County,33692,32843,849,2.5
CN4012700000000,2023-04-01,40,127,OK,Pushmataha County,4524,4398,126,2.8
CN4012900000000,2023-04-01,40,129,OK,Roger Mills County,1827,1798,29,1.6
CN4013100000000,2023-04-01,40,131,OK,Rogers County,46072,45138,934,2
CN4013300000000,2023-04-01,40,133,OK,Seminole County,9337,9044,293,3.1
CN4013500000000,2023-04-01,40,135,OK,Sequoyah County,17046,16622,424,2.5
CN4013700000000,2023-04-01,40,137,OK,Stephens County,19615,19147,468,2.4
CN4013900000000,2023-04-01,40,139,OK,Texas County,11921,11776,145,1.2
CN4014100000000,2023-04-01,40,141,OK,Tillman County,2934,2818,116,4
CN4014300000000,2023-04-01,40,143,OK,Tulsa County,331491,324122,7369,2.2
CN4014500000000,2023-04-01,40,145,OK,Wagoner County,39737,38865,872,2.2
CN4014700000000,2023-04-01,40,147,OK,Washington County,22538,22000,538,2.4
CN4014900000000,2023-04-01,40,149,OK,Washita County,5340,5237,103,1.9
CN4015100000000,2023-04-01,40,151,OK,Woods County,4459,4403,56,1.3
CN4015300000000,2023-04-01,40,153,OK,Woodward County,8937,8751,186,2.1
CN4100100000000,2023-04-01,41,001,OR,Baker County,7177,6945,232,3.2
CN4100300000000,2023-04-01,41,003,OR,Benton County,49302,48246,1056,2.1
CN4100500000000,2023-04-01,41,005,OR,Clackamas County,222906,217272,5634,2.5
CN4100700000000,2023-04-01,41,007,OR,Clatsop County,18821,18290,531,2.8
CN4100900000000,2023-04-01,41,009,OR,Columbia County,24669,23846,823,3.3
CN4101100000000,2023-04-01,41,011,OR,Coos County,25776,24858,918,3.6
CN4101300000000,2023-04-01,41,013,OR,Crook County,11029,10547,482,4.4
CN4101500000000,2023-04-01,41,015,OR,Curry County,8796,8492,304,3.5
CN4101700000000,2023-04-01,41,017,OR,Deschutes County,100353,97472,2881,2.9
CN4101900000000,2023-04-01,41,019,OR,Douglas County,45685,43981,1704,3.7
CN4102100000000,2023-04-01,41,021,OR,Gilliam County,906,881,25,2.8
CN4102300000000,2023-04-01,41,023,OR,Grant County,3103,2938,165,5.3
CN4102500000000,2023-04-01,41,025,OR,Harney County,3734,3618,116,3.1
CN4102700000000,2023-04-01,41,027,OR,Hood River County,13269,12966,303,2.3
CN4102900000000,2023-04-01,41,029,OR,Jackson County,103844,100276,3568,3.4
CN4103100000000,2023-04-01,41,031,OR,Jefferson County,10072,9716,356,3.5
CN4103300000000,2023-04-01,41,033,OR,Josephine County,35683,34314,1369,3.8
CN4103500000000,2023-04-01,41,035,OR,Klamath County,29015,27830,1185,4.1
CN4103700000000,2023-04-01,41,037,OR,Lake County,3585,3412,173,4.8
CN4103900000000,2023-04-01,41,039,OR,Lane County,177515,172123,5392,3
CN4104100000000,2023-04-01,41,041,OR,Lincoln County,20417,19750,667,3.3
CN4104300000000,2023-04-01,41,043,OR,Linn County,59749,57881,1868,3.1
CN4104500000000,2023-04-01,41,045,OR,Malheur County,12527,12176,351,2.8
CN4104700000000,2023-04-01,41,047,OR,Marion County,166992,162232,4760,2.9
CN4104900000000,2023-04-01,41,049,OR,Morrow County,5854,5706,148,2.5
CN4105100000000,2023-04-01,41,051,OR,Multnomah County,460497,448239,12258,2.7
CN4105300000000,2023-04-01,41,053,OR,Polk County,41943,40690,1253,3
CN4105500000000,2023-04-01,41,055,OR,Sherman County,956,926,30,3.1
CN4105700000000,2023-04-01,41,057,OR,Tillamook County,11912,11566,346,2.9
CN4105900000000,2023-04-01,41,059,OR,Umatilla County,36823,35725,1098,3
CN4106100000000,2023-04-01,41,061,OR,Union County,11792,11426,366,3.1
CN4106300000000,2023-04-01,41,063,OR,Wallowa County,3486,3338,148,4.2
CN4106500000000,2023-04-01,41,065,OR,Wasco County,12383,11975,408,3.3
CN4106700000000,2023-04-01,41,067,OR,Washington County,329788,321804,7984,2.4
CN4106900000000,2023-04-01,41,069,OR,Wheeler County,737,721,16,2.2
CN4107100000000,2023-04-01,41,071,OR,Yamhill County,55424,53952,1472,2.7
CN4200100000000,2023-04-01,42,001,PA,Adams County,54818,53551,1267,2.3
CN4200300000000,2023-04-01,42,003,PA,Allegheny County,628723,609447,19276,3.1
CN4200500000000,2023-04-01,42,005,PA,Armstrong County,30747,29730,1017,3.3
CN4200700000000,2023-04-01,42,007,PA,Beaver County,81222,78095,3127,3.8
CN4200900000000,2023-04-01,42,009,PA,Bedford County,24037,23238,799,3.3
CN4201100000000,2023-04-01,42,011,PA,Berks County,212078,205267,6811,3.2
CN4201300000000,2023-04-01,42,013,PA,Blair County,58198,56447,1751,3
CN4201500000000,2023-04-01,42,015,PA,Bradford County,27529,26684,845,3.1
CN4201700000000,2023-04-01,42,017,PA,Bucks County,351384,341408,9976,2.8
CN4201900000000,2023-04-01,42,019,PA,Butler County,98016,95274,2742,2.8
CN4202100000000,2023-04-01,42,021,PA,Cambria County,54496,52532,1964,3.6
CN4202300000000,2023-04-01,42,023,PA,Cameron County,1914,1808,106,5.5
CN4202500000000,2023-04-01,42,025,PA,Carbon County,32143,30915,1228,3.8
CN4202700000000,2023-04-01,42,027,PA,Centre County,79641,77763,1878,2.4
CN4202900000000,2023-04-01,42,029,PA,Chester County,296360,289456,6904,2.3
CN4203100000000,2023-04-01,42,031,PA,Clarion County,15697,15136,561,3.6
CN4203300000000,2023-04-01,42,033,PA,Clearfield County,34440,33149,1291,3.7
CN4203500000000,2023-04-01,42,035,PA,Clinton County,16709,16083,626,3.7
CN4203700000000,2023-04-01,42,037,PA,Columbia County,33906,32807,1099,3.2
CN4203900000000,2023-04-01,42,039,PA,Crawford County,37197,35959,1238,3.3
CN4204100000000,2023-04-01,42,041,PA,Cumberland County,135220,131954,3266,2.4
CN4204300000000,2023-04-01,42,043,PA,Dauphin County,146262,141987,4275,2.9
CN4204500000000,2023-04-01,42,045,PA,Delaware County,301746,292802,8944,3
CN4204700000000,2023-04-01,42,047,PA,Elk County,14030,13602,428,3.1
CN4204900000000,2023-04-01,42,049,PA,Erie County,123997,119675,4322,3.5
CN4205100000000,2023-04-01,42,051,PA,Fayette County,54392,52117,2275,4.2
CN4205300000000,2023-04-01,42,053,PA,Forest County,1619,1538,81,5
CN4205500000000,2023-04-01,42,055,PA,Franklin County,76832,74820,2012,2.6
CN4205700000000,2023-04-01,42,057,PA,Fulton County,7110,6908,202,2.8
CN4205900000000,2023-04-01,42,059,PA,Greene County,15115,14578,537,3.6
CN4206100000000,2023-04-01,42,061,PA,Huntingdon County,18981,18264,717,3.8
CN4206300000000,2023-04-01,42,063,PA,Indiana County,35615,34381,1234,3.5
CN4206500000000,2023-04-01,42,065,PA,Jefferson County,19047,18430,617,3.2
CN4206700000000,2023-04-01,42,067,PA,Juniata County,12246,11874,372,3
CN4206900000000,2023-04-01,42,069,PA,Lackawanna County,104670,101017,3653,3.5
CN4207100000000,2023-04-01,42,071,PA,Lancaster County,288549,281564,6985,2.4
CN4207300000000,2023-04-01,42,073,PA,Lawrence County,38279,36837,1442,3.8
CN4207500000000,2023-04-01,42,075,PA,Lebanon County,74060,72108,1952,2.6
CN4207700000000,2023-04-01,42,077,PA,Lehigh County,195196,188616,6580,3.4
CN4207900000000,2023-04-01,42,079,PA,Luzerne County,157523,151104,6419,4.1
CN4208100000000,2023-04-01,42,081,PA,Lycoming County,54801,53045,1756,3.2
CN4208300000000,2023-04-01,42,083,PA,McKean County,16329,15652,677,4.1
CN4208500000000,2023-04-01,42,085,PA,Mercer County,46605,45004,1601,3.4
CN4208700000000,2023-04-01,42,087,PA,Mifflin County,20787,20127,660,3.2
CN4208900000000,2023-04-01,42,089,PA,Monroe County,81343,77784,3559,4.4
CN4209100000000,2023-04-01,42,091,PA,Montgomery County,467821,455962,11859,2.5
CN4209300000000,2023-04-01,42,093,PA,Montour County,9246,9025,221,2.4
CN4209500000000,2023-04-01,42,095,PA,Northampton County,162621,157382,5239,3.2
CN4209700000000,2023-04-01,42,097,PA,Northumberland County,41242,39665,1577,3.8
CN4209900000000,2023-04-01,42,099,PA,Perry County,24702,24077,625,2.5
CN4210100000000,2023-04-01,42,101,PA,Philadelphia County/city,735670,706510,29160,4
CN4210300000000,2023-04-01,42,103,PA,Pike County,25441,24299,1142,4.5
CN4210500000000,2023-04-01,42,105,PA,Potter County,6675,6365,310,4.6
CN4210700000000,2023-04-01,42,107,PA,Schuylkill County,64810,62357,2453,3.8
CN4210900000000,2023-04-01,42,109,PA,Snyder County,19441,18847,594,3.1
CN4211100000000,2023-04-01,42,111,PA,Somerset County,31234,30114,1120,3.6
CN4211300000000,2023-04-01,42,113,PA,Sullivan County,2485,2391,94,3.8
CN4211500000000,2023-04-01,42,115,PA,Susquehanna County,19880,19263,617,3.1
CN4211700000000,2023-04-01,42,117,PA,Tioga County,18709,18005,704,3.8
CN4211900000000,2023-04-01,42,119,PA,Union County,19275,18800,475,2.5
CN4212100000000,2023-04-01,42,121,PA,Venango County,20582,19767,815,4
CN4212300000000,2023-04-01,42,123,PA,Warren County,17010,16426,584,3.4
CN4212500000000,2023-04-01,42,125,PA,Washington County,103874,100614,3260,3.1
CN4212700000000,2023-04-01,42,127,PA,Wayne County,21881,21022,859,3.9
CN4212900000000,2023-04-01,42,129,PA,Westmoreland County,174279,168786,5493,3.2
CN4213100000000,2023-04-01,42,131,PA,Wyoming County,13432,12968,464,3.5
CN4213300000000,2023-04-01,42,133,PA,York County,236347,230017,6330,2.7
CN4400100000000,2023-04-01,44,001,RI,Bristol County,26236,25708,528,2
CN4400300000000,2023-04-01,44,003,RI,Kent County,92551,90479,2072,2.2
CN4400500000000,2023-04-01,44,005,RI,Newport County,44609,43624,985,2.2
CN4400700000000,2023-04-01,44,007,RI,Providence County,330050,321196,8854,2.7
CN4400900000000,2023-04-01,44,009,RI,Washington County,69159,67798,1361,2
CN4500100000000,2023-04-01,45,001,SC,Abbeville County,9450,9161,289,3.1
CN4500300000000,2023-04-01,45,003,SC,Aiken County,74132,72370,1762,2.4
CN4500500000000,2023-04-01,45,005,SC,Allendale County,2331,2238,93,4
CN4500700000000,2023-04-01,45,007,SC,Anderson County,93454,91355,2099,2.2
CN4500900000000,2023-04-01,45,009,SC,Bamberg County,4536,4354,182,4
CN4501100000000,2023-04-01,45,011,SC,Barnwell County,7737,7488,249,3.2
CN4501300000000,2023-04-01,45,013,SC,Beaufort County,77517,75800,1717,2.2
CN4501500000000,2023-04-01,45,015,SC,Berkeley County,114874,112382,2492,2.2
CN4501700000000,2023-04-01,45,017,SC,Calhoun County,6476,6294,182,2.8
CN4501900000000,2023-04-01,45,019,SC,Charleston County,225781,221335,4446,2
CN4502100000000,2023-04-01,45,021,SC,Cherokee County,24176,23022,1154,4.8
CN4502300000000,2023-04-01,45,023,SC,Chester County,13574,13151,423,3.1
CN4502500000000,2023-04-01,45,025,SC,Chesterfield County,21441,20932,509,2.4
CN4502700000000,2023-04-01,45,027,SC,Clarendon County,12071,11674,397,3.3
CN4502900000000,2023-04-01,45,029,SC,Colleton County,16136,15716,420,2.6
CN4503100000000,2023-04-01,45,031,SC,Darlington County,30262,29474,788,2.6
CN4503300000000,2023-04-01,45,033,SC,Dillon County,12951,12452,499,3.9
CN4503500000000,2023-04-01,45,035,SC,Dorchester County,83311,81608,1703,2
CN4503700000000,2023-04-01,45,037,SC,Edgefield County,10389,10122,267,2.6
CN4503900000000,2023-04-01,45,039,SC,Fairfield County,9234,8942,292,3.2
CN4504100000000,2023-04-01,45,041,SC,Florence County,67366,65735,1631,2.4
CN4504300000000,2023-04-01,45,043,SC,Georgetown County,26369,25691,678,2.6
CN4504500000000,2023-04-01,45,045,SC,Greenville County,266138,260225,5913,2.2
CN4504700000000,2023-04-01,45,047,SC,Greenwood County,29627,28765,862,2.9
CN4504900000000,2023-04-01,45,049,SC,Hampton County,7959,7781,178,2.2
CN4505100000000,2023-04-01,45,051,SC,Horry County,156699,152380,4319,2.8
CN4505300000000,2023-04-01,45,053,SC,Jasper County,13399,13129,270,2
CN4505500000000,2023-04-01,45,055,SC,Kershaw County,29627,28907,720,2.4
CN4505700000000,2023-04-01,45,057,SC,Lancaster County,44460,43297,1163,2.6
CN4505900000000,2023-04-01,45,059,SC,Laurens County,30740,29931,809,2.6
CN4506100000000,2023-04-01,45,061,SC,Lee County,6372,6160,212,3.3
CN4506300000000,2023-04-01,45,063,SC,Lexington County,152952,149871,3081,2
CN4506500000000,2023-04-01,45,065,SC,McCormick County,3462,3365,97,2.8
CN4506700000000,2023-04-01,45,067,SC,Marion County,12719,12241,478,3.8
CN4506900000000,2023-04-01,45,069,SC,Marlboro County,7313,6817,496,6.8
CN4507100000000,2023-04-01,45,071,SC,Newberry County,19164,18761,403,2.1
CN4507300000000,2023-04-01,45,073,SC,Oconee County,35258,34498,760,2.2
CN4507500000000,2023-04-01,45,075,SC,Orangeburg County,33021,31864,1157,3.5
CN4507700000000,2023-04-01,45,077,SC,Pickens County,59378,57881,1497,2.5
CN4507900000000,2023-04-01,45,079,SC,Richland County,199247,194283,4964,2.5
CN4508100000000,2023-04-01,45,081,SC,Saluda County,8456,8257,199,2.4
CN4508300000000,2023-04-01,45,083,SC,Spartanburg County,157901,153974,3927,2.5
CN4508500000000,2023-04-01,45,085,SC,Sumter County,42400,41115,1285,3
CN4508700000000,2023-04-01,45,087,SC,Union County,11422,11006,416,3.6
CN4508900000000,2023-04-01,45,089,SC,Williamsburg County,10632,10239,393,3.7
CN4509100000000,2023-04-01,45,091,SC,York County,151487,147986,3501,2.3
CN4600300000000,2023-04-01,46,003,SD,Aurora County,1546,1521,25,1.6
CN4600500000000,2023-04-01,46,005,SD,Beadle County,9249,9067,182,2
CN4600700000000,2023-04-01,46,007,SD,Bennett County,1059,1024,35,3.3
CN4600900000000,2023-04-01,46,009,SD,Bon Homme County,2944,2889,55,1.9
CN4601100000000,2023-04-01,46,011,SD,Brookings County,19691,19255,436,2.2
CN4601300000000,2023-04-01,46,013,SD,Brown County,20120,19674,446,2.2
CN4601500000000,2023-04-01,46,015,SD,Brule County,2688,2641,47,1.7
CN4601700000000,2023-04-01,46,017,SD,Buffalo County,686,656,30,4.4
CN4601900000000,2023-04-01,46,019,SD,Butte County,5178,5073,105,2
CN4602100000000,2023-04-01,46,021,SD,Campbell County,780,762,18,2.3
CN4602300000000,2023-04-01,46,023,SD,Charles Mix County,3860,3777,83,2.2
CN4602500000000,2023-04-01,46,025,SD,Clark County,2037,1981,56,2.7
CN4602700000000,2023-04-01,46,027,SD,Clay County,7694,7520,174,2.3
CN4602900000000,2023-04-01,46,029,SD,Codington County,16214,15871,343,2.1
CN4603100000000,2023-04-01,46,031,SD,Corson County,1310,1276,34,2.6
CN4603300000000,2023-04-01,46,033,SD,Custer County,4291,4183,108,2.5
CN4603500000000,2023-04-01,46,035,SD,Davison County,11180,10985,195,1.7
CN4603700000000,2023-04-01,46,037,SD,Day County,2732,2642,90,3.3
CN4603900000000,2023-04-01,46,039,SD,Deuel County,2306,2233,73,3.2
CN4604100000000,2023-04-01,46,041,SD,Dewey County,2274,2193,81,3.6
CN4604300000000,2023-04-01,46,043,SD,Douglas County,1522,1495,27,1.8
CN4604500000000,2023-04-01,46,045,SD,Edmunds County,2033,1993,40,2
CN4604700000000,2023-04-01,46,047,SD,Fall River County,2995,2922,73,2.4
CN4604900000000,2023-04-01,46,049,SD,Faulk County,1116,1095,21,1.9
CN4605100000000,2023-04-01,46,051,SD,Grant County,4504,4369,135,3
CN4605300000000,2023-04-01,46,053,SD,Gregory County,2184,2144,40,1.8
CN4605500000000,2023-04-01,46,055,SD,Haakon County,1083,1062,21,1.9
CN4605700000000,2023-04-01,46,057,SD,Hamlin County,3674,3599,75,2
CN4605900000000,2023-04-01,46,059,SD,Hand County,1859,1830,29,1.6
CN4606100000000,2023-04-01,46,061,SD,Hanson County,1818,1783,35,1.9
CN4606300000000,2023-04-01,46,063,SD,Harding County,773,760,13,1.7
CN4606500000000,2023-04-01,46,065,SD,Hughes County,9830,9665,165,1.7
CN4606700000000,2023-04-01,46,067,SD,Hutchinson County,3697,3614,83,2.2
CN4606900000000,2023-04-01,46,069,SD,Hyde County,672,660,12,1.8
CN4607100000000,2023-04-01,46,071,SD,Jackson County,1213,1170,43,3.5
CN4607300000000,2023-04-01,46,073,SD,Jerauld County,1242,1225,17,1.4
CN4607500000000,2023-04-01,46,075,SD,Jones County,514,501,13,2.5
CN4607700000000,2023-04-01,46,077,SD,Kingsbury County,2775,2726,49,1.8
CN4607900000000,2023-04-01,46,079,SD,Lake County,6946,6804,142,2
CN4608100000000,2023-04-01,46,081,SD,Lawrence County,14061,13792,269,1.9
CN4608300000000,2023-04-01,46,083,SD,Lincoln County,38215,37587,628,1.6
CN4608500000000,2023-04-01,46,085,SD,Lyman County,1695,1646,49,2.9
CN4608700000000,2023-04-01,46,087,SD,McCook County,3199,3143,56,1.8
CN4608900000000,2023-04-01,46,089,SD,McPherson County,1012,989,23,2.3
CN4609100000000,2023-04-01,46,091,SD,Marshall County,2498,2423,75,3
CN4609300000000,2023-04-01,46,093,SD,Meade County,14628,14333,295,2
CN4609500000000,2023-04-01,46,095,SD,Mellette County,775,754,21,2.7
CN4609700000000,2023-04-01,46,097,SD,Miner County,1282,1264,18,1.4
CN4609900000000,2023-04-01,46,099,SD,Minnehaha County,118636,116435,2201,1.9
CN4610100000000,2023-04-01,46,101,SD,Moody County,4125,4048,77,1.9
CN4610200000000,2023-04-01,46,102,SD,Oglala Lakota County,3794,3629,165,4.3
CN4610300000000,2023-04-01,46,103,SD,Pennington County,60206,59082,1124,1.9
CN4610500000000,2023-04-01,46,105,SD,Perkins County,1466,1441,25,1.7
CN4610700000000,2023-04-01,46,107,SD,Potter County,1035,1009,26,2.5
CN4610900000000,2023-04-01,46,109,SD,Roberts County,4673,4513,160,3.4
CN4611100000000,2023-04-01,46,111,SD,Sanborn County,1237,1216,21,1.7
CN4611500000000,2023-04-01,46,115,SD,Spink County,3060,2981,79,2.6
CN4611700000000,2023-04-01,46,117,SD,Stanley County,1939,1904,35,1.8
CN4611900000000,2023-04-01,46,119,SD,Sully County,836,824,12,1.4
CN4612100000000,2023-04-01,46,121,SD,Todd County,2950,2849,101,3.4
CN4612300000000,2023-04-01,46,123,SD,Tripp County,3140,3087,53,1.7
CN4612500000000,2023-04-01,46,125,SD,Turner County,4862,4775,87,1.8
CN4612700000000,2023-04-01,46,127,SD,Union County,8913,8740,173,1.9
CN4612900000000,2023-04-01,46,129,SD,Walworth County,2098,2025,73,3.5
CN4613500000000,2023-04-01,46,135,SD,Yankton County,11876,11667,209,1.8
CN4613700000000,2023-04-01,46,137,SD,Ziebach County,972,937,35,3.6
CN4700100000000,2023-04-01,47,001,TN,Anderson County,35408,34540,868,2.5
CN4700300000000,2023-04-01,47,003,TN,Bedford County,21690,21137,553,2.5
CN4700500000000,2023-04-01,47,005,TN,Benton County,6695,6472,223,3.3
CN4700700000000,2023-04-01,47,007,TN,Bledsoe County,4371,4168,203,4.6
CN4700900000000,2023-04-01,47,009,TN,Blount County,65755,64225,1530,2.3
CN4701100000000,2023-04-01,47,011,TN,Bradley County,49969,48572,1397,2.8
CN4701300000000,2023-04-01,47,013,TN,Campbell County,14992,14499,493,3.3
CN4701500000000,2023-04-01,47,015,TN,Cannon County,6918,6771,147,2.1
CN4701700000000,2023-04-01,47,017,TN,Carroll County,11600,11251,349,3
CN4701900000000,2023-04-01,47,019,TN,Carter County,24038,23346,692,2.9
CN4702100000000,2023-04-01,47,021,TN,Cheatham County,22793,22325,468,2.1
CN4702300000000,2023-04-01,47,023,TN,Chester County,8452,8234,218,2.6
CN4702500000000,2023-04-01,47,025,TN,Claiborne County,12668,12298,370,2.9
CN4702700000000,2023-04-01,47,027,TN,Clay County,2768,2667,101,3.6
CN4702900000000,2023-04-01,47,029,TN,Cocke County,14488,13983,505,3.5
CN4703100000000,2023-04-01,47,031,TN,Coffee County,24967,24305,662,2.7
CN4703300000000,2023-04-01,47,033,TN,Crockett County,6723,6548,175,2.6
CN4703500000000,2023-04-01,47,035,TN,Cumberland County,23229,22516,713,3.1
CN4703700000000,2023-04-01,47,037,TN,Davidson County,417814,409021,8793,2.1
CN4703900000000,2023-04-01,47,039,TN,Decatur County,4391,4248,143,3.3
CN4704100000000,2023-04-01,47,041,TN,DeKalb County,8049,7817,232,2.9
CN4704300000000,2023-04-01,47,043,TN,Dickson County,28208,27604,604,2.1
CN4704500000000,2023-04-01,47,045,TN,Dyer County,16473,16024,449,2.7
CN4704700000000,2023-04-01,47,047,TN,Fayette County,18841,18303,538,2.9
CN4704900000000,2023-04-01,47,049,TN,Fentress County,7765,7534,231,3
CN4705100000000,2023-04-01,47,051,TN,Franklin County,18853,18342,511,2.7
CN4705300000000,2023-04-01,47,053,TN,Gibson County,21379,20807,572,2.7
CN4705500000000,2023-04-01,47,055,TN,Giles County,14709,14340,369,2.5
CN4705700000000,2023-04-01,47,057,TN,Grainger County,9695,9418,277,2.9
CN4705900000000,2023-04-01,47,059,TN,Greene County,28294,27443,851,3
CN4706100000000,2023-04-01,47,061,TN,Grundy County,4968,4792,176,3.5
CN4706300000000,2023-04-01,47,063,TN,Hamblen County,27987,27210,777,2.8
CN4706500000000,2023-04-01,47,065,TN,Hamilton County,183987,179220,4767,2.6
CN4706700000000,2023-04-01,47,067,TN,Hancock County,2272,2200,72,3.2
CN4706900000000,2023-04-01,47,069,TN,Hardeman County,8813,8501,312,3.5
CN4707100000000,2023-04-01,47,071,TN,Hardin County,9916,9597,319,3.2
CN4707300000000,2023-04-01,47,073,TN,Hawkins County,23096,22397,699,3
CN4707500000000,2023-04-01,47,075,TN,Haywood County,7426,7128,298,4
CN4707700000000,2023-04-01,47,077,TN,Henderson County,11610,11277,333,2.9
CN4707900000000,2023-04-01,47,079,TN,Henry County,13333,12932,401,3
CN4708100000000,2023-04-01,47,081,TN,Hickman County,11832,11564,268,2.3
CN4708300000000,2023-04-01,47,083,TN,Houston County,3201,3092,109,3.4
CN4708500000000,2023-04-01,47,085,TN,Humphreys County,8579,8364,215,2.5
CN4708700000000,2023-04-01,47,087,TN,Jackson County,4785,4634,151,3.2
CN4708900000000,2023-04-01,47,089,TN,Jefferson County,24833,24176,657,2.6
CN4709100000000,2023-04-01,47,091,TN,Johnson County,7429,7248,181,2.4
CN4709300000000,2023-04-01,47,093,TN,Knox County,252343,246934,5409,2.1
CN4709500000000,2023-04-01,47,095,TN,Lake County,1563,1507,56,3.6
CN4709700000000,2023-04-01,47,097,TN,Lauderdale County,9289,8930,359,3.9
CN4709900000000,2023-04-01,47,099,TN,Lawrence County,19191,18659,532,2.8
CN4710100000000,2023-04-01,47,101,TN,Lewis County,5528,5387,141,2.6
CN4710300000000,2023-04-01,47,103,TN,Lincoln County,16577,16144,433,2.6
CN4710500000000,2023-04-01,47,105,TN,Loudon County,24424,23806,618,2.5
CN4710700000000,2023-04-01,47,107,TN,McMinn County,21044,20294,750,3.6
CN4710900000000,2023-04-01,47,109,TN,McNairy County,8407,8098,309,3.7
CN4711100000000,2023-04-01,47,111,TN,Macon County,11704,11409,295,2.5
CN4711300000000,2023-04-01,47,113,TN,Madison County,48496,47237,1259,2.6
CN4711500000000,2023-04-01,47,115,TN,Marion County,12322,11942,380,3.1
CN4711700000000,2023-04-01,47,117,TN,Marshall County,15758,15353,405,2.6
CN4711900000000,2023-04-01,47,119,TN,Maury County,53506,52311,1195,2.2
CN4712100000000,2023-04-01,47,121,TN,Meigs County,5195,4956,239,4.6
CN4712300000000,2023-04-01,47,123,TN,Monroe County,20826,20259,567,2.7
CN4712500000000,2023-04-01,47,125,TN,Montgomery County,89162,86558,2604,2.9
CN4712700000000,2023-04-01,47,127,TN,Moore County,3789,3714,75,2
CN4712900000000,2023-04-01,47,129,TN,Morgan County,7888,7643,245,3.1
CN4713100000000,2023-04-01,47,131,TN,Obion County,12787,12410,377,2.9
CN4713300000000,2023-04-01,47,133,TN,Overton County,9917,9649,268,2.7
CN4713500000000,2023-04-01,47,135,TN,Perry County,2726,2622,104,3.8
CN4713700000000,2023-04-01,47,137,TN,Pickett County,2122,2066,56,2.6
CN4713900000000,2023-04-01,47,139,TN,Polk County,7013,6790,223,3.2
CN4714100000000,2023-04-01,47,141,TN,Putnam County,35313,34356,957,2.7
CN4714300000000,2023-04-01,47,143,TN,Rhea County,13801,13325,476,3.4
CN4714500000000,2023-04-01,47,145,TN,Roane County,23845,23178,667,2.8
CN4714700000000,2023-04-01,47,147,TN,Robertson County,39575,38748,827,2.1
CN4714900000000,2023-04-01,47,149,TN,Rutherford County,198316,194184,4132,2.1
CN4715100000000,2023-04-01,47,151,TN,Scott County,7956,7658,298,3.7
CN4715300000000,2023-04-01,47,153,TN,Sequatchie County,6146,5960,186,3
CN4715500000000,2023-04-01,47,155,TN,Sevier County,54723,53536,1187,2.2
CN4715700000000,2023-04-01,47,157,TN,Shelby County,430092,415087,15005,3.5
CN4715900000000,2023-04-01,47,159,TN,Smith County,9833,9609,224,2.3
CN4716100000000,2023-04-01,47,161,TN,Stewart County,5603,5432,171,3.1
CN4716300000000,2023-04-01,47,163,TN,Sullivan County,68621,66756,1865,2.7
CN4716500000000,2023-04-01,47,165,TN,Sumner County,109991,107703,2288,2.1
CN4716700000000,2023-04-01,47,167,TN,Tipton County,27145,26368,777,2.9
CN4716900000000,2023-04-01,47,169,TN,Trousdale County,5787,5648,139,2.4
CN4717100000000,2023-04-01,47,171,TN,Unicoi County,7020,6786,234,3.3
CN4717300000000,2023-04-01,47,173,TN,Union County,7826,7619,207,2.6
CN4717500000000,2023-04-01,47,175,TN,Van Buren County,2115,2040,75,3.5
CN4717700000000,2023-04-01,47,177,TN,Warren County,16231,15744,487,3
CN4717900000000,2023-04-01,47,179,TN,Washington County,61533,59958,1575,2.6
CN4718100000000,2023-04-01,47,181,TN,Wayne County,6469,6264,205,3.2
CN4718300000000,2023-04-01,47,183,TN,Weakley County,15366,14959,407,2.6
CN4718500000000,2023-04-01,47,185,TN,White County,11879,11552,327,2.8
CN4718700000000,2023-04-01,47,187,TN,Williamson County,139755,137054,2701,1.9
CN4718900000000,2023-04-01,47,189,TN,Wilson County,83063,81285,1778,2.1
CN4800100000000,2023-04-01,48,001,TX,Anderson County,23406,22668,738,3.2
CN4800300000000,2023-04-01,48,003,TX,Andrews County,9875,9620,255,2.6
CN4800500000000,2023-04-01,48,005,TX,Angelina County,35682,34243,1439,4
CN4800700000000,2023-04-01,48,007,TX,Aransas County,9397,8954,443,4.7
CN4800900000000,2023-04-01,48,009,TX,Archer County,4069,3940,129,3.2
CN4801100000000,2023-04-01,48,011,TX,Armstrong County,962,932,30,3.1
CN4801300000000,2023-04-01,48,013,TX,Atascosa County,23049,22226,823,3.6
CN4801500000000,2023-04-01,48,015,TX,Austin County,14408,13921,487,3.4
CN4801700000000,2023-04-01,48,017,TX,Bailey County,2456,2354,102,4.2
CN4801900000000,2023-04-01,48,019,TX,Bandera County,10860,10509,351,3.2
CN4802100000000,2023-04-01,48,021,TX,Bastrop County,49429,47888,1541,3.1
CN4802300000000,2023-04-01,48,023,TX,Baylor County,1976,1929,47,2.4
CN4802500000000,2023-04-01,48,025,TX,Bee County,9287,8841,446,4.8
CN4802700000000,2023-04-01,48,027,TX,Bell County,151937,145729,6208,4.1
CN4802900000000,2023-04-01,48,029,TX,Bexar County,1004875,969968,34907,3.5
CN4803100000000,2023-04-01,48,031,TX,Blanco County,7288,7097,191,2.6
CN4803300000000,2023-04-01,48,033,TX,Borden County,798,787,11,1.4
CN4803500000000,2023-04-01,48,035,TX,Bosque County,8751,8461,290,3.3
CN4803700000000,2023-04-01,48,037,TX,Bowie County,38803,37247,1556,4
CN4803900000000,2023-04-01,48,039,TX,Brazoria County,188576,180910,7666,4.1
CN4804100000000,2023-04-01,48,041,TX,Brazos County,133153,129441,3712,2.8
CN4804300000000,2023-04-01,48,043,TX,Brewster County,4427,4299,128,2.9
CN4804500000000,2023-04-01,48,045,TX,Briscoe County,601,581,20,3.3
CN4804700000000,2023-04-01,48,047,TX,Brooks County,2373,2265,108,4.6
CN4804900000000,2023-04-01,48,049,TX,Brown County,15415,14823,592,3.8
CN4805100000000,2023-04-01,48,051,TX,Burleson County,9163,8861,302,3.3
CN4805300000000,2023-04-01,48,053,TX,Burnet County,26390,25634,756,2.9
CN4805500000000,2023-04-01,48,055,TX,Caldwell County,21835,21135,700,3.2
CN4805700000000,2023-04-01,48,057,TX,Calhoun County,12407,12038,369,3
CN4805900000000,2023-04-01,48,059,TX,Callahan County,6348,6145,203,3.2
CN4806100000000,2023-04-01,48,061,TX,Cameron County,180649,171331,9318,5.2
CN4806300000000,2023-04-01,48,063,TX,Camp County,5097,4895,202,4
CN4806500000000,2023-04-01,48,065,TX,Carson County,3076,2989,87,2.8
CN4806700000000,2023-04-01,48,067,TX,Cass County,11906,11393,513,4.3
CN4806900000000,2023-04-01,48,069,TX,Castro County,3376,3280,96,2.8
CN4807100000000,2023-04-01,48,071,TX,Chambers County,21531,20439,1092,5.1
CN4807300000000,2023-04-01,48,073,TX,Cherokee County,20726,19867,859,4.1
CN4807500000000,2023-04-01,48,075,TX,Childress County,3399,3316,83,2.4
CN4807700000000,2023-04-01,48,077,TX,Clay County,4929,4757,172,3.5
CN4807900000000,2023-04-01,48,079,TX,Cochran County,1164,1121,43,3.7
CN4808100000000,2023-04-01,48,081,TX,Coke County,1564,1518,46,2.9
CN4808300000000,2023-04-01,48,083,TX,Coleman County,3123,2989,134,4.3
CN4808500000000,2023-04-01,48,085,TX,Collin County,644694,623961,20733,3.2
CN4808700000000,2023-04-01,48,087,TX,Collingsworth County,1080,1044,36,3.3
CN4808900000000,2023-04-01,48,089,TX,Colorado County,10378,10044,334,3.2
CN4809100000000,2023-04-01,48,091,TX,Comal County,84340,81579,2761,3.3
CN4809300000000,2023-04-01,48,093,TX,Comanche County,6585,6385,200,3
CN4809500000000,2023-04-01,48,095,TX,Concho County,1307,1266,41,3.1
CN4809700000000,2023-04-01,48,097,TX,Cooke County,20574,19968,606,2.9
CN4809900000000,2023-04-01,48,099,TX,Coryell County,25099,24068,1031,4.1
CN4810100000000,2023-04-01,48,101,TX,Cottle County,1094,1070,24,2.2
CN4810300000000,2023-04-01,48,103,TX,Crane County,1698,1627,71,4.2
CN4810500000000,2023-04-01,48,105,TX,Crockett County,1437,1390,47,3.3
CN4810700000000,2023-04-01,48,107,TX,Crosby County,2472,2376,96,3.9
CN4810900000000,2023-04-01,48,109,TX,Culberson County,1255,1222,33,2.6
CN4811100000000,2023-04-01,48,111,TX,Dallam County,3882,3794,88,2.3
CN4811300000000,2023-04-01,48,113,TX,Dallas County,1461714,1409033,52681,3.6
CN4811500000000,2023-04-01,48,115,TX,Dawson County,4543,4365,178,3.9
CN4811700000000,2023-04-01,48,117,TX,Deaf Smith County,9297,9031,266,2.9
CN4811900000000,2023-04-01,48,119,TX,Delta County,2560,2455,105,4.1
CN4812100000000,2023-04-01,48,121,TX,Denton County,568629,550333,18296,3.2
CN4812300000000,2023-04-01,48,123,TX,DeWitt County,9127,8851,276,3
CN4812500000000,2023-04-01,48,125,TX,Dickens County,711,681,30,4.2
CN4812700000000,2023-04-01,48,127,TX,Dimmit County,6185,5983,202,3.3
CN4812900000000,2023-04-01,48,129,TX,Donley County,1533,1487,46,3
CN4813100000000,2023-04-01,48,131,TX,Duval County,5115,4918,197,3.9
CN4813300000000,2023-04-01,48,133,TX,Eastland County,6619,6349,270,4.1
CN4813500000000,2023-04-01,48,135,TX,Ector County,86306,83640,2666,3.1
CN4813700000000,2023-04-01,48,137,TX,Edwards County,1128,1099,29,2.6
CN4813900000000,2023-04-01,48,139,TX,Ellis County,106272,102718,3554,3.3
CN4814100000000,2023-04-01,48,141,TX,El Paso County,376781,361471,15310,4.1
CN4814300000000,2023-04-01,48,143,TX,Erath County,21966,21286,680,3.1
CN4814500000000,2023-04-01,48,145,TX,Falls County,7020,6745,275,3.9
CN4814700000000,2023-04-01,48,147,TX,Fannin County,17661,17124,537,3
CN4814900000000,2023-04-01,48,149,TX,Fayette County,11984,11580,404,3.4
CN4815100000000,2023-04-01,48,151,TX,Fisher County,1697,1647,50,2.9
CN4815300000000,2023-04-01,48,153,TX,Floyd County,2447,2351,96,3.9
CN4815500000000,2023-04-01,48,155,TX,Foard County,546,523,23,4.2
CN4815700000000,2023-04-01,48,157,TX,Fort Bend County,428671,412786,15885,3.7
CN4815900000000,2023-04-01,48,159,TX,Franklin County,5585,5424,161,2.9
CN4816100000000,2023-04-01,48,161,TX,Freestone County,6392,6090,302,4.7
CN4816300000000,2023-04-01,48,163,TX,Frio County,9465,9181,284,3
CN4816500000000,2023-04-01,48,165,TX,Gaines County,10406,10127,279,2.7
CN4816700000000,2023-04-01,48,167,TX,Galveston County,172804,165910,6894,4
CN4816900000000,2023-04-01,48,169,TX,Garza County,1897,1838,59,3.1
CN4817100000000,2023-04-01,48,171,TX,Gillespie County,14955,14603,352,2.4
CN4817300000000,2023-04-01,48,173,TX,Glasscock County,958,937,21,2.2
CN4817500000000,2023-04-01,48,175,TX,Goliad County,3221,3106,115,3.6
CN4817700000000,2023-04-01,48,177,TX,Gonzales County,9559,9255,304,3.2
CN4817900000000,2023-04-01,48,179,TX,Gray County,7726,7441,285,3.7
CN4818100000000,2023-04-01,48,181,TX,Grayson County,67407,65031,2376,3.5
CN4818300000000,2023-04-01,48,183,TX,Gregg County,57653,55467,2186,3.8
CN4818500000000,2023-04-01,48,185,TX,Grimes County,11811,11321,490,4.1
CN4818700000000,2023-04-01,48,187,TX,Guadalupe County,87979,85216,2763,3.1
CN4818900000000,2023-04-01,48,189,TX,Hale County,11526,11028,498,4.3
CN4819100000000,2023-04-01,48,191,TX,Hall County,1086,1047,39,3.6
CN4819300000000,2023-04-01,48,193,TX,Hamilton County,3970,3850,120,3
CN4819500000000,2023-04-01,48,195,TX,Hansford County,2903,2838,65,2.2
CN4819700000000,2023-04-01,48,197,TX,Hardeman County,1859,1776,83,4.5
CN4819900000000,2023-04-01,48,199,TX,Hardin County,25435,24242,1193,4.7
CN4820100000000,2023-04-01,48,201,TX,Harris County,2393689,2298202,95487,4
CN4820300000000,2023-04-01,48,203,TX,Harrison County,29388,28190,1198,4.1
CN4820500000000,2023-04-01,48,205,TX,Hartley County,2598,2549,49,1.9
CN4820700000000,2023-04-01,48,207,TX,Haskell County,2811,2724,87,3.1
CN4820900000000,2023-04-01,48,209,TX,Hays County,142573,138272,4301,3
CN4821100000000,2023-04-01,48,211,TX,Hemphill County,1608,1558,50,3.1
CN4821300000000,2023-04-01,48,213,TX,Henderson County,39865,38136,1729,4.3
CN4821500000000,2023-04-01,48,215,TX,Hidalgo County,380407,359126,21281,5.6
CN4821700000000,2023-04-01,48,217,TX,Hill County,18644,17967,677,3.6
CN4821900000000,2023-04-01,48,219,TX,Hockley County,11027,10673,354,3.2
CN4822100000000,2023-04-01,48,221,TX,Hood County,30698,29646,1052,3.4
CN4822300000000,2023-04-01,48,223,TX,Hopkins County,18560,17992,568,3.1
CN4822500000000,2023-04-01,48,225,TX,Houston County,10533,10217,316,3
CN4822700000000,2023-04-01,48,227,TX,Howard County,12886,12403,483,3.7
CN4822900000000,2023-04-01,48,229,TX,Hudspeth County,1924,1857,67,3.5
CN4823100000000,2023-04-01,48,231,TX,Hunt County,48142,46323,1819,3.8
CN4823300000000,2023-04-01,48,233,TX,Hutchinson County,8424,8081,343,4.1
CN4823500000000,2023-04-01,48,235,TX,Irion County,803,780,23,2.9
CN4823700000000,2023-04-01,48,237,TX,Jack County,3493,3387,106,3
CN4823900000000,2023-04-01,48,239,TX,Jackson County,7088,6866,222,3.1
CN4824100000000,2023-04-01,48,241,TX,Jasper County,12796,12060,736,5.8
CN4824300000000,2023-04-01,48,243,TX,Jeff Davis County,987,957,30,3
CN4824500000000,2023-04-01,48,245,TX,Jefferson County,103457,97309,6148,5.9
CN4824700000000,2023-04-01,48,247,TX,Jim Hogg County,1791,1715,76,4.2
CN4824900000000,2023-04-01,48,249,TX,Jim Wells County,15648,14892,756,4.8
CN4825100000000,2023-04-01,48,251,TX,Johnson County,91669,88669,3000,3.3
CN4825300000000,2023-04-01,48,253,TX,Jones County,5926,5685,241,4.1
CN4825500000000,2023-04-01,48,255,TX,Karnes County,6756,6562,194,2.9
CN4825700000000,2023-04-01,48,257,TX,Kaufman County,77487,74539,2948,3.8
CN4825900000000,2023-04-01,48,259,TX,Kendall County,24366,23621,745,3.1
CN4826100000000,2023-04-01,48,261,TX,Kenedy County,134,126,8,6
CN4826300000000,2023-04-01,48,263,TX,Kent County,845,831,14,1.7
CN4826500000000,2023-04-01,48,265,TX,Kerr County,22269,21524,745,3.3
CN4826700000000,2023-04-01,48,267,TX,Kimble County,1804,1748,56,3.1
CN4826900000000,2023-04-01,48,269,TX,King County,640,635,5,0.8
CN4827100000000,2023-04-01,48,271,TX,Kinney County,1258,1206,52,4.1
CN4827300000000,2023-04-01,48,273,TX,Kleberg County,13231,12666,565,4.3
CN4827500000000,2023-04-01,48,275,TX,Knox County,1511,1462,49,3.2
CN4827700000000,2023-04-01,48,277,TX,Lamar County,24521,23549,972,4
CN4827900000000,2023-04-01,48,279,TX,Lamb County,5336,5137,199,3.7
CN4828100000000,2023-04-01,48,281,TX,Lampasas County,9597,9260,337,3.5
CN4828300000000,2023-04-01,48,283,TX,La Salle County,4176,4073,103,2.5
CN4828500000000,2023-04-01,48,285,TX,Lavaca County,9152,8864,288,3.1
CN4828700000000,2023-04-01,48,287,TX,Lee County,8436,8154,282,3.3
CN4828900000000,2023-04-01,48,289,TX,Leon County,6015,5734,281,4.7
CN4829100000000,2023-04-01,48,291,TX,Liberty County,35921,34101,1820,5.1
CN4829300000000,2023-04-01,48,293,TX,Limestone County,8469,8111,358,4.2
CN4829500000000,2023-04-01,48,295,TX,Lipscomb County,1457,1414,43,3
CN4829700000000,2023-04-01,48,297,TX,Live Oak County,4801,4620,181,3.8
CN4829900000000,2023-04-01,48,299,TX,Llano County,9495,9166,329,3.5
CN4830100000000,2023-04-01,48,301,TX,Loving County,1410,1405,5,0.4
CN4830300000000,2023-04-01,48,303,TX,Lubbock County,165818,160883,4935,3
CN4830500000000,2023-04-01,48,305,TX,Lynn County,2921,2833,88,3
CN4830700000000,2023-04-01,48,307,TX,McCulloch County,3099,2973,126,4.1
CN4830900000000,2023-04-01,48,309,TX,McLennan County,130098,125571,4527,3.5
CN4831100000000,2023-04-01,48,311,TX,McMullen County,873,861,12,1.4
CN4831300000000,2023-04-01,48,313,TX,Madison County,4812,4609,203,4.2
CN4831500000000,2023-04-01,48,315,TX,Marion County,4166,3982,184,4.4
CN4831700000000,2023-04-01,48,317,TX,Martin County,2922,2858,64,2.2
CN4831900000000,2023-04-01,48,319,TX,Mason County,1831,1770,61,3.3
CN4832100000000,2023-04-01,48,321,TX,Matagorda County,17946,17102,844,4.7
CN4832300000000,2023-04-01,48,323,TX,Maverick County,23805,21807,1998,8.4
CN4832500000000,2023-04-01,48,325,TX,Medina County,23277,22466,811,3.5
CN4832700000000,2023-04-01,48,327,TX,Menard County,855,828,27,3.2
CN4832900000000,2023-04-01,48,329,TX,Midland County,111149,108576,2573,2.3
CN4833100000000,2023-04-01,48,331,TX,Milam County,10414,10007,407,3.9
CN4833300000000,2023-04-01,48,333,TX,Mills County,1894,1827,67,3.5
CN4833500000000,2023-04-01,48,335,TX,Mitchell County,2311,2223,88,3.8
CN4833700000000,2023-04-01,48,337,TX,Montague County,9380,9061,319,3.4
CN4833900000000,2023-04-01,48,339,TX,Montgomery County,308783,297405,11378,3.7
CN4834100000000,2023-04-01,48,341,TX,Moore County,11319,11031,288,2.5
CN4834300000000,2023-04-01,48,343,TX,Morris County,4422,4176,246,5.6
CN4834500000000,2023-04-01,48,345,TX,Motley County,560,540,20,3.6
CN4834700000000,2023-04-01,48,347,TX,Nacogdoches County,27783,26678,1105,4
CN4834900000000,2023-04-01,48,349,TX,Navarro County,23496,22594,902,3.8
CN4835100000000,2023-04-01,48,351,TX,Newton County,5015,4672,343,6.8
CN4835300000000,2023-04-01,48,353,TX,Nolan County,6794,6565,229,3.4
CN4835500000000,2023-04-01,48,355,TX,Nueces County,166075,159353,6722,4
CN4835700000000,2023-04-01,48,357,TX,Ochiltree County,3889,3768,121,3.1
CN4835900000000,2023-04-01,48,359,TX,Oldham County,956,932,24,2.5
CN4836100000000,2023-04-01,48,361,TX,Orange County,35570,33704,1866,5.2
CN4836300000000,2023-04-01,48,363,TX,Palo Pinto County,13342,12882,460,3.4
CN4836500000000,2023-04-01,48,365,TX,Panola County,9688,9302,386,4
CN4836700000000,2023-04-01,48,367,TX,Parker County,76784,74419,2365,3.1
CN4836900000000,2023-04-01,48,369,TX,Parmer County,5225,5102,123,2.4
CN4837100000000,2023-04-01,48,371,TX,Pecos County,6576,6367,209,3.2
CN4837300000000,2023-04-01,48,373,TX,Polk County,18879,17958,921,4.9
CN4837500000000,2023-04-01,48,375,TX,Potter County,55933,54324,1609,2.9
CN4837700000000,2023-04-01,48,377,TX,Presidio County,3073,2895,178,5.8
CN4837900000000,2023-04-01,48,379,TX,Rains County,6706,6486,220,3.3
CN4838100000000,2023-04-01,48,381,TX,Randall County,77608,75478,2130,2.7
CN4838300000000,2023-04-01,48,383,TX,Reagan County,1614,1561,53,3.3
CN4838500000000,2023-04-01,48,385,TX,Real County,1165,1116,49,4.2
CN4838700000000,2023-04-01,48,387,TX,Red River County,5051,4832,219,4.3
CN4838900000000,2023-04-01,48,389,TX,Reeves County,8676,8336,340,3.9
CN4839100000000,2023-04-01,48,391,TX,Refugio County,2904,2790,114,3.9
CN4839300000000,2023-04-01,48,393,TX,Roberts County,396,382,14,3.5
CN4839500000000,2023-04-01,48,395,TX,Robertson County,8246,7962,284,3.4
CN4839700000000,2023-04-01,48,397,TX,Rockwall County,60999,58968,2031,3.3
CN4839900000000,2023-04-01,48,399,TX,Runnels County,4726,4562,164,3.5
CN4840100000000,2023-04-01,48,401,TX,Rusk County,22693,21853,840,3.7
CN4840300000000,2023-04-01,48,403,TX,Sabine County,3947,3721,226,5.7
CN4840500000000,2023-04-01,48,405,TX,San Augustine County,3152,2996,156,4.9
CN4840700000000,2023-04-01,48,407,TX,San Jacinto County,12200,11653,547,4.5
CN4840900000000,2023-04-01,48,409,TX,San Patricio County,29432,28092,1340,4.6
CN4841100000000,2023-04-01,48,411,TX,San Saba County,2230,2160,70,3.1
CN4841300000000,2023-04-01,48,413,TX,Schleicher County,1280,1245,35,2.7
CN4841500000000,2023-04-01,48,415,TX,Scurry County,6351,6122,229,3.6
CN4841700000000,2023-04-01,48,417,TX,Shackelford County,1790,1746,44,2.5
CN4841900000000,2023-04-01,48,419,TX,Shelby County,11158,10774,384,3.4
CN4842100000000,2023-04-01,48,421,TX,Sherman County,1427,1388,39,2.7
CN4842300000000,2023-04-01,48,423,TX,Smith County,113813,109972,3841,3.4
CN4842500000000,2023-04-01,48,425,TX,Somervell County,4689,4534,155,3.3
CN4842700000000,2023-04-01,48,427,TX,Starr County,24552,22290,2262,9.2
CN4842900000000,2023-04-01,48,429,TX,Stephens County,4103,3963,140,3.4
CN4843100000000,2023-04-01,48,431,TX,Sterling County,523,503,20,3.8
CN4843300000000,2023-04-01,48,433,TX,Stonewall County,798,780,18,2.3
CN4843500000000,2023-04-01,48,435,TX,Sutton County,966,910,56,5.8
CN4843700000000,2023-04-01,48,437,TX,Swisher County,2616,2508,108,4.1
CN4843900000000,2023-04-01,48,439,TX,Tarrant County,1174510,1134458,40052,3.4
CN4844100000000,2023-04-01,48,441,TX,Taylor County,69866,67742,2124,3
CN4844300000000,2023-04-01,48,443,TX,Terrell County,405,393,12,3
CN4844500000000,2023-04-01,48,445,TX,Terry County,4646,4481,165,3.6
CN4844700000000,2023-04-01,48,447,TX,Throckmorton County,640,617,23,3.6
CN4844900000000,2023-04-01,48,449,TX,Titus County,13928,13401,527,3.8
CN4845100000000,2023-04-01,48,451,TX,Tom Green County,56758,54924,1834,3.2
CN4845300000000,2023-04-01,48,453,TX,Travis County,847762,822004,25758,3
CN4845500000000,2023-04-01,48,455,TX,Trinity County,5442,5193,249,4.6
CN4845700000000,2023-04-01,48,457,TX,Tyler County,7144,6742,402,5.6
CN4845900000000,2023-04-01,48,459,TX,Upshur County,18043,17354,689,3.8
CN4846100000000,2023-04-01,48,461,TX,Upton County,2381,2328,53,2.2
CN4846300000000,2023-04-01,48,463,TX,Uvalde County,11127,10681,446,4
CN4846500000000,2023-04-01,48,465,TX,Val Verde County,21975,21070,905,4.1
CN4846700000000,2023-04-01,48,467,TX,Van Zandt County,28422,27513,909,3.2
CN4846900000000,2023-04-01,48,469,TX,Victoria County,41880,40289,1591,3.8
CN4847100000000,2023-04-01,48,471,TX,Walker County,24375,23346,1029,4.2
CN4847300000000,2023-04-01,48,473,TX,Waller County,26061,25009,1052,4
CN4847500000000,2023-04-01,48,475,TX,Ward County,6168,5980,188,3
CN4847700000000,2023-04-01,48,477,TX,Washington County,15308,14749,559,3.7
CN4847900000000,2023-04-01,48,479,TX,Webb County,119096,114513,4583,3.8
CN4848100000000,2023-04-01,48,481,TX,Wharton County,21776,20988,788,3.6
CN4848300000000,2023-04-01,48,483,TX,Wheeler County,1946,1878,68,3.5
CN4848500000000,2023-04-01,48,485,TX,Wichita County,56002,54033,1969,3.5
CN4848700000000,2023-04-01,48,487,TX,Wilbarger County,4834,4588,246,5.1
CN4848900000000,2023-04-01,48,489,TX,Willacy County,7487,6936,551,7.4
CN4849100000000,2023-04-01,48,491,TX,Williamson County,376342,364446,11896,3.2
CN4849300000000,2023-04-01,48,493,TX,Wilson County,26677,25869,808,3
CN4849500000000,2023-04-01,48,495,TX,Winkler County,4179,4047,132,3.2
CN4849700000000,2023-04-01,48,497,TX,Wise County,35283,34132,1151,3.3
CN4849900000000,2023-04-01,48,499,TX,Wood County,18457,17727,730,4
CN4850100000000,2023-04-01,48,501,TX,Yoakum County,3288,3180,108,3.3
CN4850300000000,2023-04-01,48,503,TX,Young County,8070,7818,252,3.1
CN4850500000000,2023-04-01,48,505,TX,Zapata County,4492,4222,270,6
CN4850700000000,2023-04-01,48,507,TX,Zavala County,3545,3307,238,6.7
CN4900100000000,2023-04-01,49,001,UT,Beaver County,3084,3012,72,2.3
CN4900300000000,2023-04-01,49,003,UT,Box Elder County,28605,28017,588,2.1
CN4900500000000,2023-04-01,49,005,UT,Cache County,73582,72193,1389,1.9
CN4900700000000,2023-04-01,49,007,UT,Carbon County,8555,8287,268,3.1
CN4900900000000,2023-04-01,49,009,UT,Daggett County,431,414,17,3.9
CN4901100000000,2023-04-01,49,011,UT,Davis County,188366,184479,3887,2.1
CN4901300000000,2023-04-01,49,013,UT,Duchesne County,8303,8095,208,2.5
CN4901500000000,2023-04-01,49,015,UT,Emery County,4606,4476,130,2.8
CN4901700000000,2023-04-01,49,017,UT,Garfield County,3218,3069,149,4.6
CN4901900000000,2023-04-01,49,019,UT,Grand County,7350,7193,157,2.1
CN4902100000000,2023-04-01,49,021,UT,Iron County,29430,28813,617,2.1
CN4902300000000,2023-04-01,49,023,UT,Juab County,6540,6410,130,2
CN4902500000000,2023-04-01,49,025,UT,Kane County,4188,4097,91,2.2
CN4902700000000,2023-04-01,49,027,UT,Millard County,6787,6652,135,2
CN4902900000000,2023-04-01,49,029,UT,Morgan County,6092,5991,101,1.7
CN4903100000000,2023-04-01,49,031,UT,Piute County,535,515,20,3.7
CN4903300000000,2023-04-01,49,033,UT,Rich County,1195,1162,33,2.8
CN4903500000000,2023-04-01,49,035,UT,Salt Lake County,695686,679807,15879,2.3
CN4903700000000,2023-04-01,49,037,UT,San Juan County,5799,5612,187,3.2
CN4903900000000,2023-04-01,49,039,UT,Sanpete County,14355,14015,340,2.4
CN4904100000000,2023-04-01,49,041,UT,Sevier County,10665,10421,244,2.3
CN4904300000000,2023-04-01,49,043,UT,Summit County,27686,27145,541,2
CN4904500000000,2023-04-01,49,045,UT,Tooele County,39204,38254,950,2.4
CN4904700000000,2023-04-01,49,047,UT,Uintah County,14768,14350,418,2.8
CN4904900000000,2023-04-01,49,049,UT,Utah County,351887,344219,7668,2.2
CN4905100000000,2023-04-01,49,051,UT,Wasatch County,18339,17949,390,2.1
CN4905300000000,2023-04-01,49,053,UT,Washington County,89538,87444,2094,2.3
CN4905500000000,2023-04-01,49,055,UT,Wayne County,1651,1599,52,3.1
CN4905700000000,2023-04-01,49,057,UT,Weber County,138509,135178,3331,2.4
CN5000100000000,2023-04-01,50,001,VT,Addison County,20841,20505,336,1.6
CN5000300000000,2023-04-01,50,003,VT,Bennington County,17437,17016,421,2.4
CN5000500000000,2023-04-01,50,005,VT,Caledonia County,14581,14241,340,2.3
CN5000700000000,2023-04-01,50,007,VT,Chittenden County,97914,96603,1311,1.3
CN5000900000000,2023-04-01,50,009,VT,Essex County,2603,2530,73,2.8
CN5001100000000,2023-04-01,50,011,VT,Franklin County,27799,27302,497,1.8
CN5001300000000,2023-04-01,50,013,VT,Grand Isle County,4133,4053,80,1.9
CN5001500000000,2023-04-01,50,015,VT,Lamoille County,14127,13722,405,2.9
CN5001700000000,2023-04-01,50,017,VT,Orange County,15610,15299,311,2
CN5001900000000,2023-04-01,50,019,VT,Orleans County,13299,12782,517,3.9
CN5002100000000,2023-04-01,50,021,VT,Rutland County,28994,28319,675,2.3
CN5002300000000,2023-04-01,50,023,VT,Washington County,33527,32953,574,1.7
CN5002500000000,2023-04-01,50,025,VT,Windham County,21050,20533,517,2.5
CN5002700000000,2023-04-01,50,027,VT,Windsor County,29741,29218,523,1.8
CN5100100000000,2023-04-01,51,001,VA,Accomack County,16037,15535,502,3.1
CN5100300000000,2023-04-01,51,003,VA,Albemarle County,60463,59174,1289,2.1
CN5100500000000,2023-04-01,51,005,VA,Alleghany County,6844,6652,192,2.8
CN5100700000000,2023-04-01,51,007,VA,Amelia County,6499,6332,167,2.6
CN5100900000000,2023-04-01,51,009,VA,Amherst County,15236,14824,412,2.7
CN5101100000000,2023-04-01,51,011,VA,Appomattox County,7345,7125,220,3
CN5101300000000,2023-04-01,51,013,VA,Arlington County,162190,159055,3135,1.9
CN5101500000000,2023-04-01,51,015,VA,Augusta County,39417,38556,861,2.2
CN5101700000000,2023-04-01,51,017,VA,Bath County,2570,2511,59,2.3
CN5101900000000,2023-04-01,51,019,VA,Bedford County,39590,38619,971,2.5
CN5102100000000,2023-04-01,51,021,VA,Bland County,2927,2846,81,2.8
CN5102300000000,2023-04-01,51,023,VA,Botetourt County,18268,17883,385,2.1
CN5102500000000,2023-04-01,51,025,VA,Brunswick County,6073,5824,249,4.1
CN5102700000000,2023-04-01,51,027,VA,Buchanan County,6368,6121,247,3.9
CN5102900000000,2023-04-01,51,029,VA,Buckingham County,6674,6469,205,3.1
CN5103100000000,2023-04-01,51,031,VA,Campbell County,26562,25819,743,2.8
CN5103300000000,2023-04-01,51,033,VA,Caroline County,15887,15457,430,2.7
CN5103500000000,2023-04-01,51,035,VA,Carroll County,13110,12700,410,3.1
CN5103600000000,2023-04-01,51,036,VA,Charles City County,3723,3619,104,2.8
CN5103700000000,2023-04-01,51,037,VA,Charlotte County,5700,5548,152,2.7
CN5104100000000,2023-04-01,51,041,VA,Chesterfield County,200733,195794,4939,2.5
CN5104300000000,2023-04-01,51,043,VA,Clarke County,7904,7734,170,2.2
CN5104500000000,2023-04-01,51,045,VA,Craig County,2398,2332,66,2.8
CN5104700000000,2023-04-01,51,047,VA,Culpeper County,26358,25724,634,2.4
CN5104900000000,2023-04-01,51,049,VA,Cumberland County,4968,4822,146,2.9
CN5105100000000,2023-04-01,51,051,VA,Dickenson County,4678,4504,174,3.7
CN5105300000000,2023-04-01,51,053,VA,Dinwiddie County,14284,13877,407,2.8
CN5105700000000,2023-04-01,51,057,VA,Essex County,5684,5510,174,3.1
CN5105900000000,2023-04-01,51,059,VA,Fairfax County,659543,645379,14164,2.1
CN5106100000000,2023-04-01,51,061,VA,Fauquier County,38879,38040,839,2.2
CN5106300000000,2023-04-01,51,063,VA,Floyd County,8870,8667,203,2.3
CN5106500000000,2023-04-01,51,065,VA,Fluvanna County,14825,14506,319,2.2
CN5106700000000,2023-04-01,51,067,VA,Franklin County,27409,26702,707,2.6
CN5106900000000,2023-04-01,51,069,VA,Frederick County,53180,52063,1117,2.1
CN5107100000000,2023-04-01,51,071,VA,Giles County,8475,8268,207,2.4
CN5107300000000,2023-04-01,51,073,VA,Gloucester County,20065,19589,476,2.4
CN5107500000000,2023-04-01,51,075,VA,Goochland County,12269,11980,289,2.4
CN5107700000000,2023-04-01,51,077,VA,Grayson County,8373,8175,198,2.4
CN5107900000000,2023-04-01,51,079,VA,Greene County,11103,10874,229,2.1
CN5108100000000,2023-04-01,51,081,VA,Greensville County,4419,4276,143,3.2
CN5108300000000,2023-04-01,51,083,VA,Halifax County,15831,15296,535,3.4
CN5108500000000,2023-04-01,51,085,VA,Hanover County,62250,60926,1324,2.1
CN5108700000000,2023-04-01,51,087,VA,Henrico County,192171,187377,4794,2.5
CN5108900000000,2023-04-01,51,089,VA,Henry County,24110,23370,740,3.1
CN5109100000000,2023-04-01,51,091,VA,Highland County,1521,1492,29,1.9
CN5109300000000,2023-04-01,51,093,VA,Isle of Wight County,20239,19757,482,2.4
CN5109500000000,2023-04-01,51,095,VA,James City County,38016,37097,919,2.4
CN5109700000000,2023-04-01,51,097,VA,King and Queen County,4114,4024,90,2.2
CN5109900000000,2023-04-01,51,099,VA,King George County,14709,14385,324,2.2
CN5110100000000,2023-04-01,51,101,VA,King William County,9927,9693,234,2.4
CN5110300000000,2023-04-01,51,103,VA,Lancaster County,5590,5361,229,4.1
CN5110500000000,2023-04-01,51,105,VA,Lee County,8413,8133,280,3.3
CN5110700000000,2023-04-01,51,107,VA,Loudoun County,239755,234635,5120,2.1
CN5110900000000,2023-04-01,51,109,VA,Louisa County,21494,20996,498,2.3
CN5111100000000,2023-04-01,51,111,VA,Lunenburg County,5277,5125,152,2.9
CN5111300000000,2023-04-01,51,113,VA,Madison County,7787,7641,146,1.9
CN5111500000000,2023-04-01,51,115,VA,Mathews County,4206,4105,101,2.4
CN5111700000000,2023-04-01,51,117,VA,Mecklenburg County,13490,13087,403,3
CN5111900000000,2023-04-01,51,119,VA,Middlesex County,5506,5370,136,2.5
CN5112100000000,2023-04-01,51,121,VA,Montgomery County,54341,53154,1187,2.2
CN5112500000000,2023-04-01,51,125,VA,Nelson County,7689,7510,179,2.3
CN5112700000000,2023-04-01,51,127,VA,New Kent County,13740,13434,306,2.2
CN5113100000000,2023-04-01,51,131,VA,Northampton County,5633,5446,187,3.3
CN5113300000000,2023-04-01,51,133,VA,Northumberland County,5739,5484,255,4.4
CN5113500000000,2023-04-01,51,135,VA,Nottoway County,7438,7257,181,2.4
CN5113700000000,2023-04-01,51,137,VA,Orange County,18011,17555,456,2.5
CN5113900000000,2023-04-01,51,139,VA,Page County,12552,12144,408,3.3
CN5114100000000,2023-04-01,51,141,VA,Patrick County,7162,6940,222,3.1
CN5114300000000,2023-04-01,51,143,VA,Pittsylvania County,30618,29781,837,2.7
CN5114500000000,2023-04-01,51,145,VA,Powhatan County,15228,14880,348,2.3
CN5114700000000,2023-04-01,51,147,VA,Prince Edward County,10279,9951,328,3.2
CN5114900000000,2023-04-01,51,149,VA,Prince George County,15919,15461,458,2.9
CN5115300000000,2023-04-01,51,153,VA,Prince William County,258727,252653,6074,2.3
CN5115500000000,2023-04-01,51,155,VA,Pulaski County,17394,16976,418,2.4
CN5115700000000,2023-04-01,51,157,VA,Rappahannock County,3846,3751,95,2.5
CN5115900000000,2023-04-01,51,159,VA,Richmond County,4125,4006,119,2.9
CN5116100000000,2023-04-01,51,161,VA,Roanoke County,51581,50471,1110,2.2
CN5116300000000,2023-04-01,51,163,VA,Rockbridge County,11273,11018,255,2.3
CN5116500000000,2023-04-01,51,165,VA,Rockingham County,44838,43908,930,2.1
CN5116700000000,2023-04-01,51,167,VA,Russell County,11082,10741,341,3.1
CN5116900000000,2023-04-01,51,169,VA,Scott County,9556,9278,278,2.9
CN5117100000000,2023-04-01,51,171,VA,Shenandoah County,22364,21837,527,2.4
CN5117300000000,2023-04-01,51,173,VA,Smyth County,13586,13220,366,2.7
CN5117500000000,2023-04-01,51,175,VA,Southampton County,9046,8848,198,2.2
CN5117700000000,2023-04-01,51,177,VA,Spotsylvania County,71602,69743,1859,2.6
CN5117900000000,2023-04-01,51,179,VA,Stafford County,77963,76037,1926,2.5
CN5118100000000,2023-04-01,51,181,VA,Surry County,3758,3670,88,2.3
CN5118300000000,2023-04-01,51,183,VA,Sussex County,3772,3651,121,3.2
CN5118500000000,2023-04-01,51,185,VA,Tazewell County,15609,15082,527,3.4
CN5118700000000,2023-04-01,51,187,VA,Warren County,21403,20879,524,2.4
CN5119100000000,2023-04-01,51,191,VA,Washington County,27341,26674,667,2.4
CN5119300000000,2023-04-01,51,193,VA,Westmoreland County,9784,9511,273,2.8
CN5119500000000,2023-04-01,51,195,VA,Wise County,12987,12516,471,3.6
CN5119700000000,2023-04-01,51,197,VA,Wythe County,14409,14068,341,2.4
CN5119900000000,2023-04-01,51,199,VA,York County,34098,33322,776,2.3
CN5151000000000,2023-04-01,51,510,VA,Alexandria city,104136,101909,2227,2.1
CN5152000000000,2023-04-01,51,520,VA,Bristol city,7881,7634,247,3.1
CN5153000000000,2023-04-01,51,530,VA,Buena Vista city,3129,3054,75,2.4
CN5154000000000,2023-04-01,51,540,VA,Charlottesville city,26784,26229,555,2.1
CN5155000000000,2023-04-01,51,550,VA,Chesapeake city,127358,124199,3159,2.5
CN5157000000000,2023-04-01,51,570,VA,Colonial Heights city,8825,8592,233,2.6
CN5158000000000,2023-04-01,51,580,VA,Covington city,2327,2254,73,3.1
CN5159000000000,2023-04-01,51,590,VA,Danville city,18656,17863,793,4.3
CN5159500000000,2023-04-01,51,595,VA,Emporia city,2367,2272,95,4
CN5160000000000,2023-04-01,51,600,VA,Fairfax city,13333,13051,282,2.1
CN5161000000000,2023-04-01,51,610,VA,Falls Church city,8859,8676,183,2.1
CN5162000000000,2023-04-01,51,620,VA,Franklin city,3512,3391,121,3.4
CN5163000000000,2023-04-01,51,630,VA,Fredericksburg city,14815,14376,439,3
CN5164000000000,2023-04-01,51,640,VA,Galax city,2876,2792,84,2.9
CN5165000000000,2023-04-01,51,650,VA,Hampton city,66138,63961,2177,3.3
CN5166000000000,2023-04-01,51,660,VA,Harrisonburg city,26010,25316,694,2.7
CN5167000000000,2023-04-01,51,670,VA,Hopewell city,9950,9578,372,3.7
CN5167800000000,2023-04-01,51,678,VA,Lexington city,2366,2287,79,3.3
CN5168000000000,2023-04-01,51,680,VA,Lynchburg city,36624,35408,1216,3.3
CN5168300000000,2023-04-01,51,683,VA,Manassas city,22418,21931,487,2.2
CN5168500000000,2023-04-01,51,685,VA,Manassas Park city,10128,9895,233,2.3
CN5169000000000,2023-04-01,51,690,VA,Martinsville city,5648,5408,240,4.2
CN5170000000000,2023-04-01,51,700,VA,Newport News city,90680,87992,2688,3
CN5171000000000,2023-04-01,51,710,VA,Norfolk city,113076,109760,3316,2.9
CN5172000000000,2023-04-01,51,720,VA,Norton city,1620,1560,60,3.7
CN5173000000000,2023-04-01,51,730,VA,Petersburg city,13020,12388,632,4.9
CN5173500000000,2023-04-01,51,735,VA,Poquoson city,6546,6412,134,2
CN5174000000000,2023-04-01,51,740,VA,Portsmouth city,45237,43785,1452,3.2
CN5175000000000,2023-04-01,51,750,VA,Radford city,9371,9120,251,2.7
CN5176000000000,2023-04-01,51,760,VA,Richmond city,125187,121382,3805,3
CN5177000000000,2023-04-01,51,770,VA,Roanoke city,50737,49349,1388,2.7
CN5177500000000,2023-04-01,51,775,VA,Salem city,13343,13012,331,2.5
CN5179000000000,2023-04-01,51,790,VA,Staunton city,12837,12531,306,2.4
CN5180000000000,2023-04-01,51,800,VA,Suffolk city,46906,45613,1293,2.8
CN5181000000000,2023-04-01,51,810,VA,Virginia Beach city,238686,232861,5825,2.4
CN5182000000000,2023-04-01,51,820,VA,Waynesboro city,11154,10866,288,2.6
CN5183000000000,2023-04-01,51,830,VA,Williamsburg city,6979,6752,227,3.3
CN5184000000000,2023-04-01,51,840,VA,Winchester city,15587,15210,377,2.4
CN5300100000000,2023-04-01,53,001,WA,Adams County,9514,9130,384,4
CN5300300000000,2023-04-01,53,003,WA,Asotin County,10610,10294,316,3
CN5300500000000,2023-04-01,53,005,WA,Benton County,107360,103026,4334,4
CN5300700000000,2023-04-01,53,007,WA,Chelan County,43929,42197,1732,3.9
CN5300900000000,2023-04-01,53,009,WA,Clallam County,28884,27511,1373,4.8
CN5301100000000,2023-04-01,53,011,WA,Clark County,251675,241773,9902,3.9
CN5301300000000,2023-04-01,53,013,WA,Columbia County,1769,1697,72,4.1
CN5301500000000,2023-04-01,53,015,WA,Cowlitz County,49301,47034,2267,4.6
CN5301700000000,2023-04-01,53,017,WA,Douglas County,21444,20530,914,4.3
CN5301900000000,2023-04-01,53,019,WA,Ferry County,2249,2068,181,8
CN5302100000000,2023-04-01,53,021,WA,Franklin County,43886,41566,2320,5.3
CN5302300000000,2023-04-01,53,023,WA,Garfield County,787,750,37,4.7
CN5302500000000,2023-04-01,53,025,WA,Grant County,47644,45375,2269,4.8
CN5302700000000,2023-04-01,53,027,WA,Grays Harbor County,29154,27375,1779,6.1
CN5302900000000,2023-04-01,53,029,WA,Island County,37058,35619,1439,3.9
CN5303100000000,2023-04-01,53,031,WA,Jefferson County,12602,12023,579,4.6
CN5303300000000,2023-04-01,53,033,WA,King County,1345046,1310117,34929,2.6
CN5303500000000,2023-04-01,53,035,WA,Kitsap County,130213,125409,4804,3.7
CN5303700000000,2023-04-01,53,037,WA,Kittitas County,22805,21712,1093,4.8
CN5303900000000,2023-04-01,53,039,WA,Klickitat County,9994,9538,456,4.6
CN5304100000000,2023-04-01,53,041,WA,Lewis County,35101,33318,1783,5.1
CN5304300000000,2023-04-01,53,043,WA,Lincoln County,4713,4511,202,4.3
CN5304500000000,2023-04-01,53,045,WA,Mason County,25762,24458,1304,5.1
CN5304700000000,2023-04-01,53,047,WA,Okanogan County,19338,18330,1008,5.2
CN5304900000000,2023-04-01,53,049,WA,Pacific County,8725,8266,459,5.3
CN5305100000000,2023-04-01,53,051,WA,Pend Oreille County,5185,4896,289,5.6
CN5305300000000,2023-04-01,53,053,WA,Pierce County,459828,439912,19916,4.3
CN5305500000000,2023-04-01,53,055,WA,San Juan County,8893,8621,272,3.1
CN5305700000000,2023-04-01,53,057,WA,Skagit County,61928,59366,2562,4.1
CN5305900000000,2023-04-01,53,059,WA,Skamania County,5622,5371,251,4.5
CN5306100000000,2023-04-01,53,061,WA,Snohomish County,457318,445137,12181,2.7
CN5306300000000,2023-04-01,53,063,WA,Spokane County,266222,256129,10093,3.8
CN5306500000000,2023-04-01,53,065,WA,Stevens County,19392,18254,1138,5.9
CN5306700000000,2023-04-01,53,067,WA,Thurston County,152670,146943,5727,3.8
CN5306900000000,2023-04-01,53,069,WA,Wahkiakum County,1400,1326,74,5.3
CN5307100000000,2023-04-01,53,071,WA,Walla Walla County,30763,29690,1073,3.5
CN5307300000000,2023-04-01,53,073,WA,Whatcom County,116006,111543,4463,3.8
CN5307500000000,2023-04-01,53,075,WA,Whitman County,24054,23193,861,3.6
CN5307700000000,2023-04-01,53,077,WA,Yakima County,130116,123028,7088,5.4
CN5400100000000,2023-04-01,54,001,WV,Barbour County,7376,7097,279,3.8
CN5400300000000,2023-04-01,54,003,WV,Berkeley County,59438,57687,1751,2.9
CN5400500000000,2023-04-01,54,005,WV,Boone County,6983,6722,261,3.7
CN5400700000000,2023-04-01,54,007,WV,Braxton County,4863,4622,241,5
CN5400900000000,2023-04-01,54,009,WV,Brooke County,9854,9449,405,4.1
CN5401100000000,2023-04-01,54,011,WV,Cabell County,41722,40422,1300,3.1
CN5401300000000,2023-04-01,54,013,WV,Calhoun County,2457,2315,142,5.8
CN5401500000000,2023-04-01,54,015,WV,Clay County,2914,2762,152,5.2
CN5401700000000,2023-04-01,54,017,WV,Doddridge County,3846,3752,94,2.4
CN5401900000000,2023-04-01,54,019,WV,Fayette County,15728,15126,602,3.8
CN5402100000000,2023-04-01,54,021,WV,Gilmer County,2334,2231,103,4.4
CN5402300000000,2023-04-01,54,023,WV,Grant County,5978,5779,199,3.3
CN5402500000000,2023-04-01,54,025,WV,Greenbrier County,14593,14101,492,3.4
CN5402700000000,2023-04-01,54,027,WV,Hampshire County,11184,10917,267,2.4
CN5402900000000,2023-04-01,54,029,WV,Hancock County,13116,12468,648,4.9
CN5403100000000,2023-04-01,54,031,WV,Hardy County,5655,5414,241,4.3
CN5403300000000,2023-04-01,54,033,WV,Harrison County,33178,32217,961,2.9
CN5403500000000,2023-04-01,54,035,WV,Jackson County,11545,11106,439,3.8
CN5403700000000,2023-04-01,54,037,WV,Jefferson County,30702,29991,711,2.3
CN5403900000000,2023-04-01,54,039,WV,Kanawha County,79076,76484,2592,3.3
CN5404100000000,2023-04-01,54,041,WV,Lewis County,6351,6099,252,4
CN5404300000000,2023-04-01,54,043,WV,Lincoln County,7075,6776,299,4.2
CN5404500000000,2023-04-01,54,045,WV,Logan County,10900,10500,400,3.7
CN5404700000000,2023-04-01,54,047,WV,McDowell County,4099,3891,208,5.1
CN5404900000000,2023-04-01,54,049,WV,Marion County,25389,24500,889,3.5
CN5405100000000,2023-04-01,54,051,WV,Marshall County,12954,12344,610,4.7
CN5405300000000,2023-04-01,54,053,WV,Mason County,10392,10055,337,3.2
CN5405500000000,2023-04-01,54,055,WV,Mercer County,20724,19942,782,3.8
CN5405700000000,2023-04-01,54,057,WV,Mineral County,12659,12227,432,3.4
CN5405900000000,2023-04-01,54,059,WV,Mingo County,6501,6219,282,4.3
CN5406100000000,2023-04-01,54,061,WV,Monongalia County,55861,54377,1484,2.7
CN5406300000000,2023-04-01,54,063,WV,Monroe County,6023,5871,152,2.5
CN5406500000000,2023-04-01,54,065,WV,Morgan County,8333,8102,231,2.8
CN5406700000000,2023-04-01,54,067,WV,Nicholas County,8788,8435,353,4
CN5406900000000,2023-04-01,54,069,WV,Ohio County,19690,19012,678,3.4
CN5407100000000,2023-04-01,54,071,WV,Pendleton County,3711,3634,77,2.1
CN5407300000000,2023-04-01,54,073,WV,Pleasants County,2636,2508,128,4.9
CN5407500000000,2023-04-01,54,075,WV,Pocahontas County,3713,3462,251,6.8
CN5407700000000,2023-04-01,54,077,WV,Preston County,15511,14972,539,3.5
CN5407900000000,2023-04-01,54,079,WV,Putnam County,27150,26341,809,3
CN5408100000000,2023-04-01,54,081,WV,Raleigh County,29770,28819,951,3.2
CN5408300000000,2023-04-01,54,083,WV,Randolph County,11678,11141,537,4.6
CN5408500000000,2023-04-01,54,085,WV,Ritchie County,4201,4044,157,3.7
CN5408700000000,2023-04-01,54,087,WV,Roane County,4756,4469,287,6
CN5408900000000,2023-04-01,54,089,WV,Summers County,4697,4537,160,3.4
CN5409100000000,2023-04-01,54,091,WV,Taylor County,7860,7600,260,3.3
CN5409300000000,2023-04-01,54,093,WV,Tucker County,3451,3338,113,3.3
CN5409500000000,2023-04-01,54,095,WV,Tyler County,2888,2736,152,5.3
CN5409700000000,2023-04-01,54,097,WV,Upshur County,9578,9238,340,3.5
CN5409900000000,2023-04-01,54,099,WV,Wayne County,15673,15125,548,3.5
CN5410100000000,2023-04-01,54,101,WV,Webster County,2924,2791,133,4.5
CN5410300000000,2023-04-01,54,103,WV,Wetzel County,6434,6084,350,5.4
CN5410500000000,2023-04-01,54,105,WV,Wirt County,2225,2110,115,5.2
CN5410700000000,2023-04-01,54,107,WV,Wood County,36389,35061,1328,3.6
CN5410900000000,2023-04-01,54,109,WV,Wyoming County,7275,7012,263,3.6
CN5500100000000,2023-04-01,55,001,WI,Adams County,7696,7400,296,3.8
CN5500300000000,2023-04-01,55,003,WI,Ashland County,7324,7067,257,3.5
CN5500500000000,2023-04-01,55,005,WI,Barron County,24140,23351,789,3.3
CN5500700000000,2023-04-01,55,007,WI,Bayfield County,7262,6945,317,4.4
CN5500900000000,2023-04-01,55,009,WI,Brown County,141995,139336,2659,1.9
CN5501100000000,2023-04-01,55,011,WI,Buffalo County,6381,6171,210,3.3
CN5501300000000,2023-04-01,55,013,WI,Burnett County,7289,6941,348,4.8
CN5501500000000,2023-04-01,55,015,WI,Calumet County,27868,27420,448,1.6
CN5501700000000,2023-04-01,55,017,WI,Chippewa County,34059,32999,1060,3.1
CN5501900000000,2023-04-01,55,019,WI,Clark County,18122,17759,363,2
CN5502100000000,2023-04-01,55,021,WI,Columbia County,32478,31878,600,1.8
CN5502300000000,2023-04-01,55,023,WI,Crawford County,6922,6699,223,3.2
CN5502500000000,2023-04-01,55,025,WI,Dane County,336102,330849,5253,1.6
CN5502700000000,2023-04-01,55,027,WI,Dodge County,47371,46504,867,1.8
CN5502900000000,2023-04-01,55,029,WI,Door County,14505,14139,366,2.5
CN5503100000000,2023-04-01,55,031,WI,Douglas County,22761,21799,962,4.2
CN5503300000000,2023-04-01,55,033,WI,Dunn County,24640,23926,714,2.9
CN5503500000000,2023-04-01,55,035,WI,Eau Claire County,59945,58729,1216,2
CN5503700000000,2023-04-01,55,037,WI,Florence County,2100,2034,66,3.1
CN5503900000000,2023-04-01,55,039,WI,Fond du Lac County,56640,55586,1054,1.9
CN5504100000000,2023-04-01,55,041,WI,Forest County,4030,3826,204,5.1
CN5504300000000,2023-04-01,55,043,WI,Grant County,28054,27497,557,2
CN5504500000000,2023-04-01,55,045,WI,Green County,21392,21039,353,1.7
CN5504700000000,2023-04-01,55,047,WI,Green Lake County,9084,8878,206,2.3
CN5504900000000,2023-04-01,55,049,WI,Iowa County,14035,13803,232,1.7
CN5505100000000,2023-04-01,55,051,WI,Iron County,2487,2332,155,6.2
CN5505300000000,2023-04-01,55,053,WI,Jackson County,9483,9205,278,2.9
CN5505500000000,2023-04-01,55,055,WI,Jefferson County,45941,45057,884,1.9
CN5505700000000,2023-04-01,55,057,WI,Juneau County,13313,13017,296,2.2
CN5505900000000,2023-04-01,55,059,WI,Kenosha County,89647,87327,2320,2.6
CN5506100000000,2023-04-01,55,061,WI,Kewaunee County,11056,10874,182,1.6
CN5506300000000,2023-04-01,55,063,WI,La Crosse County,67421,66263,1158,1.7
CN5506500000000,2023-04-01,55,065,WI,Lafayette County,10693,10529,164,1.5
CN5506700000000,2023-04-01,55,067,WI,Langlade County,9276,8995,281,3
CN5506900000000,2023-04-01,55,069,WI,Lincoln County,14727,14339,388,2.6
CN5507100000000,2023-04-01,55,071,WI,Manitowoc County,40347,39490,857,2.1
CN5507300000000,2023-04-01,55,073,WI,Marathon County,73441,71937,1504,2
CN5507500000000,2023-04-01,55,075,WI,Marinette County,19083,18443,640,3.4
CN5507700000000,2023-04-01,55,077,WI,Marquette County,7728,7536,192,2.5
CN5507800000000,2023-04-01,55,078,WI,Menominee County,1533,1446,87,5.7
CN5507900000000,2023-04-01,55,079,WI,Milwaukee County,453921,441038,12883,2.8
CN5508100000000,2023-04-01,55,081,WI,Monroe County,23397,22949,448,1.9
CN5508300000000,2023-04-01,55,083,WI,Oconto County,20968,20409,559,2.7
CN5508500000000,2023-04-01,55,085,WI,Oneida County,17755,17188,567,3.2
CN5508700000000,2023-04-01,55,087,WI,Outagamie County,104728,102803,1925,1.8
CN5508900000000,2023-04-01,55,089,WI,Ozaukee County,48595,47704,891,1.8
CN5509100000000,2023-04-01,55,091,WI,Pepin County,4193,4084,109,2.6
CN5509300000000,2023-04-01,55,093,WI,Pierce County,24731,24012,719,2.9
CN5509500000000,2023-04-01,55,095,WI,Polk County,24879,23876,1003,4
CN5509700000000,2023-04-01,55,097,WI,Portage County,37955,37137,818,2.2
CN5509900000000,2023-04-01,55,099,WI,Price County,6358,6169,189,3
CN5510100000000,2023-04-01,55,101,WI,Racine County,98079,95466,2613,2.7
CN5510300000000,2023-04-01,55,103,WI,Richland County,8897,8716,181,2
CN5510500000000,2023-04-01,55,105,WI,Rock County,86055,83829,2226,2.6
CN5510700000000,2023-04-01,55,107,WI,Rusk County,6644,6443,201,3
CN5510900000000,2023-04-01,55,109,WI,St. Croix County,50094,48627,1467,2.9
CN5511100000000,2023-04-01,55,111,WI,Sauk County,34252,33566,686,2
CN5511300000000,2023-04-01,55,113,WI,Sawyer County,7915,7574,341,4.3
CN5511500000000,2023-04-01,55,115,WI,Shawano County,20673,20206,467,2.3
CN5511700000000,2023-04-01,55,117,WI,Sheboygan County,61417,60361,1056,1.7
CN5511900000000,2023-04-01,55,119,WI,Taylor County,10789,10448,341,3.2
CN5512100000000,2023-04-01,55,121,WI,Trempealeau County,15118,14706,412,2.7
CN5512300000000,2023-04-01,55,123,WI,Vernon County,15614,15323,291,1.9
CN5512500000000,2023-04-01,55,125,WI,Vilas County,9938,9463,475,4.8
CN5512700000000,2023-04-01,55,127,WI,Walworth County,58050,56752,1298,2.2
CN5512900000000,2023-04-01,55,129,WI,Washburn County,7778,7504,274,3.5
CN5513100000000,2023-04-01,55,131,WI,Washington County,75878,74520,1358,1.8
CN5513300000000,2023-04-01,55,133,WI,Waukesha County,221367,217221,4146,1.9
CN5513500000000,2023-04-01,55,135,WI,Waupaca County,25265,24672,593,2.3
CN5513700000000,2023-04-01,55,137,WI,Waushara County,11223,10944,279,2.5
CN5513900000000,2023-04-01,55,139,WI,Winnebago County,92576,90878,1698,1.8
CN5514100000000,2023-04-01,55,141,WI,Wood County,33614,32754,860,2.6
CN5600100000000,2023-04-01,56,001,WY,Albany County,22295,21705,590,2.6
CN5600300000000,2023-04-01,56,003,WY,Big Horn County,5159,4971,188,3.6
CN5600500000000,2023-04-01,56,005,WY,Campbell County,23226,22534,692,3
CN5600700000000,2023-04-01,56,007,WY,Carbon County,7221,6966,255,3.5
CN5600900000000,2023-04-01,56,009,WY,Converse County,7850,7645,205,2.6
CN5601100000000,2023-04-01,56,011,WY,Crook County,4022,3916,106,2.6
CN5601300000000,2023-04-01,56,013,WY,Fremont County,19345,18600,745,3.9
CN5601500000000,2023-04-01,56,015,WY,Goshen County,6711,6521,190,2.8
CN5601700000000,2023-04-01,56,017,WY,Hot Springs County,2303,2236,67,2.9
CN5601900000000,2023-04-01,56,019,WY,Johnson County,4286,4137,149,3.5
CN5602100000000,2023-04-01,56,021,WY,Laramie County,49772,48160,1612,3.2
CN5602300000000,2023-04-01,56,023,WY,Lincoln County,9581,9243,338,3.5
CN5602500000000,2023-04-01,56,025,WY,Natrona County,40067,38633,1434,3.6
CN5602700000000,2023-04-01,56,027,WY,Niobrara County,1235,1201,34,2.8
CN5602900000000,2023-04-01,56,029,WY,Park County,15344,14802,542,3.5
CN5603100000000,2023-04-01,56,031,WY,Platte County,4584,4435,149,3.3
CN5603300000000,2023-04-01,56,033,WY,Sheridan County,16435,15919,516,3.1
CN5603500000000,2023-04-01,56,035,WY,Sublette County,3909,3755,154,3.9
CN5603700000000,2023-04-01,56,037,WY,Sweetwater County,19939,19177,762,3.8
CN5603900000000,2023-04-01,56,039,WY,Teton County,16246,15610,636,3.9
CN5604100000000,2023-04-01,56,041,WY,Uinta County,9197,8870,327,3.6
CN5604300000000,2023-04-01,56,043,WY,Washakie County,3919,3769,150,3.8
CN5604500000000,2023-04-01,56,045,WY,Weston County,3874,3789,85,2.2
CN7200100000000,2023-04-01,72,001,PR,Adjuntas Municipio,4415,4013,402,9.1
CN7200300000000,2023-04-01,72,003,PR,Aguada Municipio,13463,12530,933,6.9
CN7200500000000,2023-04-01,72,005,PR,Aguadilla Municipio,16326,15104,1222,7.5
CN7200700000000,2023-04-01,72,007,PR,Aguas Buenas Municipio,6946,6569,377,5.4
CN7200900000000,2023-04-01,72,009,PR,Aibonito Municipio,6753,6270,483,7.2
CN7201100000000,2023-04-01,72,011,PR,Anasco Municipio,10147,9521,626,6.2
CN7201300000000,2023-04-01,72,013,PR,Arecibo Municipio,25658,23988,1670,6.5
CN7201500000000,2023-04-01,72,015,PR,Arroyo Municipio,4996,4525,471,9.4
CN7201700000000,2023-04-01,72,017,PR,Barceloneta Municipio,6331,5862,469,7.4
CN7201900000000,2023-04-01,72,019,PR,Barranquitas Municipio,7800,7262,538,6.9
CN7202100000000,2023-04-01,72,021,PR,Bayamon Municipio,69551,66580,2971,4.3
CN7202300000000,2023-04-01,72,023,PR,Cabo Rojo Municipio,15177,14248,929,6.1
CN7202500000000,2023-04-01,72,025,PR,Caguas Municipio,51329,49120,2209,4.3
CN7202700000000,2023-04-01,72,027,PR,Camuy Municipio,10301,9682,619,6
CN7202900000000,2023-04-01,72,029,PR,Canovanas Municipio,17488,16760,728,4.2
CN7203100000000,2023-04-01,72,031,PR,Carolina Municipio,65690,63063,2627,4
CN7203300000000,2023-04-01,72,033,PR,Catano Municipio,8292,7939,353,4.3
CN7203500000000,2023-04-01,72,035,PR,Cayey Municipio,17371,16588,783,4.5
CN7203700000000,2023-04-01,72,037,PR,Ceiba Municipio,3860,3606,254,6.6
CN7203900000000,2023-04-01,72,039,PR,Ciales Municipio,3888,3595,293,7.5
CN7204100000000,2023-04-01,72,041,PR,Cidra Municipio,16624,15894,730,4.4
CN7204300000000,2023-04-01,72,043,PR,Coamo Municipio,11155,10289,866,7.8
CN7204500000000,2023-04-01,72,045,PR,Comerio Municipio,5274,4916,358,6.8
CN7204700000000,2023-04-01,72,047,PR,Corozal Municipio,9410,8779,631,6.7
CN7204900000000,2023-04-01,72,049,PR,Culebra Municipio,989,973,16,1.6
CN7205100000000,2023-04-01,72,051,PR,Dorado Municipio,14567,13929,638,4.4
CN7205300000000,2023-04-01,72,053,PR,Fajardo Municipio,11361,10608,753,6.6
CN7205400000000,2023-04-01,72,054,PR,Florida Municipio,3541,3241,300,8.5
CN7205500000000,2023-04-01,72,055,PR,Guanica Municipio,4074,3605,469,11.5
CN7205700000000,2023-04-01,72,057,PR,Guayama Municipio,11579,10821,758,6.5
CN7205900000000,2023-04-01,72,059,PR,Guayanilla Municipio,5435,4857,578,10.6
CN7206100000000,2023-04-01,72,061,PR,Guaynabo Municipio,40869,39797,1072,2.6
CN7206300000000,2023-04-01,72,063,PR,Gurabo Municipio,20225,19483,742,3.7
CN7206500000000,2023-04-01,72,065,PR,Hatillo Municipio,14819,13444,1375,9.3
CN7206700000000,2023-04-01,72,067,PR,Hormigueros Municipio,6035,5760,275,4.6
CN7206900000000,2023-04-01,72,069,PR,Humacao Municipio,18821,17569,1252,6.7
CN7207100000000,2023-04-01,72,071,PR,Isabela Municipio,13367,12503,864,6.5
CN7207300000000,2023-04-01,72,073,PR,Jayuya Municipio,4810,4311,499,10.4
CN7207500000000,2023-04-01,72,075,PR,Juana Diaz Municipio,16862,15668,1194,7.1
CN7207700000000,2023-04-01,72,077,PR,Juncos Municipio,13383,12574,809,6
CN7207900000000,2023-04-01,72,079,PR,Lajas Municipio,5602,5110,492,8.8
CN7208100000000,2023-04-01,72,081,PR,Lares Municipio,7519,6745,774,10.3
CN7208300000000,2023-04-01,72,083,PR,Las Marias Municipio,2563,2290,273,10.7
CN7208500000000,2023-04-01,72,085,PR,Las Piedras Municipio,12290,11590,700,5.7
CN7208700000000,2023-04-01,72,087,PR,Loiza Municipio,8857,8430,427,4.8
CN7208900000000,2023-04-01,72,089,PR,Luquillo Municipio,6610,6208,402,6.1
CN7209100000000,2023-04-01,72,091,PR,Manati Municipio,12015,11338,677,5.6
CN7209300000000,2023-04-01,72,093,PR,Maricao Municipio,2145,1932,213,9.9
CN7209500000000,2023-04-01,72,095,PR,Maunabo Municipio,3178,2728,450,14.2
CN7209700000000,2023-04-01,72,097,PR,Mayaguez Municipio,24257,22691,1566,6.5
CN7209900000000,2023-04-01,72,099,PR,Moca Municipio,11873,10928,945,8
CN7210100000000,2023-04-01,72,101,PR,Morovis Municipio,8642,8083,559,6.5
CN7210300000000,2023-04-01,72,103,PR,Naguabo Municipio,8844,8357,487,5.5
CN7210500000000,2023-04-01,72,105,PR,Naranjito Municipio,7537,7087,450,6
CN7210700000000,2023-04-01,72,107,PR,Orocovis Municipio,5229,4776,453,8.7
CN7210900000000,2023-04-01,72,109,PR,Patillas Municipio,4467,3998,469,10.5
CN7211100000000,2023-04-01,72,111,PR,Penuelas Municipio,6162,5554,608,9.9
CN7211300000000,2023-04-01,72,113,PR,Ponce Municipio,48596,45353,3243,6.7
CN7211500000000,2023-04-01,72,115,PR,Quebradillas Municipio,6516,6042,474,7.3
CN7211700000000,2023-04-01,72,117,PR,Rincon Municipio,5470,4851,619,11.3
CN7211900000000,2023-04-01,72,119,PR,Rio Grande Municipio,18097,17323,774,4.3
CN7212100000000,2023-04-01,72,121,PR,Sabana Grande Municipio,6431,5939,492,7.7
CN7212300000000,2023-04-01,72,123,PR,Salinas Municipio,7375,6758,617,8.4
CN7212500000000,2023-04-01,72,125,PR,San German Municipio,10539,9735,804,7.6
CN7212700000000,2023-04-01,72,127,PR,San Juan Municipio,143861,138069,5792,4
CN7212900000000,2023-04-01,72,129,PR,San Lorenzo Municipio,12380,11708,672,5.4
CN7213100000000,2023-04-01,72,131,PR,San Sebastian Municipio,11183,10123,1060,9.5
CN7213300000000,2023-04-01,72,133,PR,Santa Isabel Municipio,8172,7502,670,8.2
CN7213500000000,2023-04-01,72,135,PR,Toa Alta Municipio,29970,28787,1183,3.9
CN7213700000000,2023-04-01,72,137,PR,Toa Baja Municipio,31095,29887,1208,3.9
CN7213900000000,2023-04-01,72,139,PR,Trujillo Alto Municipio,29014,28254,760,2.6
CN7214100000000,2023-04-01,72,141,PR,Utuado Municipio,7369,6780,589,8
CN7214300000000,2023-04-01,72,143,PR,Vega Alta Municipio,10432,9868,564,5.4
CN7214500000000,2023-04-01,72,145,PR,Vega Baja Municipio,14029,13019,1010,7.2
CN7214700000000,2023-04-01,72,147,PR,Vieques Municipio,2705,2624,81,3
CN7214900000000,2023-04-01,72,149,PR,Villalba Municipio,7777,6943,834,10.7
CN7215100000000,2023-04-01,72,151,PR,Yabucoa Municipio,9168,8438,730,8
CN7215300000000,2023-04-01,72,153,PR,Yauco Municipio,10380,9176,1204,11.6
CN0100100000000,2023-05-01,01,001,AL,Autauga County,27036,26529,507,1.9
CN0100300000000,2023-05-01,01,003,AL,Baldwin County,105039,103048,1991,1.9
CN0100500000000,2023-05-01,01,005,AL,Barbour County,7958,7663,295,3.7
CN0100700000000,2023-05-01,01,007,AL,Bibb County,8749,8558,191,2.2
CN0100900000000,2023-05-01,01,009,AL,Blount County,25700,25223,477,1.9
CN0101100000000,2023-05-01,01,011,AL,Bullock County,4201,4115,86,2
CN0101300000000,2023-05-01,01,013,AL,Butler County,9035,8808,227,2.5
CN0101500000000,2023-05-01,01,015,AL,Calhoun County,46475,45359,1116,2.4
CN0101700000000,2023-05-01,01,017,AL,Chambers County,15864,15531,333,2.1
CN0101900000000,2023-05-01,01,019,AL,Cherokee County,11726,11480,246,2.1
CN0102100000000,2023-05-01,01,021,AL,Chilton County,20123,19743,380,1.9
CN0102300000000,2023-05-01,01,023,AL,Choctaw County,4151,4011,140,3.4
CN0102500000000,2023-05-01,01,025,AL,Clarke County,7656,7323,333,4.3
CN0102700000000,2023-05-01,01,027,AL,Clay County,5898,5778,120,2
CN0102900000000,2023-05-01,01,029,AL,Cleburne County,6114,5988,126,2.1
CN0103100000000,2023-05-01,01,031,AL,Coffee County,21794,21342,452,2.1
CN0103300000000,2023-05-01,01,033,AL,Colbert County,23858,23275,583,2.4
CN0103500000000,2023-05-01,01,035,AL,Conecuh County,4200,4083,117,2.8
CN0103700000000,2023-05-01,01,037,AL,Coosa County,4565,4469,96,2.1
CN0103900000000,2023-05-01,01,039,AL,Covington County,14644,14310,334,2.3
CN0104100000000,2023-05-01,01,041,AL,Crenshaw County,5771,5644,127,2.2
CN0104300000000,2023-05-01,01,043,AL,Cullman County,39973,39279,694,1.7
CN0104500000000,2023-05-01,01,045,AL,Dale County,21672,21205,467,2.2
CN0104700000000,2023-05-01,01,047,AL,Dallas County,13520,12907,613,4.5
CN0104900000000,2023-05-01,01,049,AL,DeKalb County,30495,29894,601,2
CN0105100000000,2023-05-01,01,051,AL,Elmore County,38749,38025,724,1.9
CN0105300000000,2023-05-01,01,053,AL,Escambia County,14409,14027,382,2.7
CN0105500000000,2023-05-01,01,055,AL,Etowah County,39176,38230,946,2.4
CN0105700000000,2023-05-01,01,057,AL,Fayette County,6568,6418,150,2.3
CN0105900000000,2023-05-01,01,059,AL,Franklin County,14652,14301,351,2.4
CN0106100000000,2023-05-01,01,061,AL,Geneva County,11111,10878,233,2.1
CN0106300000000,2023-05-01,01,063,AL,Greene County,2758,2645,113,4.1
CN0106500000000,2023-05-01,01,065,AL,Hale County,5754,5590,164,2.9
CN0106700000000,2023-05-01,01,067,AL,Henry County,7072,6914,158,2.2
CN0106900000000,2023-05-01,01,069,AL,Houston County,48739,47669,1070,2.2
CN0107100000000,2023-05-01,01,071,AL,Jackson County,23221,22727,494,2.1
CN0107300000000,2023-05-01,01,073,AL,Jefferson County,325477,318608,6869,2.1
CN0107500000000,2023-05-01,01,075,AL,Lamar County,5656,5530,126,2.2
CN0107700000000,2023-05-01,01,077,AL,Lauderdale County,43044,42104,940,2.2
CN0107900000000,2023-05-01,01,079,AL,Lawrence County,14868,14584,284,1.9
CN0108100000000,2023-05-01,01,081,AL,Lee County,81017,79359,1658,2
CN0108300000000,2023-05-01,01,083,AL,Limestone County,49494,48591,903,1.8
CN0108500000000,2023-05-01,01,085,AL,Lowndes County,3462,3325,137,4
CN0108700000000,2023-05-01,01,087,AL,Macon County,7831,7605,226,2.9
CN0108900000000,2023-05-01,01,089,AL,Madison County,204877,201251,3626,1.8
CN0109100000000,2023-05-01,01,091,AL,Marengo County,7693,7481,212,2.8
CN0109300000000,2023-05-01,01,093,AL,Marion County,13755,13395,360,2.6
CN0109500000000,2023-05-01,01,095,AL,Marshall County,46212,45398,814,1.8
CN0109700000000,2023-05-01,01,097,AL,Mobile County,194635,189755,4880,2.5
CN0109900000000,2023-05-01,01,099,AL,Monroe County,7022,6762,260,3.7
CN0110100000000,2023-05-01,01,101,AL,Montgomery County,108358,105692,2666,2.5
CN0110300000000,2023-05-01,01,103,AL,Morgan County,61936,60878,1058,1.7
CN0110500000000,2023-05-01,01,105,AL,Perry County,2874,2755,119,4.1
CN0110700000000,2023-05-01,01,107,AL,Pickens County,7643,7448,195,2.6
CN0110900000000,2023-05-01,01,109,AL,Pike County,16077,15713,364,2.3
CN0111100000000,2023-05-01,01,111,AL,Randolph County,9493,9300,193,2
CN0111300000000,2023-05-01,01,113,AL,Russell County,24339,23811,528,2.2
CN0111500000000,2023-05-01,01,115,AL,St. Clair County,42426,41661,765,1.8
CN0111700000000,2023-05-01,01,117,AL,Shelby County,122445,120485,1960,1.6
CN0111900000000,2023-05-01,01,119,AL,Sumter County,4435,4298,137,3.1
CN0112100000000,2023-05-01,01,121,AL,Talladega County,37340,36468,872,2.3
CN0112300000000,2023-05-01,01,123,AL,Tallapoosa County,16946,16564,382,2.3
CN0112500000000,2023-05-01,01,125,AL,Tuscaloosa County,105484,103258,2226,2.1
CN0112700000000,2023-05-01,01,127,AL,Walker County,25677,25074,603,2.3
CN0112900000000,2023-05-01,01,129,AL,Washington County,6405,6213,192,3
CN0113100000000,2023-05-01,01,131,AL,Wilcox County,2416,2251,165,6.8
CN0113300000000,2023-05-01,01,133,AL,Winston County,10039,9809,230,2.3
CN0201300000000,2023-05-01,02,013,AK,Aleutians East Borough,1483,1432,51,3.4
CN0201600000000,2023-05-01,02,016,AK,Aleutians West Census Area,2825,2699,126,4.5
CN0202000000000,2023-05-01,02,020,AK,Anchorage Borough/municipality,152627,147964,4663,3.1
CN0205000000000,2023-05-01,02,050,AK,Bethel Census Area,6256,5687,569,9.1
CN0206000000000,2023-05-01,02,060,AK,Bristol Bay Borough,439,424,15,3.4
CN0206300000000,2023-05-01,02,063,AK,Chugach Census Area,3408,3282,126,3.7
CN0206600000000,2023-05-01,02,066,AK,Copper River Census Area,1365,1269,96,7
CN0206800000000,2023-05-01,02,068,AK,Denali Borough,1250,1201,49,3.9
CN0207000000000,2023-05-01,02,070,AK,Dillingham Census Area,1618,1525,93,5.7
CN0209000000000,2023-05-01,02,090,AK,Fairbanks North Star Borough,45598,44078,1520,3.3
CN0210000000000,2023-05-01,02,100,AK,Haines Borough,1092,1036,56,5.1
CN0210500000000,2023-05-01,02,105,AK,Hoonah-Angoon Census Area,1389,1334,55,4
CN0211000000000,2023-05-01,02,110,AK,Juneau Borough/city,17908,17450,458,2.6
CN0212200000000,2023-05-01,02,122,AK,Kenai Peninsula Borough,28338,27204,1134,4
CN0213000000000,2023-05-01,02,130,AK,Ketchikan Gateway Borough,6925,6713,212,3.1
CN0215000000000,2023-05-01,02,150,AK,Kodiak Island Borough,5703,5510,193,3.4
CN0215800000000,2023-05-01,02,158,AK,Kusilvak Census Area,2276,1966,310,13.6
CN0216400000000,2023-05-01,02,164,AK,Lake and Peninsula Borough,685,651,34,5
CN0217000000000,2023-05-01,02,170,AK,Matanuska-Susitna Borough,50209,48088,2121,4.2
CN0218000000000,2023-05-01,02,180,AK,Nome Census Area,4143,3860,283,6.8
CN0218500000000,2023-05-01,02,185,AK,North Slope Borough,2903,2760,143,4.9
CN0218800000000,2023-05-01,02,188,AK,Northwest Arctic Borough,2784,2533,251,9
CN0219500000000,2023-05-01,02,195,AK,Petersburg Borough,1378,1318,60,4.4
CN0219800000000,2023-05-01,02,198,AK,Prince of Wales-Hyder Census Area,2756,2599,157,5.7
CN0222000000000,2023-05-01,02,220,AK,Sitka Borough/city,4605,4487,118,2.6
CN0223000000000,2023-05-01,02,230,AK,Skagway Municipality,902,878,24,2.7
CN0224000000000,2023-05-01,02,240,AK,Southeast Fairbanks Census Area,3211,3056,155,4.8
CN0227500000000,2023-05-01,02,275,AK,Wrangell Borough/city,873,835,38,4.4
CN0228200000000,2023-05-01,02,282,AK,Yakutat Borough/city,328,312,16,4.9
CN0229000000000,2023-05-01,02,290,AK,Yukon-Koyukuk Census Area,2397,2193,204,8.5
CN0400100000000,2023-05-01,04,001,AZ,Apache County,18696,17381,1315,7
CN0400300000000,2023-05-01,04,003,AZ,Cochise County,48972,46874,2098,4.3
CN0400500000000,2023-05-01,04,005,AZ,Coconino County,75612,72793,2819,3.7
CN0400700000000,2023-05-01,04,007,AZ,Gila County,20574,19738,836,4.1
CN0400900000000,2023-05-01,04,009,AZ,Graham County,16666,16068,598,3.6
CN0401100000000,2023-05-01,04,011,AZ,Greenlee County,5064,4936,128,2.5
CN0401200000000,2023-05-01,04,012,AZ,La Paz County,8740,8316,424,4.9
CN0401300000000,2023-05-01,04,013,AZ,Maricopa County,2435242,2357290,77952,3.2
CN0401500000000,2023-05-01,04,015,AZ,Mohave County,91406,87623,3783,4.1
CN0401700000000,2023-05-01,04,017,AZ,Navajo County,40086,38034,2052,5.1
CN0401900000000,2023-05-01,04,019,AZ,Pima County,499240,481372,17868,3.6
CN0402100000000,2023-05-01,04,021,AZ,Pinal County,202377,194562,7815,3.9
CN0402300000000,2023-05-01,04,023,AZ,Santa Cruz County,19027,17908,1119,5.9
CN0402500000000,2023-05-01,04,025,AZ,Yavapai County,109621,105904,3717,3.4
CN0402700000000,2023-05-01,04,027,AZ,Yuma County,95497,83746,11751,12.3
CN0500100000000,2023-05-01,05,001,AR,Arkansas County,9089,8904,185,2
CN0500300000000,2023-05-01,05,003,AR,Ashley County,6557,6266,291,4.4
CN0500500000000,2023-05-01,05,005,AR,Baxter County,16597,16152,445,2.7
CN0500700000000,2023-05-01,05,007,AR,Benton County,156876,153915,2961,1.9
CN0500900000000,2023-05-01,05,009,AR,Boone County,16032,15659,373,2.3
CN0501100000000,2023-05-01,05,011,AR,Bradley County,3980,3823,157,3.9
CN0501300000000,2023-05-01,05,013,AR,Calhoun County,2376,2324,52,2.2
CN0501500000000,2023-05-01,05,015,AR,Carroll County,12400,12130,270,2.2
CN0501700000000,2023-05-01,05,017,AR,Chicot County,2925,2801,124,4.2
CN0501900000000,2023-05-01,05,019,AR,Clark County,8521,8217,304,3.6
CN0502100000000,2023-05-01,05,021,AR,Clay County,5450,5292,158,2.9
CN0502300000000,2023-05-01,05,023,AR,Cleburne County,8965,8696,269,3
CN0502500000000,2023-05-01,05,025,AR,Cleveland County,3071,2992,79,2.6
CN0502700000000,2023-05-01,05,027,AR,Columbia County,8829,8521,308,3.5
CN0502900000000,2023-05-01,05,029,AR,Conway County,8371,8133,238,2.8
CN0503100000000,2023-05-01,05,031,AR,Craighead County,58406,57173,1233,2.1
CN0503300000000,2023-05-01,05,033,AR,Crawford County,26515,25885,630,2.4
CN0503500000000,2023-05-01,05,035,AR,Crittenden County,20429,19782,647,3.2
CN0503700000000,2023-05-01,05,037,AR,Cross County,6878,6702,176,2.6
CN0503900000000,2023-05-01,05,039,AR,Dallas County,2662,2578,84,3.2
CN0504100000000,2023-05-01,05,041,AR,Desha County,4860,4685,175,3.6
CN0504300000000,2023-05-01,05,043,AR,Drew County,7281,7041,240,3.3
CN0504500000000,2023-05-01,05,045,AR,Faulkner County,64119,62655,1464,2.3
CN0504700000000,2023-05-01,05,047,AR,Franklin County,7473,7290,183,2.4
CN0504900000000,2023-05-01,05,049,AR,Fulton County,5039,4904,135,2.7
CN0505100000000,2023-05-01,05,051,AR,Garland County,41916,40721,1195,2.9
CN0505300000000,2023-05-01,05,053,AR,Grant County,8572,8388,184,2.1
CN0505500000000,2023-05-01,05,055,AR,Greene County,19946,19427,519,2.6
CN0505700000000,2023-05-01,05,057,AR,Hempstead County,9364,9141,223,2.4
CN0505900000000,2023-05-01,05,059,AR,Hot Spring County,13930,13561,369,2.6
CN0506100000000,2023-05-01,05,061,AR,Howard County,5279,5142,137,2.6
CN0506300000000,2023-05-01,05,063,AR,Independence County,16947,16516,431,2.5
CN0506500000000,2023-05-01,05,065,AR,Izard County,4457,4282,175,3.9
CN0506700000000,2023-05-01,05,067,AR,Jackson County,5442,5223,219,4
CN0506900000000,2023-05-01,05,069,AR,Jefferson County,25554,24634,920,3.6
CN0507100000000,2023-05-01,05,071,AR,Johnson County,10073,9773,300,3
CN0507300000000,2023-05-01,05,073,AR,Lafayette County,2304,2218,86,3.7
CN0507500000000,2023-05-01,05,075,AR,Lawrence County,6912,6743,169,2.4
CN0507700000000,2023-05-01,05,077,AR,Lee County,2626,2520,106,4
CN0507900000000,2023-05-01,05,079,AR,Lincoln County,3675,3561,114,3.1
CN0508100000000,2023-05-01,05,081,AR,Little River County,5205,5068,137,2.6
CN0508300000000,2023-05-01,05,083,AR,Logan County,8256,8001,255,3.1
CN0508500000000,2023-05-01,05,085,AR,Lonoke County,34749,34003,746,2.1
CN0508700000000,2023-05-01,05,087,AR,Madison County,7989,7834,155,1.9
CN0508900000000,2023-05-01,05,089,AR,Marion County,6235,6054,181,2.9
CN0509100000000,2023-05-01,05,091,AR,Miller County,18774,18219,555,3
CN0509300000000,2023-05-01,05,093,AR,Mississippi County,16452,15765,687,4.2
CN0509500000000,2023-05-01,05,095,AR,Monroe County,2489,2413,76,3.1
CN0509700000000,2023-05-01,05,097,AR,Montgomery County,2902,2791,111,3.8
CN0509900000000,2023-05-01,05,099,AR,Nevada County,3434,3347,87,2.5
CN0510100000000,2023-05-01,05,101,AR,Newton County,3213,3135,78,2.4
CN0510300000000,2023-05-01,05,103,AR,Ouachita County,9729,9429,300,3.1
CN0510500000000,2023-05-01,05,105,AR,Perry County,4259,4147,112,2.6
CN0510700000000,2023-05-01,05,107,AR,Phillips County,5441,5177,264,4.9
CN0510900000000,2023-05-01,05,109,AR,Pike County,4031,3926,105,2.6
CN0511100000000,2023-05-01,05,111,AR,Poinsett County,10052,9807,245,2.4
CN0511300000000,2023-05-01,05,113,AR,Polk County,7850,7642,208,2.6
CN0511500000000,2023-05-01,05,115,AR,Pope County,27737,26931,806,2.9
CN0511700000000,2023-05-01,05,117,AR,Prairie County,3573,3493,80,2.2
CN0511900000000,2023-05-01,05,119,AR,Pulaski County,191983,187294,4689,2.4
CN0512100000000,2023-05-01,05,121,AR,Randolph County,7241,7056,185,2.6
CN0512300000000,2023-05-01,05,123,AR,St. Francis County,7602,7316,286,3.8
CN0512500000000,2023-05-01,05,125,AR,Saline County,61005,59722,1283,2.1
CN0512700000000,2023-05-01,05,127,AR,Scott County,4279,4181,98,2.3
CN0512900000000,2023-05-01,05,129,AR,Searcy County,2886,2790,96,3.3
CN0513100000000,2023-05-01,05,131,AR,Sebastian County,55826,54504,1322,2.4
CN0513300000000,2023-05-01,05,133,AR,Sevier County,5408,5251,157,2.9
CN0513500000000,2023-05-01,05,135,AR,Sharp County,5972,5790,182,3
CN0513700000000,2023-05-01,05,137,AR,Stone County,4496,4352,144,3.2
CN0513900000000,2023-05-01,05,139,AR,Union County,14698,14169,529,3.6
CN0514100000000,2023-05-01,05,141,AR,Van Buren County,6059,5878,181,3
CN0514300000000,2023-05-01,05,143,AR,Washington County,138483,136027,2456,1.8
CN0514500000000,2023-05-01,05,145,AR,White County,34484,33547,937,2.7
CN0514700000000,2023-05-01,05,147,AR,Woodruff County,2870,2786,84,2.9
CN0514900000000,2023-05-01,05,149,AR,Yell County,7919,7688,231,2.9
CN0600100000000,2023-05-01,06,001,CA,Alameda County,827429,797029,30400,3.7
CN0600300000000,2023-05-01,06,003,CA,Alpine County,490,456,34,6.9
CN0600500000000,2023-05-01,06,005,CA,Amador County,14307,13619,688,4.8
CN0600700000000,2023-05-01,06,007,CA,Butte County,92217,87668,4549,4.9
CN0600900000000,2023-05-01,06,009,CA,Calaveras County,22043,21186,857,3.9
CN0601100000000,2023-05-01,06,011,CA,Colusa County,10290,8905,1385,13.5
CN0601300000000,2023-05-01,06,013,CA,Contra Costa County,551344,530704,20640,3.7
CN0601500000000,2023-05-01,06,015,CA,Del Norte County,9202,8678,524,5.7
CN0601700000000,2023-05-01,06,017,CA,El Dorado County,93826,90412,3414,3.6
CN0601900000000,2023-05-01,06,019,CA,Fresno County,465577,430735,34842,7.5
CN0602100000000,2023-05-01,06,021,CA,Glenn County,12615,11816,799,6.3
CN0602300000000,2023-05-01,06,023,CA,Humboldt County,59695,57156,2539,4.3
CN0602500000000,2023-05-01,06,025,CA,Imperial County,70768,59444,11324,16
CN0602700000000,2023-05-01,06,027,CA,Inyo County,8260,7972,288,3.5
CN0602900000000,2023-05-01,06,029,CA,Kern County,397202,363046,34156,8.6
CN0603100000000,2023-05-01,06,031,CA,Kings County,58507,53844,4663,8
CN0603300000000,2023-05-01,06,033,CA,Lake County,28028,26483,1545,5.5
CN0603500000000,2023-05-01,06,035,CA,Lassen County,8810,8401,409,4.6
CN0603700000000,2023-05-01,06,037,CA,Los Angeles County,4969391,4728466,240925,4.8
CN0603900000000,2023-05-01,06,039,CA,Madera County,65763,60937,4826,7.3
CN0604100000000,2023-05-01,06,041,CA,Marin County,131411,127471,3940,3
CN0604300000000,2023-05-01,06,043,CA,Mariposa County,7602,7258,344,4.5
CN0604500000000,2023-05-01,06,045,CA,Mendocino County,36191,34643,1548,4.3
CN0604700000000,2023-05-01,06,047,CA,Merced County,116650,105848,10802,9.3
CN0604900000000,2023-05-01,06,049,CA,Modoc County,3216,3024,192,6
CN0605100000000,2023-05-01,06,051,CA,Mono County,8080,7767,313,3.9
CN0605300000000,2023-05-01,06,053,CA,Monterey County,236678,221800,14878,6.3
CN0605500000000,2023-05-01,06,055,CA,Napa County,72104,69833,2271,3.1
CN0605700000000,2023-05-01,06,057,CA,Nevada County,47073,45321,1752,3.7
CN0605900000000,2023-05-01,06,059,CA,Orange County,1594665,1543469,51196,3.2
CN0606100000000,2023-05-01,06,061,CA,Placer County,195113,188500,6613,3.4
CN0606300000000,2023-05-01,06,063,CA,Plumas County,7376,6867,509,6.9
CN0606500000000,2023-05-01,06,065,CA,Riverside County,1141760,1091597,50163,4.4
CN0606700000000,2023-05-01,06,067,CA,Sacramento County,732533,702597,29936,4.1
CN0606900000000,2023-05-01,06,069,CA,San Benito County,32625,30717,1908,5.8
CN0607100000000,2023-05-01,06,071,CA,San Bernardino County,999528,956150,43378,4.3
CN0607300000000,2023-05-01,06,073,CA,San Diego County,1595260,1539611,55649,3.5
CN0607500000000,2023-05-01,06,075,CA,San Francisco County/city,574941,557927,17014,3
CN0607700000000,2023-05-01,06,077,CA,San Joaquin County,351816,331133,20683,5.9
CN0607900000000,2023-05-01,06,079,CA,San Luis Obispo County,139859,135617,4242,3
CN0608100000000,2023-05-01,06,081,CA,San Mateo County,454424,442093,12331,2.7
CN0608300000000,2023-05-01,06,083,CA,Santa Barbara County,225464,217612,7852,3.5
CN0608500000000,2023-05-01,06,085,CA,Santa Clara County,1043239,1009895,33344,3.2
CN0608700000000,2023-05-01,06,087,CA,Santa Cruz County,135690,127926,7764,5.7
CN0608900000000,2023-05-01,06,089,CA,Shasta County,73437,69878,3559,4.8
CN0609100000000,2023-05-01,06,091,CA,Sierra County,1315,1255,60,4.6
CN0609300000000,2023-05-01,06,093,CA,Siskiyou County,16476,15501,975,5.9
CN0609500000000,2023-05-01,06,095,CA,Solano County,202188,193535,8653,4.3
CN0609700000000,2023-05-01,06,097,CA,Sonoma County,248283,240006,8277,3.3
CN0609900000000,2023-05-01,06,099,CA,Stanislaus County,245796,230183,15613,6.4
CN0610100000000,2023-05-01,06,101,CA,Sutter County,47768,43976,3792,7.9
CN0610300000000,2023-05-01,06,103,CA,Tehama County,25270,23822,1448,5.7
CN0610500000000,2023-05-01,06,105,CA,Trinity County,4433,4189,244,5.5
CN0610700000000,2023-05-01,06,107,CA,Tulare County,216327,194750,21577,10
CN0610900000000,2023-05-01,06,109,CA,Tuolumne County,19632,18699,933,4.8
CN0611100000000,2023-05-01,06,111,CA,Ventura County,415829,400393,15436,3.7
CN0611300000000,2023-05-01,06,113,CA,Yolo County,109903,105297,4606,4.2
CN0611500000000,2023-05-01,06,115,CA,Yuba County,32242,30234,2008,6.2
CN0800100000000,2023-05-01,08,001,CO,Adams County,284073,275550,8523,3
CN0800300000000,2023-05-01,08,003,CO,Alamosa County,8561,8313,248,2.9
CN0800500000000,2023-05-01,08,005,CO,Arapahoe County,378021,367626,10395,2.7
CN0800700000000,2023-05-01,08,007,CO,Archuleta County,7165,6977,188,2.6
CN0800900000000,2023-05-01,08,009,CO,Baca County,2094,2057,37,1.8
CN0801100000000,2023-05-01,08,011,CO,Bent County,1821,1778,43,2.4
CN0801300000000,2023-05-01,08,013,CO,Boulder County,204815,199636,5179,2.5
CN0801400000000,2023-05-01,08,014,CO,Broomfield County/city,42997,41836,1161,2.7
CN0801500000000,2023-05-01,08,015,CO,Chaffee County,10057,9805,252,2.5
CN0801700000000,2023-05-01,08,017,CO,Cheyenne County,1061,1043,18,1.7
CN0801900000000,2023-05-01,08,019,CO,Clear Creek County,6200,6041,159,2.6
CN0802100000000,2023-05-01,08,021,CO,Conejos County,4147,4041,106,2.6
CN0802300000000,2023-05-01,08,023,CO,Costilla County,1843,1770,73,4
CN0802500000000,2023-05-01,08,025,CO,Crowley County,1397,1342,55,3.9
CN0802700000000,2023-05-01,08,027,CO,Custer County,2533,2471,62,2.4
CN0802900000000,2023-05-01,08,029,CO,Delta County,13460,13039,421,3.1
CN0803100000000,2023-05-01,08,031,CO,Denver County/city,440351,427369,12982,2.9
CN0803300000000,2023-05-01,08,033,CO,Dolores County,1206,1166,40,3.3
CN0803500000000,2023-05-01,08,035,CO,Douglas County,210136,204711,5425,2.6
CN0803700000000,2023-05-01,08,037,CO,Eagle County,33371,32331,1040,3.1
CN0803900000000,2023-05-01,08,039,CO,Elbert County,16176,15797,379,2.3
CN0804100000000,2023-05-01,08,041,CO,El Paso County,366119,355411,10708,2.9
CN0804300000000,2023-05-01,08,043,CO,Fremont County,14520,13905,615,4.2
CN0804500000000,2023-05-01,08,045,CO,Garfield County,30309,29484,825,2.7
CN0804700000000,2023-05-01,08,047,CO,Gilpin County,3963,3862,101,2.5
CN0804900000000,2023-05-01,08,049,CO,Grand County,8716,8479,237,2.7
CN0805100000000,2023-05-01,08,051,CO,Gunnison County,11539,11196,343,3
CN0805300000000,2023-05-01,08,053,CO,Hinsdale County,460,451,9,2
CN0805500000000,2023-05-01,08,055,CO,Huerfano County,2451,2326,125,5.1
CN0805700000000,2023-05-01,08,057,CO,Jackson County,1060,1042,18,1.7
CN0805900000000,2023-05-01,08,059,CO,Jefferson County,345965,337036,8929,2.6
CN0806100000000,2023-05-01,08,061,CO,Kiowa County,902,886,16,1.8
CN0806300000000,2023-05-01,08,063,CO,Kit Carson County,4258,4185,73,1.7
CN0806500000000,2023-05-01,08,065,CO,Lake County,4895,4767,128,2.6
CN0806700000000,2023-05-01,08,067,CO,La Plata County,32139,31348,791,2.5
CN0806900000000,2023-05-01,08,069,CO,Larimer County,218302,213010,5292,2.4
CN0807100000000,2023-05-01,08,071,CO,Las Animas County,6098,5813,285,4.7
CN0807300000000,2023-05-01,08,073,CO,Lincoln County,2240,2182,58,2.6
CN0807500000000,2023-05-01,08,075,CO,Logan County,10319,10082,237,2.3
CN0807700000000,2023-05-01,08,077,CO,Mesa County,77327,75058,2269,2.9
CN0807900000000,2023-05-01,08,079,CO,Mineral County,451,441,10,2.2
CN0808100000000,2023-05-01,08,081,CO,Moffat County,6907,6707,200,2.9
CN0808300000000,2023-05-01,08,083,CO,Montezuma County,12672,12265,407,3.2
CN0808500000000,2023-05-01,08,085,CO,Montrose County,21647,21036,611,2.8
CN0808700000000,2023-05-01,08,087,CO,Morgan County,15861,15435,426,2.7
CN0808900000000,2023-05-01,08,089,CO,Otero County,7949,7653,296,3.7
CN0809100000000,2023-05-01,08,091,CO,Ouray County,2435,2359,76,3.1
CN0809300000000,2023-05-01,08,093,CO,Park County,11738,11434,304,2.6
CN0809500000000,2023-05-01,08,095,CO,Phillips County,2470,2426,44,1.8
CN0809700000000,2023-05-01,08,097,CO,Pitkin County,10587,10072,515,4.9
CN0809900000000,2023-05-01,08,099,CO,Prowers County,6358,6201,157,2.5
CN0810100000000,2023-05-01,08,101,CO,Pueblo County,76525,73542,2983,3.9
CN0810300000000,2023-05-01,08,103,CO,Rio Blanco County,2952,2873,79,2.7
CN0810500000000,2023-05-01,08,105,CO,Rio Grande County,5416,5264,152,2.8
CN0810700000000,2023-05-01,08,107,CO,Routt County,15290,14881,409,2.7
CN0810900000000,2023-05-01,08,109,CO,Saguache County,3518,3416,102,2.9
CN0811100000000,2023-05-01,08,111,CO,San Juan County,511,497,14,2.7
CN0811300000000,2023-05-01,08,113,CO,San Miguel County,4986,4667,319,6.4
CN0811500000000,2023-05-01,08,115,CO,Sedgwick County,1028,999,29,2.8
CN0811700000000,2023-05-01,08,117,CO,Summit County,20544,20043,501,2.4
CN0811900000000,2023-05-01,08,119,CO,Teller County,13661,13302,359,2.6
CN0812100000000,2023-05-01,08,121,CO,Washington County,2846,2792,54,1.9
CN0812300000000,2023-05-01,08,123,CO,Weld County,171556,166660,4896,2.9
CN0812500000000,2023-05-01,08,125,CO,Yuma County,5769,5677,92,1.6
CN0900100000000,2023-05-01,09,001,CT,Fairfield County,477478,459321,18157,3.8
CN0900300000000,2023-05-01,09,003,CT,Hartford County,470565,453464,17101,3.6
CN0900500000000,2023-05-01,09,005,CT,Litchfield County,103445,100067,3378,3.3
CN0900700000000,2023-05-01,09,007,CT,Middlesex County,92735,89764,2971,3.2
CN0900900000000,2023-05-01,09,009,CT,New Haven County,461582,443743,17839,3.9
CN0901100000000,2023-05-01,09,011,CT,New London County,132188,127387,4801,3.6
CN0901300000000,2023-05-01,09,013,CT,Tolland County,85177,82343,2834,3.3
CN0901500000000,2023-05-01,09,015,CT,Windham County,63196,60799,2397,3.8
CN1000100000000,2023-05-01,10,001,DE,Kent County,80466,76929,3537,4.4
CN1000300000000,2023-05-01,10,003,DE,New Castle County,308145,296313,11832,3.8
CN1000500000000,2023-05-01,10,005,DE,Sussex County,113491,109162,4329,3.8
CN1100100000000,2023-05-01,11,001,DC,District of Columbia,391319,372248,19071,4.9
CN1200100000000,2023-05-01,12,001,FL,Alachua County,144067,139996,4071,2.8
CN1200300000000,2023-05-01,12,003,FL,Baker County,13125,12776,349,2.7
CN1200500000000,2023-05-01,12,005,FL,Bay County,90507,88339,2168,2.4
CN1200700000000,2023-05-01,12,007,FL,Bradford County,11270,10966,304,2.7
CN1200900000000,2023-05-01,12,009,FL,Brevard County,303433,295104,8329,2.7
CN1201100000000,2023-05-01,12,011,FL,Broward County,1086370,1057751,28619,2.6
CN1201300000000,2023-05-01,12,013,FL,Calhoun County,4985,4846,139,2.8
CN1201500000000,2023-05-01,12,015,FL,Charlotte County,78529,76145,2384,3
CN1201700000000,2023-05-01,12,017,FL,Citrus County,51179,49189,1990,3.9
CN1201900000000,2023-05-01,12,019,FL,Clay County,117446,114434,3012,2.6
CN1202100000000,2023-05-01,12,021,FL,Collier County,190375,185538,4837,2.5
CN1202300000000,2023-05-01,12,023,FL,Columbia County,29919,29036,883,3
CN1202700000000,2023-05-01,12,027,FL,DeSoto County,14581,14147,434,3
CN1202900000000,2023-05-01,12,029,FL,Dixie County,5973,5787,186,3.1
CN1203100000000,2023-05-01,12,031,FL,Duval County,530959,516120,14839,2.8
CN1203300000000,2023-05-01,12,033,FL,Escambia County,152279,148043,4236,2.8
CN1203500000000,2023-05-01,12,035,FL,Flagler County,52282,50542,1740,3.3
CN1203700000000,2023-05-01,12,037,FL,Franklin County,5002,4876,126,2.5
CN1203900000000,2023-05-01,12,039,FL,Gadsden County,19370,18701,669,3.5
CN1204100000000,2023-05-01,12,041,FL,Gilchrist County,7522,7281,241,3.2
CN1204300000000,2023-05-01,12,043,FL,Glades County,5450,5281,169,3.1
CN1204500000000,2023-05-01,12,045,FL,Gulf County,5588,5462,126,2.3
CN1204700000000,2023-05-01,12,047,FL,Hamilton County,4212,4057,155,3.7
CN1204900000000,2023-05-01,12,049,FL,Hardee County,9016,8696,320,3.5
CN1205100000000,2023-05-01,12,051,FL,Hendry County,15625,14987,638,4.1
CN1205300000000,2023-05-01,12,053,FL,Hernando County,79777,77058,2719,3.4
CN1205500000000,2023-05-01,12,055,FL,Highlands County,36952,35490,1462,4
CN1205700000000,2023-05-01,12,057,FL,Hillsborough County,834848,812818,22030,2.6
CN1205900000000,2023-05-01,12,059,FL,Holmes County,7248,7044,204,2.8
CN1206100000000,2023-05-01,12,061,FL,Indian River County,68692,66491,2201,3.2
CN1206300000000,2023-05-01,12,063,FL,Jackson County,16943,16417,526,3.1
CN1206500000000,2023-05-01,12,065,FL,Jefferson County,5830,5661,169,2.9
CN1206700000000,2023-05-01,12,067,FL,Lafayette County,2886,2804,82,2.8
CN1206900000000,2023-05-01,12,069,FL,Lake County,176080,171108,4972,2.8
CN1207100000000,2023-05-01,12,071,FL,Lee County,388267,377322,10945,2.8
CN1207300000000,2023-05-01,12,073,FL,Leon County,162491,157821,4670,2.9
CN1207500000000,2023-05-01,12,075,FL,Levy County,17333,16803,530,3.1
CN1207700000000,2023-05-01,12,077,FL,Liberty County,2711,2636,75,2.8
CN1207900000000,2023-05-01,12,079,FL,Madison County,7966,7746,220,2.8
CN1208100000000,2023-05-01,12,081,FL,Manatee County,191828,186595,5233,2.7
CN1208300000000,2023-05-01,12,083,FL,Marion County,152015,146978,5037,3.3
CN1208500000000,2023-05-01,12,085,FL,Martin County,78328,76331,1997,2.5
CN1208600000000,2023-05-01,12,086,FL,Miami-Dade County,1364211,1334724,29487,2.2
CN1208700000000,2023-05-01,12,087,FL,Monroe County,51366,50501,865,1.7
CN1208900000000,2023-05-01,12,089,FL,Nassau County,46382,45211,1171,2.5
CN1209100000000,2023-05-01,12,091,FL,Okaloosa County,106420,104009,2411,2.3
CN1209300000000,2023-05-01,12,093,FL,Okeechobee County,18278,17742,536,2.9
CN1209500000000,2023-05-01,12,095,FL,Orange County,815095,793726,21369,2.6
CN1209700000000,2023-05-01,12,097,FL,Osceola County,202903,196656,6247,3.1
CN1209900000000,2023-05-01,12,099,FL,Palm Beach County,780423,759507,20916,2.7
CN1210100000000,2023-05-01,12,101,FL,Pasco County,268097,260064,8033,3
CN1210300000000,2023-05-01,12,103,FL,Pinellas County,529316,516237,13079,2.5
CN1210500000000,2023-05-01,12,105,FL,Polk County,346362,334941,11421,3.3
CN1210700000000,2023-05-01,12,107,FL,Putnam County,27969,26937,1032,3.7
CN1210900000000,2023-05-01,12,109,FL,St. Johns County,155405,151750,3655,2.4
CN1211100000000,2023-05-01,12,111,FL,St. Lucie County,160716,155695,5021,3.1
CN1211300000000,2023-05-01,12,113,FL,Santa Rosa County,89597,87276,2321,2.6
CN1211500000000,2023-05-01,12,115,FL,Sarasota County,201047,195561,5486,2.7
CN1211700000000,2023-05-01,12,117,FL,Seminole County,271728,264784,6944,2.6
CN1211900000000,2023-05-01,12,119,FL,Sumter County,38951,37499,1452,3.7
CN1212100000000,2023-05-01,12,121,FL,Suwannee County,17960,17395,565,3.1
CN1212300000000,2023-05-01,12,123,FL,Taylor County,8325,8082,243,2.9
CN1212500000000,2023-05-01,12,125,FL,Union County,4618,4487,131,2.8
CN1212700000000,2023-05-01,12,127,FL,Volusia County,274791,266725,8066,2.9
CN1212900000000,2023-05-01,12,129,FL,Wakulla County,16250,15858,392,2.4
CN1213100000000,2023-05-01,12,131,FL,Walton County,36001,35124,877,2.4
CN1213300000000,2023-05-01,12,133,FL,Washington County,10118,9824,294,2.9
CN1300100000000,2023-05-01,13,001,GA,Appling County,9554,9209,345,3.6
CN1300300000000,2023-05-01,13,003,GA,Atkinson County,4445,4296,149,3.4
CN1300500000000,2023-05-01,13,005,GA,Bacon County,5008,4850,158,3.2
CN1300700000000,2023-05-01,13,007,GA,Baker County,1128,1083,45,4
CN1300900000000,2023-05-01,13,009,GA,Baldwin County,18339,17563,776,4.2
CN1301100000000,2023-05-01,13,011,GA,Banks County,10940,10673,267,2.4
CN1301300000000,2023-05-01,13,013,GA,Barrow County,43666,42363,1303,3
CN1301500000000,2023-05-01,13,015,GA,Bartow County,52922,51238,1684,3.2
CN1301700000000,2023-05-01,13,017,GA,Ben Hill County,5616,5360,256,4.6
CN1301900000000,2023-05-01,13,019,GA,Berrien County,7756,7474,282,3.6
CN1302100000000,2023-05-01,13,021,GA,Bibb County,66188,63350,2838,4.3
CN1302300000000,2023-05-01,13,023,GA,Bleckley County,4544,4333,211,4.6
CN1302500000000,2023-05-01,13,025,GA,Brantley County,7610,7326,284,3.7
CN1302700000000,2023-05-01,13,027,GA,Brooks County,6719,6476,243,3.6
CN1302900000000,2023-05-01,13,029,GA,Bryan County,20335,19743,592,2.9
CN1303100000000,2023-05-01,13,031,GA,Bulloch County,38908,37510,1398,3.6
CN1303300000000,2023-05-01,13,033,GA,Burke County,9112,8575,537,5.9
CN1303500000000,2023-05-01,13,035,GA,Butts County,11487,11115,372,3.2
CN1303700000000,2023-05-01,13,037,GA,Calhoun County,2187,2119,68,3.1
CN1303900000000,2023-05-01,13,039,GA,Camden County,22530,21775,755,3.4
CN1304300000000,2023-05-01,13,043,GA,Candler County,6298,6137,161,2.6
CN1304500000000,2023-05-01,13,045,GA,Carroll County,57986,55975,2011,3.5
CN1304700000000,2023-05-01,13,047,GA,Catoosa County,33858,32858,1000,3
CN1304900000000,2023-05-01,13,049,GA,Charlton County,5081,4908,173,3.4
CN1305100000000,2023-05-01,13,051,GA,Chatham County,145363,140696,4667,3.2
CN1305300000000,2023-05-01,13,053,GA,Chattahoochee County,1961,1864,97,4.9
CN1305500000000,2023-05-01,13,055,GA,Chattooga County,9040,8683,357,3.9
CN1305700000000,2023-05-01,13,057,GA,Cherokee County,144616,140571,4045,2.8
CN1305900000000,2023-05-01,13,059,GA,Clarke County,59290,57144,2146,3.6
CN1306100000000,2023-05-01,13,061,GA,Clay County,817,755,62,7.6
CN1306300000000,2023-05-01,13,063,GA,Clayton County,142069,135909,6160,4.3
CN1306500000000,2023-05-01,13,065,GA,Clinch County,3085,2991,94,3
CN1306700000000,2023-05-01,13,067,GA,Cobb County,437107,423930,13177,3
CN1306900000000,2023-05-01,13,069,GA,Coffee County,19213,18463,750,3.9
CN1307100000000,2023-05-01,13,071,GA,Colquitt County,22463,21793,670,3
CN1307300000000,2023-05-01,13,073,GA,Columbia County,76390,73927,2463,3.2
CN1307500000000,2023-05-01,13,075,GA,Cook County,8317,8036,281,3.4
CN1307700000000,2023-05-01,13,077,GA,Coweta County,78814,76323,2491,3.2
CN1307900000000,2023-05-01,13,079,GA,Crawford County,5422,5233,189,3.5
CN1308100000000,2023-05-01,13,081,GA,Crisp County,9809,9423,386,3.9
CN1308300000000,2023-05-01,13,083,GA,Dade County,8131,7895,236,2.9
CN1308500000000,2023-05-01,13,085,GA,Dawson County,13593,13195,398,2.9
CN1308700000000,2023-05-01,13,087,GA,Decatur County,11901,11471,430,3.6
CN1308900000000,2023-05-01,13,089,GA,DeKalb County,410376,395938,14438,3.5
CN1309100000000,2023-05-01,13,091,GA,Dodge County,6830,6529,301,4.4
CN1309300000000,2023-05-01,13,093,GA,Dooly County,4947,4762,185,3.7
CN1309500000000,2023-05-01,13,095,GA,Dougherty County,36732,35067,1665,4.5
CN1309700000000,2023-05-01,13,097,GA,Douglas County,76088,73316,2772,3.6
CN1309900000000,2023-05-01,13,099,GA,Early County,4423,4250,173,3.9
CN1310100000000,2023-05-01,13,101,GA,Echols County,1874,1824,50,2.7
CN1310300000000,2023-05-01,13,103,GA,Effingham County,34015,33021,994,2.9
CN1310500000000,2023-05-01,13,105,GA,Elbert County,8107,7809,298,3.7
CN1310700000000,2023-05-01,13,107,GA,Emanuel County,9059,8678,381,4.2
CN1310900000000,2023-05-01,13,109,GA,Evans County,4978,4826,152,3.1
CN1311100000000,2023-05-01,13,111,GA,Fannin County,12272,11889,383,3.1
CN1311300000000,2023-05-01,13,113,GA,Fayette County,60402,58526,1876,3.1
CN1311500000000,2023-05-01,13,115,GA,Floyd County,45394,43821,1573,3.5
CN1311700000000,2023-05-01,13,117,GA,Forsyth County,131981,128307,3674,2.8
CN1311900000000,2023-05-01,13,119,GA,Franklin County,9754,9408,346,3.5
CN1312100000000,2023-05-01,13,121,GA,Fulton County,583420,562182,21238,3.6
CN1312300000000,2023-05-01,13,123,GA,Gilmer County,12489,12051,438,3.5
CN1312500000000,2023-05-01,13,125,GA,Glascock County,1261,1216,45,3.6
CN1312700000000,2023-05-01,13,127,GA,Glynn County,40833,39574,1259,3.1
CN1312900000000,2023-05-01,13,129,GA,Gordon County,28923,28031,892,3.1
CN1313100000000,2023-05-01,13,131,GA,Grady County,11043,10665,378,3.4
CN1313300000000,2023-05-01,13,133,GA,Greene County,7404,7125,279,3.8
CN1313500000000,2023-05-01,13,135,GA,Gwinnett County,507508,491821,15687,3.1
CN1313700000000,2023-05-01,13,137,GA,Habersham County,19050,18397,653,3.4
CN1313900000000,2023-05-01,13,139,GA,Hall County,109044,106099,2945,2.7
CN1314100000000,2023-05-01,13,141,GA,Hancock County,2601,2457,144,5.5
CN1314300000000,2023-05-01,13,143,GA,Haralson County,13197,12733,464,3.5
CN1314500000000,2023-05-01,13,145,GA,Harris County,17228,16712,516,3
CN1314700000000,2023-05-01,13,147,GA,Hart County,12696,12308,388,3.1
CN1314900000000,2023-05-01,13,149,GA,Heard County,5395,5213,182,3.4
CN1315100000000,2023-05-01,13,151,GA,Henry County,122379,117918,4461,3.6
CN1315300000000,2023-05-01,13,153,GA,Houston County,71171,68895,2276,3.2
CN1315500000000,2023-05-01,13,155,GA,Irwin County,3537,3397,140,4
CN1315700000000,2023-05-01,13,157,GA,Jackson County,45654,44531,1123,2.5
CN1315900000000,2023-05-01,13,159,GA,Jasper County,7306,7074,232,3.2
CN1316100000000,2023-05-01,13,161,GA,Jeff Davis County,6237,5963,274,4.4
CN1316300000000,2023-05-01,13,163,GA,Jefferson County,6656,6394,262,3.9
CN1316500000000,2023-05-01,13,165,GA,Jenkins County,3469,3291,178,5.1
CN1316700000000,2023-05-01,13,167,GA,Johnson County,3977,3840,137,3.4
CN1316900000000,2023-05-01,13,169,GA,Jones County,13443,13003,440,3.3
CN1317100000000,2023-05-01,13,171,GA,Lamar County,8477,8179,298,3.5
CN1317300000000,2023-05-01,13,173,GA,Lanier County,3799,3640,159,4.2
CN1317500000000,2023-05-01,13,175,GA,Laurens County,19052,18172,880,4.6
CN1317700000000,2023-05-01,13,177,GA,Lee County,15150,14689,461,3
CN1317900000000,2023-05-01,13,179,GA,Liberty County,26398,25450,948,3.6
CN1318100000000,2023-05-01,13,181,GA,Lincoln County,3540,3398,142,4
CN1318300000000,2023-05-01,13,183,GA,Long County,8555,8255,300,3.5
CN1318500000000,2023-05-01,13,185,GA,Lowndes County,50661,48729,1932,3.8
CN1318700000000,2023-05-01,13,187,GA,Lumpkin County,18869,18339,530,2.8
CN1318900000000,2023-05-01,13,189,GA,McDuffie County,8469,8055,414,4.9
CN1319100000000,2023-05-01,13,191,GA,McIntosh County,6387,6179,208,3.3
CN1319300000000,2023-05-01,13,193,GA,Macon County,4529,4330,199,4.4
CN1319500000000,2023-05-01,13,195,GA,Madison County,13659,13228,431,3.2
CN1319700000000,2023-05-01,13,197,GA,Marion County,3323,3197,126,3.8
CN1319900000000,2023-05-01,13,199,GA,Meriwether County,9113,8716,397,4.4
CN1320100000000,2023-05-01,13,201,GA,Miller County,2964,2886,78,2.6
CN1320500000000,2023-05-01,13,205,GA,Mitchell County,8460,8122,338,4
CN1320700000000,2023-05-01,13,207,GA,Monroe County,12925,12501,424,3.3
CN1320900000000,2023-05-01,13,209,GA,Montgomery County,4063,3905,158,3.9
CN1321100000000,2023-05-01,13,211,GA,Morgan County,9806,9511,295,3
CN1321300000000,2023-05-01,13,213,GA,Murray County,15391,14766,625,4.1
CN1321500000000,2023-05-01,13,215,GA,Muscogee County,77377,73981,3396,4.4
CN1321700000000,2023-05-01,13,217,GA,Newton County,55044,52904,2140,3.9
CN1321900000000,2023-05-01,13,219,GA,Oconee County,20463,19909,554,2.7
CN1322100000000,2023-05-01,13,221,GA,Oglethorpe County,7072,6854,218,3.1
CN1322300000000,2023-05-01,13,223,GA,Paulding County,92646,89820,2826,3.1
CN1322500000000,2023-05-01,13,225,GA,Peach County,11962,11461,501,4.2
CN1322700000000,2023-05-01,13,227,GA,Pickens County,16126,15644,482,3
CN1322900000000,2023-05-01,13,229,GA,Pierce County,9087,8775,312,3.4
CN1323100000000,2023-05-01,13,231,GA,Pike County,9298,9029,269,2.9
CN1323300000000,2023-05-01,13,233,GA,Polk County,18442,17782,660,3.6
CN1323500000000,2023-05-01,13,235,GA,Pulaski County,4053,3890,163,4
CN1323700000000,2023-05-01,13,237,GA,Putnam County,8799,8442,357,4.1
CN1323900000000,2023-05-01,13,239,GA,Quitman County,715,672,43,6
CN1324100000000,2023-05-01,13,241,GA,Rabun County,8000,7738,262,3.3
CN1324300000000,2023-05-01,13,243,GA,Randolph County,2395,2296,99,4.1
CN1324500000000,2023-05-01,13,245,GA,Richmond County,83452,79391,4061,4.9
CN1324700000000,2023-05-01,13,247,GA,Rockdale County,45825,44058,1767,3.9
CN1324900000000,2023-05-01,13,249,GA,Schley County,2228,2154,74,3.3
CN1325100000000,2023-05-01,13,251,GA,Screven County,5107,4825,282,5.5
CN1325300000000,2023-05-01,13,253,GA,Seminole County,3098,2968,130,4.2
CN1325500000000,2023-05-01,13,255,GA,Spalding County,29758,28618,1140,3.8
CN1325700000000,2023-05-01,13,257,GA,Stephens County,10624,10193,431,4.1
CN1325900000000,2023-05-01,13,259,GA,Stewart County,2679,2575,104,3.9
CN1326100000000,2023-05-01,13,261,GA,Sumter County,12838,12192,646,5
CN1326300000000,2023-05-01,13,263,GA,Talbot County,2827,2730,97,3.4
CN1326500000000,2023-05-01,13,265,GA,Taliaferro County,543,520,23,4.2
CN1326700000000,2023-05-01,13,267,GA,Tattnall County,9107,8778,329,3.6
CN1326900000000,2023-05-01,13,269,GA,Taylor County,2655,2523,132,5
CN1327100000000,2023-05-01,13,271,GA,Telfair County,3501,3248,253,7.2
CN1327300000000,2023-05-01,13,273,GA,Terrell County,3516,3343,173,4.9
CN1327500000000,2023-05-01,13,275,GA,Thomas County,16784,16086,698,4.2
CN1327700000000,2023-05-01,13,277,GA,Tift County,20809,20152,657,3.2
CN1327900000000,2023-05-01,13,279,GA,Toombs County,12725,12259,466,3.7
CN1328100000000,2023-05-01,13,281,GA,Towns County,4263,4071,192,4.5
CN1328300000000,2023-05-01,13,283,GA,Treutlen County,2726,2600,126,4.6
CN1328500000000,2023-05-01,13,285,GA,Troup County,36239,35097,1142,3.2
CN1328700000000,2023-05-01,13,287,GA,Turner County,3203,3056,147,4.6
CN1328900000000,2023-05-01,13,289,GA,Twiggs County,2773,2617,156,5.6
CN1329100000000,2023-05-01,13,291,GA,Union County,11710,11364,346,3
CN1329300000000,2023-05-01,13,293,GA,Upson County,11884,11468,416,3.5
CN1329500000000,2023-05-01,13,295,GA,Walker County,31651,30615,1036,3.3
CN1329700000000,2023-05-01,13,297,GA,Walton County,48635,47095,1540,3.2
CN1329900000000,2023-05-01,13,299,GA,Ware County,16159,15606,553,3.4
CN1330100000000,2023-05-01,13,301,GA,Warren County,2702,2584,118,4.4
CN1330300000000,2023-05-01,13,303,GA,Washington County,7093,6802,291,4.1
CN1330500000000,2023-05-01,13,305,GA,Wayne County,12268,11850,418,3.4
CN1330700000000,2023-05-01,13,307,GA,Webster County,971,933,38,3.9
CN1330900000000,2023-05-01,13,309,GA,Wheeler County,1754,1650,104,5.9
CN1331100000000,2023-05-01,13,311,GA,White County,17127,16689,438,2.6
CN1331300000000,2023-05-01,13,313,GA,Whitfield County,43122,41526,1596,3.7
CN1331500000000,2023-05-01,13,315,GA,Wilcox County,2718,2607,111,4.1
CN1331700000000,2023-05-01,13,317,GA,Wilkes County,3716,3565,151,4.1
CN1331900000000,2023-05-01,13,319,GA,Wilkinson County,4015,3869,146,3.6
CN1332100000000,2023-05-01,13,321,GA,Worth County,8832,8531,301,3.4
CN1500100000000,2023-05-01,15,001,HI,Hawaii County,93686,90852,2834,3
CN1500300000000,2023-05-01,15,003,HI,Honolulu County/city,455696,443896,11800,2.6
CN1500700000000,2023-05-01,15,007,HI,Kauai County,36445,35520,925,2.5
CN1500900000000,2023-05-01,15,009,HI,Maui County,86100,83915,2185,2.5
CN1600100000000,2023-05-01,16,001,ID,Ada County,282613,275747,6866,2.4
CN1600300000000,2023-05-01,16,003,ID,Adams County,1916,1807,109,5.7
CN1600500000000,2023-05-01,16,005,ID,Bannock County,45388,44243,1145,2.5
CN1600700000000,2023-05-01,16,007,ID,Bear Lake County,3035,2964,71,2.3
CN1600900000000,2023-05-01,16,009,ID,Benewah County,4114,3914,200,4.9
CN1601100000000,2023-05-01,16,011,ID,Bingham County,24589,23967,622,2.5
CN1601300000000,2023-05-01,16,013,ID,Blaine County,13040,12686,354,2.7
CN1601500000000,2023-05-01,16,015,ID,Boise County,3870,3720,150,3.9
CN1601700000000,2023-05-01,16,017,ID,Bonner County,22893,22009,884,3.9
CN1601900000000,2023-05-01,16,019,ID,Bonneville County,64759,63246,1513,2.3
CN1602100000000,2023-05-01,16,021,ID,Boundary County,6086,5852,234,3.8
CN1602300000000,2023-05-01,16,023,ID,Butte County,1442,1399,43,3
CN1602500000000,2023-05-01,16,025,ID,Camas County,747,730,17,2.3
CN1602700000000,2023-05-01,16,027,ID,Canyon County,116579,113169,3410,2.9
CN1602900000000,2023-05-01,16,029,ID,Caribou County,4340,4224,116,2.7
CN1603100000000,2023-05-01,16,031,ID,Cassia County,13032,12739,293,2.2
CN1603300000000,2023-05-01,16,033,ID,Clark County,394,380,14,3.6
CN1603500000000,2023-05-01,16,035,ID,Clearwater County,3380,3182,198,5.9
CN1603700000000,2023-05-01,16,037,ID,Custer County,2267,2195,72,3.2
CN1603900000000,2023-05-01,16,039,ID,Elmore County,12867,12497,370,2.9
CN1604100000000,2023-05-01,16,041,ID,Franklin County,7831,7671,160,2
CN1604300000000,2023-05-01,16,043,ID,Fremont County,8141,7960,181,2.2
CN1604500000000,2023-05-01,16,045,ID,Gem County,9466,9137,329,3.5
CN1604700000000,2023-05-01,16,047,ID,Gooding County,8661,8454,207,2.4
CN1604900000000,2023-05-01,16,049,ID,Idaho County,7364,7079,285,3.9
CN1605100000000,2023-05-01,16,051,ID,Jefferson County,16163,15812,351,2.2
CN1605300000000,2023-05-01,16,053,ID,Jerome County,12086,11780,306,2.5
CN1605500000000,2023-05-01,16,055,ID,Kootenai County,86478,83915,2563,3
CN1605700000000,2023-05-01,16,057,ID,Latah County,21102,20606,496,2.4
CN1605900000000,2023-05-01,16,059,ID,Lemhi County,4106,3966,140,3.4
CN1606100000000,2023-05-01,16,061,ID,Lewis County,1746,1688,58,3.3
CN1606300000000,2023-05-01,16,063,ID,Lincoln County,2890,2799,91,3.1
CN1606500000000,2023-05-01,16,065,ID,Madison County,24392,23939,453,1.9
CN1606700000000,2023-05-01,16,067,ID,Minidoka County,12512,12224,288,2.3
CN1606900000000,2023-05-01,16,069,ID,Nez Perce County,21742,21221,521,2.4
CN1607100000000,2023-05-01,16,071,ID,Oneida County,2699,2641,58,2.1
CN1607300000000,2023-05-01,16,073,ID,Owyhee County,5713,5516,197,3.4
CN1607500000000,2023-05-01,16,075,ID,Payette County,12142,11724,418,3.4
CN1607700000000,2023-05-01,16,077,ID,Power County,4464,4338,126,2.8
CN1607900000000,2023-05-01,16,079,ID,Shoshone County,5304,5042,262,4.9
CN1608100000000,2023-05-01,16,081,ID,Teton County,7908,7695,213,2.7
CN1608300000000,2023-05-01,16,083,ID,Twin Falls County,44099,42889,1210,2.7
CN1608500000000,2023-05-01,16,085,ID,Valley County,5584,5366,218,3.9
CN1608700000000,2023-05-01,16,087,ID,Washington County,5172,4982,190,3.7
CN1700100000000,2023-05-01,17,001,IL,Adams County,30110,29127,983,3.3
CN1700300000000,2023-05-01,17,003,IL,Alexander County,1777,1685,92,5.2
CN1700500000000,2023-05-01,17,005,IL,Bond County,7360,7107,253,3.4
CN1700700000000,2023-05-01,17,007,IL,Boone County,24454,22866,1588,6.5
CN1700900000000,2023-05-01,17,009,IL,Brown County,3108,3040,68,2.2
CN1701100000000,2023-05-01,17,011,IL,Bureau County,15782,15082,700,4.4
CN1701300000000,2023-05-01,17,013,IL,Calhoun County,2142,2060,82,3.8
CN1701500000000,2023-05-01,17,015,IL,Carroll County,7152,6881,271,3.8
CN1701700000000,2023-05-01,17,017,IL,Cass County,5589,5371,218,3.9
CN1701900000000,2023-05-01,17,019,IL,Champaign County,110108,106079,4029,3.7
CN1702100000000,2023-05-01,17,021,IL,Christian County,13054,12460,594,4.6
CN1702300000000,2023-05-01,17,023,IL,Clark County,7233,6935,298,4.1
CN1702500000000,2023-05-01,17,025,IL,Clay County,5502,5245,257,4.7
CN1702700000000,2023-05-01,17,027,IL,Clinton County,19669,19122,547,2.8
CN1702900000000,2023-05-01,17,029,IL,Coles County,21665,20803,862,4
CN1703100000000,2023-05-01,17,031,IL,Cook County,2643382,2553573,89809,3.4
CN1703300000000,2023-05-01,17,033,IL,Crawford County,8240,7949,291,3.5
CN1703500000000,2023-05-01,17,035,IL,Cumberland County,5840,5670,170,2.9
CN1703700000000,2023-05-01,17,037,IL,DeKalb County,53387,51188,2199,4.1
CN1703900000000,2023-05-01,17,039,IL,De Witt County,7297,7006,291,4
CN1704100000000,2023-05-01,17,041,IL,Douglas County,10011,9687,324,3.2
CN1704300000000,2023-05-01,17,043,IL,DuPage County,518693,505374,13319,2.6
CN1704500000000,2023-05-01,17,045,IL,Edgar County,9105,8828,277,3
CN1704700000000,2023-05-01,17,047,IL,Edwards County,2327,2212,115,4.9
CN1704900000000,2023-05-01,17,049,IL,Effingham County,19686,19164,522,2.7
CN1705100000000,2023-05-01,17,051,IL,Fayette County,9622,9221,401,4.2
CN1705300000000,2023-05-01,17,053,IL,Ford County,6295,6035,260,4.1
CN1705500000000,2023-05-01,17,055,IL,Franklin County,15396,14624,772,5
CN1705700000000,2023-05-01,17,057,IL,Fulton County,14553,13880,673,4.6
CN1705900000000,2023-05-01,17,059,IL,Gallatin County,1962,1856,106,5.4
CN1706100000000,2023-05-01,17,061,IL,Greene County,5826,5602,224,3.8
CN1706300000000,2023-05-01,17,063,IL,Grundy County,26032,25209,823,3.2
CN1706500000000,2023-05-01,17,065,IL,Hamilton County,4347,4205,142,3.3
CN1706700000000,2023-05-01,17,067,IL,Hancock County,7803,7521,282,3.6
CN1706900000000,2023-05-01,17,069,IL,Hardin County,1462,1394,68,4.7
CN1707100000000,2023-05-01,17,071,IL,Henderson County,3515,3397,118,3.4
CN1707300000000,2023-05-01,17,073,IL,Henry County,23362,22284,1078,4.6
CN1707500000000,2023-05-01,17,075,IL,Iroquois County,12060,11561,499,4.1
CN1707700000000,2023-05-01,17,077,IL,Jackson County,26174,25123,1051,4
CN1707900000000,2023-05-01,17,079,IL,Jasper County,4922,4768,154,3.1
CN1708100000000,2023-05-01,17,081,IL,Jefferson County,15963,15294,669,4.2
CN1708300000000,2023-05-01,17,083,IL,Jersey County,10469,10100,369,3.5
CN1708500000000,2023-05-01,17,085,IL,Jo Daviess County,10385,10041,344,3.3
CN1708700000000,2023-05-01,17,087,IL,Johnson County,4054,3851,203,5
CN1708900000000,2023-05-01,17,089,IL,Kane County,262278,250782,11496,4.4
CN1709100000000,2023-05-01,17,091,IL,Kankakee County,50803,48249,2554,5
CN1709300000000,2023-05-01,17,093,IL,Kendall County,72478,70453,2025,2.8
CN1709500000000,2023-05-01,17,095,IL,Knox County,19514,18546,968,5
CN1709700000000,2023-05-01,17,097,IL,Lake County,359264,343801,15463,4.3
CN1709900000000,2023-05-01,17,099,IL,LaSalle County,50792,48314,2478,4.9
CN1710100000000,2023-05-01,17,101,IL,Lawrence County,4898,4671,227,4.6
CN1710300000000,2023-05-01,17,103,IL,Lee County,16288,15636,652,4
CN1710500000000,2023-05-01,17,105,IL,Livingston County,15357,14797,560,3.6
CN1710700000000,2023-05-01,17,107,IL,Logan County,11174,10721,453,4.1
CN1710900000000,2023-05-01,17,109,IL,McDonough County,12872,12363,509,4
CN1711100000000,2023-05-01,17,111,IL,McHenry County,169213,164514,4699,2.8
CN1711300000000,2023-05-01,17,113,IL,McLean County,88484,85463,3021,3.4
CN1711500000000,2023-05-01,17,115,IL,Macon County,44723,42286,2437,5.4
CN1711700000000,2023-05-01,17,117,IL,Macoupin County,21804,21029,775,3.6
CN1711900000000,2023-05-01,17,119,IL,Madison County,129758,125072,4686,3.6
CN1712100000000,2023-05-01,17,121,IL,Marion County,16268,15557,711,4.4
CN1712300000000,2023-05-01,17,123,IL,Marshall County,5047,4823,224,4.4
CN1712500000000,2023-05-01,17,125,IL,Mason County,5874,5604,270,4.6
CN1712700000000,2023-05-01,17,127,IL,Massac County,5305,5069,236,4.4
CN1712900000000,2023-05-01,17,129,IL,Menard County,6056,5850,206,3.4
CN1713100000000,2023-05-01,17,131,IL,Mercer County,7400,7105,295,4
CN1713300000000,2023-05-01,17,133,IL,Monroe County,18510,17983,527,2.8
CN1713500000000,2023-05-01,17,135,IL,Montgomery County,10936,10465,471,4.3
CN1713700000000,2023-05-01,17,137,IL,Morgan County,15533,14981,552,3.6
CN1713900000000,2023-05-01,17,139,IL,Moultrie County,7355,7127,228,3.1
CN1714100000000,2023-05-01,17,141,IL,Ogle County,23615,22488,1127,4.8
CN1714300000000,2023-05-01,17,143,IL,Peoria County,81742,77731,4011,4.9
CN1714500000000,2023-05-01,17,145,IL,Perry County,7611,7249,362,4.8
CN1714700000000,2023-05-01,17,147,IL,Piatt County,8626,8339,287,3.3
CN1714900000000,2023-05-01,17,149,IL,Pike County,6710,6469,241,3.6
CN1715100000000,2023-05-01,17,151,IL,Pope County,1773,1709,64,3.6
CN1715300000000,2023-05-01,17,153,IL,Pulaski County,1634,1523,111,6.8
CN1715500000000,2023-05-01,17,155,IL,Putnam County,2972,2832,140,4.7
CN1715700000000,2023-05-01,17,157,IL,Randolph County,13272,12794,478,3.6
CN1715900000000,2023-05-01,17,159,IL,Richland County,7176,6913,263,3.7
CN1716100000000,2023-05-01,17,161,IL,Rock Island County,66443,63424,3019,4.5
CN1716300000000,2023-05-01,17,163,IL,St. Clair County,121922,116791,5131,4.2
CN1716500000000,2023-05-01,17,165,IL,Saline County,9202,8783,419,4.6
CN1716700000000,2023-05-01,17,167,IL,Sangamon County,95537,91910,3627,3.8
CN1716900000000,2023-05-01,17,169,IL,Schuyler County,3048,2948,100,3.3
CN1717100000000,2023-05-01,17,171,IL,Scott County,2255,2165,90,4
CN1717300000000,2023-05-01,17,173,IL,Shelby County,9757,9391,366,3.8
CN1717500000000,2023-05-01,17,175,IL,Stark County,2357,2242,115,4.9
CN1717700000000,2023-05-01,17,177,IL,Stephenson County,20325,19396,929,4.6
CN1717900000000,2023-05-01,17,179,IL,Tazewell County,61416,59011,2405,3.9
CN1718100000000,2023-05-01,17,181,IL,Union County,6943,6637,306,4.4
CN1718300000000,2023-05-01,17,183,IL,Vermilion County,31457,29821,1636,5.2
CN1718500000000,2023-05-01,17,185,IL,Wabash County,5644,5481,163,2.9
CN1718700000000,2023-05-01,17,187,IL,Warren County,7673,7391,282,3.7
CN1718900000000,2023-05-01,17,189,IL,Washington County,9834,9616,218,2.2
CN1719100000000,2023-05-01,17,191,IL,Wayne County,7043,6755,288,4.1
CN1719300000000,2023-05-01,17,193,IL,White County,5990,5758,232,3.9
CN1719500000000,2023-05-01,17,195,IL,Whiteside County,27364,26257,1107,4
CN1719700000000,2023-05-01,17,197,IL,Will County,366679,355296,11383,3.1
CN1719900000000,2023-05-01,17,199,IL,Williamson County,29940,28745,1195,4
CN1720100000000,2023-05-01,17,201,IL,Winnebago County,129879,122285,7594,5.8
CN1720300000000,2023-05-01,17,203,IL,Woodford County,18078,17467,611,3.4
CN1800100000000,2023-05-01,18,001,IN,Adams County,16970,16469,501,3
CN1800300000000,2023-05-01,18,003,IN,Allen County,191402,184992,6410,3.3
CN1800500000000,2023-05-01,18,005,IN,Bartholomew County,44753,43424,1329,3
CN1800700000000,2023-05-01,18,007,IN,Benton County,4396,4265,131,3
CN1800900000000,2023-05-01,18,009,IN,Blackford County,4768,4553,215,4.5
CN1801100000000,2023-05-01,18,011,IN,Boone County,38971,37915,1056,2.7
CN1801300000000,2023-05-01,18,013,IN,Brown County,7903,7647,256,3.2
CN1801500000000,2023-05-01,18,015,IN,Carroll County,9858,9516,342,3.5
CN1801700000000,2023-05-01,18,017,IN,Cass County,17363,16686,677,3.9
CN1801900000000,2023-05-01,18,019,IN,Clark County,62843,60779,2064,3.3
CN1802100000000,2023-05-01,18,021,IN,Clay County,11849,11413,436,3.7
CN1802300000000,2023-05-01,18,023,IN,Clinton County,17296,16780,516,3
CN1802500000000,2023-05-01,18,025,IN,Crawford County,4789,4610,179,3.7
CN1802700000000,2023-05-01,18,027,IN,Daviess County,16786,16322,464,2.8
CN1802900000000,2023-05-01,18,029,IN,Dearborn County,26345,25445,900,3.4
CN1803100000000,2023-05-01,18,031,IN,Decatur County,14501,14058,443,3.1
CN1803300000000,2023-05-01,18,033,IN,DeKalb County,22593,21879,714,3.2
CN1803500000000,2023-05-01,18,035,IN,Delaware County,51500,49314,2186,4.2
CN1803700000000,2023-05-01,18,037,IN,Dubois County,22042,21408,634,2.9
CN1803900000000,2023-05-01,18,039,IN,Elkhart County,114585,110371,4214,3.7
CN1804100000000,2023-05-01,18,041,IN,Fayette County,8268,7876,392,4.7
CN1804300000000,2023-05-01,18,043,IN,Floyd County,42324,41060,1264,3
CN1804500000000,2023-05-01,18,045,IN,Fountain County,8141,7864,277,3.4
CN1804700000000,2023-05-01,18,047,IN,Franklin County,11495,11114,381,3.3
CN1804900000000,2023-05-01,18,049,IN,Fulton County,9582,9235,347,3.6
CN1805100000000,2023-05-01,18,051,IN,Gibson County,19731,19203,528,2.7
CN1805300000000,2023-05-01,18,053,IN,Grant County,31709,30504,1205,3.8
CN1805500000000,2023-05-01,18,055,IN,Greene County,13491,12948,543,4
CN1805700000000,2023-05-01,18,057,IN,Hamilton County,199730,194109,5621,2.8
CN1805900000000,2023-05-01,18,059,IN,Hancock County,43630,42292,1338,3.1
CN1806100000000,2023-05-01,18,061,IN,Harrison County,20486,19857,629,3.1
CN1806300000000,2023-05-01,18,063,IN,Hendricks County,97285,94459,2826,2.9
CN1806500000000,2023-05-01,18,065,IN,Henry County,22176,21339,837,3.8
CN1806700000000,2023-05-01,18,067,IN,Howard County,32824,31040,1784,5.4
CN1806900000000,2023-05-01,18,069,IN,Huntington County,18485,17902,583,3.2
CN1807100000000,2023-05-01,18,071,IN,Jackson County,23333,22599,734,3.1
CN1807300000000,2023-05-01,18,073,IN,Jasper County,16128,15530,598,3.7
CN1807500000000,2023-05-01,18,075,IN,Jay County,8881,8579,302,3.4
CN1807700000000,2023-05-01,18,077,IN,Jefferson County,15198,14670,528,3.5
CN1807900000000,2023-05-01,18,079,IN,Jennings County,13599,13140,459,3.4
CN1808100000000,2023-05-01,18,081,IN,Johnson County,88774,86229,2545,2.9
CN1808300000000,2023-05-01,18,083,IN,Knox County,17718,17118,600,3.4
CN1808500000000,2023-05-01,18,085,IN,Kosciusko County,41121,39708,1413,3.4
CN1808700000000,2023-05-01,18,087,IN,LaGrange County,21608,20922,686,3.2
CN1808900000000,2023-05-01,18,089,IN,Lake County,229596,218048,11548,5
CN1809100000000,2023-05-01,18,091,IN,LaPorte County,46966,45021,1945,4.1
CN1809300000000,2023-05-01,18,093,IN,Lawrence County,20369,19554,815,4
CN1809500000000,2023-05-01,18,095,IN,Madison County,61495,59168,2327,3.8
CN1809700000000,2023-05-01,18,097,IN,Marion County,517158,499152,18006,3.5
CN1809900000000,2023-05-01,18,099,IN,Marshall County,23273,22433,840,3.6
CN1810100000000,2023-05-01,18,101,IN,Martin County,5410,5241,169,3.1
CN1810300000000,2023-05-01,18,103,IN,Miami County,14289,13680,609,4.3
CN1810500000000,2023-05-01,18,105,IN,Monroe County,71109,68465,2644,3.7
CN1810700000000,2023-05-01,18,107,IN,Montgomery County,19083,18478,605,3.2
CN1810900000000,2023-05-01,18,109,IN,Morgan County,38013,36806,1207,3.2
CN1811100000000,2023-05-01,18,111,IN,Newton County,6795,6533,262,3.9
CN1811300000000,2023-05-01,18,113,IN,Noble County,21956,21135,821,3.7
CN1811500000000,2023-05-01,18,115,IN,Ohio County,3255,3153,102,3.1
CN1811700000000,2023-05-01,18,117,IN,Orange County,8260,7940,320,3.9
CN1811900000000,2023-05-01,18,119,IN,Owen County,9351,8986,365,3.9
CN1812100000000,2023-05-01,18,121,IN,Parke County,7169,6907,262,3.7
CN1812300000000,2023-05-01,18,123,IN,Perry County,8890,8603,287,3.2
CN1812500000000,2023-05-01,18,125,IN,Pike County,5922,5726,196,3.3
CN1812700000000,2023-05-01,18,127,IN,Porter County,86597,83249,3348,3.9
CN1812900000000,2023-05-01,18,129,IN,Posey County,13141,12744,397,3
CN1813100000000,2023-05-01,18,131,IN,Pulaski County,6886,6668,218,3.2
CN1813300000000,2023-05-01,18,133,IN,Putnam County,17240,16652,588,3.4
CN1813500000000,2023-05-01,18,135,IN,Randolph County,12363,11927,436,3.5
CN1813700000000,2023-05-01,18,137,IN,Ripley County,12786,12320,466,3.6
CN1813900000000,2023-05-01,18,139,IN,Rush County,9059,8784,275,3
CN1814100000000,2023-05-01,18,141,IN,St. Joseph County,131696,126374,5322,4
CN1814300000000,2023-05-01,18,143,IN,Scott County,10588,10181,407,3.8
CN1814500000000,2023-05-01,18,145,IN,Shelby County,24180,23469,711,2.9
CN1814700000000,2023-05-01,18,147,IN,Spencer County,10961,10612,349,3.2
CN1814900000000,2023-05-01,18,149,IN,Starke County,9790,9381,409,4.2
CN1815100000000,2023-05-01,18,151,IN,Steuben County,20590,19998,592,2.9
CN1815300000000,2023-05-01,18,153,IN,Sullivan County,8154,7835,319,3.9
CN1815500000000,2023-05-01,18,155,IN,Switzerland County,4778,4609,169,3.5
CN1815700000000,2023-05-01,18,157,IN,Tippecanoe County,96394,93061,3333,3.5
CN1815900000000,2023-05-01,18,159,IN,Tipton County,9113,8820,293,3.2
CN1816100000000,2023-05-01,18,161,IN,Union County,3653,3537,116,3.2
CN1816300000000,2023-05-01,18,163,IN,Vanderburgh County,93145,89965,3180,3.4
CN1816500000000,2023-05-01,18,165,IN,Vermillion County,6715,6430,285,4.2
CN1816700000000,2023-05-01,18,167,IN,Vigo County,46766,44877,1889,4
CN1816900000000,2023-05-01,18,169,IN,Wabash County,14904,14396,508,3.4
CN1817100000000,2023-05-01,18,171,IN,Warren County,4165,4033,132,3.2
CN1817300000000,2023-05-01,18,173,IN,Warrick County,32585,31559,1026,3.1
CN1817500000000,2023-05-01,18,175,IN,Washington County,13815,13367,448,3.2
CN1817700000000,2023-05-01,18,177,IN,Wayne County,30089,28991,1098,3.6
CN1817900000000,2023-05-01,18,179,IN,Wells County,14532,14115,417,2.9
CN1818100000000,2023-05-01,18,181,IN,White County,13489,13100,389,2.9
CN1818300000000,2023-05-01,18,183,IN,Whitley County,18107,17584,523,2.9
CN1900100000000,2023-05-01,19,001,IA,Adair County,4459,4368,91,2
CN1900300000000,2023-05-01,19,003,IA,Adams County,2190,2151,39,1.8
CN1900500000000,2023-05-01,19,005,IA,Allamakee County,7142,6936,206,2.9
CN1900700000000,2023-05-01,19,007,IA,Appanoose County,6262,6076,186,3
CN1900900000000,2023-05-01,19,009,IA,Audubon County,3134,3069,65,2.1
CN1901100000000,2023-05-01,19,011,IA,Benton County,13242,12896,346,2.6
CN1901300000000,2023-05-01,19,013,IA,Black Hawk County,69036,66881,2155,3.1
CN1901500000000,2023-05-01,19,015,IA,Boone County,15103,14748,355,2.4
CN1901700000000,2023-05-01,19,017,IA,Bremer County,14292,13933,359,2.5
CN1901900000000,2023-05-01,19,019,IA,Buchanan County,11558,11236,322,2.8
CN1902100000000,2023-05-01,19,021,IA,Buena Vista County,12106,11859,247,2
CN1902300000000,2023-05-01,19,023,IA,Butler County,8551,8306,245,2.9
CN1902500000000,2023-05-01,19,025,IA,Calhoun County,4322,4218,104,2.4
CN1902700000000,2023-05-01,19,027,IA,Carroll County,11014,10769,245,2.2
CN1902900000000,2023-05-01,19,029,IA,Cass County,7058,6898,160,2.3
CN1903100000000,2023-05-01,19,031,IA,Cedar County,10618,10333,285,2.7
CN1903300000000,2023-05-01,19,033,IA,Cerro Gordo County,22408,21729,679,3
CN1903500000000,2023-05-01,19,035,IA,Cherokee County,6244,6105,139,2.2
CN1903700000000,2023-05-01,19,037,IA,Chickasaw County,6781,6625,156,2.3
CN1903900000000,2023-05-01,19,039,IA,Clarke County,5010,4887,123,2.5
CN1904100000000,2023-05-01,19,041,IA,Clay County,8637,8418,219,2.5
CN1904300000000,2023-05-01,19,043,IA,Clayton County,9648,9328,320,3.3
CN1904500000000,2023-05-01,19,045,IA,Clinton County,22622,21865,757,3.3
CN1904700000000,2023-05-01,19,047,IA,Crawford County,8007,7654,353,4.4
CN1904900000000,2023-05-01,19,049,IA,Dallas County,55261,54175,1086,2
CN1905100000000,2023-05-01,19,051,IA,Davis County,4385,4292,93,2.1
CN1905300000000,2023-05-01,19,053,IA,Decatur County,4415,4315,100,2.3
CN1905500000000,2023-05-01,19,055,IA,Delaware County,10680,10449,231,2.2
CN1905700000000,2023-05-01,19,057,IA,Des Moines County,18375,17676,699,3.8
CN1905900000000,2023-05-01,19,059,IA,Dickinson County,11138,10868,270,2.4
CN1906100000000,2023-05-01,19,061,IA,Dubuque County,56852,55416,1436,2.5
CN1906300000000,2023-05-01,19,063,IA,Emmet County,4976,4850,126,2.5
CN1906500000000,2023-05-01,19,065,IA,Fayette County,10591,10284,307,2.9
CN1906700000000,2023-05-01,19,067,IA,Floyd County,8485,8199,286,3.4
CN1906900000000,2023-05-01,19,069,IA,Franklin County,5771,5622,149,2.6
CN1907100000000,2023-05-01,19,071,IA,Fremont County,3741,3661,80,2.1
CN1907300000000,2023-05-01,19,073,IA,Greene County,5506,5407,99,1.8
CN1907500000000,2023-05-01,19,075,IA,Grundy County,6566,6393,173,2.6
CN1907700000000,2023-05-01,19,077,IA,Guthrie County,5807,5662,145,2.5
CN1907900000000,2023-05-01,19,079,IA,Hamilton County,7100,6927,173,2.4
CN1908100000000,2023-05-01,19,081,IA,Hancock County,5848,5608,240,4.1
CN1908300000000,2023-05-01,19,083,IA,Hardin County,7941,7727,214,2.7
CN1908500000000,2023-05-01,19,085,IA,Harrison County,7232,7067,165,2.3
CN1908700000000,2023-05-01,19,087,IA,Henry County,9443,9166,277,2.9
CN1908900000000,2023-05-01,19,089,IA,Howard County,5358,5213,145,2.7
CN1909100000000,2023-05-01,19,091,IA,Humboldt County,4982,4856,126,2.5
CN1909300000000,2023-05-01,19,093,IA,Ida County,4079,4014,65,1.6
CN1909500000000,2023-05-01,19,095,IA,Iowa County,9955,9732,223,2.2
CN1909700000000,2023-05-01,19,097,IA,Jackson County,10830,10529,301,2.8
CN1909900000000,2023-05-01,19,099,IA,Jasper County,18946,18451,495,2.6
CN1910100000000,2023-05-01,19,101,IA,Jefferson County,10296,10060,236,2.3
CN1910300000000,2023-05-01,19,103,IA,Johnson County,87219,85352,1867,2.1
CN1910500000000,2023-05-01,19,105,IA,Jones County,10534,10238,296,2.8
CN1910700000000,2023-05-01,19,107,IA,Keokuk County,5324,5166,158,3
CN1910900000000,2023-05-01,19,109,IA,Kossuth County,8463,8257,206,2.4
CN1911100000000,2023-05-01,19,111,IA,Lee County,14744,14186,558,3.8
CN1911300000000,2023-05-01,19,113,IA,Linn County,122213,118405,3808,3.1
CN1911500000000,2023-05-01,19,115,IA,Louisa County,5958,5802,156,2.6
CN1911700000000,2023-05-01,19,117,IA,Lucas County,4639,4542,97,2.1
CN1911900000000,2023-05-01,19,119,IA,Lyon County,7299,7176,123,1.7
CN1912100000000,2023-05-01,19,121,IA,Madison County,8971,8724,247,2.8
CN1912300000000,2023-05-01,19,123,IA,Mahaska County,12451,12181,270,2.2
CN1912500000000,2023-05-01,19,125,IA,Marion County,19683,19317,366,1.9
CN1912700000000,2023-05-01,19,127,IA,Marshall County,17612,16567,1045,5.9
CN1912900000000,2023-05-01,19,129,IA,Mills County,7214,7049,165,2.3
CN1913100000000,2023-05-01,19,131,IA,Mitchell County,5997,5865,132,2.2
CN1913300000000,2023-05-01,19,133,IA,Monona County,4472,4370,102,2.3
CN1913500000000,2023-05-01,19,135,IA,Monroe County,4118,4019,99,2.4
CN1913700000000,2023-05-01,19,137,IA,Montgomery County,5073,4952,121,2.4
CN1913900000000,2023-05-01,19,139,IA,Muscatine County,20889,20294,595,2.8
CN1914100000000,2023-05-01,19,141,IA,O'Brien County,8452,8257,195,2.3
CN1914300000000,2023-05-01,19,143,IA,Osceola County,3797,3730,67,1.8
CN1914500000000,2023-05-01,19,145,IA,Page County,6567,6407,160,2.4
CN1914700000000,2023-05-01,19,147,IA,Palo Alto County,4503,4410,93,2.1
CN1914900000000,2023-05-01,19,149,IA,Plymouth County,15190,14911,279,1.8
CN1915100000000,2023-05-01,19,151,IA,Pocahontas County,4241,4157,84,2
CN1915300000000,2023-05-01,19,153,IA,Polk County,282399,275234,7165,2.5
CN1915500000000,2023-05-01,19,155,IA,Pottawattamie County,48168,46970,1198,2.5
CN1915700000000,2023-05-01,19,157,IA,Poweshiek County,10737,10477,260,2.4
CN1915900000000,2023-05-01,19,159,IA,Ringgold County,2410,2362,48,2
CN1916100000000,2023-05-01,19,161,IA,Sac County,5440,5332,108,2
CN1916300000000,2023-05-01,19,163,IA,Scott County,89564,86680,2884,3.2
CN1916500000000,2023-05-01,19,165,IA,Shelby County,6522,6371,151,2.3
CN1916700000000,2023-05-01,19,167,IA,Sioux County,23252,22901,351,1.5
CN1916900000000,2023-05-01,19,169,IA,Story County,60955,59828,1127,1.8
CN1917100000000,2023-05-01,19,171,IA,Tama County,9350,9047,303,3.2
CN1917300000000,2023-05-01,19,173,IA,Taylor County,3251,3191,60,1.8
CN1917500000000,2023-05-01,19,175,IA,Union County,6232,6074,158,2.5
CN1917700000000,2023-05-01,19,177,IA,Van Buren County,3752,3650,102,2.7
CN1917900000000,2023-05-01,19,179,IA,Wapello County,16779,16269,510,3
CN1918100000000,2023-05-01,19,181,IA,Warren County,29963,29312,651,2.2
CN1918300000000,2023-05-01,19,183,IA,Washington County,11883,11621,262,2.2
CN1918500000000,2023-05-01,19,185,IA,Wayne County,3044,2966,78,2.6
CN1918700000000,2023-05-01,19,187,IA,Webster County,19184,18663,521,2.7
CN1918900000000,2023-05-01,19,189,IA,Winnebago County,5379,4955,424,7.9
CN1919100000000,2023-05-01,19,191,IA,Winneshiek County,11724,11406,318,2.7
CN1919300000000,2023-05-01,19,193,IA,Woodbury County,57138,55710,1428,2.5
CN1919500000000,2023-05-01,19,195,IA,Worth County,4121,3972,149,3.6
CN1919700000000,2023-05-01,19,197,IA,Wright County,6835,6671,164,2.4
CN2000100000000,2023-05-01,20,001,KS,Allen County,6314,6140,174,2.8
CN2000300000000,2023-05-01,20,003,KS,Anderson County,4363,4275,88,2
CN2000500000000,2023-05-01,20,005,KS,Atchison County,6636,6410,226,3.4
CN2000700000000,2023-05-01,20,007,KS,Barber County,2211,2146,65,2.9
CN2000900000000,2023-05-01,20,009,KS,Barton County,12774,12419,355,2.8
CN2001100000000,2023-05-01,20,011,KS,Bourbon County,6149,5944,205,3.3
CN2001300000000,2023-05-01,20,013,KS,Brown County,4896,4758,138,2.8
CN2001500000000,2023-05-01,20,015,KS,Butler County,32952,32053,899,2.7
CN2001700000000,2023-05-01,20,017,KS,Chase County,1362,1335,27,2
CN2001900000000,2023-05-01,20,019,KS,Chautauqua County,1392,1352,40,2.9
CN2002100000000,2023-05-01,20,021,KS,Cherokee County,9824,9563,261,2.7
CN2002300000000,2023-05-01,20,023,KS,Cheyenne County,1185,1154,31,2.6
CN2002500000000,2023-05-01,20,025,KS,Clark County,1099,1076,23,2.1
CN2002700000000,2023-05-01,20,027,KS,Clay County,3631,3539,92,2.5
CN2002900000000,2023-05-01,20,029,KS,Cloud County,3697,3597,100,2.7
CN2003100000000,2023-05-01,20,031,KS,Coffey County,3672,3542,130,3.5
CN2003300000000,2023-05-01,20,033,KS,Comanche County,841,822,19,2.3
CN2003500000000,2023-05-01,20,035,KS,Cowley County,16200,15715,485,3
CN2003700000000,2023-05-01,20,037,KS,Crawford County,19291,18751,540,2.8
CN2003900000000,2023-05-01,20,039,KS,Decatur County,1161,1121,40,3.4
CN2004100000000,2023-05-01,20,041,KS,Dickinson County,8569,8322,247,2.9
CN2004300000000,2023-05-01,20,043,KS,Doniphan County,4013,3911,102,2.5
CN2004500000000,2023-05-01,20,045,KS,Douglas County,68853,67132,1721,2.5
CN2004700000000,2023-05-01,20,047,KS,Edwards County,1314,1283,31,2.4
CN2004900000000,2023-05-01,20,049,KS,Elk County,1179,1152,27,2.3
CN2005100000000,2023-05-01,20,051,KS,Ellis County,16976,16648,328,1.9
CN2005300000000,2023-05-01,20,053,KS,Ellsworth County,2605,2546,59,2.3
CN2005500000000,2023-05-01,20,055,KS,Finney County,20544,20115,429,2.1
CN2005700000000,2023-05-01,20,057,KS,Ford County,17981,17603,378,2.1
CN2005900000000,2023-05-01,20,059,KS,Franklin County,14927,14534,393,2.6
CN2006100000000,2023-05-01,20,061,KS,Geary County,11447,11010,437,3.8
CN2006300000000,2023-05-01,20,063,KS,Gove County,1315,1284,31,2.4
CN2006500000000,2023-05-01,20,065,KS,Graham County,1198,1169,29,2.4
CN2006700000000,2023-05-01,20,067,KS,Grant County,2639,2570,69,2.6
CN2006900000000,2023-05-01,20,069,KS,Gray County,3128,3067,61,2
CN2007100000000,2023-05-01,20,071,KS,Greeley County,737,722,15,2
CN2007300000000,2023-05-01,20,073,KS,Greenwood County,3022,2934,88,2.9
CN2007500000000,2023-05-01,20,075,KS,Hamilton County,1606,1575,31,1.9
CN2007700000000,2023-05-01,20,077,KS,Harper County,2848,2783,65,2.3
CN2007900000000,2023-05-01,20,079,KS,Harvey County,17244,16763,481,2.8
CN2008100000000,2023-05-01,20,081,KS,Haskell County,2077,2037,40,1.9
CN2008300000000,2023-05-01,20,083,KS,Hodgeman County,973,948,25,2.6
CN2008500000000,2023-05-01,20,085,KS,Jackson County,7344,7168,176,2.4
CN2008700000000,2023-05-01,20,087,KS,Jefferson County,10410,10155,255,2.4
CN2008900000000,2023-05-01,20,089,KS,Jewell County,1150,1114,36,3.1
CN2009100000000,2023-05-01,20,091,KS,Johnson County,355590,346749,8841,2.5
CN2009300000000,2023-05-01,20,093,KS,Kearny County,1949,1907,42,2.2
CN2009500000000,2023-05-01,20,095,KS,Kingman County,3255,3161,94,2.9
CN2009700000000,2023-05-01,20,097,KS,Kiowa County,1163,1130,33,2.8
CN2009900000000,2023-05-01,20,099,KS,Labette County,10353,10048,305,2.9
CN2010100000000,2023-05-01,20,101,KS,Lane County,700,679,21,3
CN2010300000000,2023-05-01,20,103,KS,Leavenworth County,37974,36933,1041,2.7
CN2010500000000,2023-05-01,20,105,KS,Lincoln County,1589,1558,31,2
CN2010700000000,2023-05-01,20,107,KS,Linn County,4403,4227,176,4
CN2010900000000,2023-05-01,20,109,KS,Logan County,1632,1599,33,2
CN2011100000000,2023-05-01,20,111,KS,Lyon County,17032,16593,439,2.6
CN2011300000000,2023-05-01,20,113,KS,McPherson County,17610,17257,353,2
CN2011500000000,2023-05-01,20,115,KS,Marion County,5862,5720,142,2.4
CN2011700000000,2023-05-01,20,117,KS,Marshall County,5148,5033,115,2.2
CN2011900000000,2023-05-01,20,119,KS,Meade County,2055,2011,44,2.1
CN2012100000000,2023-05-01,20,121,KS,Miami County,18297,17837,460,2.5
CN2012300000000,2023-05-01,20,123,KS,Mitchell County,3293,3234,59,1.8
CN2012500000000,2023-05-01,20,125,KS,Montgomery County,14654,14194,460,3.1
CN2012700000000,2023-05-01,20,127,KS,Morris County,2840,2769,71,2.5
CN2012900000000,2023-05-01,20,129,KS,Morton County,1136,1107,29,2.6
CN2013100000000,2023-05-01,20,131,KS,Nemaha County,5656,5556,100,1.8
CN2013300000000,2023-05-01,20,133,KS,Neosho County,6193,5969,224,3.6
CN2013500000000,2023-05-01,20,135,KS,Ness County,1266,1235,31,2.4
CN2013700000000,2023-05-01,20,137,KS,Norton County,2548,2492,56,2.2
CN2013900000000,2023-05-01,20,139,KS,Osage County,8041,7830,211,2.6
CN2014100000000,2023-05-01,20,141,KS,Osborne County,1840,1798,42,2.3
CN2014300000000,2023-05-01,20,143,KS,Ottawa County,2993,2926,67,2.2
CN2014500000000,2023-05-01,20,145,KS,Pawnee County,2633,2560,73,2.8
CN2014700000000,2023-05-01,20,147,KS,Phillips County,2578,2526,52,2
CN2014900000000,2023-05-01,20,149,KS,Pottawatomie County,12995,12715,280,2.2
CN2015100000000,2023-05-01,20,151,KS,Pratt County,4829,4722,107,2.2
CN2015300000000,2023-05-01,20,153,KS,Rawlins County,1487,1460,27,1.8
CN2015500000000,2023-05-01,20,155,KS,Reno County,29147,28252,895,3.1
CN2015700000000,2023-05-01,20,157,KS,Republic County,2304,2252,52,2.3
CN2015900000000,2023-05-01,20,159,KS,Rice County,5825,5668,157,2.7
CN2016100000000,2023-05-01,20,161,KS,Riley County,36144,35291,853,2.4
CN2016300000000,2023-05-01,20,163,KS,Rooks County,2409,2344,65,2.7
CN2016500000000,2023-05-01,20,165,KS,Rush County,1591,1555,36,2.3
CN2016700000000,2023-05-01,20,167,KS,Russell County,3248,3171,77,2.4
CN2016900000000,2023-05-01,20,169,KS,Saline County,30028,29311,717,2.4
CN2017100000000,2023-05-01,20,171,KS,Scott County,2533,2483,50,2
CN2017300000000,2023-05-01,20,173,KS,Sedgwick County,257688,249853,7835,3
CN2017500000000,2023-05-01,20,175,KS,Seward County,9792,9556,236,2.4
CN2017700000000,2023-05-01,20,177,KS,Shawnee County,92950,90365,2585,2.8
CN2017900000000,2023-05-01,20,179,KS,Sheridan County,1420,1387,33,2.3
CN2018100000000,2023-05-01,20,181,KS,Sherman County,2691,2628,63,2.3
CN2018300000000,2023-05-01,20,183,KS,Smith County,1959,1913,46,2.3
CN2018500000000,2023-05-01,20,185,KS,Stafford County,1876,1832,44,2.3
CN2018700000000,2023-05-01,20,187,KS,Stanton County,1045,1022,23,2.2
CN2018900000000,2023-05-01,20,189,KS,Stevens County,2965,2904,61,2.1
CN2019100000000,2023-05-01,20,191,KS,Sumner County,10769,10474,295,2.7
CN2019300000000,2023-05-01,20,193,KS,Thomas County,4072,3997,75,1.8
CN2019500000000,2023-05-01,20,195,KS,Trego County,1347,1307,40,3
CN2019700000000,2023-05-01,20,197,KS,Wabaunsee County,3737,3637,100,2.7
CN2019900000000,2023-05-01,20,199,KS,Wallace County,835,816,19,2.3
CN2020100000000,2023-05-01,20,201,KS,Washington County,2928,2863,65,2.2
CN2020300000000,2023-05-01,20,203,KS,Wichita County,1084,1059,25,2.3
CN2020500000000,2023-05-01,20,205,KS,Wilson County,3680,3565,115,3.1
CN2020700000000,2023-05-01,20,207,KS,Woodson County,1482,1426,56,3.8
CN2020900000000,2023-05-01,20,209,KS,Wyandotte County,79445,76724,2721,3.4
CN2100100000000,2023-05-01,21,001,KY,Adair County,7062,6711,351,5
CN2100300000000,2023-05-01,21,003,KY,Allen County,9078,8741,337,3.7
CN2100500000000,2023-05-01,21,005,KY,Anderson County,11873,11507,366,3.1
CN2100700000000,2023-05-01,21,007,KY,Ballard County,3516,3362,154,4.4
CN2100900000000,2023-05-01,21,009,KY,Barren County,17805,17098,707,4
CN2101100000000,2023-05-01,21,011,KY,Bath County,4691,4463,228,4.9
CN2101300000000,2023-05-01,21,013,KY,Bell County,8274,7830,444,5.4
CN2101500000000,2023-05-01,21,015,KY,Boone County,73891,71427,2464,3.3
CN2101700000000,2023-05-01,21,017,KY,Bourbon County,9494,9171,323,3.4
CN2101900000000,2023-05-01,21,019,KY,Boyd County,17382,16435,947,5.4
CN2102100000000,2023-05-01,21,021,KY,Boyle County,13094,12541,553,4.2
CN2102300000000,2023-05-01,21,023,KY,Bracken County,3844,3692,152,4
CN2102500000000,2023-05-01,21,025,KY,Breathitt County,3161,2947,214,6.8
CN2102700000000,2023-05-01,21,027,KY,Breckinridge County,8010,7654,356,4.4
CN2102900000000,2023-05-01,21,029,KY,Bullitt County,43043,41543,1500,3.5
CN2103100000000,2023-05-01,21,031,KY,Butler County,5148,4951,197,3.8
CN2103300000000,2023-05-01,21,033,KY,Caldwell County,6346,6110,236,3.7
CN2103500000000,2023-05-01,21,035,KY,Calloway County,16453,15746,707,4.3
CN2103700000000,2023-05-01,21,037,KY,Campbell County,51938,50173,1765,3.4
CN2103900000000,2023-05-01,21,039,KY,Carlisle County,2335,2259,76,3.3
CN2104100000000,2023-05-01,21,041,KY,Carroll County,5902,5736,166,2.8
CN2104300000000,2023-05-01,21,043,KY,Carter County,9661,8989,672,7
CN2104500000000,2023-05-01,21,045,KY,Casey County,6348,6089,259,4.1
CN2104700000000,2023-05-01,21,047,KY,Christian County,25231,24010,1221,4.8
CN2104900000000,2023-05-01,21,049,KY,Clark County,17648,17019,629,3.6
CN2105100000000,2023-05-01,21,051,KY,Clay County,5086,4761,325,6.4
CN2105300000000,2023-05-01,21,053,KY,Clinton County,3559,3388,171,4.8
CN2105500000000,2023-05-01,21,055,KY,Crittenden County,3835,3685,150,3.9
CN2105700000000,2023-05-01,21,057,KY,Cumberland County,3379,3270,109,3.2
CN2105900000000,2023-05-01,21,059,KY,Daviess County,45829,44006,1823,4
CN2106100000000,2023-05-01,21,061,KY,Edmonson County,4862,4642,220,4.5
CN2106300000000,2023-05-01,21,063,KY,Elliott County,1884,1736,148,7.9
CN2106500000000,2023-05-01,21,065,KY,Estill County,5178,4931,247,4.8
CN2106700000000,2023-05-01,21,067,KY,Fayette County,179645,173950,5695,3.2
CN2106900000000,2023-05-01,21,069,KY,Fleming County,6013,5754,259,4.3
CN2107100000000,2023-05-01,21,071,KY,Floyd County,10962,10329,633,5.8
CN2107300000000,2023-05-01,21,073,KY,Franklin County,24940,24095,845,3.4
CN2107500000000,2023-05-01,21,075,KY,Fulton County,2118,2015,103,4.9
CN2107700000000,2023-05-01,21,077,KY,Gallatin County,4069,3919,150,3.7
CN2107900000000,2023-05-01,21,079,KY,Garrard County,8138,7840,298,3.7
CN2108100000000,2023-05-01,21,081,KY,Grant County,11931,11489,442,3.7
CN2108300000000,2023-05-01,21,083,KY,Graves County,15494,14869,625,4
CN2108500000000,2023-05-01,21,085,KY,Grayson County,10299,9859,440,4.3
CN2108700000000,2023-05-01,21,087,KY,Green County,5015,4836,179,3.6
CN2108900000000,2023-05-01,21,089,KY,Greenup County,13043,12256,787,6
CN2109100000000,2023-05-01,21,091,KY,Hancock County,3809,3651,158,4.1
CN2109300000000,2023-05-01,21,093,KY,Hardin County,47343,45483,1860,3.9
CN2109500000000,2023-05-01,21,095,KY,Harlan County,6473,6058,415,6.4
CN2109700000000,2023-05-01,21,097,KY,Harrison County,8910,8589,321,3.6
CN2109900000000,2023-05-01,21,099,KY,Hart County,7726,7409,317,4.1
CN2110100000000,2023-05-01,21,101,KY,Henderson County,20846,20088,758,3.6
CN2110300000000,2023-05-01,21,103,KY,Henry County,8101,7830,271,3.3
CN2110500000000,2023-05-01,21,105,KY,Hickman County,1595,1529,66,4.1
CN2110700000000,2023-05-01,21,107,KY,Hopkins County,18014,17050,964,5.4
CN2110900000000,2023-05-01,21,109,KY,Jackson County,4212,3972,240,5.7
CN2111100000000,2023-05-01,21,111,KY,Jefferson County,396372,382643,13729,3.5
CN2111300000000,2023-05-01,21,113,KY,Jessamine County,27260,26364,896,3.3
CN2111500000000,2023-05-01,21,115,KY,Johnson County,6738,6300,438,6.5
CN2111700000000,2023-05-01,21,117,KY,Kenton County,89804,86762,3042,3.4
CN2111900000000,2023-05-01,21,119,KY,Knott County,4277,4008,269,6.3
CN2112100000000,2023-05-01,21,121,KY,Knox County,10141,9588,553,5.5
CN2112300000000,2023-05-01,21,123,KY,Larue County,5796,5558,238,4.1
CN2112500000000,2023-05-01,21,125,KY,Laurel County,25619,24544,1075,4.2
CN2112700000000,2023-05-01,21,127,KY,Lawrence County,5683,5387,296,5.2
CN2112900000000,2023-05-01,21,129,KY,Lee County,2087,1960,127,6.1
CN2113100000000,2023-05-01,21,131,KY,Leslie County,2518,2356,162,6.4
CN2113300000000,2023-05-01,21,133,KY,Letcher County,5829,5461,368,6.3
CN2113500000000,2023-05-01,21,135,KY,Lewis County,4538,4224,314,6.9
CN2113700000000,2023-05-01,21,137,KY,Lincoln County,9556,9108,448,4.7
CN2113900000000,2023-05-01,21,139,KY,Livingston County,3697,3524,173,4.7
CN2114100000000,2023-05-01,21,141,KY,Logan County,12474,12032,442,3.5
CN2114300000000,2023-05-01,21,143,KY,Lyon County,3264,3124,140,4.3
CN2114500000000,2023-05-01,21,145,KY,McCracken County,30445,29274,1171,3.8
CN2114700000000,2023-05-01,21,147,KY,McCreary County,4690,4435,255,5.4
CN2114900000000,2023-05-01,21,149,KY,McLean County,3938,3755,183,4.6
CN2115100000000,2023-05-01,21,151,KY,Madison County,47384,45670,1714,3.6
CN2115300000000,2023-05-01,21,153,KY,Magoffin County,3232,2944,288,8.9
CN2115500000000,2023-05-01,21,155,KY,Marion County,9475,9173,302,3.2
CN2115700000000,2023-05-01,21,157,KY,Marshall County,14551,14000,551,3.8
CN2115900000000,2023-05-01,21,159,KY,Martin County,2220,2045,175,7.9
CN2116100000000,2023-05-01,21,161,KY,Mason County,6544,6234,310,4.7
CN2116300000000,2023-05-01,21,163,KY,Meade County,11654,11159,495,4.2
CN2116500000000,2023-05-01,21,165,KY,Menifee County,2368,2247,121,5.1
CN2116700000000,2023-05-01,21,167,KY,Mercer County,10501,10100,401,3.8
CN2116900000000,2023-05-01,21,169,KY,Metcalfe County,3869,3707,162,4.2
CN2117100000000,2023-05-01,21,171,KY,Monroe County,4634,4478,156,3.4
CN2117300000000,2023-05-01,21,173,KY,Montgomery County,11945,11429,516,4.3
CN2117500000000,2023-05-01,21,175,KY,Morgan County,4030,3843,187,4.6
CN2117700000000,2023-05-01,21,177,KY,Muhlenberg County,10093,9481,612,6.1
CN2117900000000,2023-05-01,21,179,KY,Nelson County,23909,23149,760,3.2
CN2118100000000,2023-05-01,21,181,KY,Nicholas County,3253,3113,140,4.3
CN2118300000000,2023-05-01,21,183,KY,Ohio County,9059,8617,442,4.9
CN2118500000000,2023-05-01,21,185,KY,Oldham County,33447,32417,1030,3.1
CN2118700000000,2023-05-01,21,187,KY,Owen County,5471,5288,183,3.3
CN2118900000000,2023-05-01,21,189,KY,Owsley County,1051,983,68,6.5
CN2119100000000,2023-05-01,21,191,KY,Pendleton County,7064,6832,232,3.3
CN2119300000000,2023-05-01,21,193,KY,Perry County,8039,7620,419,5.2
CN2119500000000,2023-05-01,21,195,KY,Pike County,18682,17661,1021,5.5
CN2119700000000,2023-05-01,21,197,KY,Powell County,5316,5108,208,3.9
CN2119900000000,2023-05-01,21,199,KY,Pulaski County,25140,23969,1171,4.7
CN2120100000000,2023-05-01,21,201,KY,Robertson County,808,769,39,4.8
CN2120300000000,2023-05-01,21,203,KY,Rockcastle County,6543,6255,288,4.4
CN2120500000000,2023-05-01,21,205,KY,Rowan County,10231,9756,475,4.6
CN2120700000000,2023-05-01,21,207,KY,Russell County,6198,5875,323,5.2
CN2120900000000,2023-05-01,21,209,KY,Scott County,31002,30040,962,3.1
CN2121100000000,2023-05-01,21,211,KY,Shelby County,25828,25018,810,3.1
CN2121300000000,2023-05-01,21,213,KY,Simpson County,8812,8489,323,3.7
CN2121500000000,2023-05-01,21,215,KY,Spencer County,10568,10254,314,3
CN2121700000000,2023-05-01,21,217,KY,Taylor County,12181,11743,438,3.6
CN2121900000000,2023-05-01,21,219,KY,Todd County,5856,5657,199,3.4
CN2122100000000,2023-05-01,21,221,KY,Trigg County,6090,5827,263,4.3
CN2122300000000,2023-05-01,21,223,KY,Trimble County,3809,3669,140,3.7
CN2122500000000,2023-05-01,21,225,KY,Union County,5939,5657,282,4.7
CN2122700000000,2023-05-01,21,227,KY,Warren County,67701,65241,2460,3.6
CN2122900000000,2023-05-01,21,229,KY,Washington County,6096,5897,199,3.3
CN2123100000000,2023-05-01,21,231,KY,Wayne County,6924,6560,364,5.3
CN2123300000000,2023-05-01,21,233,KY,Webster County,5172,4923,249,4.8
CN2123500000000,2023-05-01,21,235,KY,Whitley County,14169,13548,621,4.4
CN2123700000000,2023-05-01,21,237,KY,Wolfe County,2369,2248,121,5.1
CN2123900000000,2023-05-01,21,239,KY,Woodford County,14951,14501,450,3
CN2200100000000,2023-05-01,22,001,LA,Acadia Parish,24072,23120,952,4
CN2200300000000,2023-05-01,22,003,LA,Allen Parish,8360,7999,361,4.3
CN2200500000000,2023-05-01,22,005,LA,Ascension Parish,68726,66572,2154,3.1
CN2200700000000,2023-05-01,22,007,LA,Assumption Parish,8883,8453,430,4.8
CN2200900000000,2023-05-01,22,009,LA,Avoyelles Parish,14356,13708,648,4.5
CN2201100000000,2023-05-01,22,011,LA,Beauregard Parish,14892,14346,546,3.7
CN2201300000000,2023-05-01,22,013,LA,Bienville Parish,5220,4988,232,4.4
CN2201500000000,2023-05-01,22,015,LA,Bossier Parish,58729,56718,2011,3.4
CN2201700000000,2023-05-01,22,017,LA,Caddo Parish,102818,98349,4469,4.3
CN2201900000000,2023-05-01,22,019,LA,Calcasieu Parish,93030,89623,3407,3.7
CN2202100000000,2023-05-01,22,021,LA,Caldwell Parish,3727,3576,151,4.1
CN2202300000000,2023-05-01,22,023,LA,Cameron Parish,3453,3351,102,3
CN2202500000000,2023-05-01,22,025,LA,Catahoula Parish,3473,3310,163,4.7
CN2202700000000,2023-05-01,22,027,LA,Claiborne Parish,5443,5209,234,4.3
CN2202900000000,2023-05-01,22,029,LA,Concordia Parish,6971,6639,332,4.8
CN2203100000000,2023-05-01,22,031,LA,De Soto Parish,11032,10575,457,4.1
CN2203300000000,2023-05-01,22,033,LA,East Baton Rouge Parish,239624,231136,8488,3.5
CN2203500000000,2023-05-01,22,035,LA,East Carroll Parish,1727,1544,183,10.6
CN2203700000000,2023-05-01,22,037,LA,East Feliciana Parish,8145,7837,308,3.8
CN2203900000000,2023-05-01,22,039,LA,Evangeline Parish,12211,11702,509,4.2
CN2204100000000,2023-05-01,22,041,LA,Franklin Parish,7531,7105,426,5.7
CN2204300000000,2023-05-01,22,043,LA,Grant Parish,8413,8118,295,3.5
CN2204500000000,2023-05-01,22,045,LA,Iberia Parish,27861,26606,1255,4.5
CN2204700000000,2023-05-01,22,047,LA,Iberville Parish,14255,13631,624,4.4
CN2204900000000,2023-05-01,22,049,LA,Jackson Parish,7051,6811,240,3.4
CN2205100000000,2023-05-01,22,051,LA,Jefferson Parish,211790,203978,7812,3.7
CN2205300000000,2023-05-01,22,053,LA,Jefferson Davis Parish,12483,11992,491,3.9
CN2205500000000,2023-05-01,22,055,LA,Lafayette Parish,117273,113275,3998,3.4
CN2205700000000,2023-05-01,22,057,LA,Lafourche Parish,40539,39155,1384,3.4
CN2205900000000,2023-05-01,22,059,LA,LaSalle Parish,6786,6564,222,3.3
CN2206100000000,2023-05-01,22,061,LA,Lincoln Parish,21465,20627,838,3.9
CN2206300000000,2023-05-01,22,063,LA,Livingston Parish,73696,71458,2238,3
CN2206500000000,2023-05-01,22,065,LA,Madison Parish,3501,3287,214,6.1
CN2206700000000,2023-05-01,22,067,LA,Morehouse Parish,9900,9278,622,6.3
CN2206900000000,2023-05-01,22,069,LA,Natchitoches Parish,16885,16113,772,4.6
CN2207100000000,2023-05-01,22,071,LA,Orleans Parish,177924,169587,8337,4.7
CN2207300000000,2023-05-01,22,073,LA,Ouachita Parish,71321,68399,2922,4.1
CN2207500000000,2023-05-01,22,075,LA,Plaquemines Parish,9865,9537,328,3.3
CN2207700000000,2023-05-01,22,077,LA,Pointe Coupee Parish,10054,9673,381,3.8
CN2207900000000,2023-05-01,22,079,LA,Rapides Parish,56807,54793,2014,3.5
CN2208100000000,2023-05-01,22,081,LA,Red River Parish,3803,3668,135,3.5
CN2208300000000,2023-05-01,22,083,LA,Richland Parish,8296,7876,420,5.1
CN2208500000000,2023-05-01,22,085,LA,Sabine Parish,9198,8837,361,3.9
CN2208700000000,2023-05-01,22,087,LA,St. Bernard Parish,20218,19321,897,4.4
CN2208900000000,2023-05-01,22,089,LA,St. Charles Parish,24968,24096,872,3.5
CN2209100000000,2023-05-01,22,091,LA,St. Helena Parish,4374,4152,222,5.1
CN2209300000000,2023-05-01,22,093,LA,St. James Parish,8959,8539,420,4.7
CN2209500000000,2023-05-01,22,095,LA,St. John the Baptist Parish,19136,18235,901,4.7
CN2209700000000,2023-05-01,22,097,LA,St. Landry Parish,31898,30341,1557,4.9
CN2209900000000,2023-05-01,22,099,LA,St. Martin Parish,22185,21331,854,3.8
CN2210100000000,2023-05-01,22,101,LA,St. Mary Parish,19913,19039,874,4.4
CN2210300000000,2023-05-01,22,103,LA,St. Tammany Parish,120982,116882,4100,3.4
CN2210500000000,2023-05-01,22,105,LA,Tangipahoa Parish,57511,54843,2668,4.6
CN2210700000000,2023-05-01,22,107,LA,Tensas Parish,1284,1211,73,5.7
CN2210900000000,2023-05-01,22,109,LA,Terrebonne Parish,44523,42840,1683,3.8
CN2211100000000,2023-05-01,22,111,LA,Union Parish,9338,8916,422,4.5
CN2211300000000,2023-05-01,22,113,LA,Vermilion Parish,24320,23374,946,3.9
CN2211500000000,2023-05-01,22,115,LA,Vernon Parish,16423,15718,705,4.3
CN2211700000000,2023-05-01,22,117,LA,Washington Parish,16764,15988,776,4.6
CN2211900000000,2023-05-01,22,119,LA,Webster Parish,14330,13684,646,4.5
CN2212100000000,2023-05-01,22,121,LA,West Baton Rouge Parish,14409,13891,518,3.6
CN2212300000000,2023-05-01,22,123,LA,West Carroll Parish,3473,3253,220,6.3
CN2212500000000,2023-05-01,22,125,LA,West Feliciana Parish,5587,5436,151,2.7
CN2212700000000,2023-05-01,22,127,LA,Winn Parish,4636,4410,226,4.9
CN2300100000000,2023-05-01,23,001,ME,Androscoggin County,53095,51674,1421,2.7
CN2300300000000,2023-05-01,23,003,ME,Aroostook County,27995,26811,1184,4.2
CN2300500000000,2023-05-01,23,005,ME,Cumberland County,164112,160403,3709,2.3
CN2300700000000,2023-05-01,23,007,ME,Franklin County,13063,12569,494,3.8
CN2300900000000,2023-05-01,23,009,ME,Hancock County,28182,27445,737,2.6
CN2301100000000,2023-05-01,23,011,ME,Kennebec County,60979,59546,1433,2.3
CN2301300000000,2023-05-01,23,013,ME,Knox County,19703,19221,482,2.4
CN2301500000000,2023-05-01,23,015,ME,Lincoln County,16517,16100,417,2.5
CN2301700000000,2023-05-01,23,017,ME,Oxford County,25516,24756,760,3
CN2301900000000,2023-05-01,23,019,ME,Penobscot County,74936,72955,1981,2.6
CN2302100000000,2023-05-01,23,021,ME,Piscataquis County,7275,6976,299,4.1
CN2302300000000,2023-05-01,23,023,ME,Sagadahoc County,18943,18535,408,2.2
CN2302500000000,2023-05-01,23,025,ME,Somerset County,21759,20936,823,3.8
CN2302700000000,2023-05-01,23,027,ME,Waldo County,20146,19625,521,2.6
CN2302900000000,2023-05-01,23,029,ME,Washington County,13131,12653,478,3.6
CN2303100000000,2023-05-01,23,031,ME,York County,113063,110558,2505,2.2
CN2400100000000,2023-05-01,24,001,MD,Allegany County,31563,30683,880,2.8
CN2400300000000,2023-05-01,24,003,MD,Anne Arundel County,315180,309153,6027,1.9
CN2400500000000,2023-05-01,24,005,MD,Baltimore County,445868,435669,10199,2.3
CN2400900000000,2023-05-01,24,009,MD,Calvert County,49637,48651,986,2
CN2401100000000,2023-05-01,24,011,MD,Caroline County,17890,17513,377,2.1
CN2401300000000,2023-05-01,24,013,MD,Carroll County,95225,93543,1682,1.8
CN2401500000000,2023-05-01,24,015,MD,Cecil County,54831,53622,1209,2.2
CN2401700000000,2023-05-01,24,017,MD,Charles County,86745,84814,1931,2.2
CN2401900000000,2023-05-01,24,019,MD,Dorchester County,15990,15604,386,2.4
CN2402100000000,2023-05-01,24,021,MD,Frederick County,137323,134551,2772,2
CN2402300000000,2023-05-01,24,023,MD,Garrett County,15149,14831,318,2.1
CN2402500000000,2023-05-01,24,025,MD,Harford County,140499,137570,2929,2.1
CN2402700000000,2023-05-01,24,027,MD,Howard County,188688,185293,3395,1.8
CN2402900000000,2023-05-01,24,029,MD,Kent County,10002,9776,226,2.3
CN2403100000000,2023-05-01,24,031,MD,Montgomery County,554345,543492,10853,2
CN2403300000000,2023-05-01,24,033,MD,Prince George's County,497826,486290,11536,2.3
CN2403500000000,2023-05-01,24,035,MD,Queen Anne's County,28252,27725,527,1.9
CN2403700000000,2023-05-01,24,037,MD,St. Mary's County,57123,55945,1178,2.1
CN2403900000000,2023-05-01,24,039,MD,Somerset County,9135,8844,291,3.2
CN2404100000000,2023-05-01,24,041,MD,Talbot County,17815,17445,370,2.1
CN2404300000000,2023-05-01,24,043,MD,Washington County,70907,69212,1695,2.4
CN2404500000000,2023-05-01,24,045,MD,Wicomico County,52055,50693,1362,2.6
CN2404700000000,2023-05-01,24,047,MD,Worcester County,25449,24742,707,2.8
CN2451000000000,2023-05-01,24,510,MD,Baltimore city,273903,265720,8183,3
CN2500100000000,2023-05-01,25,001,MA,Barnstable County,110290,107445,2845,2.6
CN2500300000000,2023-05-01,25,003,MA,Berkshire County,59478,58040,1438,2.4
CN2500500000000,2023-05-01,25,005,MA,Bristol County,289824,282009,7815,2.7
CN2500700000000,2023-05-01,25,007,MA,Dukes County,9362,9108,254,2.7
CN2500900000000,2023-05-01,25,009,MA,Essex County,413657,403792,9865,2.4
CN2501100000000,2023-05-01,25,011,MA,Franklin County,39371,38635,736,1.9
CN2501300000000,2023-05-01,25,013,MA,Hampden County,217694,211564,6130,2.8
CN2501500000000,2023-05-01,25,015,MA,Hampshire County,87454,85850,1604,1.8
CN2501700000000,2023-05-01,25,017,MA,Middlesex County,899278,881431,17847,2
CN2501900000000,2023-05-01,25,019,MA,Nantucket County/town,7648,7402,246,3.2
CN2502100000000,2023-05-01,25,021,MA,Norfolk County,388037,379716,8321,2.1
CN2502300000000,2023-05-01,25,023,MA,Plymouth County,278647,271805,6842,2.5
CN2502500000000,2023-05-01,25,025,MA,Suffolk County,447575,437398,10177,2.3
CN2502700000000,2023-05-01,25,027,MA,Worcester County,433728,423606,10122,2.3
CN2600100000000,2023-05-01,26,001,MI,Alcona County,4146,3878,268,6.5
CN2600300000000,2023-05-01,26,003,MI,Alger County,3358,3081,277,8.2
CN2600500000000,2023-05-01,26,005,MI,Allegan County,65205,62965,2240,3.4
CN2600700000000,2023-05-01,26,007,MI,Alpena County,13966,13327,639,4.6
CN2600900000000,2023-05-01,26,009,MI,Antrim County,10703,10137,566,5.3
CN2601100000000,2023-05-01,26,011,MI,Arenac County,6157,5776,381,6.2
CN2601300000000,2023-05-01,26,013,MI,Baraga County,3167,2950,217,6.9
CN2601500000000,2023-05-01,26,015,MI,Barry County,33439,32226,1213,3.6
CN2601700000000,2023-05-01,26,017,MI,Bay County,50794,48277,2517,5
CN2601900000000,2023-05-01,26,019,MI,Benzie County,9211,8757,454,4.9
CN2602100000000,2023-05-01,26,021,MI,Berrien County,75186,71949,3237,4.3
CN2602300000000,2023-05-01,26,023,MI,Branch County,20425,19612,813,4
CN2602500000000,2023-05-01,26,025,MI,Calhoun County,62051,59220,2831,4.6
CN2602700000000,2023-05-01,26,027,MI,Cass County,24333,23247,1086,4.5
CN2602900000000,2023-05-01,26,029,MI,Charlevoix County,13293,12683,610,4.6
CN2603100000000,2023-05-01,26,031,MI,Cheboygan County,10707,10089,618,5.8
CN2603300000000,2023-05-01,26,033,MI,Chippewa County,16402,15450,952,5.8
CN2603500000000,2023-05-01,26,035,MI,Clare County,11704,10963,741,6.3
CN2603700000000,2023-05-01,26,037,MI,Clinton County,42540,41048,1492,3.5
CN2603900000000,2023-05-01,26,039,MI,Crawford County,5771,5430,341,5.9
CN2604100000000,2023-05-01,26,041,MI,Delta County,17205,16307,898,5.2
CN2604300000000,2023-05-01,26,043,MI,Dickinson County,12414,11889,525,4.2
CN2604500000000,2023-05-01,26,045,MI,Eaton County,59015,56857,2158,3.7
CN2604700000000,2023-05-01,26,047,MI,Emmet County,17562,16611,951,5.4
CN2604900000000,2023-05-01,26,049,MI,Genesee County,185587,176191,9396,5.1
CN2605100000000,2023-05-01,26,051,MI,Gladwin County,10423,9818,605,5.8
CN2605300000000,2023-05-01,26,053,MI,Gogebic County,5816,5500,316,5.4
CN2605500000000,2023-05-01,26,055,MI,Grand Traverse County,52101,50284,1817,3.5
CN2605700000000,2023-05-01,26,057,MI,Gratiot County,18163,17330,833,4.6
CN2605900000000,2023-05-01,26,059,MI,Hillsdale County,20752,19841,911,4.4
CN2606100000000,2023-05-01,26,061,MI,Houghton County,15886,14990,896,5.6
CN2606300000000,2023-05-01,26,063,MI,Huron County,15515,14804,711,4.6
CN2606500000000,2023-05-01,26,065,MI,Ingham County,154793,148548,6245,4
CN2606700000000,2023-05-01,26,067,MI,Ionia County,31795,30611,1184,3.7
CN2606900000000,2023-05-01,26,069,MI,Iosco County,10884,10279,605,5.6
CN2607100000000,2023-05-01,26,071,MI,Iron County,4838,4524,314,6.5
CN2607300000000,2023-05-01,26,073,MI,Isabella County,32918,31341,1577,4.8
CN2607500000000,2023-05-01,26,075,MI,Jackson County,76637,73436,3201,4.2
CN2607700000000,2023-05-01,26,077,MI,Kalamazoo County,137033,131617,5416,4
CN2607900000000,2023-05-01,26,079,MI,Kalkaska County,8275,7821,454,5.5
CN2608100000000,2023-05-01,26,081,MI,Kent County,378660,365830,12830,3.4
CN2608300000000,2023-05-01,26,083,MI,Keweenaw County,902,828,74,8.2
CN2608500000000,2023-05-01,26,085,MI,Lake County,4151,3862,289,7
CN2608700000000,2023-05-01,26,087,MI,Lapeer County,40271,38968,1303,3.2
CN2608900000000,2023-05-01,26,089,MI,Leelanau County,10858,10434,424,3.9
CN2609100000000,2023-05-01,26,091,MI,Lenawee County,45721,43595,2126,4.6
CN2609300000000,2023-05-01,26,093,MI,Livingston County,103583,101126,2457,2.4
CN2609500000000,2023-05-01,26,095,MI,Luce County,2098,1948,150,7.1
CN2609700000000,2023-05-01,26,097,MI,Mackinac County,5601,5321,280,5
CN2609900000000,2023-05-01,26,099,MI,Macomb County,442509,429432,13077,3
CN2610100000000,2023-05-01,26,101,MI,Manistee County,10318,9761,557,5.4
CN2610300000000,2023-05-01,26,103,MI,Marquette County,32186,30564,1622,5
CN2610500000000,2023-05-01,26,105,MI,Mason County,13795,13136,659,4.8
CN2610700000000,2023-05-01,26,107,MI,Mecosta County,19084,18063,1021,5.4
CN2610900000000,2023-05-01,26,109,MI,Menominee County,11061,10562,499,4.5
CN2611100000000,2023-05-01,26,111,MI,Midland County,41494,39816,1678,4
CN2611300000000,2023-05-01,26,113,MI,Missaukee County,7113,6775,338,4.8
CN2611500000000,2023-05-01,26,115,MI,Monroe County,77546,73792,3754,4.8
CN2611700000000,2023-05-01,26,117,MI,Montcalm County,29243,27954,1289,4.4
CN2611900000000,2023-05-01,26,119,MI,Montmorency County,3228,3004,224,6.9
CN2612100000000,2023-05-01,26,121,MI,Muskegon County,79375,75680,3695,4.7
CN2612300000000,2023-05-01,26,123,MI,Newaygo County,24521,23452,1069,4.4
CN2612500000000,2023-05-01,26,125,MI,Oakland County,670004,652992,17012,2.5
CN2612700000000,2023-05-01,26,127,MI,Oceana County,12037,11362,675,5.6
CN2612900000000,2023-05-01,26,129,MI,Ogemaw County,8665,8121,544,6.3
CN2613100000000,2023-05-01,26,131,MI,Ontonagon County,2143,1957,186,8.7
CN2613300000000,2023-05-01,26,133,MI,Osceola County,12106,11544,562,4.6
CN2613500000000,2023-05-01,26,135,MI,Oscoda County,3007,2797,210,7
CN2613700000000,2023-05-01,26,137,MI,Otsego County,12182,11579,603,4.9
CN2613900000000,2023-05-01,26,139,MI,Ottawa County,170377,164814,5563,3.3
CN2614100000000,2023-05-01,26,141,MI,Presque Isle County,5176,4854,322,6.2
CN2614300000000,2023-05-01,26,143,MI,Roscommon County,8474,7861,613,7.2
CN2614500000000,2023-05-01,26,145,MI,Saginaw County,84903,80382,4521,5.3
CN2614700000000,2023-05-01,26,147,MI,St. Clair County,74683,72355,2328,3.1
CN2614900000000,2023-05-01,26,149,MI,St. Joseph County,29231,27935,1296,4.4
CN2615100000000,2023-05-01,26,151,MI,Sanilac County,19678,18677,1001,5.1
CN2615300000000,2023-05-01,26,153,MI,Schoolcraft County,3276,3044,232,7.1
CN2615500000000,2023-05-01,26,155,MI,Shiawassee County,33651,32225,1426,4.2
CN2615700000000,2023-05-01,26,157,MI,Tuscola County,23702,22470,1232,5.2
CN2615900000000,2023-05-01,26,159,MI,Van Buren County,35540,33855,1685,4.7
CN2616100000000,2023-05-01,26,161,MI,Washtenaw County,204987,197696,7291,3.6
CN2616300000000,2023-05-01,26,163,MI,Wayne County,787676,758971,28705,3.6
CN2616500000000,2023-05-01,26,165,MI,Wexford County,15499,14725,774,5
CN2700100000000,2023-05-01,27,001,MN,Aitkin County,7577,7204,373,4.9
CN2700300000000,2023-05-01,27,003,MN,Anoka County,202191,196309,5882,2.9
CN2700500000000,2023-05-01,27,005,MN,Becker County,19769,19260,509,2.6
CN2700700000000,2023-05-01,27,007,MN,Beltrami County,25330,24412,918,3.6
CN2700900000000,2023-05-01,27,009,MN,Benton County,21739,21028,711,3.3
CN2701100000000,2023-05-01,27,011,MN,Big Stone County,2352,2293,59,2.5
CN2701300000000,2023-05-01,27,013,MN,Blue Earth County,41401,40394,1007,2.4
CN2701500000000,2023-05-01,27,015,MN,Brown County,13627,13215,412,3
CN2701700000000,2023-05-01,27,017,MN,Carlton County,17599,16882,717,4.1
CN2701900000000,2023-05-01,27,019,MN,Carver County,60348,58803,1545,2.6
CN2702100000000,2023-05-01,27,021,MN,Cass County,14920,14295,625,4.2
CN2702300000000,2023-05-01,27,023,MN,Chippewa County,6412,6216,196,3.1
CN2702500000000,2023-05-01,27,025,MN,Chisago County,30350,29414,936,3.1
CN2702700000000,2023-05-01,27,027,MN,Clay County,37756,36897,859,2.3
CN2702900000000,2023-05-01,27,029,MN,Clearwater County,4548,4284,264,5.8
CN2703100000000,2023-05-01,27,031,MN,Cook County,2717,2604,113,4.2
CN2703300000000,2023-05-01,27,033,MN,Cottonwood County,6760,6570,190,2.8
CN2703500000000,2023-05-01,27,035,MN,Crow Wing County,34314,33172,1142,3.3
CN2703700000000,2023-05-01,27,037,MN,Dakota County,246752,239980,6772,2.7
CN2703900000000,2023-05-01,27,039,MN,Dodge County,11974,11660,314,2.6
CN2704100000000,2023-05-01,27,041,MN,Douglas County,21806,21231,575,2.6
CN2704300000000,2023-05-01,27,043,MN,Faribault County,6970,6752,218,3.1
CN2704500000000,2023-05-01,27,045,MN,Fillmore County,11441,11133,308,2.7
CN2704700000000,2023-05-01,27,047,MN,Freeborn County,15996,15554,442,2.8
CN2704900000000,2023-05-01,27,049,MN,Goodhue County,26684,25993,691,2.6
CN2705100000000,2023-05-01,27,051,MN,Grant County,3286,3199,87,2.6
CN2705300000000,2023-05-01,27,053,MN,Hennepin County,718005,697007,20998,2.9
CN2705500000000,2023-05-01,27,055,MN,Houston County,10467,10210,257,2.5
CN2705700000000,2023-05-01,27,057,MN,Hubbard County,10377,9945,432,4.2
CN2705900000000,2023-05-01,27,059,MN,Isanti County,22037,21294,743,3.4
CN2706100000000,2023-05-01,27,061,MN,Itasca County,21812,20706,1106,5.1
CN2706300000000,2023-05-01,27,063,MN,Jackson County,5366,5201,165,3.1
CN2706500000000,2023-05-01,27,065,MN,Kanabec County,9253,8880,373,4
CN2706700000000,2023-05-01,27,067,MN,Kandiyohi County,22971,22292,679,3
CN2706900000000,2023-05-01,27,069,MN,Kittson County,2198,2141,57,2.6
CN2707100000000,2023-05-01,27,071,MN,Koochiching County,5792,5474,318,5.5
CN2707300000000,2023-05-01,27,073,MN,Lac qui Parle County,3376,3288,88,2.6
CN2707500000000,2023-05-01,27,075,MN,Lake County,5186,4970,216,4.2
CN2707700000000,2023-05-01,27,077,MN,Lake of the Woods County,2374,2285,89,3.7
CN2707900000000,2023-05-01,27,079,MN,Le Sueur County,16027,15502,525,3.3
CN2708100000000,2023-05-01,27,081,MN,Lincoln County,2970,2877,93,3.1
CN2708300000000,2023-05-01,27,083,MN,Lyon County,14385,14048,337,2.3
CN2708500000000,2023-05-01,27,085,MN,McLeod County,19416,18806,610,3.1
CN2708700000000,2023-05-01,27,087,MN,Mahnomen County,2315,2212,103,4.4
CN2708900000000,2023-05-01,27,089,MN,Marshall County,5393,5176,217,4
CN2709100000000,2023-05-01,27,091,MN,Martin County,9500,9236,264,2.8
CN2709300000000,2023-05-01,27,093,MN,Meeker County,13720,13331,389,2.8
CN2709500000000,2023-05-01,27,095,MN,Mille Lacs County,12822,12261,561,4.4
CN2709700000000,2023-05-01,27,097,MN,Morrison County,17213,16572,641,3.7
CN2709900000000,2023-05-01,27,099,MN,Mower County,20909,20320,589,2.8
CN2710100000000,2023-05-01,27,101,MN,Murray County,4629,4494,135,2.9
CN2710300000000,2023-05-01,27,103,MN,Nicollet County,21190,20721,469,2.2
CN2710500000000,2023-05-01,27,105,MN,Nobles County,10766,10510,256,2.4
CN2710700000000,2023-05-01,27,107,MN,Norman County,3116,3017,99,3.2
CN2710900000000,2023-05-01,27,109,MN,Olmsted County,92227,90104,2123,2.3
CN2711100000000,2023-05-01,27,111,MN,Otter Tail County,31424,30518,906,2.9
CN2711300000000,2023-05-01,27,113,MN,Pennington County,8821,8560,261,3
CN2711500000000,2023-05-01,27,115,MN,Pine County,14368,13714,654,4.6
CN2711700000000,2023-05-01,27,117,MN,Pipestone County,4700,4575,125,2.7
CN2711900000000,2023-05-01,27,119,MN,Polk County,16067,15575,492,3.1
CN2712100000000,2023-05-01,27,121,MN,Pope County,6531,6366,165,2.5
CN2712300000000,2023-05-01,27,123,MN,Ramsey County,290688,281818,8870,3.1
CN2712500000000,2023-05-01,27,125,MN,Red Lake County,2163,2083,80,3.7
CN2712700000000,2023-05-01,27,127,MN,Redwood County,7574,7354,220,2.9
CN2712900000000,2023-05-01,27,129,MN,Renville County,7933,7619,314,4
CN2713100000000,2023-05-01,27,131,MN,Rice County,37921,36986,935,2.5
CN2713300000000,2023-05-01,27,133,MN,Rock County,6014,5910,104,1.7
CN2713500000000,2023-05-01,27,135,MN,Roseau County,7842,7637,205,2.6
CN2713700000000,2023-05-01,27,137,MN,St. Louis County,100253,96713,3540,3.5
CN2713900000000,2023-05-01,27,139,MN,Scott County,85897,83647,2250,2.6
CN2714100000000,2023-05-01,27,141,MN,Sherburne County,53962,52365,1597,3
CN2714300000000,2023-05-01,27,143,MN,Sibley County,8087,7834,253,3.1
CN2714500000000,2023-05-01,27,145,MN,Stearns County,90072,87624,2448,2.7
CN2714700000000,2023-05-01,27,147,MN,Steele County,18581,18007,574,3.1
CN2714900000000,2023-05-01,27,149,MN,Stevens County,5289,5168,121,2.3
CN2715100000000,2023-05-01,27,151,MN,Swift County,4744,4592,152,3.2
CN2715300000000,2023-05-01,27,153,MN,Todd County,13519,13081,438,3.2
CN2715500000000,2023-05-01,27,155,MN,Traverse County,1615,1568,47,2.9
CN2715700000000,2023-05-01,27,157,MN,Wabasha County,12191,11869,322,2.6
CN2715900000000,2023-05-01,27,159,MN,Wadena County,6135,5893,242,3.9
CN2716100000000,2023-05-01,27,161,MN,Waseca County,8422,8092,330,3.9
CN2716300000000,2023-05-01,27,163,MN,Washington County,147597,143625,3972,2.7
CN2716500000000,2023-05-01,27,165,MN,Watonwan County,6527,6341,186,2.8
CN2716700000000,2023-05-01,27,167,MN,Wilkin County,3394,3298,96,2.8
CN2716900000000,2023-05-01,27,169,MN,Winona County,28531,27769,762,2.7
CN2717100000000,2023-05-01,27,171,MN,Wright County,77724,75615,2109,2.7
CN2717300000000,2023-05-01,27,173,MN,Yellow Medicine County,4928,4793,135,2.7
CN2800100000000,2023-05-01,28,001,MS,Adams County,10658,10218,440,4.1
CN2800300000000,2023-05-01,28,003,MS,Alcorn County,14966,14538,428,2.9
CN2800500000000,2023-05-01,28,005,MS,Amite County,4232,4072,160,3.8
CN2800700000000,2023-05-01,28,007,MS,Attala County,6919,6687,232,3.4
CN2800900000000,2023-05-01,28,009,MS,Benton County,3004,2892,112,3.7
CN2801100000000,2023-05-01,28,011,MS,Bolivar County,10934,10539,395,3.6
CN2801300000000,2023-05-01,28,013,MS,Calhoun County,5366,5201,165,3.1
CN2801500000000,2023-05-01,28,015,MS,Carroll County,3180,3073,107,3.4
CN2801700000000,2023-05-01,28,017,MS,Chickasaw County,6327,6077,250,4
CN2801900000000,2023-05-01,28,019,MS,Choctaw County,3527,3438,89,2.5
CN2802100000000,2023-05-01,28,021,MS,Claiborne County,2824,2635,189,6.7
CN2802300000000,2023-05-01,28,023,MS,Clarke County,5495,5320,175,3.2
CN2802500000000,2023-05-01,28,025,MS,Clay County,9047,8788,259,2.9
CN2802700000000,2023-05-01,28,027,MS,Coahoma County,7441,7066,375,5
CN2802900000000,2023-05-01,28,029,MS,Copiah County,10794,10442,352,3.3
CN2803100000000,2023-05-01,28,031,MS,Covington County,8099,7893,206,2.5
CN2803300000000,2023-05-01,28,033,MS,DeSoto County,92571,90139,2432,2.6
CN2803500000000,2023-05-01,28,035,MS,Forrest County,32989,32045,944,2.9
CN2803700000000,2023-05-01,28,037,MS,Franklin County,2587,2473,114,4.4
CN2803900000000,2023-05-01,28,039,MS,George County,8764,8441,323,3.7
CN2804100000000,2023-05-01,28,041,MS,Greene County,4145,3977,168,4.1
CN2804300000000,2023-05-01,28,043,MS,Grenada County,8329,8046,283,3.4
CN2804500000000,2023-05-01,28,045,MS,Hancock County,18873,18277,596,3.2
CN2804700000000,2023-05-01,28,047,MS,Harrison County,87057,84613,2444,2.8
CN2804900000000,2023-05-01,28,049,MS,Hinds County,102015,98998,3017,3
CN2805100000000,2023-05-01,28,051,MS,Holmes County,5089,4793,296,5.8
CN2805300000000,2023-05-01,28,053,MS,Humphreys County,1952,1830,122,6.3
CN2805500000000,2023-05-01,28,055,MS,Issaquena County,316,291,25,7.9
CN2805700000000,2023-05-01,28,057,MS,Itawamba County,10085,9812,273,2.7
CN2805900000000,2023-05-01,28,059,MS,Jackson County,58323,56497,1826,3.1
CN2806100000000,2023-05-01,28,061,MS,Jasper County,5821,5625,196,3.4
CN2806300000000,2023-05-01,28,063,MS,Jefferson County,1803,1619,184,10.2
CN2806500000000,2023-05-01,28,065,MS,Jefferson Davis County,3891,3744,147,3.8
CN2806700000000,2023-05-01,28,067,MS,Jones County,24893,24149,744,3
CN2806900000000,2023-05-01,28,069,MS,Kemper County,3194,3056,138,4.3
CN2807100000000,2023-05-01,28,071,MS,Lafayette County,28114,27485,629,2.2
CN2807300000000,2023-05-01,28,073,MS,Lamar County,31422,30693,729,2.3
CN2807500000000,2023-05-01,28,075,MS,Lauderdale County,28446,27562,884,3.1
CN2807700000000,2023-05-01,28,077,MS,Lawrence County,4812,4646,166,3.4
CN2807900000000,2023-05-01,28,079,MS,Leake County,7981,7742,239,3
CN2808100000000,2023-05-01,28,081,MS,Lee County,40013,38972,1041,2.6
CN2808300000000,2023-05-01,28,083,MS,Leflore County,8969,8561,408,4.5
CN2808500000000,2023-05-01,28,085,MS,Lincoln County,14364,13969,395,2.7
CN2808700000000,2023-05-01,28,087,MS,Lowndes County,24537,23766,771,3.1
CN2808900000000,2023-05-01,28,089,MS,Madison County,53636,52297,1339,2.5
CN2809100000000,2023-05-01,28,091,MS,Marion County,9838,9537,301,3.1
CN2809300000000,2023-05-01,28,093,MS,Marshall County,14050,13576,474,3.4
CN2809500000000,2023-05-01,28,095,MS,Monroe County,15251,14650,601,3.9
CN2809700000000,2023-05-01,28,097,MS,Montgomery County,3845,3725,120,3.1
CN2809900000000,2023-05-01,28,099,MS,Neshoba County,9771,9465,306,3.1
CN2810100000000,2023-05-01,28,101,MS,Newton County,7945,7688,257,3.2
CN2810300000000,2023-05-01,28,103,MS,Noxubee County,3327,3179,148,4.4
CN2810500000000,2023-05-01,28,105,MS,Oktibbeha County,22216,21556,660,3
CN2810700000000,2023-05-01,28,107,MS,Panola County,12076,11628,448,3.7
CN2810900000000,2023-05-01,28,109,MS,Pearl River County,23251,22584,667,2.9
CN2811100000000,2023-05-01,28,111,MS,Perry County,4194,4047,147,3.5
CN2811300000000,2023-05-01,28,113,MS,Pike County,13816,13317,499,3.6
CN2811500000000,2023-05-01,28,115,MS,Pontotoc County,14575,14208,367,2.5
CN2811700000000,2023-05-01,28,117,MS,Prentiss County,11268,10985,283,2.5
CN2811900000000,2023-05-01,28,119,MS,Quitman County,2296,2189,107,4.7
CN2812100000000,2023-05-01,28,121,MS,Rankin County,76921,75274,1647,2.1
CN2812300000000,2023-05-01,28,123,MS,Scott County,12123,11835,288,2.4
CN2812500000000,2023-05-01,28,125,MS,Sharkey County,1320,1224,96,7.3
CN2812700000000,2023-05-01,28,127,MS,Simpson County,10632,10327,305,2.9
CN2812900000000,2023-05-01,28,129,MS,Smith County,6612,6441,171,2.6
CN2813100000000,2023-05-01,28,131,MS,Stone County,6987,6771,216,3.1
CN2813300000000,2023-05-01,28,133,MS,Sunflower County,7125,6812,313,4.4
CN2813500000000,2023-05-01,28,135,MS,Tallahatchie County,4531,4375,156,3.4
CN2813700000000,2023-05-01,28,137,MS,Tate County,11955,11606,349,2.9
CN2813900000000,2023-05-01,28,139,MS,Tippah County,9666,9416,250,2.6
CN2814100000000,2023-05-01,28,141,MS,Tishomingo County,8716,8453,263,3
CN2814300000000,2023-05-01,28,143,MS,Tunica County,4106,3973,133,3.2
CN2814500000000,2023-05-01,28,145,MS,Union County,14677,14376,301,2.1
CN2814700000000,2023-05-01,28,147,MS,Walthall County,4834,4643,191,4
CN2814900000000,2023-05-01,28,149,MS,Warren County,18870,18233,637,3.4
CN2815100000000,2023-05-01,28,151,MS,Washington County,14264,13554,710,5
CN2815300000000,2023-05-01,28,153,MS,Wayne County,6920,6680,240,3.5
CN2815500000000,2023-05-01,28,155,MS,Webster County,3835,3725,110,2.9
CN2815700000000,2023-05-01,28,157,MS,Wilkinson County,2590,2453,137,5.3
CN2815900000000,2023-05-01,28,159,MS,Winston County,7109,6887,222,3.1
CN2816100000000,2023-05-01,28,161,MS,Yalobusha County,4675,4509,166,3.6
CN2816300000000,2023-05-01,28,163,MS,Yazoo County,8874,8583,291,3.3
CN2900100000000,2023-05-01,29,001,MO,Adair County,9937,9567,370,3.7
CN2900300000000,2023-05-01,29,003,MO,Andrew County,9476,9247,229,2.4
CN2900500000000,2023-05-01,29,005,MO,Atchison County,2496,2438,58,2.3
CN2900700000000,2023-05-01,29,007,MO,Audrain County,9763,9436,327,3.3
CN2900900000000,2023-05-01,29,009,MO,Barry County,14206,13741,465,3.3
CN2901100000000,2023-05-01,29,011,MO,Barton County,5271,5123,148,2.8
CN2901300000000,2023-05-01,29,013,MO,Bates County,7817,7585,232,3
CN2901500000000,2023-05-01,29,015,MO,Benton County,7405,7115,290,3.9
CN2901700000000,2023-05-01,29,017,MO,Bollinger County,5383,5226,157,2.9
CN2901900000000,2023-05-01,29,019,MO,Boone County,103471,100901,2570,2.5
CN2902100000000,2023-05-01,29,021,MO,Buchanan County,42739,41542,1197,2.8
CN2902300000000,2023-05-01,29,023,MO,Butler County,17752,17072,680,3.8
CN2902500000000,2023-05-01,29,025,MO,Caldwell County,4329,4207,122,2.8
CN2902700000000,2023-05-01,29,027,MO,Callaway County,22256,21668,588,2.6
CN2902900000000,2023-05-01,29,029,MO,Camden County,19948,19289,659,3.3
CN2903100000000,2023-05-01,29,031,MO,Cape Girardeau County,41621,40511,1110,2.7
CN2903300000000,2023-05-01,29,033,MO,Carroll County,4425,4298,127,2.9
CN2903500000000,2023-05-01,29,035,MO,Carter County,2472,2384,88,3.6
CN2903700000000,2023-05-01,29,037,MO,Cass County,56958,55400,1558,2.7
CN2903900000000,2023-05-01,29,039,MO,Cedar County,5803,5615,188,3.2
CN2904100000000,2023-05-01,29,041,MO,Chariton County,3749,3655,94,2.5
CN2904300000000,2023-05-01,29,043,MO,Christian County,48575,47390,1185,2.4
CN2904500000000,2023-05-01,29,045,MO,Clark County,2977,2875,102,3.4
CN2904700000000,2023-05-01,29,047,MO,Clay County,143796,140131,3665,2.5
CN2904900000000,2023-05-01,29,049,MO,Clinton County,10922,10627,295,2.7
CN2905100000000,2023-05-01,29,051,MO,Cole County,40514,39537,977,2.4
CN2905300000000,2023-05-01,29,053,MO,Cooper County,7265,7056,209,2.9
CN2905500000000,2023-05-01,29,055,MO,Crawford County,10915,10566,349,3.2
CN2905700000000,2023-05-01,29,057,MO,Dade County,3420,3316,104,3
CN2905900000000,2023-05-01,29,059,MO,Dallas County,7325,7109,216,2.9
CN2906100000000,2023-05-01,29,061,MO,Daviess County,4049,3945,104,2.6
CN2906300000000,2023-05-01,29,063,MO,DeKalb County,4027,3930,97,2.4
CN2906500000000,2023-05-01,29,065,MO,Dent County,6156,5938,218,3.5
CN2906700000000,2023-05-01,29,067,MO,Douglas County,5293,5127,166,3.1
CN2906900000000,2023-05-01,29,069,MO,Dunklin County,10970,10454,516,4.7
CN2907100000000,2023-05-01,29,071,MO,Franklin County,54154,52677,1477,2.7
CN2907300000000,2023-05-01,29,073,MO,Gasconade County,7708,7513,195,2.5
CN2907500000000,2023-05-01,29,075,MO,Gentry County,3178,3098,80,2.5
CN2907700000000,2023-05-01,29,077,MO,Greene County,159297,155177,4120,2.6
CN2907900000000,2023-05-01,29,079,MO,Grundy County,4023,3901,122,3
CN2908100000000,2023-05-01,29,081,MO,Harrison County,3701,3583,118,3.2
CN2908300000000,2023-05-01,29,083,MO,Henry County,10568,10269,299,2.8
CN2908500000000,2023-05-01,29,085,MO,Hickory County,4236,4095,141,3.3
CN2908700000000,2023-05-01,29,087,MO,Holt County,2455,2400,55,2.2
CN2908900000000,2023-05-01,29,089,MO,Howard County,4751,4614,137,2.9
CN2909100000000,2023-05-01,29,091,MO,Howell County,16198,15630,568,3.5
CN2909300000000,2023-05-01,29,093,MO,Iron County,3494,3335,159,4.6
CN2909500000000,2023-05-01,29,095,MO,Jackson County,373971,362230,11741,3.1
CN2909700000000,2023-05-01,29,097,MO,Jasper County,58434,56674,1760,3
CN2909900000000,2023-05-01,29,099,MO,Jefferson County,120929,117639,3290,2.7
CN2910100000000,2023-05-01,29,101,MO,Johnson County,23495,22714,781,3.3
CN2910300000000,2023-05-01,29,103,MO,Knox County,1679,1635,44,2.6
CN2910500000000,2023-05-01,29,105,MO,Laclede County,16972,16470,502,3
CN2910700000000,2023-05-01,29,107,MO,Lafayette County,17239,16775,464,2.7
CN2910900000000,2023-05-01,29,109,MO,Lawrence County,17410,16895,515,3
CN2911100000000,2023-05-01,29,111,MO,Lewis County,4804,4673,131,2.7
CN2911300000000,2023-05-01,29,113,MO,Lincoln County,29878,29031,847,2.8
CN2911500000000,2023-05-01,29,115,MO,Linn County,5229,5061,168,3.2
CN2911700000000,2023-05-01,29,117,MO,Livingston County,7139,6968,171,2.4
CN2911900000000,2023-05-01,29,119,MO,McDonald County,11511,11179,332,2.9
CN2912100000000,2023-05-01,29,121,MO,Macon County,7117,6912,205,2.9
CN2912300000000,2023-05-01,29,123,MO,Madison County,5459,5274,185,3.4
CN2912500000000,2023-05-01,29,125,MO,Maries County,3896,3771,125,3.2
CN2912700000000,2023-05-01,29,127,MO,Marion County,13802,13391,411,3
CN2912900000000,2023-05-01,29,129,MO,Mercer County,1676,1633,43,2.6
CN2913100000000,2023-05-01,29,131,MO,Miller County,13402,13038,364,2.7
CN2913300000000,2023-05-01,29,133,MO,Mississippi County,5107,4932,175,3.4
CN2913500000000,2023-05-01,29,135,MO,Moniteau County,7216,7040,176,2.4
CN2913700000000,2023-05-01,29,137,MO,Monroe County,3861,3750,111,2.9
CN2913900000000,2023-05-01,29,139,MO,Montgomery County,5921,5755,166,2.8
CN2914100000000,2023-05-01,29,141,MO,Morgan County,8672,8387,285,3.3
CN2914300000000,2023-05-01,29,143,MO,New Madrid County,8180,7908,272,3.3
CN2914500000000,2023-05-01,29,145,MO,Newton County,27548,26738,810,2.9
CN2914700000000,2023-05-01,29,147,MO,Nodaway County,11163,10851,312,2.8
CN2914900000000,2023-05-01,29,149,MO,Oregon County,3847,3710,137,3.6
CN2915100000000,2023-05-01,29,151,MO,Osage County,7215,7049,166,2.3
CN2915300000000,2023-05-01,29,153,MO,Ozark County,3495,3363,132,3.8
CN2915500000000,2023-05-01,29,155,MO,Pemiscot County,5731,5491,240,4.2
CN2915700000000,2023-05-01,29,157,MO,Perry County,9485,9240,245,2.6
CN2915900000000,2023-05-01,29,159,MO,Pettis County,20240,19618,622,3.1
CN2916100000000,2023-05-01,29,161,MO,Phelps County,20600,19988,612,3
CN2916300000000,2023-05-01,29,163,MO,Pike County,7308,7087,221,3
CN2916500000000,2023-05-01,29,165,MO,Platte County,62297,60750,1547,2.5
CN2916700000000,2023-05-01,29,167,MO,Polk County,14988,14530,458,3.1
CN2916900000000,2023-05-01,29,169,MO,Pulaski County,15007,14476,531,3.5
CN2917100000000,2023-05-01,29,171,MO,Putnam County,2095,2031,64,3.1
CN2917300000000,2023-05-01,29,173,MO,Ralls County,5409,5257,152,2.8
CN2917500000000,2023-05-01,29,175,MO,Randolph County,10615,10288,327,3.1
CN2917700000000,2023-05-01,29,177,MO,Ray County,11198,10876,322,2.9
CN2917900000000,2023-05-01,29,179,MO,Reynolds County,2863,2775,88,3.1
CN2918100000000,2023-05-01,29,181,MO,Ripley County,5170,4974,196,3.8
CN2918300000000,2023-05-01,29,183,MO,St. Charles County,235007,229179,5828,2.5
CN2918500000000,2023-05-01,29,185,MO,St. Clair County,3892,3740,152,3.9
CN2918600000000,2023-05-01,29,186,MO,Ste. Genevieve County,9452,9202,250,2.6
CN2918700000000,2023-05-01,29,187,MO,St. Francois County,25894,24972,922,3.6
CN2918900000000,2023-05-01,29,189,MO,St. Louis County,539667,524272,15395,2.9
CN2919500000000,2023-05-01,29,195,MO,Saline County,10492,10182,310,3
CN2919700000000,2023-05-01,29,197,MO,Schuyler County,1791,1723,68,3.8
CN2919900000000,2023-05-01,29,199,MO,Scotland County,2235,2180,55,2.5
CN2920100000000,2023-05-01,29,201,MO,Scott County,20137,19556,581,2.9
CN2920300000000,2023-05-01,29,203,MO,Shannon County,3300,3165,135,4.1
CN2920500000000,2023-05-01,29,205,MO,Shelby County,3012,2942,70,2.3
CN2920700000000,2023-05-01,29,207,MO,Stoddard County,13239,12797,442,3.3
CN2920900000000,2023-05-01,29,209,MO,Stone County,13865,13357,508,3.7
CN2921100000000,2023-05-01,29,211,MO,Sullivan County,2546,2462,84,3.3
CN2921300000000,2023-05-01,29,213,MO,Taney County,26677,25739,938,3.5
CN2921500000000,2023-05-01,29,215,MO,Texas County,9289,8959,330,3.6
CN2921700000000,2023-05-01,29,217,MO,Vernon County,9330,9030,300,3.2
CN2921900000000,2023-05-01,29,219,MO,Warren County,19168,18633,535,2.8
CN2922100000000,2023-05-01,29,221,MO,Washington County,10274,9915,359,3.5
CN2922300000000,2023-05-01,29,223,MO,Wayne County,4739,4530,209,4.4
CN2922500000000,2023-05-01,29,225,MO,Webster County,17978,17477,501,2.8
CN2922700000000,2023-05-01,29,227,MO,Worth County,1145,1118,27,2.4
CN2922900000000,2023-05-01,29,229,MO,Wright County,7877,7602,275,3.5
CN2951000000000,2023-05-01,29,510,MO,St. Louis city,152397,147226,5171,3.4
CN3000100000000,2023-05-01,30,001,MT,Beaverhead County,5819,5717,102,1.8
CN3000300000000,2023-05-01,30,003,MT,Big Horn County,4603,4436,167,3.6
CN3000500000000,2023-05-01,30,005,MT,Blaine County,2306,2243,63,2.7
CN3000700000000,2023-05-01,30,007,MT,Broadwater County,2832,2752,80,2.8
CN3000900000000,2023-05-01,30,009,MT,Carbon County,5821,5686,135,2.3
CN3001100000000,2023-05-01,30,011,MT,Carter County,696,685,11,1.6
CN3001300000000,2023-05-01,30,013,MT,Cascade County,40092,39129,963,2.4
CN3001500000000,2023-05-01,30,015,MT,Chouteau County,2575,2508,67,2.6
CN3001700000000,2023-05-01,30,017,MT,Custer County,6578,6438,140,2.1
CN3001900000000,2023-05-01,30,019,MT,Daniels County,895,879,16,1.8
CN3002100000000,2023-05-01,30,021,MT,Dawson County,4579,4483,96,2.1
CN3002300000000,2023-05-01,30,023,MT,Deer Lodge County,5595,5467,128,2.3
CN3002500000000,2023-05-01,30,025,MT,Fallon County,1698,1675,23,1.4
CN3002700000000,2023-05-01,30,027,MT,Fergus County,5999,5861,138,2.3
CN3002900000000,2023-05-01,30,029,MT,Flathead County,54078,52527,1551,2.9
CN3003100000000,2023-05-01,30,031,MT,Gallatin County,80148,78597,1551,1.9
CN3003300000000,2023-05-01,30,033,MT,Garfield County,757,739,18,2.4
CN3003500000000,2023-05-01,30,035,MT,Glacier County,5583,5326,257,4.6
CN3003700000000,2023-05-01,30,037,MT,Golden Valley County,377,368,9,2.4
CN3003900000000,2023-05-01,30,039,MT,Granite County,1753,1695,58,3.3
CN3004100000000,2023-05-01,30,041,MT,Hill County,7782,7618,164,2.1
CN3004300000000,2023-05-01,30,043,MT,Jefferson County,6250,6104,146,2.3
CN3004500000000,2023-05-01,30,045,MT,Judith Basin County,1017,994,23,2.3
CN3004700000000,2023-05-01,30,047,MT,Lake County,14627,14230,397,2.7
CN3004900000000,2023-05-01,30,049,MT,Lewis and Clark County,39513,38722,791,2
CN3005100000000,2023-05-01,30,051,MT,Liberty County,994,972,22,2.2
CN3005300000000,2023-05-01,30,053,MT,Lincoln County,8949,8567,382,4.3
CN3005500000000,2023-05-01,30,055,MT,McCone County,1011,996,15,1.5
CN3005700000000,2023-05-01,30,057,MT,Madison County,4798,4675,123,2.6
CN3005900000000,2023-05-01,30,059,MT,Meagher County,991,969,22,2.2
CN3006100000000,2023-05-01,30,061,MT,Mineral County,1916,1849,67,3.5
CN3006300000000,2023-05-01,30,063,MT,Missoula County,69455,67853,1602,2.3
CN3006500000000,2023-05-01,30,065,MT,Musselshell County,2395,2334,61,2.5
CN3006700000000,2023-05-01,30,067,MT,Park County,10148,9900,248,2.4
CN3006900000000,2023-05-01,30,069,MT,Petroleum County,275,269,6,2.2
CN3007100000000,2023-05-01,30,071,MT,Phillips County,1853,1786,67,3.6
CN3007300000000,2023-05-01,30,073,MT,Pondera County,2694,2631,63,2.3
CN3007500000000,2023-05-01,30,075,MT,Powder River County,1017,999,18,1.8
CN3007700000000,2023-05-01,30,077,MT,Powell County,2951,2873,78,2.6
CN3007900000000,2023-05-01,30,079,MT,Prairie County,522,508,14,2.7
CN3008100000000,2023-05-01,30,081,MT,Ravalli County,22718,22166,552,2.4
CN3008300000000,2023-05-01,30,083,MT,Richland County,5806,5660,146,2.5
CN3008500000000,2023-05-01,30,085,MT,Roosevelt County,4404,4261,143,3.2
CN3008700000000,2023-05-01,30,087,MT,Rosebud County,3675,3579,96,2.6
CN3008900000000,2023-05-01,30,089,MT,Sanders County,5688,5479,209,3.7
CN3009100000000,2023-05-01,30,091,MT,Sheridan County,1755,1726,29,1.7
CN3009300000000,2023-05-01,30,093,MT,Silver Bow County,18017,17521,496,2.8
CN3009500000000,2023-05-01,30,095,MT,Stillwater County,5425,5305,120,2.2
CN3009700000000,2023-05-01,30,097,MT,Sweet Grass County,1923,1888,35,1.8
CN3009900000000,2023-05-01,30,099,MT,Teton County,2833,2766,67,2.4
CN3010100000000,2023-05-01,30,101,MT,Toole County,2107,2069,38,1.8
CN3010300000000,2023-05-01,30,103,MT,Treasure County,363,354,9,2.5
CN3010500000000,2023-05-01,30,105,MT,Valley County,4056,3979,77,1.9
CN3010700000000,2023-05-01,30,107,MT,Wheatland County,791,766,25,3.2
CN3010900000000,2023-05-01,30,109,MT,Wibaux County,468,457,11,2.4
CN3011100000000,2023-05-01,30,111,MT,Yellowstone County,87137,85234,1903,2.2
CN3100100000000,2023-05-01,31,001,NE,Adams County,17361,17044,317,1.8
CN3100300000000,2023-05-01,31,003,NE,Antelope County,3619,3559,60,1.7
CN3100500000000,2023-05-01,31,005,NE,Arthur County,220,213,7,3.2
CN3100700000000,2023-05-01,31,007,NE,Banner County,372,362,10,2.7
CN3100900000000,2023-05-01,31,009,NE,Blaine County,240,231,9,3.8
CN3101100000000,2023-05-01,31,011,NE,Boone County,2983,2942,41,1.4
CN3101300000000,2023-05-01,31,013,NE,Box Butte County,5332,5226,106,2
CN3101500000000,2023-05-01,31,015,NE,Boyd County,1001,982,19,1.9
CN3101700000000,2023-05-01,31,017,NE,Brown County,1391,1362,29,2.1
CN3101900000000,2023-05-01,31,019,NE,Buffalo County,28527,28036,491,1.7
CN3102100000000,2023-05-01,31,021,NE,Burt County,3570,3490,80,2.2
CN3102300000000,2023-05-01,31,023,NE,Butler County,4719,4647,72,1.5
CN3102500000000,2023-05-01,31,025,NE,Cass County,13796,13513,283,2.1
CN3102700000000,2023-05-01,31,027,NE,Cedar County,4698,4618,80,1.7
CN3102900000000,2023-05-01,31,029,NE,Chase County,2211,2179,32,1.4
CN3103100000000,2023-05-01,31,031,NE,Cherry County,3303,3238,65,2
CN3103300000000,2023-05-01,31,033,NE,Cheyenne County,4182,4099,83,2
CN3103500000000,2023-05-01,31,035,NE,Clay County,3005,2942,63,2.1
CN3103700000000,2023-05-01,31,037,NE,Colfax County,5762,5653,109,1.9
CN3103900000000,2023-05-01,31,039,NE,Cuming County,4824,4739,85,1.8
CN3104100000000,2023-05-01,31,041,NE,Custer County,6262,6156,106,1.7
CN3104300000000,2023-05-01,31,043,NE,Dakota County,11243,11018,225,2
CN3104500000000,2023-05-01,31,045,NE,Dawes County,4994,4894,100,2
CN3104700000000,2023-05-01,31,047,NE,Dawson County,13672,13372,300,2.2
CN3104900000000,2023-05-01,31,049,NE,Deuel County,1029,1010,19,1.8
CN3105100000000,2023-05-01,31,051,NE,Dixon County,3051,2991,60,2
CN3105300000000,2023-05-01,31,053,NE,Dodge County,21108,20665,443,2.1
CN3105500000000,2023-05-01,31,055,NE,Douglas County,310673,303505,7168,2.3
CN3105700000000,2023-05-01,31,057,NE,Dundy County,1148,1131,17,1.5
CN3105900000000,2023-05-01,31,059,NE,Fillmore County,3342,3282,60,1.8
CN3106100000000,2023-05-01,31,061,NE,Franklin County,1521,1489,32,2.1
CN3106300000000,2023-05-01,31,063,NE,Frontier County,1492,1461,31,2.1
CN3106500000000,2023-05-01,31,065,NE,Furnas County,2512,2468,44,1.8
CN3106700000000,2023-05-01,31,067,NE,Gage County,10890,10643,247,2.3
CN3106900000000,2023-05-01,31,069,NE,Garden County,1069,1047,22,2.1
CN3107100000000,2023-05-01,31,071,NE,Garfield County,1140,1121,19,1.7
CN3107300000000,2023-05-01,31,073,NE,Gosper County,1207,1183,24,2
CN3107500000000,2023-05-01,31,075,NE,Grant County,415,408,7,1.7
CN3107700000000,2023-05-01,31,077,NE,Greeley County,1229,1207,22,1.8
CN3107900000000,2023-05-01,31,079,NE,Hall County,33493,32801,692,2.1
CN3108100000000,2023-05-01,31,081,NE,Hamilton County,4947,4858,89,1.8
CN3108300000000,2023-05-01,31,083,NE,Harlan County,1880,1849,31,1.6
CN3108500000000,2023-05-01,31,085,NE,Hayes County,578,569,9,1.6
CN3108700000000,2023-05-01,31,087,NE,Hitchcock County,1309,1273,36,2.8
CN3108900000000,2023-05-01,31,089,NE,Holt County,5557,5474,83,1.5
CN3109100000000,2023-05-01,31,091,NE,Hooker County,412,403,9,2.2
CN3109300000000,2023-05-01,31,093,NE,Howard County,3520,3455,65,1.8
CN3109500000000,2023-05-01,31,095,NE,Jefferson County,4215,4149,66,1.6
CN3109700000000,2023-05-01,31,097,NE,Johnson County,2016,1967,49,2.4
CN3109900000000,2023-05-01,31,099,NE,Kearney County,3729,3671,58,1.6
CN3110100000000,2023-05-01,31,101,NE,Keith County,4668,4588,80,1.7
CN3110300000000,2023-05-01,31,103,NE,Keya Paha County,536,524,12,2.2
CN3110500000000,2023-05-01,31,105,NE,Kimball County,1938,1901,37,1.9
CN3110700000000,2023-05-01,31,107,NE,Knox County,4545,4465,80,1.8
CN3110900000000,2023-05-01,31,109,NE,Lancaster County,183823,180152,3671,2
CN3111100000000,2023-05-01,31,111,NE,Lincoln County,18475,18099,376,2
CN3111300000000,2023-05-01,31,113,NE,Logan County,471,461,10,2.1
CN3111500000000,2023-05-01,31,115,NE,Loup County,398,388,10,2.5
CN3111700000000,2023-05-01,31,117,NE,McPherson County,433,424,9,2.1
CN3111900000000,2023-05-01,31,119,NE,Madison County,19920,19545,375,1.9
CN3112100000000,2023-05-01,31,121,NE,Merrick County,4231,4151,80,1.9
CN3112300000000,2023-05-01,31,123,NE,Morrill County,2620,2560,60,2.3
CN3112500000000,2023-05-01,31,125,NE,Nance County,1947,1916,31,1.6
CN3112700000000,2023-05-01,31,127,NE,Nemaha County,3646,3566,80,2.2
CN3112900000000,2023-05-01,31,129,NE,Nuckolls County,2450,2407,43,1.8
CN3113100000000,2023-05-01,31,131,NE,Otoe County,8676,8523,153,1.8
CN3113300000000,2023-05-01,31,133,NE,Pawnee County,1460,1431,29,2
CN3113500000000,2023-05-01,31,135,NE,Perkins County,1809,1775,34,1.9
CN3113700000000,2023-05-01,31,137,NE,Phelps County,4991,4911,80,1.6
CN3113900000000,2023-05-01,31,139,NE,Pierce County,4193,4125,68,1.6
CN3114100000000,2023-05-01,31,141,NE,Platte County,18627,18300,327,1.8
CN3114300000000,2023-05-01,31,143,NE,Polk County,2858,2803,55,1.9
CN3114500000000,2023-05-01,31,145,NE,Red Willow County,5889,5773,116,2
CN3114700000000,2023-05-01,31,147,NE,Richardson County,4173,4095,78,1.9
CN3114900000000,2023-05-01,31,149,NE,Rock County,893,879,14,1.6
CN3115100000000,2023-05-01,31,151,NE,Saline County,7186,7040,146,2
CN3115300000000,2023-05-01,31,153,NE,Sarpy County,101428,99396,2032,2
CN3115500000000,2023-05-01,31,155,NE,Saunders County,11576,11377,199,1.7
CN3115700000000,2023-05-01,31,157,NE,Scotts Bluff County,17768,17335,433,2.4
CN3115900000000,2023-05-01,31,159,NE,Seward County,8929,8755,174,1.9
CN3116100000000,2023-05-01,31,161,NE,Sheridan County,2757,2699,58,2.1
CN3116300000000,2023-05-01,31,163,NE,Sherman County,1646,1612,34,2.1
CN3116500000000,2023-05-01,31,165,NE,Sioux County,736,719,17,2.3
CN3116700000000,2023-05-01,31,167,NE,Stanton County,3522,3461,61,1.7
CN3116900000000,2023-05-01,31,169,NE,Thayer County,2705,2662,43,1.6
CN3117100000000,2023-05-01,31,171,NE,Thomas County,433,418,15,3.5
CN3117300000000,2023-05-01,31,173,NE,Thurston County,3286,3197,89,2.7
CN3117500000000,2023-05-01,31,175,NE,Valley County,2105,2068,37,1.8
CN3117700000000,2023-05-01,31,177,NE,Washington County,11632,11399,233,2
CN3117900000000,2023-05-01,31,179,NE,Wayne County,5768,5647,121,2.1
CN3118100000000,2023-05-01,31,181,NE,Webster County,1665,1622,43,2.6
CN3118300000000,2023-05-01,31,183,NE,Wheeler County,537,528,9,1.7
CN3118500000000,2023-05-01,31,185,NE,York County,7415,7265,150,2
CN3200100000000,2023-05-01,32,001,NV,Churchill County,10972,10497,475,4.3
CN3200300000000,2023-05-01,32,003,NV,Clark County,1170248,1104682,65566,5.6
CN3200500000000,2023-05-01,32,005,NV,Douglas County,22728,21716,1012,4.5
CN3200700000000,2023-05-01,32,007,NV,Elko County,26119,25144,975,3.7
CN3200900000000,2023-05-01,32,009,NV,Esmeralda County,405,387,18,4.4
CN3201100000000,2023-05-01,32,011,NV,Eureka County,1020,984,36,3.5
CN3201300000000,2023-05-01,32,013,NV,Humboldt County,7800,7501,299,3.8
CN3201500000000,2023-05-01,32,015,NV,Lander County,3113,2998,115,3.7
CN3201700000000,2023-05-01,32,017,NV,Lincoln County,2098,2000,98,4.7
CN3201900000000,2023-05-01,32,019,NV,Lyon County,23919,22555,1364,5.7
CN3202100000000,2023-05-01,32,021,NV,Mineral County,2010,1901,109,5.4
CN3202300000000,2023-05-01,32,023,NV,Nye County,18182,16961,1221,6.7
CN3202700000000,2023-05-01,32,027,NV,Pershing County,2420,2310,110,4.5
CN3202900000000,2023-05-01,32,029,NV,Storey County,2139,2041,98,4.6
CN3203100000000,2023-05-01,32,031,NV,Washoe County,263094,252301,10793,4.1
CN3203300000000,2023-05-01,32,033,NV,White Pine County,4570,4407,163,3.6
CN3251000000000,2023-05-01,32,510,NV,Carson City,26012,24862,1150,4.4
CN3300100000000,2023-05-01,33,001,NH,Belknap County,30293,29831,462,1.5
CN3300300000000,2023-05-01,33,003,NH,Carroll County,22447,22099,348,1.6
CN3300500000000,2023-05-01,33,005,NH,Cheshire County,38200,37584,616,1.6
CN3300700000000,2023-05-01,33,007,NH,Coos County,13514,13245,269,2
CN3300900000000,2023-05-01,33,009,NH,Grafton County,46689,46037,652,1.4
CN3301100000000,2023-05-01,33,011,NH,Hillsborough County,238302,234533,3769,1.6
CN3301300000000,2023-05-01,33,013,NH,Merrimack County,80995,79940,1055,1.3
CN3301500000000,2023-05-01,33,015,NH,Rockingham County,185859,182910,2949,1.6
CN3301700000000,2023-05-01,33,017,NH,Strafford County,73519,72480,1039,1.4
CN3301900000000,2023-05-01,33,019,NH,Sullivan County,22295,22003,292,1.3
CN3400100000000,2023-05-01,34,001,NJ,Atlantic County,126252,119942,6310,5
CN3400300000000,2023-05-01,34,003,NJ,Bergen County,513077,495731,17346,3.4
CN3400500000000,2023-05-01,34,005,NJ,Burlington County,254294,245604,8690,3.4
CN3400700000000,2023-05-01,34,007,NJ,Camden County,278341,266520,11821,4.2
CN3400900000000,2023-05-01,34,009,NJ,Cape May County,49087,46056,3031,6.2
CN3401100000000,2023-05-01,34,011,NJ,Cumberland County,70920,67055,3865,5.4
CN3401300000000,2023-05-01,34,013,NJ,Essex County,397541,378017,19524,4.9
CN3401500000000,2023-05-01,34,015,NJ,Gloucester County,165518,159423,6095,3.7
CN3401700000000,2023-05-01,34,017,NJ,Hudson County,385224,370281,14943,3.9
CN3401900000000,2023-05-01,34,019,NJ,Hunterdon County,69417,67303,2114,3
CN3402100000000,2023-05-01,34,021,NJ,Mercer County,223578,216202,7376,3.3
CN3402300000000,2023-05-01,34,023,NJ,Middlesex County,475016,458141,16875,3.6
CN3402500000000,2023-05-01,34,025,NJ,Monmouth County,355425,343564,11861,3.3
CN3402700000000,2023-05-01,34,027,NJ,Morris County,274465,265702,8763,3.2
CN3402900000000,2023-05-01,34,029,NJ,Ocean County,304389,293312,11077,3.6
CN3403100000000,2023-05-01,34,031,NJ,Passaic County,258295,245853,12442,4.8
CN3403300000000,2023-05-01,34,033,NJ,Salem County,31511,29999,1512,4.8
CN3403500000000,2023-05-01,34,035,NJ,Somerset County,183318,177238,6080,3.3
CN3403700000000,2023-05-01,34,037,NJ,Sussex County,78981,76121,2860,3.6
CN3403900000000,2023-05-01,34,039,NJ,Union County,296368,284040,12328,4.2
CN3404100000000,2023-05-01,34,041,NJ,Warren County,59738,57713,2025,3.4
CN3500100000000,2023-05-01,35,001,NM,Bernalillo County,337394,327235,10159,3
CN3500300000000,2023-05-01,35,003,NM,Catron County,1095,1049,46,4.2
CN3500500000000,2023-05-01,35,005,NM,Chaves County,27313,26395,918,3.4
CN3500600000000,2023-05-01,35,006,NM,Cibola County,8208,7842,366,4.5
CN3500700000000,2023-05-01,35,007,NM,Colfax County,5133,4965,168,3.3
CN3500900000000,2023-05-01,35,009,NM,Curry County,22145,21584,561,2.5
CN3501100000000,2023-05-01,35,011,NM,De Baca County,727,705,22,3
CN3501300000000,2023-05-01,35,013,NM,Dona Ana County,101318,97107,4211,4.2
CN3501500000000,2023-05-01,35,015,NM,Eddy County,32010,31253,757,2.4
CN3501700000000,2023-05-01,35,017,NM,Grant County,11845,11487,358,3
CN3501900000000,2023-05-01,35,019,NM,Guadalupe County,1414,1363,51,3.6
CN3502100000000,2023-05-01,35,021,NM,Harding County,283,274,9,3.2
CN3502300000000,2023-05-01,35,023,NM,Hidalgo County,1885,1833,52,2.8
CN3502500000000,2023-05-01,35,025,NM,Lea County,29671,28718,953,3.2
CN3502700000000,2023-05-01,35,027,NM,Lincoln County,8572,8316,256,3
CN3502800000000,2023-05-01,35,028,NM,Los Alamos County,10951,10767,184,1.7
CN3502900000000,2023-05-01,35,029,NM,Luna County,10064,9046,1018,10.1
CN3503100000000,2023-05-01,35,031,NM,McKinley County,24175,23152,1023,4.2
CN3503300000000,2023-05-01,35,033,NM,Mora County,1985,1905,80,4
CN3503500000000,2023-05-01,35,035,NM,Otero County,25654,24760,894,3.5
CN3503700000000,2023-05-01,35,037,NM,Quay County,2960,2852,108,3.6
CN3503900000000,2023-05-01,35,039,NM,Rio Arriba County,16407,15899,508,3.1
CN3504100000000,2023-05-01,35,041,NM,Roosevelt County,8530,8278,252,3
CN3504300000000,2023-05-01,35,043,NM,Sandoval County,68137,65981,2156,3.2
CN3504500000000,2023-05-01,35,045,NM,San Juan County,49667,47784,1883,3.8
CN3504700000000,2023-05-01,35,047,NM,San Miguel County,10814,10381,433,4
CN3504900000000,2023-05-01,35,049,NM,Santa Fe County,71808,69744,2064,2.9
CN3505100000000,2023-05-01,35,051,NM,Sierra County,3804,3553,251,6.6
CN3505300000000,2023-05-01,35,053,NM,Socorro County,6059,5825,234,3.9
CN3505500000000,2023-05-01,35,055,NM,Taos County,14773,14129,644,4.4
CN3505700000000,2023-05-01,35,057,NM,Torrance County,5320,5083,237,4.5
CN3505900000000,2023-05-01,35,059,NM,Union County,1514,1471,43,2.8
CN3506100000000,2023-05-01,35,061,NM,Valencia County,31024,29886,1138,3.7
CN3600100000000,2023-05-01,36,001,NY,Albany County,160801,156384,4417,2.7
CN3600300000000,2023-05-01,36,003,NY,Allegany County,19213,18551,662,3.4
CN3600500000000,2023-05-01,36,005,NY,Bronx County,610900,569745,41155,6.7
CN3600700000000,2023-05-01,36,007,NY,Broome County,82555,79982,2573,3.1
CN3600900000000,2023-05-01,36,009,NY,Cattaraugus County,32696,31552,1144,3.5
CN3601100000000,2023-05-01,36,011,NY,Cayuga County,35323,34315,1008,2.9
CN3601300000000,2023-05-01,36,013,NY,Chautauqua County,54544,52702,1842,3.4
CN3601500000000,2023-05-01,36,015,NY,Chemung County,34554,33393,1161,3.4
CN3601700000000,2023-05-01,36,017,NY,Chenango County,21765,21186,579,2.7
CN3601900000000,2023-05-01,36,019,NY,Clinton County,34362,33336,1026,3
CN3602100000000,2023-05-01,36,021,NY,Columbia County,30294,29564,730,2.4
CN3602300000000,2023-05-01,36,023,NY,Cortland County,22924,22208,716,3.1
CN3602500000000,2023-05-01,36,025,NY,Delaware County,18482,17903,579,3.1
CN3602700000000,2023-05-01,36,027,NY,Dutchess County,144753,140743,4010,2.8
CN3602900000000,2023-05-01,36,029,NY,Erie County,450013,436191,13822,3.1
CN3603100000000,2023-05-01,36,031,NY,Essex County,15825,15323,502,3.2
CN3603300000000,2023-05-01,36,033,NY,Franklin County,18429,17842,587,3.2
CN3603500000000,2023-05-01,36,035,NY,Fulton County,22317,21514,803,3.6
CN3603700000000,2023-05-01,36,037,NY,Genesee County,30001,29248,753,2.5
CN3603900000000,2023-05-01,36,039,NY,Greene County,19933,19267,666,3.3
CN3604100000000,2023-05-01,36,041,NY,Hamilton County,2109,2016,93,4.4
CN3604300000000,2023-05-01,36,043,NY,Herkimer County,27256,26381,875,3.2
CN3604500000000,2023-05-01,36,045,NY,Jefferson County,44456,42929,1527,3.4
CN3604700000000,2023-05-01,36,047,NY,Kings County,1230134,1163572,66562,5.4
CN3604900000000,2023-05-01,36,049,NY,Lewis County,11526,11137,389,3.4
CN3605100000000,2023-05-01,36,051,NY,Livingston County,30554,29686,868,2.8
CN3605300000000,2023-05-01,36,053,NY,Madison County,33131,32193,938,2.8
CN3605500000000,2023-05-01,36,055,NY,Monroe County,368450,357360,11090,3
CN3605700000000,2023-05-01,36,057,NY,Montgomery County,22208,21364,844,3.8
CN3605900000000,2023-05-01,36,059,NY,Nassau County,736237,716916,19321,2.6
CN3606100000000,2023-05-01,36,061,NY,New York County,938974,896557,42417,4.5
CN3606300000000,2023-05-01,36,063,NY,Niagara County,99263,96044,3219,3.2
CN3606500000000,2023-05-01,36,065,NY,Oneida County,100098,96991,3107,3.1
CN3606700000000,2023-05-01,36,067,NY,Onondaga County,226301,219823,6478,2.9
CN3606900000000,2023-05-01,36,069,NY,Ontario County,56343,54857,1486,2.6
CN3607100000000,2023-05-01,36,071,NY,Orange County,192778,187208,5570,2.9
CN3607300000000,2023-05-01,36,073,NY,Orleans County,17293,16754,539,3.1
CN3607500000000,2023-05-01,36,075,NY,Oswego County,53282,51433,1849,3.5
CN3607700000000,2023-05-01,36,077,NY,Otsego County,26654,25884,770,2.9
CN3607900000000,2023-05-01,36,079,NY,Putnam County,51364,50012,1352,2.6
CN3608100000000,2023-05-01,36,081,NY,Queens County,1158695,1106229,52466,4.5
CN3608300000000,2023-05-01,36,083,NY,Rensselaer County,82821,80602,2219,2.7
CN3608500000000,2023-05-01,36,085,NY,Richmond County,230927,219914,11013,4.8
CN3608700000000,2023-05-01,36,087,NY,Rockland County,160983,156881,4102,2.5
CN3608900000000,2023-05-01,36,089,NY,St. Lawrence County,42162,40636,1526,3.6
CN3609100000000,2023-05-01,36,091,NY,Saratoga County,122559,119673,2886,2.4
CN3609300000000,2023-05-01,36,093,NY,Schenectady County,78484,76215,2269,2.9
CN3609500000000,2023-05-01,36,095,NY,Schoharie County,14870,14383,487,3.3
CN3609700000000,2023-05-01,36,097,NY,Schuyler County,8002,7765,237,3
CN3609900000000,2023-05-01,36,099,NY,Seneca County,14735,14332,403,2.7
CN3610100000000,2023-05-01,36,101,NY,Steuben County,40827,39453,1374,3.4
CN3610300000000,2023-05-01,36,103,NY,Suffolk County,808023,785508,22515,2.8
CN3610500000000,2023-05-01,36,105,NY,Sullivan County,37391,36359,1032,2.8
CN3610700000000,2023-05-01,36,107,NY,Tioga County,22371,21776,595,2.7
CN3610900000000,2023-05-01,36,109,NY,Tompkins County,51061,49787,1274,2.5
CN3611100000000,2023-05-01,36,111,NY,Ulster County,88083,85600,2483,2.8
CN3611300000000,2023-05-01,36,113,NY,Warren County,31424,30492,932,3
CN3611500000000,2023-05-01,36,115,NY,Washington County,27640,26894,746,2.7
CN3611700000000,2023-05-01,36,117,NY,Wayne County,43823,42663,1160,2.6
CN3611900000000,2023-05-01,36,119,NY,Westchester County,500892,486849,14043,2.8
CN3612100000000,2023-05-01,36,121,NY,Wyoming County,17458,16979,479,2.7
CN3612300000000,2023-05-01,36,123,NY,Yates County,11702,11425,277,2.4
CN3700100000000,2023-05-01,37,001,NC,Alamance County,84272,81354,2918,3.5
CN3700300000000,2023-05-01,37,003,NC,Alexander County,18309,17760,549,3
CN3700500000000,2023-05-01,37,005,NC,Alleghany County,4785,4576,209,4.4
CN3700700000000,2023-05-01,37,007,NC,Anson County,10415,10000,415,4
CN3700900000000,2023-05-01,37,009,NC,Ashe County,12957,12578,379,2.9
CN3701100000000,2023-05-01,37,011,NC,Avery County,7945,7711,234,2.9
CN3701300000000,2023-05-01,37,013,NC,Beaufort County,20210,19400,810,4
CN3701500000000,2023-05-01,37,015,NC,Bertie County,7033,6725,308,4.4
CN3701700000000,2023-05-01,37,017,NC,Bladen County,14842,14226,616,4.2
CN3701900000000,2023-05-01,37,019,NC,Brunswick County,59659,57252,2407,4
CN3702100000000,2023-05-01,37,021,NC,Buncombe County,144746,140872,3874,2.7
CN3702300000000,2023-05-01,37,023,NC,Burke County,41463,40064,1399,3.4
CN3702500000000,2023-05-01,37,025,NC,Cabarrus County,118962,115204,3758,3.2
CN3702700000000,2023-05-01,37,027,NC,Caldwell County,36848,35604,1244,3.4
CN3702900000000,2023-05-01,37,029,NC,Camden County,4761,4608,153,3.2
CN3703100000000,2023-05-01,37,031,NC,Carteret County,32621,31579,1042,3.2
CN3703300000000,2023-05-01,37,033,NC,Caswell County,9738,9398,340,3.5
CN3703500000000,2023-05-01,37,035,NC,Catawba County,80399,77772,2627,3.3
CN3703700000000,2023-05-01,37,037,NC,Chatham County,38227,37109,1118,2.9
CN3703900000000,2023-05-01,37,039,NC,Cherokee County,11263,10843,420,3.7
CN3704100000000,2023-05-01,37,041,NC,Chowan County,5952,5730,222,3.7
CN3704300000000,2023-05-01,37,043,NC,Clay County,4300,4144,156,3.6
CN3704500000000,2023-05-01,37,045,NC,Cleveland County,49735,48015,1720,3.5
CN3704700000000,2023-05-01,37,047,NC,Columbus County,24498,23625,873,3.6
CN3704900000000,2023-05-01,37,049,NC,Craven County,42461,40966,1495,3.5
CN3705100000000,2023-05-01,37,051,NC,Cumberland County,127476,121409,6067,4.8
CN3705300000000,2023-05-01,37,053,NC,Currituck County,14792,14349,443,3
CN3705500000000,2023-05-01,37,055,NC,Dare County,20471,19765,706,3.4
CN3705700000000,2023-05-01,37,057,NC,Davidson County,82967,80271,2696,3.2
CN3705900000000,2023-05-01,37,059,NC,Davie County,21195,20536,659,3.1
CN3706100000000,2023-05-01,37,061,NC,Duplin County,25667,24801,866,3.4
CN3706300000000,2023-05-01,37,063,NC,Durham County,182225,176626,5599,3.1
CN3706500000000,2023-05-01,37,065,NC,Edgecombe County,20313,19194,1119,5.5
CN3706700000000,2023-05-01,37,067,NC,Forsyth County,192033,185362,6671,3.5
CN3706900000000,2023-05-01,37,069,NC,Franklin County,34658,33436,1222,3.5
CN3707100000000,2023-05-01,37,071,NC,Gaston County,117292,113374,3918,3.3
CN3707300000000,2023-05-01,37,073,NC,Gates County,5219,5041,178,3.4
CN3707500000000,2023-05-01,37,075,NC,Graham County,2933,2807,126,4.3
CN3707700000000,2023-05-01,37,077,NC,Granville County,30585,29672,913,3
CN3707900000000,2023-05-01,37,079,NC,Greene County,9830,9541,289,2.9
CN3708100000000,2023-05-01,37,081,NC,Guilford County,263815,253567,10248,3.9
CN3708300000000,2023-05-01,37,083,NC,Halifax County,19181,18220,961,5
CN3708500000000,2023-05-01,37,085,NC,Harnett County,55679,53492,2187,3.9
CN3708700000000,2023-05-01,37,087,NC,Haywood County,30808,29915,893,2.9
CN3708900000000,2023-05-01,37,089,NC,Henderson County,56752,55107,1645,2.9
CN3709100000000,2023-05-01,37,091,NC,Hertford County,8436,8029,407,4.8
CN3709300000000,2023-05-01,37,093,NC,Hoke County,20287,19386,901,4.4
CN3709500000000,2023-05-01,37,095,NC,Hyde County,1847,1761,86,4.7
CN3709700000000,2023-05-01,37,097,NC,Iredell County,96996,93927,3069,3.2
CN3709900000000,2023-05-01,37,099,NC,Jackson County,19797,19050,747,3.8
CN3710100000000,2023-05-01,37,101,NC,Johnston County,110362,106840,3522,3.2
CN3710300000000,2023-05-01,37,103,NC,Jones County,4442,4296,146,3.3
CN3710500000000,2023-05-01,37,105,NC,Lee County,26133,25127,1006,3.8
CN3710700000000,2023-05-01,37,107,NC,Lenoir County,27601,26650,951,3.4
CN3710900000000,2023-05-01,37,109,NC,Lincoln County,47584,46163,1421,3
CN3711100000000,2023-05-01,37,111,NC,McDowell County,20453,19783,670,3.3
CN3711300000000,2023-05-01,37,113,NC,Macon County,16362,15851,511,3.1
CN3711500000000,2023-05-01,37,115,NC,Madison County,10313,9973,340,3.3
CN3711700000000,2023-05-01,37,117,NC,Martin County,8684,8307,377,4.3
CN3711900000000,2023-05-01,37,119,NC,Mecklenburg County,667461,645632,21829,3.3
CN3712100000000,2023-05-01,37,121,NC,Mitchell County,6099,5880,219,3.6
CN3712300000000,2023-05-01,37,123,NC,Montgomery County,11218,10814,404,3.6
CN3712500000000,2023-05-01,37,125,NC,Moore County,42397,40869,1528,3.6
CN3712700000000,2023-05-01,37,127,NC,Nash County,42554,40650,1904,4.5
CN3712900000000,2023-05-01,37,129,NC,New Hanover County,133004,128921,4083,3.1
CN3713100000000,2023-05-01,37,131,NC,Northampton County,7288,6959,329,4.5
CN3713300000000,2023-05-01,37,133,NC,Onslow County,70586,67792,2794,4
CN3713500000000,2023-05-01,37,135,NC,Orange County,83046,80565,2481,3
CN3713700000000,2023-05-01,37,137,NC,Pamlico County,5570,5391,179,3.2
CN3713900000000,2023-05-01,37,139,NC,Pasquotank County,16896,16228,668,4
CN3714100000000,2023-05-01,37,141,NC,Pender County,31712,30707,1005,3.2
CN3714300000000,2023-05-01,37,143,NC,Perquimans County,5074,4879,195,3.8
CN3714500000000,2023-05-01,37,145,NC,Person County,19203,18527,676,3.5
CN3714700000000,2023-05-01,37,147,NC,Pitt County,89627,86067,3560,4
CN3714900000000,2023-05-01,37,149,NC,Polk County,9457,9132,325,3.4
CN3715100000000,2023-05-01,37,151,NC,Randolph County,66518,64182,2336,3.5
CN3715300000000,2023-05-01,37,153,NC,Richmond County,17092,16328,764,4.5
CN3715500000000,2023-05-01,37,155,NC,Robeson County,48153,45763,2390,5
CN3715700000000,2023-05-01,37,157,NC,Rockingham County,40074,38538,1536,3.8
CN3715900000000,2023-05-01,37,159,NC,Rowan County,69406,67096,2310,3.3
CN3716100000000,2023-05-01,37,161,NC,Rutherford County,24786,23698,1088,4.4
CN3716300000000,2023-05-01,37,163,NC,Sampson County,30064,29067,997,3.3
CN3716500000000,2023-05-01,37,165,NC,Scotland County,11277,10565,712,6.3
CN3716700000000,2023-05-01,37,167,NC,Stanly County,31169,30216,953,3.1
CN3716900000000,2023-05-01,37,169,NC,Stokes County,22072,21388,684,3.1
CN3717100000000,2023-05-01,37,171,NC,Surry County,32931,31874,1057,3.2
CN3717300000000,2023-05-01,37,173,NC,Swain County,7210,7009,201,2.8
CN3717500000000,2023-05-01,37,175,NC,Transylvania County,14851,14362,489,3.3
CN3717700000000,2023-05-01,37,177,NC,Tyrrell County,1385,1321,64,4.6
CN3717900000000,2023-05-01,37,179,NC,Union County,133748,129764,3984,3
CN3718100000000,2023-05-01,37,181,NC,Vance County,16759,15860,899,5.4
CN3718300000000,2023-05-01,37,183,NC,Wake County,642737,623380,19357,3
CN3718500000000,2023-05-01,37,185,NC,Warren County,6488,6150,338,5.2
CN3718700000000,2023-05-01,37,187,NC,Washington County,4326,4117,209,4.8
CN3718900000000,2023-05-01,37,189,NC,Watauga County,29059,28119,940,3.2
CN3719100000000,2023-05-01,37,191,NC,Wayne County,51863,49923,1940,3.7
CN3719300000000,2023-05-01,37,193,NC,Wilkes County,26882,25866,1016,3.8
CN3719500000000,2023-05-01,37,195,NC,Wilson County,33916,32232,1684,5
CN3719700000000,2023-05-01,37,197,NC,Yadkin County,18068,17508,560,3.1
CN3719900000000,2023-05-01,37,199,NC,Yancey County,8305,8033,272,3.3
CN3800100000000,2023-05-01,38,001,ND,Adams County,953,933,20,2.1
CN3800300000000,2023-05-01,38,003,ND,Barnes County,5290,5181,109,2.1
CN3800500000000,2023-05-01,38,005,ND,Benson County,2365,2299,66,2.8
CN3800700000000,2023-05-01,38,007,ND,Billings County,472,463,9,1.9
CN3800900000000,2023-05-01,38,009,ND,Bottineau County,3143,3078,65,2.1
CN3801100000000,2023-05-01,38,011,ND,Bowman County,1555,1530,25,1.6
CN3801300000000,2023-05-01,38,013,ND,Burke County,1072,1051,21,2
CN3801500000000,2023-05-01,38,015,ND,Burleigh County,52102,51155,947,1.8
CN3801700000000,2023-05-01,38,017,ND,Cass County,112116,110164,1952,1.7
CN3801900000000,2023-05-01,38,019,ND,Cavalier County,1882,1838,44,2.3
CN3802100000000,2023-05-01,38,021,ND,Dickey County,2269,2228,41,1.8
CN3802300000000,2023-05-01,38,023,ND,Divide County,1451,1429,22,1.5
CN3802500000000,2023-05-01,38,025,ND,Dunn County,3299,3261,38,1.2
CN3802700000000,2023-05-01,38,027,ND,Eddy County,1215,1186,29,2.4
CN3802900000000,2023-05-01,38,029,ND,Emmons County,1500,1439,61,4.1
CN3803100000000,2023-05-01,38,031,ND,Foster County,1561,1532,29,1.9
CN3803300000000,2023-05-01,38,033,ND,Golden Valley County,861,846,15,1.7
CN3803500000000,2023-05-01,38,035,ND,Grand Forks County,38422,37741,681,1.8
CN3803700000000,2023-05-01,38,037,ND,Grant County,1257,1236,21,1.7
CN3803900000000,2023-05-01,38,039,ND,Griggs County,1057,1035,22,2.1
CN3804100000000,2023-05-01,38,041,ND,Hettinger County,1423,1401,22,1.5
CN3804300000000,2023-05-01,38,043,ND,Kidder County,1345,1306,39,2.9
CN3804500000000,2023-05-01,38,045,ND,LaMoure County,2210,2169,41,1.9
CN3804700000000,2023-05-01,38,047,ND,Logan County,869,847,22,2.5
CN3804900000000,2023-05-01,38,049,ND,McHenry County,3198,3120,78,2.4
CN3805100000000,2023-05-01,38,051,ND,McIntosh County,1066,1047,19,1.8
CN3805300000000,2023-05-01,38,053,ND,McKenzie County,9780,9645,135,1.4
CN3805500000000,2023-05-01,38,055,ND,McLean County,4908,4801,107,2.2
CN3805700000000,2023-05-01,38,057,ND,Mercer County,3800,3715,85,2.2
CN3805900000000,2023-05-01,38,059,ND,Morton County,17124,16752,372,2.2
CN3806100000000,2023-05-01,38,061,ND,Mountrail County,6559,6466,93,1.4
CN3806300000000,2023-05-01,38,063,ND,Nelson County,1507,1474,33,2.2
CN3806500000000,2023-05-01,38,065,ND,Oliver County,881,857,24,2.7
CN3806700000000,2023-05-01,38,067,ND,Pembina County,3221,3137,84,2.6
CN3806900000000,2023-05-01,38,069,ND,Pierce County,1727,1684,43,2.5
CN3807100000000,2023-05-01,38,071,ND,Ramsey County,5829,5707,122,2.1
CN3807300000000,2023-05-01,38,073,ND,Ransom County,2703,2657,46,1.7
CN3807500000000,2023-05-01,38,075,ND,Renville County,1241,1220,21,1.7
CN3807700000000,2023-05-01,38,077,ND,Richland County,9088,8930,158,1.7
CN3807900000000,2023-05-01,38,079,ND,Rolette County,4793,4597,196,4.1
CN3808100000000,2023-05-01,38,081,ND,Sargent County,2328,2291,37,1.6
CN3808300000000,2023-05-01,38,083,ND,Sheridan County,667,650,17,2.5
CN3808500000000,2023-05-01,38,085,ND,Sioux County,1232,1195,37,3
CN3808700000000,2023-05-01,38,087,ND,Slope County,336,327,9,2.7
CN3808900000000,2023-05-01,38,089,ND,Stark County,18540,18233,307,1.7
CN3809100000000,2023-05-01,38,091,ND,Steele County,951,926,25,2.6
CN3809300000000,2023-05-01,38,093,ND,Stutsman County,10924,10720,204,1.9
CN3809500000000,2023-05-01,38,095,ND,Towner County,1171,1146,25,2.1
CN3809700000000,2023-05-01,38,097,ND,Traill County,4641,4561,80,1.7
CN3809900000000,2023-05-01,38,099,ND,Walsh County,5357,5213,144,2.7
CN3810100000000,2023-05-01,38,101,ND,Ward County,32631,31930,701,2.1
CN3810300000000,2023-05-01,38,103,ND,Wells County,1947,1900,47,2.4
CN3810500000000,2023-05-01,38,105,ND,Williams County,23397,23003,394,1.7
CN3900100000000,2023-05-01,39,001,OH,Adams County,11328,10857,471,4.2
CN3900300000000,2023-05-01,39,003,OH,Allen County,46694,44950,1744,3.7
CN3900500000000,2023-05-01,39,005,OH,Ashland County,26076,25273,803,3.1
CN3900700000000,2023-05-01,39,007,OH,Ashtabula County,44113,42557,1556,3.5
CN3900900000000,2023-05-01,39,009,OH,Athens County,25617,24536,1081,4.2
CN3901100000000,2023-05-01,39,011,OH,Auglaize County,24526,23898,628,2.6
CN3901300000000,2023-05-01,39,013,OH,Belmont County,27112,26028,1084,4
CN3901500000000,2023-05-01,39,015,OH,Brown County,19944,19224,720,3.6
CN3901700000000,2023-05-01,39,017,OH,Butler County,203227,197110,6117,3
CN3901900000000,2023-05-01,39,019,OH,Carroll County,12787,12344,443,3.5
CN3902100000000,2023-05-01,39,021,OH,Champaign County,19662,19109,553,2.8
CN3902300000000,2023-05-01,39,023,OH,Clark County,64268,62147,2121,3.3
CN3902500000000,2023-05-01,39,025,OH,Clermont County,111116,107873,3243,2.9
CN3902700000000,2023-05-01,39,027,OH,Clinton County,18373,17732,641,3.5
CN3902900000000,2023-05-01,39,029,OH,Columbiana County,45238,43493,1745,3.9
CN3903100000000,2023-05-01,39,031,OH,Coshocton County,13939,13336,603,4.3
CN3903300000000,2023-05-01,39,033,OH,Crawford County,17983,17285,698,3.9
CN3903500000000,2023-05-01,39,035,OH,Cuyahoga County,605991,581225,24766,4.1
CN3903700000000,2023-05-01,39,037,OH,Darke County,26019,25272,747,2.9
CN3903900000000,2023-05-01,39,039,OH,Defiance County,17389,16828,561,3.2
CN3904100000000,2023-05-01,39,041,OH,Delaware County,118175,114969,3206,2.7
CN3904300000000,2023-05-01,39,043,OH,Erie County,37838,36337,1501,4
CN3904500000000,2023-05-01,39,045,OH,Fairfield County,82103,79682,2421,2.9
CN3904700000000,2023-05-01,39,047,OH,Fayette County,13825,13361,464,3.4
CN3904900000000,2023-05-01,39,049,OH,Franklin County,724887,702741,22146,3.1
CN3905100000000,2023-05-01,39,051,OH,Fulton County,21929,21231,698,3.2
CN3905300000000,2023-05-01,39,053,OH,Gallia County,12456,11973,483,3.9
CN3905500000000,2023-05-01,39,055,OH,Geauga County,48585,47048,1537,3.2
CN3905700000000,2023-05-01,39,057,OH,Greene County,84163,81550,2613,3.1
CN3905900000000,2023-05-01,39,059,OH,Guernsey County,18035,17354,681,3.8
CN3906100000000,2023-05-01,39,061,OH,Hamilton County,429914,416633,13281,3.1
CN3906300000000,2023-05-01,39,063,OH,Hancock County,40753,39624,1129,2.8
CN3906500000000,2023-05-01,39,065,OH,Hardin County,13227,12741,486,3.7
CN3906700000000,2023-05-01,39,067,OH,Harrison County,6523,6273,250,3.8
CN3906900000000,2023-05-01,39,069,OH,Henry County,12931,12487,444,3.4
CN3907100000000,2023-05-01,39,071,OH,Highland County,17606,16919,687,3.9
CN3907300000000,2023-05-01,39,073,OH,Hocking County,13172,12729,443,3.4
CN3907500000000,2023-05-01,39,075,OH,Holmes County,22269,21737,532,2.4
CN3907700000000,2023-05-01,39,077,OH,Huron County,28628,27650,978,3.4
CN3907900000000,2023-05-01,39,079,OH,Jackson County,12674,12163,511,4
CN3908100000000,2023-05-01,39,081,OH,Jefferson County,27046,25852,1194,4.4
CN3908300000000,2023-05-01,39,083,OH,Knox County,31795,30875,920,2.9
CN3908500000000,2023-05-01,39,085,OH,Lake County,125947,121660,4287,3.4
CN3908700000000,2023-05-01,39,087,OH,Lawrence County,23583,22641,942,4
CN3908900000000,2023-05-01,39,089,OH,Licking County,93921,91191,2730,2.9
CN3909100000000,2023-05-01,39,091,OH,Logan County,23206,22554,652,2.8
CN3909300000000,2023-05-01,39,093,OH,Lorain County,155183,149184,5999,3.9
CN3909500000000,2023-05-01,39,095,OH,Lucas County,205870,197414,8456,4.1
CN3909700000000,2023-05-01,39,097,OH,Madison County,21561,20962,599,2.8
CN3909900000000,2023-05-01,39,099,OH,Mahoning County,99366,95425,3941,4
CN3910100000000,2023-05-01,39,101,OH,Marion County,27735,26849,886,3.2
CN3910300000000,2023-05-01,39,103,OH,Medina County,98713,95576,3137,3.2
CN3910500000000,2023-05-01,39,105,OH,Meigs County,8628,8231,397,4.6
CN3910700000000,2023-05-01,39,107,OH,Mercer County,23326,22831,495,2.1
CN3910900000000,2023-05-01,39,109,OH,Miami County,54768,53119,1649,3
CN3911100000000,2023-05-01,39,111,OH,Monroe County,5213,4966,247,4.7
CN3911300000000,2023-05-01,39,113,OH,Montgomery County,251642,242479,9163,3.6
CN3911500000000,2023-05-01,39,115,OH,Morgan County,7075,6831,244,3.4
CN3911700000000,2023-05-01,39,117,OH,Morrow County,17325,16781,544,3.1
CN3911900000000,2023-05-01,39,119,OH,Muskingum County,41570,40108,1462,3.5
CN3912100000000,2023-05-01,39,121,OH,Noble County,4612,4424,188,4.1
CN3912300000000,2023-05-01,39,123,OH,Ottawa County,21445,20633,812,3.8
CN3912500000000,2023-05-01,39,125,OH,Paulding County,8923,8656,267,3
CN3912700000000,2023-05-01,39,127,OH,Perry County,16275,15709,566,3.5
CN3912900000000,2023-05-01,39,129,OH,Pickaway County,27403,26566,837,3.1
CN3913100000000,2023-05-01,39,131,OH,Pike County,11511,11034,477,4.1
CN3913300000000,2023-05-01,39,133,OH,Portage County,86137,83395,2742,3.2
CN3913500000000,2023-05-01,39,135,OH,Preble County,22323,21671,652,2.9
CN3913700000000,2023-05-01,39,137,OH,Putnam County,19350,18903,447,2.3
CN3913900000000,2023-05-01,39,139,OH,Richland County,50983,49039,1944,3.8
CN3914100000000,2023-05-01,39,141,OH,Ross County,36240,35108,1132,3.1
CN3914300000000,2023-05-01,39,143,OH,Sandusky County,30198,29234,964,3.2
CN3914500000000,2023-05-01,39,145,OH,Scioto County,30013,28665,1348,4.5
CN3914700000000,2023-05-01,39,147,OH,Seneca County,26959,26094,865,3.2
CN3914900000000,2023-05-01,39,149,OH,Shelby County,23990,23288,702,2.9
CN3915100000000,2023-05-01,39,151,OH,Stark County,184135,177748,6387,3.5
CN3915300000000,2023-05-01,39,153,OH,Summit County,268288,259088,9200,3.4
CN3915500000000,2023-05-01,39,155,OH,Trumbull County,83847,80389,3458,4.1
CN3915700000000,2023-05-01,39,157,OH,Tuscarawas County,45330,43942,1388,3.1
CN3915900000000,2023-05-01,39,159,OH,Union County,30932,30114,818,2.6
CN3916100000000,2023-05-01,39,161,OH,Van Wert County,14748,14355,393,2.7
CN3916300000000,2023-05-01,39,163,OH,Vinton County,5529,5302,227,4.1
CN3916500000000,2023-05-01,39,165,OH,Warren County,126422,122791,3631,2.9
CN3916700000000,2023-05-01,39,167,OH,Washington County,26893,25838,1055,3.9
CN3916900000000,2023-05-01,39,169,OH,Wayne County,61371,59783,1588,2.6
CN3917100000000,2023-05-01,39,171,OH,Williams County,18388,17862,526,2.9
CN3917300000000,2023-05-01,39,173,OH,Wood County,70335,68099,2236,3.2
CN3917500000000,2023-05-01,39,175,OH,Wyandot County,13633,13322,311,2.3
CN4000100000000,2023-05-01,40,001,OK,Adair County,8764,8477,287,3.3
CN4000300000000,2023-05-01,40,003,OK,Alfalfa County,2788,2715,73,2.6
CN4000500000000,2023-05-01,40,005,OK,Atoka County,5196,5027,169,3.3
CN4000700000000,2023-05-01,40,007,OK,Beaver County,2822,2769,53,1.9
CN4000900000000,2023-05-01,40,009,OK,Beckham County,10224,9942,282,2.8
CN4001100000000,2023-05-01,40,011,OK,Blaine County,4410,4326,84,1.9
CN4001300000000,2023-05-01,40,013,OK,Bryan County,23697,23066,631,2.7
CN4001500000000,2023-05-01,40,015,OK,Caddo County,11905,11557,348,2.9
CN4001700000000,2023-05-01,40,017,OK,Canadian County,82802,80803,1999,2.4
CN4001900000000,2023-05-01,40,019,OK,Carter County,21923,21175,748,3.4
CN4002100000000,2023-05-01,40,021,OK,Cherokee County,20706,20071,635,3.1
CN4002300000000,2023-05-01,40,023,OK,Choctaw County,6167,5935,232,3.8
CN4002500000000,2023-05-01,40,025,OK,Cimarron County,1639,1614,25,1.5
CN4002700000000,2023-05-01,40,027,OK,Cleveland County,152589,148901,3688,2.4
CN4002900000000,2023-05-01,40,029,OK,Coal County,2409,2323,86,3.6
CN4003100000000,2023-05-01,40,031,OK,Comanche County,48181,46457,1724,3.6
CN4003300000000,2023-05-01,40,033,OK,Cotton County,2722,2649,73,2.7
CN4003500000000,2023-05-01,40,035,OK,Craig County,5951,5766,185,3.1
CN4003700000000,2023-05-01,40,037,OK,Creek County,31996,31021,975,3
CN4003900000000,2023-05-01,40,039,OK,Custer County,15468,15091,377,2.4
CN4004100000000,2023-05-01,40,041,OK,Delaware County,20449,19850,599,2.9
CN4004300000000,2023-05-01,40,043,OK,Dewey County,3112,3054,58,1.9
CN4004500000000,2023-05-01,40,045,OK,Ellis County,2197,2155,42,1.9
CN4004700000000,2023-05-01,40,047,OK,Garfield County,26640,25884,756,2.8
CN4004900000000,2023-05-01,40,049,OK,Garvin County,12843,12486,357,2.8
CN4005100000000,2023-05-01,40,051,OK,Grady County,28161,27418,743,2.6
CN4005300000000,2023-05-01,40,053,OK,Grant County,2768,2717,51,1.8
CN4005500000000,2023-05-01,40,055,OK,Greer County,1880,1818,62,3.3
CN4005700000000,2023-05-01,40,057,OK,Harmon County,1230,1199,31,2.5
CN4005900000000,2023-05-01,40,059,OK,Harper County,1877,1833,44,2.3
CN4006100000000,2023-05-01,40,061,OK,Haskell County,4290,4107,183,4.3
CN4006300000000,2023-05-01,40,063,OK,Hughes County,5238,5062,176,3.4
CN4006500000000,2023-05-01,40,065,OK,Jackson County,10904,10609,295,2.7
CN4006700000000,2023-05-01,40,067,OK,Jefferson County,2525,2453,72,2.9
CN4006900000000,2023-05-01,40,069,OK,Johnston County,4128,3997,131,3.2
CN4007100000000,2023-05-01,40,071,OK,Kay County,18837,18268,569,3
CN4007300000000,2023-05-01,40,073,OK,Kingfisher County,9212,9034,178,1.9
CN4007500000000,2023-05-01,40,075,OK,Kiowa County,3774,3650,124,3.3
CN4007700000000,2023-05-01,40,077,OK,Latimer County,3157,3004,153,4.8
CN4007900000000,2023-05-01,40,079,OK,Le Flore County,19992,19308,684,3.4
CN4008100000000,2023-05-01,40,081,OK,Lincoln County,16690,16208,482,2.9
CN4008300000000,2023-05-01,40,083,OK,Logan County,24073,23428,645,2.7
CN4008500000000,2023-05-01,40,085,OK,Love County,6018,5892,126,2.1
CN4008700000000,2023-05-01,40,087,OK,McClain County,21540,21010,530,2.5
CN4008900000000,2023-05-01,40,089,OK,McCurtain County,16329,15726,603,3.7
CN4009100000000,2023-05-01,40,091,OK,McIntosh County,7517,7176,341,4.5
CN4009300000000,2023-05-01,40,093,OK,Major County,3850,3757,93,2.4
CN4009500000000,2023-05-01,40,095,OK,Marshall County,7538,7324,214,2.8
CN4009700000000,2023-05-01,40,097,OK,Mayes County,20480,19876,604,2.9
CN4009900000000,2023-05-01,40,099,OK,Murray County,6305,6136,169,2.7
CN4010100000000,2023-05-01,40,101,OK,Muskogee County,29319,28342,977,3.3
CN4010300000000,2023-05-01,40,103,OK,Noble County,6044,5898,146,2.4
CN4010500000000,2023-05-01,40,105,OK,Nowata County,4824,4688,136,2.8
CN4010700000000,2023-05-01,40,107,OK,Okfuskee County,4550,4374,176,3.9
CN4010900000000,2023-05-01,40,109,OK,Oklahoma County,409743,398191,11552,2.8
CN4011100000000,2023-05-01,40,111,OK,Okmulgee County,15876,15272,604,3.8
CN4011300000000,2023-05-01,40,113,OK,Osage County,20917,20230,687,3.3
CN4011500000000,2023-05-01,40,115,OK,Ottawa County,15512,15114,398,2.6
CN4011700000000,2023-05-01,40,117,OK,Pawnee County,7507,7267,240,3.2
CN4011900000000,2023-05-01,40,119,OK,Payne County,39510,38510,1000,2.5
CN4012100000000,2023-05-01,40,121,OK,Pittsburg County,16447,15794,653,4
CN4012300000000,2023-05-01,40,123,OK,Pontotoc County,19906,19343,563,2.8
CN4012500000000,2023-05-01,40,125,OK,Pottawatomie County,33817,32769,1048,3.1
CN4012700000000,2023-05-01,40,127,OK,Pushmataha County,4594,4431,163,3.5
CN4012900000000,2023-05-01,40,129,OK,Roger Mills County,1868,1826,42,2.2
CN4013100000000,2023-05-01,40,131,OK,Rogers County,46344,45107,1237,2.7
CN4013300000000,2023-05-01,40,133,OK,Seminole County,9462,9073,389,4.1
CN4013500000000,2023-05-01,40,135,OK,Sequoyah County,17216,16651,565,3.3
CN4013700000000,2023-05-01,40,137,OK,Stephens County,19688,19074,614,3.1
CN4013900000000,2023-05-01,40,139,OK,Texas County,12099,11891,208,1.7
CN4014100000000,2023-05-01,40,141,OK,Tillman County,2976,2838,138,4.6
CN4014300000000,2023-05-01,40,143,OK,Tulsa County,332991,323436,9555,2.9
CN4014500000000,2023-05-01,40,145,OK,Wagoner County,39967,38812,1155,2.9
CN4014700000000,2023-05-01,40,147,OK,Washington County,22568,21881,687,3
CN4014900000000,2023-05-01,40,149,OK,Washita County,5434,5284,150,2.8
CN4015100000000,2023-05-01,40,151,OK,Woods County,4498,4414,84,1.9
CN4015300000000,2023-05-01,40,153,OK,Woodward County,9050,8810,240,2.7
CN4100100000000,2023-05-01,41,001,OR,Baker County,7182,6935,247,3.4
CN4100300000000,2023-05-01,41,003,OR,Benton County,49175,47968,1207,2.5
CN4100500000000,2023-05-01,41,005,OR,Clackamas County,222812,216275,6537,2.9
CN4100700000000,2023-05-01,41,007,OR,Clatsop County,19016,18401,615,3.2
CN4100900000000,2023-05-01,41,009,OR,Columbia County,24658,23743,915,3.7
CN4101100000000,2023-05-01,41,011,OR,Coos County,25796,24785,1011,3.9
CN4101300000000,2023-05-01,41,013,OR,Crook County,11027,10520,507,4.6
CN4101500000000,2023-05-01,41,015,OR,Curry County,8905,8562,343,3.9
CN4101700000000,2023-05-01,41,017,OR,Deschutes County,100188,96974,3214,3.2
CN4101900000000,2023-05-01,41,019,OR,Douglas County,45621,43743,1878,4.1
CN4102100000000,2023-05-01,41,021,OR,Gilliam County,914,879,35,3.8
CN4102300000000,2023-05-01,41,023,OR,Grant County,3147,2996,151,4.8
CN4102500000000,2023-05-01,41,025,OR,Harney County,3720,3592,128,3.4
CN4102700000000,2023-05-01,41,027,OR,Hood River County,13097,12765,332,2.5
CN4102900000000,2023-05-01,41,029,OR,Jackson County,104132,100243,3889,3.7
CN4103100000000,2023-05-01,41,031,OR,Jefferson County,10035,9645,390,3.9
CN4103300000000,2023-05-01,41,033,OR,Josephine County,35810,34320,1490,4.2
CN4103500000000,2023-05-01,41,035,OR,Klamath County,29072,27862,1210,4.2
CN4103700000000,2023-05-01,41,037,OR,Lake County,3572,3429,143,4
CN4103900000000,2023-05-01,41,039,OR,Lane County,176737,170746,5991,3.4
CN4104100000000,2023-05-01,41,041,OR,Lincoln County,20576,19792,784,3.8
CN4104300000000,2023-05-01,41,043,OR,Linn County,59725,57590,2135,3.6
CN4104500000000,2023-05-01,41,045,OR,Malheur County,12465,12071,394,3.2
CN4104700000000,2023-05-01,41,047,OR,Marion County,167547,162207,5340,3.2
CN4104900000000,2023-05-01,41,049,OR,Morrow County,5819,5653,166,2.9
CN4105100000000,2023-05-01,41,051,OR,Multnomah County,460223,446019,14204,3.1
CN4105300000000,2023-05-01,41,053,OR,Polk County,42013,40684,1329,3.2
CN4105500000000,2023-05-01,41,055,OR,Sherman County,963,933,30,3.1
CN4105700000000,2023-05-01,41,057,OR,Tillamook County,11973,11578,395,3.3
CN4105900000000,2023-05-01,41,059,OR,Umatilla County,37055,35845,1210,3.3
CN4106100000000,2023-05-01,41,061,OR,Union County,11788,11407,381,3.2
CN4106300000000,2023-05-01,41,063,OR,Wallowa County,3586,3440,146,4.1
CN4106500000000,2023-05-01,41,065,OR,Wasco County,12389,11949,440,3.6
CN4106700000000,2023-05-01,41,067,OR,Washington County,329876,320601,9275,2.8
CN4106900000000,2023-05-01,41,069,OR,Wheeler County,747,729,18,2.4
CN4107100000000,2023-05-01,41,071,OR,Yamhill County,55425,53801,1624,2.9
CN4200100000000,2023-05-01,42,001,PA,Adams County,54988,53467,1521,2.8
CN4200300000000,2023-05-01,42,003,PA,Allegheny County,632962,610561,22401,3.5
CN4200500000000,2023-05-01,42,005,PA,Armstrong County,30954,29838,1116,3.6
CN4200700000000,2023-05-01,42,007,PA,Beaver County,81668,78263,3405,4.2
CN4200900000000,2023-05-01,42,009,PA,Bedford County,24515,23670,845,3.4
CN4201100000000,2023-05-01,42,011,PA,Berks County,213335,205525,7810,3.7
CN4201300000000,2023-05-01,42,013,PA,Blair County,58752,56798,1954,3.3
CN4201500000000,2023-05-01,42,015,PA,Bradford County,27970,27019,951,3.4
CN4201700000000,2023-05-01,42,017,PA,Bucks County,353964,342686,11278,3.2
CN4201900000000,2023-05-01,42,019,PA,Butler County,98670,95543,3127,3.2
CN4202100000000,2023-05-01,42,021,PA,Cambria County,54922,52687,2235,4.1
CN4202300000000,2023-05-01,42,023,PA,Cameron County,1915,1829,86,4.5
CN4202500000000,2023-05-01,42,025,PA,Carbon County,32329,31044,1285,4
CN4202700000000,2023-05-01,42,027,PA,Centre County,79883,77580,2303,2.9
CN4202900000000,2023-05-01,42,029,PA,Chester County,299561,291418,8143,2.7
CN4203100000000,2023-05-01,42,031,PA,Clarion County,15838,15159,679,4.3
CN4203300000000,2023-05-01,42,033,PA,Clearfield County,34740,33393,1347,3.9
CN4203500000000,2023-05-01,42,035,PA,Clinton County,16902,16248,654,3.9
CN4203700000000,2023-05-01,42,037,PA,Columbia County,33856,32640,1216,3.6
CN4203900000000,2023-05-01,42,039,PA,Crawford County,37856,36515,1341,3.5
CN4204100000000,2023-05-01,42,041,PA,Cumberland County,136445,132573,3872,2.8
CN4204300000000,2023-05-01,42,043,PA,Dauphin County,147415,142512,4903,3.3
CN4204500000000,2023-05-01,42,045,PA,Delaware County,303154,292955,10199,3.4
CN4204700000000,2023-05-01,42,047,PA,Elk County,14228,13727,501,3.5
CN4204900000000,2023-05-01,42,049,PA,Erie County,124851,120193,4658,3.7
CN4205100000000,2023-05-01,42,051,PA,Fayette County,54685,52266,2419,4.4
CN4205300000000,2023-05-01,42,053,PA,Forest County,1650,1567,83,5
CN4205500000000,2023-05-01,42,055,PA,Franklin County,77880,75525,2355,3
CN4205700000000,2023-05-01,42,057,PA,Fulton County,7184,6961,223,3.1
CN4205900000000,2023-05-01,42,059,PA,Greene County,15116,14504,612,4
CN4206100000000,2023-05-01,42,061,PA,Huntingdon County,19135,18380,755,3.9
CN4206300000000,2023-05-01,42,063,PA,Indiana County,35224,33785,1439,4.1
CN4206500000000,2023-05-01,42,065,PA,Jefferson County,19382,18683,699,3.6
CN4206700000000,2023-05-01,42,067,PA,Juniata County,12377,11964,413,3.3
CN4206900000000,2023-05-01,42,069,PA,Lackawanna County,105215,101268,3947,3.8
CN4207100000000,2023-05-01,42,071,PA,Lancaster County,290945,282520,8425,2.9
CN4207300000000,2023-05-01,42,073,PA,Lawrence County,38904,37354,1550,4
CN4207500000000,2023-05-01,42,075,PA,Lebanon County,74859,72592,2267,3
CN4207700000000,2023-05-01,42,077,PA,Lehigh County,196776,189330,7446,3.8
CN4207900000000,2023-05-01,42,079,PA,Luzerne County,158446,151495,6951,4.4
CN4208100000000,2023-05-01,42,081,PA,Lycoming County,54856,52917,1939,3.5
CN4208300000000,2023-05-01,42,083,PA,McKean County,16704,15967,737,4.4
CN4208500000000,2023-05-01,42,085,PA,Mercer County,47283,45436,1847,3.9
CN4208700000000,2023-05-01,42,087,PA,Mifflin County,20981,20245,736,3.5
CN4208900000000,2023-05-01,42,089,PA,Monroe County,81975,78173,3802,4.6
CN4209100000000,2023-05-01,42,091,PA,Montgomery County,471243,457501,13742,2.9
CN4209300000000,2023-05-01,42,093,PA,Montour County,9237,8979,258,2.8
CN4209500000000,2023-05-01,42,095,PA,Northampton County,163795,157976,5819,3.6
CN4209700000000,2023-05-01,42,097,PA,Northumberland County,42181,40489,1692,4
CN4209900000000,2023-05-01,42,099,PA,Perry County,24974,24260,714,2.9
CN4210100000000,2023-05-01,42,101,PA,Philadelphia County/city,736805,704254,32551,4.4
CN4210300000000,2023-05-01,42,103,PA,Pike County,25742,24532,1210,4.7
CN4210500000000,2023-05-01,42,105,PA,Potter County,6827,6520,307,4.5
CN4210700000000,2023-05-01,42,107,PA,Schuylkill County,65372,62686,2686,4.1
CN4210900000000,2023-05-01,42,109,PA,Snyder County,19465,18825,640,3.3
CN4211100000000,2023-05-01,42,111,PA,Somerset County,31810,30575,1235,3.9
CN4211300000000,2023-05-01,42,113,PA,Sullivan County,2554,2451,103,4
CN4211500000000,2023-05-01,42,115,PA,Susquehanna County,20354,19686,668,3.3
CN4211700000000,2023-05-01,42,117,PA,Tioga County,19110,18394,716,3.7
CN4211900000000,2023-05-01,42,119,PA,Union County,19467,18901,566,2.9
CN4212100000000,2023-05-01,42,121,PA,Venango County,20823,19851,972,4.7
CN4212300000000,2023-05-01,42,123,PA,Warren County,17351,16712,639,3.7
CN4212500000000,2023-05-01,42,125,PA,Washington County,104580,100869,3711,3.5
CN4212700000000,2023-05-01,42,127,PA,Wayne County,22360,21484,876,3.9
CN4212900000000,2023-05-01,42,129,PA,Westmoreland County,175378,169228,6150,3.5
CN4213100000000,2023-05-01,42,131,PA,Wyoming County,13534,13039,495,3.7
CN4213300000000,2023-05-01,42,133,PA,York County,239062,231623,7439,3.1
CN4400100000000,2023-05-01,44,001,RI,Bristol County,26544,25924,620,2.3
CN4400300000000,2023-05-01,44,003,RI,Kent County,93518,91239,2279,2.4
CN4400500000000,2023-05-01,44,005,RI,Newport County,45004,43989,1015,2.3
CN4400700000000,2023-05-01,44,007,RI,Providence County,334185,323889,10296,3.1
CN4400900000000,2023-05-01,44,009,RI,Washington County,70318,68710,1608,2.3
CN4500100000000,2023-05-01,45,001,SC,Abbeville County,9501,9128,373,3.9
CN4500300000000,2023-05-01,45,003,SC,Aiken County,74420,72314,2106,2.8
CN4500500000000,2023-05-01,45,005,SC,Allendale County,2364,2255,109,4.6
CN4500700000000,2023-05-01,45,007,SC,Anderson County,93787,91295,2492,2.7
CN4500900000000,2023-05-01,45,009,SC,Bamberg County,4609,4376,233,5.1
CN4501100000000,2023-05-01,45,011,SC,Barnwell County,7801,7493,308,3.9
CN4501300000000,2023-05-01,45,013,SC,Beaufort County,78449,76439,2010,2.6
CN4501500000000,2023-05-01,45,015,SC,Berkeley County,115345,112390,2955,2.6
CN4501700000000,2023-05-01,45,017,SC,Calhoun County,6518,6317,201,3.1
CN4501900000000,2023-05-01,45,019,SC,Charleston County,226332,221186,5146,2.3
CN4502100000000,2023-05-01,45,021,SC,Cherokee County,23632,22731,901,3.8
CN4502300000000,2023-05-01,45,023,SC,Chester County,13734,13233,501,3.6
CN4502500000000,2023-05-01,45,025,SC,Chesterfield County,21632,21023,609,2.8
CN4502700000000,2023-05-01,45,027,SC,Clarendon County,12154,11704,450,3.7
CN4502900000000,2023-05-01,45,029,SC,Colleton County,16200,15708,492,3
CN4503100000000,2023-05-01,45,031,SC,Darlington County,30544,29603,941,3.1
CN4503300000000,2023-05-01,45,033,SC,Dillon County,13098,12541,557,4.3
CN4503500000000,2023-05-01,45,035,SC,Dorchester County,83662,81613,2049,2.4
CN4503700000000,2023-05-01,45,037,SC,Edgefield County,10449,10131,318,3
CN4503900000000,2023-05-01,45,039,SC,Fairfield County,9314,8974,340,3.7
CN4504100000000,2023-05-01,45,041,SC,Florence County,67779,65883,1896,2.8
CN4504300000000,2023-05-01,45,043,SC,Georgetown County,26738,25955,783,2.9
CN4504500000000,2023-05-01,45,045,SC,Greenville County,266853,260022,6831,2.6
CN4504700000000,2023-05-01,45,047,SC,Greenwood County,29959,28714,1245,4.2
CN4504900000000,2023-05-01,45,049,SC,Hampton County,8044,7835,209,2.6
CN4505100000000,2023-05-01,45,051,SC,Horry County,158735,153905,4830,3
CN4505300000000,2023-05-01,45,053,SC,Jasper County,13521,13202,319,2.4
CN4505500000000,2023-05-01,45,055,SC,Kershaw County,29836,29004,832,2.8
CN4505700000000,2023-05-01,45,057,SC,Lancaster County,44877,43530,1347,3
CN4505900000000,2023-05-01,45,059,SC,Laurens County,30858,29919,939,3
CN4506100000000,2023-05-01,45,061,SC,Lee County,6428,6182,246,3.8
CN4506300000000,2023-05-01,45,063,SC,Lexington County,153899,150260,3639,2.4
CN4506500000000,2023-05-01,45,065,SC,McCormick County,3468,3353,115,3.3
CN4506700000000,2023-05-01,45,067,SC,Marion County,12828,12291,537,4.2
CN4506900000000,2023-05-01,45,069,SC,Marlboro County,7315,6817,498,6.8
CN4507100000000,2023-05-01,45,071,SC,Newberry County,19345,18847,498,2.6
CN4507300000000,2023-05-01,45,073,SC,Oconee County,35450,34555,895,2.5
CN4507500000000,2023-05-01,45,075,SC,Orangeburg County,33195,31845,1350,4.1
CN4507700000000,2023-05-01,45,077,SC,Pickens County,59566,57814,1752,2.9
CN4507900000000,2023-05-01,45,079,SC,Richland County,200596,194727,5869,2.9
CN4508100000000,2023-05-01,45,081,SC,Saluda County,8566,8337,229,2.7
CN4508300000000,2023-05-01,45,083,SC,Spartanburg County,158198,153873,4325,2.7
CN4508500000000,2023-05-01,45,085,SC,Sumter County,42443,40941,1502,3.5
CN4508700000000,2023-05-01,45,087,SC,Union County,11429,10997,432,3.8
CN4508900000000,2023-05-01,45,089,SC,Williamsburg County,10732,10273,459,4.3
CN4509100000000,2023-05-01,45,091,SC,York County,152752,148680,4072,2.7
CN4600300000000,2023-05-01,46,003,SD,Aurora County,1542,1517,25,1.6
CN4600500000000,2023-05-01,46,005,SD,Beadle County,9358,9190,168,1.8
CN4600700000000,2023-05-01,46,007,SD,Bennett County,1047,1019,28,2.7
CN4600900000000,2023-05-01,46,009,SD,Bon Homme County,2937,2884,53,1.8
CN4601100000000,2023-05-01,46,011,SD,Brookings County,19432,19091,341,1.8
CN4601300000000,2023-05-01,46,013,SD,Brown County,20269,19871,398,2
CN4601500000000,2023-05-01,46,015,SD,Brule County,2710,2662,48,1.8
CN4601700000000,2023-05-01,46,017,SD,Buffalo County,688,662,26,3.8
CN4601900000000,2023-05-01,46,019,SD,Butte County,5207,5111,96,1.8
CN4602100000000,2023-05-01,46,021,SD,Campbell County,787,769,18,2.3
CN4602300000000,2023-05-01,46,023,SD,Charles Mix County,3886,3808,78,2
CN4602500000000,2023-05-01,46,025,SD,Clark County,2012,1968,44,2.2
CN4602700000000,2023-05-01,46,027,SD,Clay County,7018,6875,143,2
CN4602900000000,2023-05-01,46,029,SD,Codington County,16366,16078,288,1.8
CN4603100000000,2023-05-01,46,031,SD,Corson County,1285,1244,41,3.2
CN4603300000000,2023-05-01,46,033,SD,Custer County,4249,4139,110,2.6
CN4603500000000,2023-05-01,46,035,SD,Davison County,11269,11084,185,1.6
CN4603700000000,2023-05-01,46,037,SD,Day County,2762,2697,65,2.4
CN4603900000000,2023-05-01,46,039,SD,Deuel County,2314,2261,53,2.3
CN4604100000000,2023-05-01,46,041,SD,Dewey County,2244,2177,67,3
CN4604300000000,2023-05-01,46,043,SD,Douglas County,1507,1479,28,1.9
CN4604500000000,2023-05-01,46,045,SD,Edmunds County,2010,1972,38,1.9
CN4604700000000,2023-05-01,46,047,SD,Fall River County,3081,3002,79,2.6
CN4604900000000,2023-05-01,46,049,SD,Faulk County,1090,1069,21,1.9
CN4605100000000,2023-05-01,46,051,SD,Grant County,4463,4380,83,1.9
CN4605300000000,2023-05-01,46,053,SD,Gregory County,2191,2155,36,1.6
CN4605500000000,2023-05-01,46,055,SD,Haakon County,1075,1058,17,1.6
CN4605700000000,2023-05-01,46,057,SD,Hamlin County,3690,3628,62,1.7
CN4605900000000,2023-05-01,46,059,SD,Hand County,1862,1833,29,1.6
CN4606100000000,2023-05-01,46,061,SD,Hanson County,1805,1775,30,1.7
CN4606300000000,2023-05-01,46,063,SD,Harding County,746,731,15,2
CN4606500000000,2023-05-01,46,065,SD,Hughes County,10122,9969,153,1.5
CN4606700000000,2023-05-01,46,067,SD,Hutchinson County,3689,3616,73,2
CN4606900000000,2023-05-01,46,069,SD,Hyde County,661,649,12,1.8
CN4607100000000,2023-05-01,46,071,SD,Jackson County,1265,1231,34,2.7
CN4607300000000,2023-05-01,46,073,SD,Jerauld County,1236,1215,21,1.7
CN4607500000000,2023-05-01,46,075,SD,Jones County,530,517,13,2.5
CN4607700000000,2023-05-01,46,077,SD,Kingsbury County,2802,2753,49,1.7
CN4607900000000,2023-05-01,46,079,SD,Lake County,6988,6853,135,1.9
CN4608100000000,2023-05-01,46,081,SD,Lawrence County,14347,14073,274,1.9
CN4608300000000,2023-05-01,46,083,SD,Lincoln County,38745,38146,599,1.5
CN4608500000000,2023-05-01,46,085,SD,Lyman County,1713,1668,45,2.6
CN4608700000000,2023-05-01,46,087,SD,McCook County,3192,3140,52,1.6
CN4608900000000,2023-05-01,46,089,SD,McPherson County,989,969,20,2
CN4609100000000,2023-05-01,46,091,SD,Marshall County,2554,2496,58,2.3
CN4609300000000,2023-05-01,46,093,SD,Meade County,14702,14393,309,2.1
CN4609500000000,2023-05-01,46,095,SD,Mellette County,754,733,21,2.8
CN4609700000000,2023-05-01,46,097,SD,Miner County,1287,1267,20,1.6
CN4609900000000,2023-05-01,46,099,SD,Minnehaha County,120337,118292,2045,1.7
CN4610100000000,2023-05-01,46,101,SD,Moody County,4127,4064,63,1.5
CN4610200000000,2023-05-01,46,102,SD,Oglala Lakota County,3826,3674,152,4
CN4610300000000,2023-05-01,46,103,SD,Pennington County,60668,59513,1155,1.9
CN4610500000000,2023-05-01,46,105,SD,Perkins County,1456,1428,28,1.9
CN4610700000000,2023-05-01,46,107,SD,Potter County,1056,1031,25,2.4
CN4610900000000,2023-05-01,46,109,SD,Roberts County,4646,4518,128,2.8
CN4611100000000,2023-05-01,46,111,SD,Sanborn County,1229,1207,22,1.8
CN4611500000000,2023-05-01,46,115,SD,Spink County,3051,2984,67,2.2
CN4611700000000,2023-05-01,46,117,SD,Stanley County,1966,1933,33,1.7
CN4611900000000,2023-05-01,46,119,SD,Sully County,827,814,13,1.6
CN4612100000000,2023-05-01,46,121,SD,Todd County,2901,2819,82,2.8
CN4612300000000,2023-05-01,46,123,SD,Tripp County,3111,3062,49,1.6
CN4612500000000,2023-05-01,46,125,SD,Turner County,4852,4765,87,1.8
CN4612700000000,2023-05-01,46,127,SD,Union County,8931,8754,177,2
CN4612900000000,2023-05-01,46,129,SD,Walworth County,2124,2062,62,2.9
CN4613500000000,2023-05-01,46,135,SD,Yankton County,12063,11849,214,1.8
CN4613700000000,2023-05-01,46,137,SD,Ziebach County,956,926,30,3.1
CN4700100000000,2023-05-01,47,001,TN,Anderson County,35621,34490,1131,3.2
CN4700300000000,2023-05-01,47,003,TN,Bedford County,21805,21109,696,3.2
CN4700500000000,2023-05-01,47,005,TN,Benton County,6781,6507,274,4
CN4700700000000,2023-05-01,47,007,TN,Bledsoe County,4397,4165,232,5.3
CN4700900000000,2023-05-01,47,009,TN,Blount County,66053,64100,1953,3
CN4701100000000,2023-05-01,47,011,TN,Bradley County,50077,48331,1746,3.5
CN4701300000000,2023-05-01,47,013,TN,Campbell County,15087,14467,620,4.1
CN4701500000000,2023-05-01,47,015,TN,Cannon County,6957,6747,210,3
CN4701700000000,2023-05-01,47,017,TN,Carroll County,11658,11211,447,3.8
CN4701900000000,2023-05-01,47,019,TN,Carter County,23992,23113,879,3.7
CN4702100000000,2023-05-01,47,021,TN,Cheatham County,22813,22230,583,2.6
CN4702300000000,2023-05-01,47,023,TN,Chester County,8479,8210,269,3.2
CN4702500000000,2023-05-01,47,025,TN,Claiborne County,12705,12234,471,3.7
CN4702700000000,2023-05-01,47,027,TN,Clay County,2821,2707,114,4
CN4702900000000,2023-05-01,47,029,TN,Cocke County,14674,14084,590,4
CN4703100000000,2023-05-01,47,031,TN,Coffee County,25242,24402,840,3.3
CN4703300000000,2023-05-01,47,033,TN,Crockett County,6724,6509,215,3.2
CN4703500000000,2023-05-01,47,035,TN,Cumberland County,23500,22588,912,3.9
CN4703700000000,2023-05-01,47,037,TN,Davidson County,419123,407972,11151,2.7
CN4703900000000,2023-05-01,47,039,TN,Decatur County,4450,4268,182,4.1
CN4704100000000,2023-05-01,47,041,TN,DeKalb County,8187,7880,307,3.7
CN4704300000000,2023-05-01,47,043,TN,Dickson County,28297,27529,768,2.7
CN4704500000000,2023-05-01,47,045,TN,Dyer County,16545,15979,566,3.4
CN4704700000000,2023-05-01,47,047,TN,Fayette County,18915,18224,691,3.7
CN4704900000000,2023-05-01,47,049,TN,Fentress County,7840,7554,286,3.6
CN4705100000000,2023-05-01,47,051,TN,Franklin County,18932,18274,658,3.5
CN4705300000000,2023-05-01,47,053,TN,Gibson County,21554,20823,731,3.4
CN4705500000000,2023-05-01,47,055,TN,Giles County,14733,14259,474,3.2
CN4705700000000,2023-05-01,47,057,TN,Grainger County,9723,9383,340,3.5
CN4705900000000,2023-05-01,47,059,TN,Greene County,28485,27443,1042,3.7
CN4706100000000,2023-05-01,47,061,TN,Grundy County,4973,4756,217,4.4
CN4706300000000,2023-05-01,47,063,TN,Hamblen County,28155,27173,982,3.5
CN4706500000000,2023-05-01,47,065,TN,Hamilton County,184545,178576,5969,3.2
CN4706700000000,2023-05-01,47,067,TN,Hancock County,2285,2192,93,4.1
CN4706900000000,2023-05-01,47,069,TN,Hardeman County,8854,8465,389,4.4
CN4707100000000,2023-05-01,47,071,TN,Hardin County,10046,9641,405,4
CN4707300000000,2023-05-01,47,073,TN,Hawkins County,23331,22476,855,3.7
CN4707500000000,2023-05-01,47,075,TN,Haywood County,7479,7120,359,4.8
CN4707700000000,2023-05-01,47,077,TN,Henderson County,11764,11350,414,3.5
CN4707900000000,2023-05-01,47,079,TN,Henry County,13436,12935,501,3.7
CN4708100000000,2023-05-01,47,081,TN,Hickman County,11850,11513,337,2.8
CN4708300000000,2023-05-01,47,083,TN,Houston County,3210,3072,138,4.3
CN4708500000000,2023-05-01,47,085,TN,Humphreys County,8665,8391,274,3.2
CN4708700000000,2023-05-01,47,087,TN,Jackson County,4807,4625,182,3.8
CN4708900000000,2023-05-01,47,089,TN,Jefferson County,24969,24140,829,3.3
CN4709100000000,2023-05-01,47,091,TN,Johnson County,7475,7246,229,3.1
CN4709300000000,2023-05-01,47,093,TN,Knox County,253636,246595,7041,2.8
CN4709500000000,2023-05-01,47,095,TN,Lake County,1575,1505,70,4.4
CN4709700000000,2023-05-01,47,097,TN,Lauderdale County,9379,8938,441,4.7
CN4709900000000,2023-05-01,47,099,TN,Lawrence County,19241,18574,667,3.5
CN4710100000000,2023-05-01,47,101,TN,Lewis County,5590,5413,177,3.2
CN4710300000000,2023-05-01,47,103,TN,Lincoln County,16761,16219,542,3.2
CN4710500000000,2023-05-01,47,105,TN,Loudon County,24525,23745,780,3.2
CN4710700000000,2023-05-01,47,107,TN,McMinn County,21120,20276,844,4
CN4710900000000,2023-05-01,47,109,TN,McNairy County,8483,8100,383,4.5
CN4711100000000,2023-05-01,47,111,TN,Macon County,11722,11343,379,3.2
CN4711300000000,2023-05-01,47,113,TN,Madison County,48742,47131,1611,3.3
CN4711500000000,2023-05-01,47,115,TN,Marion County,12385,11895,490,4
CN4711700000000,2023-05-01,47,117,TN,Marshall County,15868,15359,509,3.2
CN4711900000000,2023-05-01,47,119,TN,Maury County,53635,52166,1469,2.7
CN4712100000000,2023-05-01,47,121,TN,Meigs County,5199,4974,225,4.3
CN4712300000000,2023-05-01,47,123,TN,Monroe County,20999,20306,693,3.3
CN4712500000000,2023-05-01,47,125,TN,Montgomery County,89104,85829,3275,3.7
CN4712700000000,2023-05-01,47,127,TN,Moore County,3801,3709,92,2.4
CN4712900000000,2023-05-01,47,129,TN,Morgan County,7943,7632,311,3.9
CN4713100000000,2023-05-01,47,131,TN,Obion County,12839,12377,462,3.6
CN4713300000000,2023-05-01,47,133,TN,Overton County,9952,9614,338,3.4
CN4713500000000,2023-05-01,47,135,TN,Perry County,2703,2577,126,4.7
CN4713700000000,2023-05-01,47,137,TN,Pickett County,2161,2082,79,3.7
CN4713900000000,2023-05-01,47,139,TN,Polk County,7026,6751,275,3.9
CN4714100000000,2023-05-01,47,141,TN,Putnam County,35217,33992,1225,3.5
CN4714300000000,2023-05-01,47,143,TN,Rhea County,13880,13303,577,4.2
CN4714500000000,2023-05-01,47,145,TN,Roane County,23978,23146,832,3.5
CN4714700000000,2023-05-01,47,147,TN,Robertson County,39693,38619,1074,2.7
CN4714900000000,2023-05-01,47,149,TN,Rutherford County,199377,193768,5609,2.8
CN4715100000000,2023-05-01,47,151,TN,Scott County,8067,7643,424,5.3
CN4715300000000,2023-05-01,47,153,TN,Sequatchie County,6166,5929,237,3.8
CN4715500000000,2023-05-01,47,155,TN,Sevier County,55691,54262,1429,2.6
CN4715700000000,2023-05-01,47,157,TN,Shelby County,432116,414261,17855,4.1
CN4715900000000,2023-05-01,47,159,TN,Smith County,9868,9572,296,3
CN4716100000000,2023-05-01,47,161,TN,Stewart County,5624,5414,210,3.7
CN4716300000000,2023-05-01,47,163,TN,Sullivan County,69347,66978,2369,3.4
CN4716500000000,2023-05-01,47,165,TN,Sumner County,110306,107382,2924,2.7
CN4716700000000,2023-05-01,47,167,TN,Tipton County,27339,26300,1039,3.8
CN4716900000000,2023-05-01,47,169,TN,Trousdale County,5809,5629,180,3.1
CN4717100000000,2023-05-01,47,171,TN,Unicoi County,6993,6713,280,4
CN4717300000000,2023-05-01,47,173,TN,Union County,7879,7594,285,3.6
CN4717500000000,2023-05-01,47,175,TN,Van Buren County,2132,2043,89,4.2
CN4717700000000,2023-05-01,47,177,TN,Warren County,16309,15684,625,3.8
CN4717900000000,2023-05-01,47,179,TN,Washington County,61429,59418,2011,3.3
CN4718100000000,2023-05-01,47,181,TN,Wayne County,6522,6271,251,3.8
CN4718300000000,2023-05-01,47,183,TN,Weakley County,15306,14760,546,3.6
CN4718500000000,2023-05-01,47,185,TN,White County,11916,11499,417,3.5
CN4718700000000,2023-05-01,47,187,TN,Williamson County,140118,136584,3534,2.5
CN4718900000000,2023-05-01,47,189,TN,Wilson County,83348,81066,2282,2.7
CN4800100000000,2023-05-01,48,001,TX,Anderson County,23227,22399,828,3.6
CN4800300000000,2023-05-01,48,003,TX,Andrews County,9776,9479,297,3
CN4800500000000,2023-05-01,48,005,TX,Angelina County,35471,33845,1626,4.6
CN4800700000000,2023-05-01,48,007,TX,Aransas County,9388,8912,476,5.1
CN4800900000000,2023-05-01,48,009,TX,Archer County,4032,3887,145,3.6
CN4801100000000,2023-05-01,48,011,TX,Armstrong County,955,921,34,3.6
CN4801300000000,2023-05-01,48,013,TX,Atascosa County,23012,22138,874,3.8
CN4801500000000,2023-05-01,48,015,TX,Austin County,14364,13820,544,3.8
CN4801700000000,2023-05-01,48,017,TX,Bailey County,2425,2305,120,4.9
CN4801900000000,2023-05-01,48,019,TX,Bandera County,10860,10470,390,3.6
CN4802100000000,2023-05-01,48,021,TX,Bastrop County,49163,47455,1708,3.5
CN4802300000000,2023-05-01,48,023,TX,Baylor County,1984,1929,55,2.8
CN4802500000000,2023-05-01,48,025,TX,Bee County,9283,8786,497,5.4
CN4802700000000,2023-05-01,48,027,TX,Bell County,150982,144049,6933,4.6
CN4802900000000,2023-05-01,48,029,TX,Bexar County,1006580,967571,39009,3.9
CN4803100000000,2023-05-01,48,031,TX,Blanco County,7225,7011,214,3
CN4803300000000,2023-05-01,48,033,TX,Borden County,787,774,13,1.7
CN4803500000000,2023-05-01,48,035,TX,Bosque County,8711,8388,323,3.7
CN4803700000000,2023-05-01,48,037,TX,Bowie County,38774,37061,1713,4.4
CN4803900000000,2023-05-01,48,039,TX,Brazoria County,188542,179834,8708,4.6
CN4804100000000,2023-05-01,48,041,TX,Brazos County,132296,128080,4216,3.2
CN4804300000000,2023-05-01,48,043,TX,Brewster County,4288,4142,146,3.4
CN4804500000000,2023-05-01,48,045,TX,Briscoe County,597,574,23,3.9
CN4804700000000,2023-05-01,48,047,TX,Brooks County,2309,2186,123,5.3
CN4804900000000,2023-05-01,48,049,TX,Brown County,15349,14654,695,4.5
CN4805100000000,2023-05-01,48,051,TX,Burleson County,9086,8761,325,3.6
CN4805300000000,2023-05-01,48,053,TX,Burnet County,26295,25431,864,3.3
CN4805500000000,2023-05-01,48,055,TX,Caldwell County,21739,20945,794,3.7
CN4805700000000,2023-05-01,48,057,TX,Calhoun County,12328,11917,411,3.3
CN4805900000000,2023-05-01,48,059,TX,Callahan County,6321,6082,239,3.8
CN4806100000000,2023-05-01,48,061,TX,Cameron County,180189,169859,10330,5.7
CN4806300000000,2023-05-01,48,063,TX,Camp County,5078,4851,227,4.5
CN4806500000000,2023-05-01,48,065,TX,Carson County,3047,2950,97,3.2
CN4806700000000,2023-05-01,48,067,TX,Cass County,11810,11217,593,5
CN4806900000000,2023-05-01,48,069,TX,Castro County,3328,3221,107,3.2
CN4807100000000,2023-05-01,48,071,TX,Chambers County,21562,20320,1242,5.8
CN4807300000000,2023-05-01,48,073,TX,Cherokee County,20468,19534,934,4.6
CN4807500000000,2023-05-01,48,075,TX,Childress County,3401,3305,96,2.8
CN4807700000000,2023-05-01,48,077,TX,Clay County,4878,4690,188,3.9
CN4807900000000,2023-05-01,48,079,TX,Cochran County,1138,1093,45,4
CN4808100000000,2023-05-01,48,081,TX,Coke County,1546,1494,52,3.4
CN4808300000000,2023-05-01,48,083,TX,Coleman County,3072,2919,153,5
CN4808500000000,2023-05-01,48,085,TX,Collin County,642011,618877,23134,3.6
CN4808700000000,2023-05-01,48,087,TX,Collingsworth County,1069,1024,45,4.2
CN4808900000000,2023-05-01,48,089,TX,Colorado County,10462,10092,370,3.5
CN4809100000000,2023-05-01,48,091,TX,Comal County,84456,81365,3091,3.7
CN4809300000000,2023-05-01,48,093,TX,Comanche County,6554,6319,235,3.6
CN4809500000000,2023-05-01,48,095,TX,Concho County,1274,1232,42,3.3
CN4809700000000,2023-05-01,48,097,TX,Cooke County,20443,19751,692,3.4
CN4809900000000,2023-05-01,48,099,TX,Coryell County,24949,23789,1160,4.6
CN4810100000000,2023-05-01,48,101,TX,Cottle County,1107,1081,26,2.3
CN4810300000000,2023-05-01,48,103,TX,Crane County,1680,1600,80,4.8
CN4810500000000,2023-05-01,48,105,TX,Crockett County,1428,1374,54,3.8
CN4810700000000,2023-05-01,48,107,TX,Crosby County,2442,2336,106,4.3
CN4810900000000,2023-05-01,48,109,TX,Culberson County,1237,1200,37,3
CN4811100000000,2023-05-01,48,111,TX,Dallam County,3838,3739,99,2.6
CN4811300000000,2023-05-01,48,113,TX,Dallas County,1455977,1397673,58304,4
CN4811500000000,2023-05-01,48,115,TX,Dawson County,4472,4271,201,4.5
CN4811700000000,2023-05-01,48,117,TX,Deaf Smith County,9156,8857,299,3.3
CN4811900000000,2023-05-01,48,119,TX,Delta County,2543,2423,120,4.7
CN4812100000000,2023-05-01,48,121,TX,Denton County,566242,545825,20417,3.6
CN4812300000000,2023-05-01,48,123,TX,DeWitt County,9014,8696,318,3.5
CN4812500000000,2023-05-01,48,125,TX,Dickens County,724,693,31,4.3
CN4812700000000,2023-05-01,48,127,TX,Dimmit County,6044,5833,211,3.5
CN4812900000000,2023-05-01,48,129,TX,Donley County,1513,1461,52,3.4
CN4813100000000,2023-05-01,48,131,TX,Duval County,5101,4870,231,4.5
CN4813300000000,2023-05-01,48,133,TX,Eastland County,6544,6232,312,4.8
CN4813500000000,2023-05-01,48,135,TX,Ector County,85847,82906,2941,3.4
CN4813700000000,2023-05-01,48,137,TX,Edwards County,1100,1063,37,3.4
CN4813900000000,2023-05-01,48,139,TX,Ellis County,105838,101867,3971,3.8
CN4814100000000,2023-05-01,48,141,TX,El Paso County,375305,358407,16898,4.5
CN4814300000000,2023-05-01,48,143,TX,Erath County,21449,20694,755,3.5
CN4814500000000,2023-05-01,48,145,TX,Falls County,6963,6669,294,4.2
CN4814700000000,2023-05-01,48,147,TX,Fannin County,17525,16922,603,3.4
CN4814900000000,2023-05-01,48,149,TX,Fayette County,11853,11413,440,3.7
CN4815100000000,2023-05-01,48,151,TX,Fisher County,1676,1622,54,3.2
CN4815300000000,2023-05-01,48,153,TX,Floyd County,2414,2304,110,4.6
CN4815500000000,2023-05-01,48,155,TX,Foard County,534,513,21,3.9
CN4815700000000,2023-05-01,48,157,TX,Fort Bend County,428096,410396,17700,4.1
CN4815900000000,2023-05-01,48,159,TX,Franklin County,5553,5358,195,3.5
CN4816100000000,2023-05-01,48,161,TX,Freestone County,6381,6012,369,5.8
CN4816300000000,2023-05-01,48,163,TX,Frio County,9323,9010,313,3.4
CN4816500000000,2023-05-01,48,165,TX,Gaines County,10220,9903,317,3.1
CN4816700000000,2023-05-01,48,167,TX,Galveston County,172595,164921,7674,4.4
CN4816900000000,2023-05-01,48,169,TX,Garza County,1883,1815,68,3.6
CN4817100000000,2023-05-01,48,171,TX,Gillespie County,14817,14414,403,2.7
CN4817300000000,2023-05-01,48,173,TX,Glasscock County,927,906,21,2.3
CN4817500000000,2023-05-01,48,175,TX,Goliad County,3196,3069,127,4
CN4817700000000,2023-05-01,48,177,TX,Gonzales County,9419,9086,333,3.5
CN4817900000000,2023-05-01,48,179,TX,Gray County,7681,7345,336,4.4
CN4818100000000,2023-05-01,48,181,TX,Grayson County,67082,64435,2647,3.9
CN4818300000000,2023-05-01,48,183,TX,Gregg County,57422,54950,2472,4.3
CN4818500000000,2023-05-01,48,185,TX,Grimes County,11737,11186,551,4.7
CN4818700000000,2023-05-01,48,187,TX,Guadalupe County,88041,84986,3055,3.5
CN4818900000000,2023-05-01,48,189,TX,Hale County,11392,10840,552,4.8
CN4819100000000,2023-05-01,48,191,TX,Hall County,1082,1032,50,4.6
CN4819300000000,2023-05-01,48,193,TX,Hamilton County,3904,3777,127,3.3
CN4819500000000,2023-05-01,48,195,TX,Hansford County,2886,2810,76,2.6
CN4819700000000,2023-05-01,48,197,TX,Hardeman County,1841,1744,97,5.3
CN4819900000000,2023-05-01,48,199,TX,Hardin County,25356,24039,1317,5.2
CN4820100000000,2023-05-01,48,201,TX,Harris County,2391974,2284997,106977,4.5
CN4820300000000,2023-05-01,48,203,TX,Harrison County,29137,27773,1364,4.7
CN4820500000000,2023-05-01,48,205,TX,Hartley County,2565,2507,58,2.3
CN4820700000000,2023-05-01,48,207,TX,Haskell County,2774,2675,99,3.6
CN4820900000000,2023-05-01,48,209,TX,Hays County,141924,137080,4844,3.4
CN4821100000000,2023-05-01,48,211,TX,Hemphill County,1565,1510,55,3.5
CN4821300000000,2023-05-01,48,213,TX,Henderson County,39350,37661,1689,4.3
CN4821500000000,2023-05-01,48,215,TX,Hidalgo County,378011,354724,23287,6.2
CN4821700000000,2023-05-01,48,217,TX,Hill County,18495,17772,723,3.9
CN4821900000000,2023-05-01,48,219,TX,Hockley County,10808,10392,416,3.8
CN4822100000000,2023-05-01,48,221,TX,Hood County,30565,29405,1160,3.8
CN4822300000000,2023-05-01,48,223,TX,Hopkins County,18460,17825,635,3.4
CN4822500000000,2023-05-01,48,225,TX,Houston County,10468,10114,354,3.4
CN4822700000000,2023-05-01,48,227,TX,Howard County,12805,12253,552,4.3
CN4822900000000,2023-05-01,48,229,TX,Hudspeth County,1896,1828,68,3.6
CN4823100000000,2023-05-01,48,231,TX,Hunt County,47973,45932,2041,4.3
CN4823300000000,2023-05-01,48,233,TX,Hutchinson County,8391,8022,369,4.4
CN4823500000000,2023-05-01,48,235,TX,Irion County,798,770,28,3.5
CN4823700000000,2023-05-01,48,237,TX,Jack County,3480,3357,123,3.5
CN4823900000000,2023-05-01,48,239,TX,Jackson County,7009,6761,248,3.5
CN4824100000000,2023-05-01,48,241,TX,Jasper County,12723,11904,819,6.4
CN4824300000000,2023-05-01,48,243,TX,Jeff Davis County,1002,965,37,3.7
CN4824500000000,2023-05-01,48,245,TX,Jefferson County,103448,96491,6957,6.7
CN4824700000000,2023-05-01,48,247,TX,Jim Hogg County,1779,1688,91,5.1
CN4824900000000,2023-05-01,48,249,TX,Jim Wells County,15606,14758,848,5.4
CN4825100000000,2023-05-01,48,251,TX,Johnson County,91317,87980,3337,3.7
CN4825300000000,2023-05-01,48,253,TX,Jones County,5886,5610,276,4.7
CN4825500000000,2023-05-01,48,255,TX,Karnes County,6609,6393,216,3.3
CN4825700000000,2023-05-01,48,257,TX,Kaufman County,77206,73921,3285,4.3
CN4825900000000,2023-05-01,48,259,TX,Kendall County,24359,23523,836,3.4
CN4826100000000,2023-05-01,48,261,TX,Kenedy County,132,122,10,7.6
CN4826300000000,2023-05-01,48,263,TX,Kent County,832,816,16,1.9
CN4826500000000,2023-05-01,48,265,TX,Kerr County,22070,21237,833,3.8
CN4826700000000,2023-05-01,48,267,TX,Kimble County,1798,1731,67,3.7
CN4826900000000,2023-05-01,48,269,TX,King County,609,604,5,0.8
CN4827100000000,2023-05-01,48,271,TX,Kinney County,1237,1174,63,5.1
CN4827300000000,2023-05-01,48,273,TX,Kleberg County,13112,12500,612,4.7
CN4827500000000,2023-05-01,48,275,TX,Knox County,1500,1443,57,3.8
CN4827700000000,2023-05-01,48,277,TX,Lamar County,24124,23052,1072,4.4
CN4827900000000,2023-05-01,48,279,TX,Lamb County,5291,5062,229,4.3
CN4828100000000,2023-05-01,48,281,TX,Lampasas County,9529,9147,382,4
CN4828300000000,2023-05-01,48,283,TX,La Salle County,4035,3925,110,2.7
CN4828500000000,2023-05-01,48,285,TX,Lavaca County,9111,8793,318,3.5
CN4828700000000,2023-05-01,48,287,TX,Lee County,8443,8141,302,3.6
CN4828900000000,2023-05-01,48,289,TX,Leon County,5927,5622,305,5.1
CN4829100000000,2023-05-01,48,291,TX,Liberty County,35884,33883,2001,5.6
CN4829300000000,2023-05-01,48,293,TX,Limestone County,8439,8035,404,4.8
CN4829500000000,2023-05-01,48,295,TX,Lipscomb County,1427,1378,49,3.4
CN4829700000000,2023-05-01,48,297,TX,Live Oak County,4747,4547,200,4.2
CN4829900000000,2023-05-01,48,299,TX,Llano County,9434,9072,362,3.8
CN4830100000000,2023-05-01,48,301,TX,Loving County,1385,1380,5,0.4
CN4830300000000,2023-05-01,48,303,TX,Lubbock County,165133,159546,5587,3.4
CN4830500000000,2023-05-01,48,305,TX,Lynn County,2886,2790,96,3.3
CN4830700000000,2023-05-01,48,307,TX,McCulloch County,3095,2960,135,4.4
CN4830900000000,2023-05-01,48,309,TX,McLennan County,129198,124459,4739,3.7
CN4831100000000,2023-05-01,48,311,TX,McMullen County,861,845,16,1.9
CN4831300000000,2023-05-01,48,313,TX,Madison County,4778,4543,235,4.9
CN4831500000000,2023-05-01,48,315,TX,Marion County,4130,3919,211,5.1
CN4831700000000,2023-05-01,48,317,TX,Martin County,2904,2826,78,2.7
CN4831900000000,2023-05-01,48,319,TX,Mason County,1827,1759,68,3.7
CN4832100000000,2023-05-01,48,321,TX,Matagorda County,17841,16865,976,5.5
CN4832300000000,2023-05-01,48,323,TX,Maverick County,23460,21472,1988,8.5
CN4832500000000,2023-05-01,48,325,TX,Medina County,23280,22374,906,3.9
CN4832700000000,2023-05-01,48,327,TX,Menard County,841,812,29,3.4
CN4832900000000,2023-05-01,48,329,TX,Midland County,110744,107826,2918,2.6
CN4833100000000,2023-05-01,48,331,TX,Milam County,10352,9899,453,4.4
CN4833300000000,2023-05-01,48,333,TX,Mills County,1855,1779,76,4.1
CN4833500000000,2023-05-01,48,335,TX,Mitchell County,2271,2175,96,4.2
CN4833700000000,2023-05-01,48,337,TX,Montague County,9248,8909,339,3.7
CN4833900000000,2023-05-01,48,339,TX,Montgomery County,308273,295666,12607,4.1
CN4834100000000,2023-05-01,48,341,TX,Moore County,11152,10829,323,2.9
CN4834300000000,2023-05-01,48,343,TX,Morris County,4423,4150,273,6.2
CN4834500000000,2023-05-01,48,345,TX,Motley County,551,528,23,4.2
CN4834700000000,2023-05-01,48,347,TX,Nacogdoches County,27569,26242,1327,4.8
CN4834900000000,2023-05-01,48,349,TX,Navarro County,23243,22246,997,4.3
CN4835100000000,2023-05-01,48,351,TX,Newton County,5003,4629,374,7.5
CN4835300000000,2023-05-01,48,353,TX,Nolan County,6731,6484,247,3.7
CN4835500000000,2023-05-01,48,355,TX,Nueces County,166097,158750,7347,4.4
CN4835700000000,2023-05-01,48,357,TX,Ochiltree County,3832,3692,140,3.7
CN4835900000000,2023-05-01,48,359,TX,Oldham County,948,920,28,3
CN4836100000000,2023-05-01,48,361,TX,Orange County,35480,33429,2051,5.8
CN4836300000000,2023-05-01,48,363,TX,Palo Pinto County,13269,12756,513,3.9
CN4836500000000,2023-05-01,48,365,TX,Panola County,9613,9178,435,4.5
CN4836700000000,2023-05-01,48,367,TX,Parker County,76428,73826,2602,3.4
CN4836900000000,2023-05-01,48,369,TX,Parmer County,5163,5028,135,2.6
CN4837100000000,2023-05-01,48,371,TX,Pecos County,6416,6190,226,3.5
CN4837300000000,2023-05-01,48,373,TX,Polk County,18912,17869,1043,5.5
CN4837500000000,2023-05-01,48,375,TX,Potter County,55694,53860,1834,3.3
CN4837700000000,2023-05-01,48,377,TX,Presidio County,3058,2848,210,6.9
CN4837900000000,2023-05-01,48,379,TX,Rains County,6624,6376,248,3.7
CN4838100000000,2023-05-01,48,381,TX,Randall County,77181,74789,2392,3.1
CN4838300000000,2023-05-01,48,383,TX,Reagan County,1587,1527,60,3.8
CN4838500000000,2023-05-01,48,385,TX,Real County,1213,1159,54,4.5
CN4838700000000,2023-05-01,48,387,TX,Red River County,4987,4739,248,5
CN4838900000000,2023-05-01,48,389,TX,Reeves County,8569,8226,343,4
CN4839100000000,2023-05-01,48,391,TX,Refugio County,2869,2736,133,4.6
CN4839300000000,2023-05-01,48,393,TX,Roberts County,389,374,15,3.9
CN4839500000000,2023-05-01,48,395,TX,Robertson County,8168,7864,304,3.7
CN4839700000000,2023-05-01,48,397,TX,Rockwall County,60770,58490,2280,3.8
CN4839900000000,2023-05-01,48,399,TX,Runnels County,4679,4486,193,4.1
CN4840100000000,2023-05-01,48,401,TX,Rusk County,22588,21636,952,4.2
CN4840300000000,2023-05-01,48,403,TX,Sabine County,3924,3659,265,6.8
CN4840500000000,2023-05-01,48,405,TX,San Augustine County,3142,2968,174,5.5
CN4840700000000,2023-05-01,48,407,TX,San Jacinto County,12164,11552,612,5
CN4840900000000,2023-05-01,48,409,TX,San Patricio County,29435,27965,1470,5
CN4841100000000,2023-05-01,48,411,TX,San Saba County,2189,2098,91,4.2
CN4841300000000,2023-05-01,48,413,TX,Schleicher County,1261,1220,41,3.3
CN4841500000000,2023-05-01,48,415,TX,Scurry County,6257,5999,258,4.1
CN4841700000000,2023-05-01,48,417,TX,Shackelford County,1758,1708,50,2.8
CN4841900000000,2023-05-01,48,419,TX,Shelby County,11064,10622,442,4
CN4842100000000,2023-05-01,48,421,TX,Sherman County,1397,1352,45,3.2
CN4842300000000,2023-05-01,48,423,TX,Smith County,112825,108500,4325,3.8
CN4842500000000,2023-05-01,48,425,TX,Somervell County,4668,4499,169,3.6
CN4842700000000,2023-05-01,48,427,TX,Starr County,24148,21913,2235,9.3
CN4842900000000,2023-05-01,48,429,TX,Stephens County,4032,3871,161,4
CN4843100000000,2023-05-01,48,431,TX,Sterling County,514,493,21,4.1
CN4843300000000,2023-05-01,48,433,TX,Stonewall County,805,784,21,2.6
CN4843500000000,2023-05-01,48,435,TX,Sutton County,959,897,62,6.5
CN4843700000000,2023-05-01,48,437,TX,Swisher County,2582,2465,117,4.5
CN4843900000000,2023-05-01,48,439,TX,Tarrant County,1170318,1125971,44347,3.8
CN4844100000000,2023-05-01,48,441,TX,Taylor County,69424,67048,2376,3.4
CN4844300000000,2023-05-01,48,443,TX,Terrell County,403,390,13,3.2
CN4844500000000,2023-05-01,48,445,TX,Terry County,4585,4388,197,4.3
CN4844700000000,2023-05-01,48,447,TX,Throckmorton County,642,616,26,4
CN4844900000000,2023-05-01,48,449,TX,Titus County,13770,13190,580,4.2
CN4845100000000,2023-05-01,48,451,TX,Tom Green County,56519,54465,2054,3.6
CN4845300000000,2023-05-01,48,453,TX,Travis County,843927,815068,28859,3.4
CN4845500000000,2023-05-01,48,455,TX,Trinity County,5372,5098,274,5.1
CN4845700000000,2023-05-01,48,457,TX,Tyler County,7077,6632,445,6.3
CN4845900000000,2023-05-01,48,459,TX,Upshur County,17970,17182,788,4.4
CN4846100000000,2023-05-01,48,461,TX,Upton County,2361,2303,58,2.5
CN4846300000000,2023-05-01,48,463,TX,Uvalde County,11035,10548,487,4.4
CN4846500000000,2023-05-01,48,465,TX,Val Verde County,22141,20777,1364,6.2
CN4846700000000,2023-05-01,48,467,TX,Van Zandt County,28120,27113,1007,3.6
CN4846900000000,2023-05-01,48,469,TX,Victoria County,41583,39839,1744,4.2
CN4847100000000,2023-05-01,48,471,TX,Walker County,24247,23099,1148,4.7
CN4847300000000,2023-05-01,48,473,TX,Waller County,26006,24835,1171,4.5
CN4847500000000,2023-05-01,48,475,TX,Ward County,6135,5929,206,3.4
CN4847700000000,2023-05-01,48,477,TX,Washington County,15160,14527,633,4.2
CN4847900000000,2023-05-01,48,479,TX,Webb County,118672,113564,5108,4.3
CN4848100000000,2023-05-01,48,481,TX,Wharton County,21531,20674,857,4
CN4848300000000,2023-05-01,48,483,TX,Wheeler County,1933,1849,84,4.3
CN4848500000000,2023-05-01,48,485,TX,Wichita County,55607,53421,2186,3.9
CN4848700000000,2023-05-01,48,487,TX,Wilbarger County,4784,4518,266,5.6
CN4848900000000,2023-05-01,48,489,TX,Willacy County,7404,6801,603,8.1
CN4849100000000,2023-05-01,48,491,TX,Williamson County,374518,361316,13202,3.5
CN4849300000000,2023-05-01,48,493,TX,Wilson County,26657,25787,870,3.3
CN4849500000000,2023-05-01,48,495,TX,Winkler County,4108,3960,148,3.6
CN4849700000000,2023-05-01,48,497,TX,Wise County,35118,33848,1270,3.6
CN4849900000000,2023-05-01,48,499,TX,Wood County,18257,17430,827,4.5
CN4850100000000,2023-05-01,48,501,TX,Yoakum County,3226,3104,122,3.8
CN4850300000000,2023-05-01,48,503,TX,Young County,8004,7712,292,3.6
CN4850500000000,2023-05-01,48,505,TX,Zapata County,4456,4185,271,6.1
CN4850700000000,2023-05-01,48,507,TX,Zavala County,3522,3264,258,7.3
CN4900100000000,2023-05-01,49,001,UT,Beaver County,3079,2996,83,2.7
CN4900300000000,2023-05-01,49,003,UT,Box Elder County,29007,28344,663,2.3
CN4900500000000,2023-05-01,49,005,UT,Cache County,74347,72758,1589,2.1
CN4900700000000,2023-05-01,49,007,UT,Carbon County,8623,8339,284,3.3
CN4900900000000,2023-05-01,49,009,UT,Daggett County,474,461,13,2.7
CN4901100000000,2023-05-01,49,011,UT,Davis County,191879,187471,4408,2.3
CN4901300000000,2023-05-01,49,013,UT,Duchesne County,8409,8186,223,2.7
CN4901500000000,2023-05-01,49,015,UT,Emery County,4663,4526,137,2.9
CN4901700000000,2023-05-01,49,017,UT,Garfield County,3319,3194,125,3.8
CN4901900000000,2023-05-01,49,019,UT,Grand County,7598,7448,150,2
CN4902100000000,2023-05-01,49,021,UT,Iron County,28941,28229,712,2.5
CN4902300000000,2023-05-01,49,023,UT,Juab County,6608,6461,147,2.2
CN4902500000000,2023-05-01,49,025,UT,Kane County,4291,4198,93,2.2
CN4902700000000,2023-05-01,49,027,UT,Millard County,6755,6618,137,2
CN4902900000000,2023-05-01,49,029,UT,Morgan County,6197,6078,119,1.9
CN4903100000000,2023-05-01,49,031,UT,Piute County,536,517,19,3.5
CN4903300000000,2023-05-01,49,033,UT,Rich County,1311,1283,28,2.1
CN4903500000000,2023-05-01,49,035,UT,Salt Lake County,706700,689308,17392,2.5
CN4903700000000,2023-05-01,49,037,UT,San Juan County,5926,5740,186,3.1
CN4903900000000,2023-05-01,49,039,UT,Sanpete County,14343,13977,366,2.6
CN4904100000000,2023-05-01,49,041,UT,Sevier County,10729,10471,258,2.4
CN4904300000000,2023-05-01,49,043,UT,Summit County,27176,26273,903,3.3
CN4904500000000,2023-05-01,49,045,UT,Tooele County,39827,38804,1023,2.6
CN4904700000000,2023-05-01,49,047,UT,Uintah County,14923,14467,456,3.1
CN4904900000000,2023-05-01,49,049,UT,Utah County,355381,346785,8596,2.4
CN4905100000000,2023-05-01,49,051,UT,Wasatch County,18478,17932,546,3
CN4905300000000,2023-05-01,49,053,UT,Washington County,90153,87832,2321,2.6
CN4905500000000,2023-05-01,49,055,UT,Wayne County,1667,1612,55,3.3
CN4905700000000,2023-05-01,49,057,UT,Weber County,140981,137344,3637,2.6
CN5000100000000,2023-05-01,50,001,VT,Addison County,20885,20616,269,1.3
CN5000300000000,2023-05-01,50,003,VT,Bennington County,17644,17265,379,2.1
CN5000500000000,2023-05-01,50,005,VT,Caledonia County,14732,14455,277,1.9
CN5000700000000,2023-05-01,50,007,VT,Chittenden County,97836,96610,1226,1.3
CN5000900000000,2023-05-01,50,009,VT,Essex County,2632,2583,49,1.9
CN5001100000000,2023-05-01,50,011,VT,Franklin County,27742,27352,390,1.4
CN5001300000000,2023-05-01,50,013,VT,Grand Isle County,4112,4053,59,1.4
CN5001500000000,2023-05-01,50,015,VT,Lamoille County,14086,13755,331,2.3
CN5001700000000,2023-05-01,50,017,VT,Orange County,15661,15432,229,1.5
CN5001900000000,2023-05-01,50,019,VT,Orleans County,13202,12840,362,2.7
CN5002100000000,2023-05-01,50,021,VT,Rutland County,29170,28473,697,2.4
CN5002300000000,2023-05-01,50,023,VT,Washington County,33696,33185,511,1.5
CN5002500000000,2023-05-01,50,025,VT,Windham County,21194,20708,486,2.3
CN5002700000000,2023-05-01,50,027,VT,Windsor County,28929,28474,455,1.6
CN5100100000000,2023-05-01,51,001,VA,Accomack County,15834,15342,492,3.1
CN5100300000000,2023-05-01,51,003,VA,Albemarle County,60605,59067,1538,2.5
CN5100500000000,2023-05-01,51,005,VA,Alleghany County,6776,6572,204,3
CN5100700000000,2023-05-01,51,007,VA,Amelia County,6499,6319,180,2.8
CN5100900000000,2023-05-01,51,009,VA,Amherst County,15311,14866,445,2.9
CN5101100000000,2023-05-01,51,011,VA,Appomattox County,7357,7119,238,3.2
CN5101300000000,2023-05-01,51,013,VA,Arlington County,163842,160640,3202,2
CN5101500000000,2023-05-01,51,015,VA,Augusta County,39481,38489,992,2.5
CN5101700000000,2023-05-01,51,017,VA,Bath County,2574,2512,62,2.4
CN5101900000000,2023-05-01,51,019,VA,Bedford County,39849,38768,1081,2.7
CN5102100000000,2023-05-01,51,021,VA,Bland County,2912,2837,75,2.6
CN5102300000000,2023-05-01,51,023,VA,Botetourt County,18469,18027,442,2.4
CN5102500000000,2023-05-01,51,025,VA,Brunswick County,6038,5780,258,4.3
CN5102700000000,2023-05-01,51,027,VA,Buchanan County,6403,6139,264,4.1
CN5102900000000,2023-05-01,51,029,VA,Buckingham County,6648,6429,219,3.3
CN5103100000000,2023-05-01,51,031,VA,Campbell County,26743,25943,800,3
CN5103300000000,2023-05-01,51,033,VA,Caroline County,16022,15573,449,2.8
CN5103500000000,2023-05-01,51,035,VA,Carroll County,13203,12786,417,3.2
CN5103600000000,2023-05-01,51,036,VA,Charles City County,3721,3614,107,2.9
CN5103700000000,2023-05-01,51,037,VA,Charlotte County,5657,5477,180,3.2
CN5104100000000,2023-05-01,51,041,VA,Chesterfield County,203211,197759,5452,2.7
CN5104300000000,2023-05-01,51,043,VA,Clarke County,7901,7710,191,2.4
CN5104500000000,2023-05-01,51,045,VA,Craig County,2417,2346,71,2.9
CN5104700000000,2023-05-01,51,047,VA,Culpeper County,26493,25796,697,2.6
CN5104900000000,2023-05-01,51,049,VA,Cumberland County,4968,4820,148,3
CN5105100000000,2023-05-01,51,051,VA,Dickenson County,4682,4491,191,4.1
CN5105300000000,2023-05-01,51,053,VA,Dinwiddie County,14375,13929,446,3.1
CN5105700000000,2023-05-01,51,057,VA,Essex County,5728,5553,175,3.1
CN5105900000000,2023-05-01,51,059,VA,Fairfax County,667096,651524,15572,2.3
CN5106100000000,2023-05-01,51,061,VA,Fauquier County,38967,38028,939,2.4
CN5106300000000,2023-05-01,51,063,VA,Floyd County,8532,8315,217,2.5
CN5106500000000,2023-05-01,51,065,VA,Fluvanna County,14876,14524,352,2.4
CN5106700000000,2023-05-01,51,067,VA,Franklin County,27613,26828,785,2.8
CN5106900000000,2023-05-01,51,069,VA,Frederick County,53319,52053,1266,2.4
CN5107100000000,2023-05-01,51,071,VA,Giles County,8270,8024,246,3
CN5107300000000,2023-05-01,51,073,VA,Gloucester County,20197,19684,513,2.5
CN5107500000000,2023-05-01,51,075,VA,Goochland County,12362,12045,317,2.6
CN5107700000000,2023-05-01,51,077,VA,Grayson County,8446,8245,201,2.4
CN5107900000000,2023-05-01,51,079,VA,Greene County,11130,10858,272,2.4
CN5108100000000,2023-05-01,51,081,VA,Greensville County,4389,4253,136,3.1
CN5108300000000,2023-05-01,51,083,VA,Halifax County,15815,15254,561,3.5
CN5108500000000,2023-05-01,51,085,VA,Hanover County,62935,61424,1511,2.4
CN5108700000000,2023-05-01,51,087,VA,Henrico County,194485,189384,5101,2.6
CN5108900000000,2023-05-01,51,089,VA,Henry County,23997,23205,792,3.3
CN5109100000000,2023-05-01,51,091,VA,Highland County,1470,1441,29,2
CN5109300000000,2023-05-01,51,093,VA,Isle of Wight County,20378,19836,542,2.7
CN5109500000000,2023-05-01,51,095,VA,James City County,38443,37412,1031,2.7
CN5109700000000,2023-05-01,51,097,VA,King and Queen County,4108,4011,97,2.4
CN5109900000000,2023-05-01,51,099,VA,King George County,14868,14509,359,2.4
CN5110100000000,2023-05-01,51,101,VA,King William County,10002,9743,259,2.6
CN5110300000000,2023-05-01,51,103,VA,Lancaster County,5619,5419,200,3.6
CN5110500000000,2023-05-01,51,105,VA,Lee County,8415,8114,301,3.6
CN5110700000000,2023-05-01,51,107,VA,Loudoun County,242393,236689,5704,2.4
CN5110900000000,2023-05-01,51,109,VA,Louisa County,21609,21079,530,2.5
CN5111100000000,2023-05-01,51,111,VA,Lunenburg County,5231,5066,165,3.2
CN5111300000000,2023-05-01,51,113,VA,Madison County,7817,7648,169,2.2
CN5111500000000,2023-05-01,51,115,VA,Mathews County,4242,4132,110,2.6
CN5111700000000,2023-05-01,51,117,VA,Mecklenburg County,13443,13001,442,3.3
CN5111900000000,2023-05-01,51,119,VA,Middlesex County,5493,5358,135,2.5
CN5112100000000,2023-05-01,51,121,VA,Montgomery County,53310,51794,1516,2.8
CN5112500000000,2023-05-01,51,125,VA,Nelson County,7632,7432,200,2.6
CN5112700000000,2023-05-01,51,127,VA,New Kent County,13856,13533,323,2.3
CN5113100000000,2023-05-01,51,131,VA,Northampton County,5503,5325,178,3.2
CN5113300000000,2023-05-01,51,133,VA,Northumberland County,5673,5450,223,3.9
CN5113500000000,2023-05-01,51,135,VA,Nottoway County,7481,7280,201,2.7
CN5113700000000,2023-05-01,51,137,VA,Orange County,18020,17517,503,2.8
CN5113900000000,2023-05-01,51,139,VA,Page County,12529,12150,379,3
CN5114100000000,2023-05-01,51,141,VA,Patrick County,7187,6947,240,3.3
CN5114300000000,2023-05-01,51,143,VA,Pittsylvania County,30519,29631,888,2.9
CN5114500000000,2023-05-01,51,145,VA,Powhatan County,15381,15006,375,2.4
CN5114700000000,2023-05-01,51,147,VA,Prince Edward County,10313,9899,414,4
CN5114900000000,2023-05-01,51,149,VA,Prince George County,16092,15602,490,3
CN5115300000000,2023-05-01,51,153,VA,Prince William County,261786,255125,6661,2.5
CN5115500000000,2023-05-01,51,155,VA,Pulaski County,16999,16549,450,2.6
CN5115700000000,2023-05-01,51,157,VA,Rappahannock County,3823,3729,94,2.5
CN5115900000000,2023-05-01,51,159,VA,Richmond County,4122,4005,117,2.8
CN5116100000000,2023-05-01,51,161,VA,Roanoke County,52324,51061,1263,2.4
CN5116300000000,2023-05-01,51,163,VA,Rockbridge County,11195,10902,293,2.6
CN5116500000000,2023-05-01,51,165,VA,Rockingham County,43816,42731,1085,2.5
CN5116700000000,2023-05-01,51,167,VA,Russell County,11073,10698,375,3.4
CN5116900000000,2023-05-01,51,169,VA,Scott County,9617,9323,294,3.1
CN5117100000000,2023-05-01,51,171,VA,Shenandoah County,22430,21851,579,2.6
CN5117300000000,2023-05-01,51,173,VA,Smyth County,13590,13182,408,3
CN5117500000000,2023-05-01,51,175,VA,Southampton County,8922,8697,225,2.5
CN5117700000000,2023-05-01,51,177,VA,Spotsylvania County,72362,70326,2036,2.8
CN5117900000000,2023-05-01,51,179,VA,Stafford County,78932,76793,2139,2.7
CN5118100000000,2023-05-01,51,181,VA,Surry County,3809,3718,91,2.4
CN5118300000000,2023-05-01,51,183,VA,Sussex County,3700,3570,130,3.5
CN5118500000000,2023-05-01,51,185,VA,Tazewell County,15664,15093,571,3.6
CN5118700000000,2023-05-01,51,187,VA,Warren County,21595,21020,575,2.7
CN5119100000000,2023-05-01,51,191,VA,Washington County,27615,26863,752,2.7
CN5119300000000,2023-05-01,51,193,VA,Westmoreland County,9725,9448,277,2.8
CN5119500000000,2023-05-01,51,195,VA,Wise County,13000,12493,507,3.9
CN5119700000000,2023-05-01,51,197,VA,Wythe County,14360,13975,385,2.7
CN5119900000000,2023-05-01,51,199,VA,York County,34569,33657,912,2.6
CN5151000000000,2023-05-01,51,510,VA,Alexandria city,105139,102908,2231,2.1
CN5152000000000,2023-05-01,51,520,VA,Bristol city,7973,7711,262,3.3
CN5153000000000,2023-05-01,51,530,VA,Buena Vista city,3135,3047,88,2.8
CN5154000000000,2023-05-01,51,540,VA,Charlottesville city,26903,26286,617,2.3
CN5155000000000,2023-05-01,51,550,VA,Chesapeake city,128916,125420,3496,2.7
CN5157000000000,2023-05-01,51,570,VA,Colonial Heights city,8939,8683,256,2.9
CN5158000000000,2023-05-01,51,580,VA,Covington city,2322,2242,80,3.4
CN5159000000000,2023-05-01,51,590,VA,Danville city,18642,17857,785,4.2
CN5159500000000,2023-05-01,51,595,VA,Emporia city,2353,2250,103,4.4
CN5160000000000,2023-05-01,51,600,VA,Fairfax city,13486,13177,309,2.3
CN5161000000000,2023-05-01,51,610,VA,Falls Church city,8961,8761,200,2.2
CN5162000000000,2023-05-01,51,620,VA,Franklin city,3528,3398,130,3.7
CN5163000000000,2023-05-01,51,630,VA,Fredericksburg city,15023,14532,491,3.3
CN5164000000000,2023-05-01,51,640,VA,Galax city,2938,2847,91,3.1
CN5165000000000,2023-05-01,51,650,VA,Hampton city,66933,64616,2317,3.5
CN5166000000000,2023-05-01,51,660,VA,Harrisonburg city,25767,24862,905,3.5
CN5167000000000,2023-05-01,51,670,VA,Hopewell city,10065,9680,385,3.8
CN5167800000000,2023-05-01,51,678,VA,Lexington city,2388,2285,103,4.3
CN5168000000000,2023-05-01,51,680,VA,Lynchburg city,37117,35637,1480,4
CN5168300000000,2023-05-01,51,683,VA,Manassas city,22697,22150,547,2.4
CN5168500000000,2023-05-01,51,685,VA,Manassas Park city,10227,9985,242,2.4
CN5169000000000,2023-05-01,51,690,VA,Martinsville city,5613,5381,232,4.1
CN5170000000000,2023-05-01,51,700,VA,Newport News city,91772,88942,2830,3.1
CN5171000000000,2023-05-01,51,710,VA,Norfolk city,114493,110953,3540,3.1
CN5172000000000,2023-05-01,51,720,VA,Norton city,1616,1552,64,4
CN5173000000000,2023-05-01,51,730,VA,Petersburg city,13103,12518,585,4.5
CN5173500000000,2023-05-01,51,735,VA,Poquoson city,6590,6432,158,2.4
CN5174000000000,2023-05-01,51,740,VA,Portsmouth city,45787,44255,1532,3.3
CN5175000000000,2023-05-01,51,750,VA,Radford city,9235,8896,339,3.7
CN5176000000000,2023-05-01,51,760,VA,Richmond city,126639,122627,4012,3.2
CN5177000000000,2023-05-01,51,770,VA,Roanoke city,51411,49944,1467,2.9
CN5177500000000,2023-05-01,51,775,VA,Salem city,13564,13180,384,2.8
CN5179000000000,2023-05-01,51,790,VA,Staunton city,12942,12602,340,2.6
CN5180000000000,2023-05-01,51,800,VA,Suffolk city,47411,46045,1366,2.9
CN5181000000000,2023-05-01,51,810,VA,Virginia Beach city,241487,235192,6295,2.6
CN5182000000000,2023-05-01,51,820,VA,Waynesboro city,11261,10945,316,2.8
CN5183000000000,2023-05-01,51,830,VA,Williamsburg city,7112,6825,287,4
CN5184000000000,2023-05-01,51,840,VA,Winchester city,15577,15153,424,2.7
CN5300100000000,2023-05-01,53,001,WA,Adams County,9596,9309,287,3
CN5300300000000,2023-05-01,53,003,WA,Asotin County,10499,10244,255,2.4
CN5300500000000,2023-05-01,53,005,WA,Benton County,107715,104129,3586,3.3
CN5300700000000,2023-05-01,53,007,WA,Chelan County,44294,42904,1390,3.1
CN5300900000000,2023-05-01,53,009,WA,Clallam County,28619,27532,1087,3.8
CN5301100000000,2023-05-01,53,011,WA,Clark County,249695,241651,8044,3.2
CN5301300000000,2023-05-01,53,013,WA,Columbia County,1751,1696,55,3.1
CN5301500000000,2023-05-01,53,015,WA,Cowlitz County,49044,47192,1852,3.8
CN5301700000000,2023-05-01,53,017,WA,Douglas County,21691,20965,726,3.3
CN5301900000000,2023-05-01,53,019,WA,Ferry County,2204,2072,132,6
CN5302100000000,2023-05-01,53,021,WA,Franklin County,44085,42274,1811,4.1
CN5302300000000,2023-05-01,53,023,WA,Garfield County,782,752,30,3.8
CN5302500000000,2023-05-01,53,025,WA,Grant County,47768,45976,1792,3.8
CN5302700000000,2023-05-01,53,027,WA,Grays Harbor County,28640,27265,1375,4.8
CN5302900000000,2023-05-01,53,029,WA,Island County,36551,35400,1151,3.1
CN5303100000000,2023-05-01,53,031,WA,Jefferson County,12233,11787,446,3.6
CN5303300000000,2023-05-01,53,033,WA,King County,1364896,1321357,43539,3.2
CN5303500000000,2023-05-01,53,035,WA,Kitsap County,129375,125520,3855,3
CN5303700000000,2023-05-01,53,037,WA,Kittitas County,22511,21658,853,3.8
CN5303900000000,2023-05-01,53,039,WA,Klickitat County,9876,9521,355,3.6
CN5304100000000,2023-05-01,53,041,WA,Lewis County,34563,33156,1407,4.1
CN5304300000000,2023-05-01,53,043,WA,Lincoln County,4669,4513,156,3.3
CN5304500000000,2023-05-01,53,045,WA,Mason County,25214,24183,1031,4.1
CN5304700000000,2023-05-01,53,047,WA,Okanogan County,19185,18451,734,3.8
CN5304900000000,2023-05-01,53,049,WA,Pacific County,8545,8174,371,4.3
CN5305100000000,2023-05-01,53,051,WA,Pend Oreille County,5127,4905,222,4.3
CN5305300000000,2023-05-01,53,053,WA,Pierce County,453877,437976,15901,3.5
CN5305500000000,2023-05-01,53,055,WA,San Juan County,8792,8578,214,2.4
CN5305700000000,2023-05-01,53,057,WA,Skagit County,61606,59559,2047,3.3
CN5305900000000,2023-05-01,53,059,WA,Skamania County,5558,5368,190,3.4
CN5306100000000,2023-05-01,53,061,WA,Snohomish County,464264,449186,15078,3.2
CN5306300000000,2023-05-01,53,063,WA,Spokane County,265067,257213,7854,3
CN5306500000000,2023-05-01,53,065,WA,Stevens County,19112,18304,808,4.2
CN5306700000000,2023-05-01,53,067,WA,Thurston County,150700,146134,4566,3
CN5306900000000,2023-05-01,53,069,WA,Wahkiakum County,1355,1300,55,4.1
CN5307100000000,2023-05-01,53,071,WA,Walla Walla County,30812,29919,893,2.9
CN5307300000000,2023-05-01,53,073,WA,Whatcom County,114796,111157,3639,3.2
CN5307500000000,2023-05-01,53,075,WA,Whitman County,23454,22747,707,3
CN5307700000000,2023-05-01,53,077,WA,Yakima County,130378,124848,5530,4.2
CN5400100000000,2023-05-01,54,001,WV,Barbour County,7398,7107,291,3.9
CN5400300000000,2023-05-01,54,003,WV,Berkeley County,59554,57750,1804,3
CN5400500000000,2023-05-01,54,005,WV,Boone County,7030,6762,268,3.8
CN5400700000000,2023-05-01,54,007,WV,Braxton County,4895,4675,220,4.5
CN5400900000000,2023-05-01,54,009,WV,Brooke County,9913,9495,418,4.2
CN5401100000000,2023-05-01,54,011,WV,Cabell County,42082,40701,1381,3.3
CN5401300000000,2023-05-01,54,013,WV,Calhoun County,2471,2336,135,5.5
CN5401500000000,2023-05-01,54,015,WV,Clay County,2926,2778,148,5.1
CN5401700000000,2023-05-01,54,017,WV,Doddridge County,3846,3750,96,2.5
CN5401900000000,2023-05-01,54,019,WV,Fayette County,15898,15310,588,3.7
CN5402100000000,2023-05-01,54,021,WV,Gilmer County,2346,2237,109,4.6
CN5402300000000,2023-05-01,54,023,WV,Grant County,6004,5817,187,3.1
CN5402500000000,2023-05-01,54,025,WV,Greenbrier County,14590,14108,482,3.3
CN5402700000000,2023-05-01,54,027,WV,Hampshire County,11188,10914,274,2.4
CN5402900000000,2023-05-01,54,029,WV,Hancock County,13087,12532,555,4.2
CN5403100000000,2023-05-01,54,031,WV,Hardy County,5616,5409,207,3.7
CN5403300000000,2023-05-01,54,033,WV,Harrison County,33483,32524,959,2.9
CN5403500000000,2023-05-01,54,035,WV,Jackson County,11663,11220,443,3.8
CN5403700000000,2023-05-01,54,037,WV,Jefferson County,30970,30223,747,2.4
CN5403900000000,2023-05-01,54,039,WV,Kanawha County,79556,76927,2629,3.3
CN5404100000000,2023-05-01,54,041,WV,Lewis County,6381,6135,246,3.9
CN5404300000000,2023-05-01,54,043,WV,Lincoln County,7119,6820,299,4.2
CN5404500000000,2023-05-01,54,045,WV,Logan County,10984,10578,406,3.7
CN5404700000000,2023-05-01,54,047,WV,McDowell County,4150,3934,216,5.2
CN5404900000000,2023-05-01,54,049,WV,Marion County,25299,24397,902,3.6
CN5405100000000,2023-05-01,54,051,WV,Marshall County,13006,12456,550,4.2
CN5405300000000,2023-05-01,54,053,WV,Mason County,10476,10113,363,3.5
CN5405500000000,2023-05-01,54,055,WV,Mercer County,20830,19993,837,4
CN5405700000000,2023-05-01,54,057,WV,Mineral County,12736,12316,420,3.3
CN5405900000000,2023-05-01,54,059,WV,Mingo County,6514,6236,278,4.3
CN5406100000000,2023-05-01,54,061,WV,Monongalia County,55755,54192,1563,2.8
CN5406300000000,2023-05-01,54,063,WV,Monroe County,5981,5825,156,2.6
CN5406500000000,2023-05-01,54,065,WV,Morgan County,8378,8143,235,2.8
CN5406700000000,2023-05-01,54,067,WV,Nicholas County,8820,8473,347,3.9
CN5406900000000,2023-05-01,54,069,WV,Ohio County,19855,19186,669,3.4
CN5407100000000,2023-05-01,54,071,WV,Pendleton County,3738,3657,81,2.2
CN5407300000000,2023-05-01,54,073,WV,Pleasants County,2634,2506,128,4.9
CN5407500000000,2023-05-01,54,075,WV,Pocahontas County,3696,3496,200,5.4
CN5407700000000,2023-05-01,54,077,WV,Preston County,15431,14911,520,3.4
CN5407900000000,2023-05-01,54,079,WV,Putnam County,27318,26541,777,2.8
CN5408100000000,2023-05-01,54,081,WV,Raleigh County,30176,29190,986,3.3
CN5408300000000,2023-05-01,54,083,WV,Randolph County,11710,11204,506,4.3
CN5408500000000,2023-05-01,54,085,WV,Ritchie County,4191,4055,136,3.2
CN5408700000000,2023-05-01,54,087,WV,Roane County,4743,4500,243,5.1
CN5408900000000,2023-05-01,54,089,WV,Summers County,4760,4600,160,3.4
CN5409100000000,2023-05-01,54,091,WV,Taylor County,7906,7655,251,3.2
CN5409300000000,2023-05-01,54,093,WV,Tucker County,3506,3394,112,3.2
CN5409500000000,2023-05-01,54,095,WV,Tyler County,2909,2758,151,5.2
CN5409700000000,2023-05-01,54,097,WV,Upshur County,9621,9254,367,3.8
CN5409900000000,2023-05-01,54,099,WV,Wayne County,15782,15235,547,3.5
CN5410100000000,2023-05-01,54,101,WV,Webster County,2950,2823,127,4.3
CN5410300000000,2023-05-01,54,103,WV,Wetzel County,6450,6128,322,5
CN5410500000000,2023-05-01,54,105,WV,Wirt County,2232,2124,108,4.8
CN5410700000000,2023-05-01,54,107,WV,Wood County,36552,35254,1298,3.6
CN5410900000000,2023-05-01,54,109,WV,Wyoming County,7375,7115,260,3.5
CN5500100000000,2023-05-01,55,001,WI,Adams County,7848,7526,322,4.1
CN5500300000000,2023-05-01,55,003,WI,Ashland County,7543,7286,257,3.4
CN5500500000000,2023-05-01,55,005,WI,Barron County,24222,23523,699,2.9
CN5500700000000,2023-05-01,55,007,WI,Bayfield County,7394,7131,263,3.6
CN5500900000000,2023-05-01,55,009,WI,Brown County,143321,139954,3367,2.3
CN5501100000000,2023-05-01,55,011,WI,Buffalo County,6275,6069,206,3.3
CN5501300000000,2023-05-01,55,013,WI,Burnett County,7370,7089,281,3.8
CN5501500000000,2023-05-01,55,015,WI,Calumet County,27960,27369,591,2.1
CN5501700000000,2023-05-01,55,017,WI,Chippewa County,33784,32902,882,2.6
CN5501900000000,2023-05-01,55,019,WI,Clark County,17806,17433,373,2.1
CN5502100000000,2023-05-01,55,021,WI,Columbia County,32411,31663,748,2.3
CN5502300000000,2023-05-01,55,023,WI,Crawford County,6863,6643,220,3.2
CN5502500000000,2023-05-01,55,025,WI,Dane County,337061,330064,6997,2.1
CN5502700000000,2023-05-01,55,027,WI,Dodge County,47627,46473,1154,2.4
CN5502900000000,2023-05-01,55,029,WI,Door County,15507,15138,369,2.4
CN5503100000000,2023-05-01,55,031,WI,Douglas County,22881,21931,950,4.2
CN5503300000000,2023-05-01,55,033,WI,Dunn County,24125,23454,671,2.8
CN5503500000000,2023-05-01,55,035,WI,Eau Claire County,60250,58842,1408,2.3
CN5503700000000,2023-05-01,55,037,WI,Florence County,2125,2056,69,3.2
CN5503900000000,2023-05-01,55,039,WI,Fond du Lac County,56972,55698,1274,2.2
CN5504100000000,2023-05-01,55,041,WI,Forest County,3999,3830,169,4.2
CN5504300000000,2023-05-01,55,043,WI,Grant County,27682,27075,607,2.2
CN5504500000000,2023-05-01,55,045,WI,Green County,21245,20791,454,2.1
CN5504700000000,2023-05-01,55,047,WI,Green Lake County,9236,8965,271,2.9
CN5504900000000,2023-05-01,55,049,WI,Iowa County,13873,13575,298,2.1
CN5505100000000,2023-05-01,55,051,WI,Iron County,2518,2379,139,5.5
CN5505300000000,2023-05-01,55,053,WI,Jackson County,9441,9178,263,2.8
CN5505500000000,2023-05-01,55,055,WI,Jefferson County,46133,45057,1076,2.3
CN5505700000000,2023-05-01,55,057,WI,Juneau County,13445,13070,375,2.8
CN5505900000000,2023-05-01,55,059,WI,Kenosha County,91342,88501,2841,3.1
CN5506100000000,2023-05-01,55,061,WI,Kewaunee County,10992,10758,234,2.1
CN5506300000000,2023-05-01,55,063,WI,La Crosse County,67238,65803,1435,2.1
CN5506500000000,2023-05-01,55,065,WI,Lafayette County,10515,10309,206,2
CN5506700000000,2023-05-01,55,067,WI,Langlade County,9209,8952,257,2.8
CN5506900000000,2023-05-01,55,069,WI,Lincoln County,14825,14424,401,2.7
CN5507100000000,2023-05-01,55,071,WI,Manitowoc County,40622,39524,1098,2.7
CN5507300000000,2023-05-01,55,073,WI,Marathon County,73443,71670,1773,2.4
CN5507500000000,2023-05-01,55,075,WI,Marinette County,19163,18482,681,3.6
CN5507700000000,2023-05-01,55,077,WI,Marquette County,7744,7514,230,3
CN5507800000000,2023-05-01,55,078,WI,Menominee County,1521,1437,84,5.5
CN5507900000000,2023-05-01,55,079,WI,Milwaukee County,460277,443940,16337,3.5
CN5508100000000,2023-05-01,55,081,WI,Monroe County,23465,22925,540,2.3
CN5508300000000,2023-05-01,55,083,WI,Oconto County,20932,20357,575,2.7
CN5508500000000,2023-05-01,55,085,WI,Oneida County,18201,17696,505,2.8
CN5508700000000,2023-05-01,55,087,WI,Outagamie County,105481,103154,2327,2.2
CN5508900000000,2023-05-01,55,089,WI,Ozaukee County,49074,47886,1188,2.4
CN5509100000000,2023-05-01,55,091,WI,Pepin County,4161,4065,96,2.3
CN5509300000000,2023-05-01,55,093,WI,Pierce County,24940,24282,658,2.6
CN5509500000000,2023-05-01,55,095,WI,Polk County,24949,24179,770,3.1
CN5509700000000,2023-05-01,55,097,WI,Portage County,38040,37072,968,2.5
CN5509900000000,2023-05-01,55,099,WI,Price County,6364,6170,194,3
CN5510100000000,2023-05-01,55,101,WI,Racine County,98930,95718,3212,3.2
CN5510300000000,2023-05-01,55,103,WI,Richland County,8866,8638,228,2.6
CN5510500000000,2023-05-01,55,105,WI,Rock County,86615,83809,2806,3.2
CN5510700000000,2023-05-01,55,107,WI,Rusk County,6531,6341,190,2.9
CN5510900000000,2023-05-01,55,109,WI,St. Croix County,50809,49366,1443,2.8
CN5511100000000,2023-05-01,55,111,WI,Sauk County,34777,33982,795,2.3
CN5511300000000,2023-05-01,55,113,WI,Sawyer County,8219,7952,267,3.2
CN5511500000000,2023-05-01,55,115,WI,Shawano County,20617,20091,526,2.6
CN5511700000000,2023-05-01,55,117,WI,Sheboygan County,61796,60382,1414,2.3
CN5511900000000,2023-05-01,55,119,WI,Taylor County,10630,10332,298,2.8
CN5512100000000,2023-05-01,55,121,WI,Trempealeau County,14952,14551,401,2.7
CN5512300000000,2023-05-01,55,123,WI,Vernon County,15549,15209,340,2.2
CN5512500000000,2023-05-01,55,125,WI,Vilas County,10417,10068,349,3.4
CN5512700000000,2023-05-01,55,127,WI,Walworth County,58907,57454,1453,2.5
CN5512900000000,2023-05-01,55,129,WI,Washburn County,7871,7631,240,3
CN5513100000000,2023-05-01,55,131,WI,Washington County,76604,74847,1757,2.3
CN5513300000000,2023-05-01,55,133,WI,Waukesha County,224062,218598,5464,2.4
CN5513500000000,2023-05-01,55,135,WI,Waupaca County,25312,24656,656,2.6
CN5513700000000,2023-05-01,55,137,WI,Waushara County,11180,10854,326,2.9
CN5513900000000,2023-05-01,55,139,WI,Winnebago County,93393,91180,2213,2.4
CN5514100000000,2023-05-01,55,141,WI,Wood County,33799,32749,1050,3.1
CN5600100000000,2023-05-01,56,001,WY,Albany County,22083,21559,524,2.4
CN5600300000000,2023-05-01,56,003,WY,Big Horn County,5260,5107,153,2.9
CN5600500000000,2023-05-01,56,005,WY,Campbell County,23062,22473,589,2.6
CN5600700000000,2023-05-01,56,007,WY,Carbon County,7417,7215,202,2.7
CN5600900000000,2023-05-01,56,009,WY,Converse County,7860,7685,175,2.2
CN5601100000000,2023-05-01,56,011,WY,Crook County,4172,4082,90,2.2
CN5601300000000,2023-05-01,56,013,WY,Fremont County,19262,18666,596,3.1
CN5601500000000,2023-05-01,56,015,WY,Goshen County,6749,6590,159,2.4
CN5601700000000,2023-05-01,56,017,WY,Hot Springs County,2314,2254,60,2.6
CN5601900000000,2023-05-01,56,019,WY,Johnson County,4408,4289,119,2.7
CN5602100000000,2023-05-01,56,021,WY,Laramie County,49532,48149,1383,2.8
CN5602300000000,2023-05-01,56,023,WY,Lincoln County,9638,9370,268,2.8
CN5602500000000,2023-05-01,56,025,WY,Natrona County,39505,38360,1145,2.9
CN5602700000000,2023-05-01,56,027,WY,Niobrara County,1259,1233,26,2.1
CN5602900000000,2023-05-01,56,029,WY,Park County,16334,15926,408,2.5
CN5603100000000,2023-05-01,56,031,WY,Platte County,4617,4500,117,2.5
CN5603300000000,2023-05-01,56,033,WY,Sheridan County,16473,16056,417,2.5
CN5603500000000,2023-05-01,56,035,WY,Sublette County,4010,3891,119,3
CN5603700000000,2023-05-01,56,037,WY,Sweetwater County,19714,19087,627,3.2
CN5603900000000,2023-05-01,56,039,WY,Teton County,16338,15877,461,2.8
CN5604100000000,2023-05-01,56,041,WY,Uinta County,9246,8971,275,3
CN5604300000000,2023-05-01,56,043,WY,Washakie County,3917,3796,121,3.1
CN5604500000000,2023-05-01,56,045,WY,Weston County,3900,3827,73,1.9
CN7200100000000,2023-05-01,72,001,PR,Adjuntas Municipio,4325,3959,366,8.5
CN7200300000000,2023-05-01,72,003,PR,Aguada Municipio,13282,12312,970,7.3
CN7200500000000,2023-05-01,72,005,PR,Aguadilla Municipio,16180,14847,1333,8.2
CN7200700000000,2023-05-01,72,007,PR,Aguas Buenas Municipio,6898,6486,412,6
CN7200900000000,2023-05-01,72,009,PR,Aibonito Municipio,6711,6200,511,7.6
CN7201100000000,2023-05-01,72,011,PR,Anasco Municipio,10004,9353,651,6.5
CN7201300000000,2023-05-01,72,013,PR,Arecibo Municipio,25554,23705,1849,7.2
CN7201500000000,2023-05-01,72,015,PR,Arroyo Municipio,4975,4464,511,10.3
CN7201700000000,2023-05-01,72,017,PR,Barceloneta Municipio,6336,5796,540,8.5
CN7201900000000,2023-05-01,72,019,PR,Barranquitas Municipio,7771,7172,599,7.7
CN7202100000000,2023-05-01,72,021,PR,Bayamon Municipio,68948,65673,3275,4.7
CN7202300000000,2023-05-01,72,023,PR,Cabo Rojo Municipio,14991,14004,987,6.6
CN7202500000000,2023-05-01,72,025,PR,Caguas Municipio,50899,48476,2423,4.8
CN7202700000000,2023-05-01,72,027,PR,Camuy Municipio,10212,9561,651,6.4
CN7202900000000,2023-05-01,72,029,PR,Canovanas Municipio,17296,16550,746,4.3
CN7203100000000,2023-05-01,72,031,PR,Carolina Municipio,65103,62245,2858,4.4
CN7203300000000,2023-05-01,72,033,PR,Catano Municipio,8211,7830,381,4.6
CN7203500000000,2023-05-01,72,035,PR,Cayey Municipio,17239,16363,876,5.1
CN7203700000000,2023-05-01,72,037,PR,Ceiba Municipio,3818,3555,263,6.9
CN7203900000000,2023-05-01,72,039,PR,Ciales Municipio,3881,3550,331,8.5
CN7204100000000,2023-05-01,72,041,PR,Cidra Municipio,16479,15691,788,4.8
CN7204300000000,2023-05-01,72,043,PR,Coamo Municipio,11013,10070,943,8.6
CN7204500000000,2023-05-01,72,045,PR,Comerio Municipio,5242,4854,388,7.4
CN7204700000000,2023-05-01,72,047,PR,Corozal Municipio,9332,8676,656,7
CN7204900000000,2023-05-01,72,049,PR,Culebra Municipio,974,954,20,2.1
CN7205100000000,2023-05-01,72,051,PR,Dorado Municipio,14446,13744,702,4.9
CN7205300000000,2023-05-01,72,053,PR,Fajardo Municipio,11275,10467,808,7.2
CN7205400000000,2023-05-01,72,054,PR,Florida Municipio,3520,3203,317,9
CN7205500000000,2023-05-01,72,055,PR,Guanica Municipio,4016,3552,464,11.6
CN7205700000000,2023-05-01,72,057,PR,Guayama Municipio,11499,10674,825,7.2
CN7205900000000,2023-05-01,72,059,PR,Guayanilla Municipio,5407,4798,609,11.3
CN7206100000000,2023-05-01,72,061,PR,Guaynabo Municipio,40413,39232,1181,2.9
CN7206300000000,2023-05-01,72,063,PR,Gurabo Municipio,20045,19240,805,4
CN7206500000000,2023-05-01,72,065,PR,Hatillo Municipio,14542,13297,1245,8.6
CN7206700000000,2023-05-01,72,067,PR,Hormigueros Municipio,5947,5665,282,4.7
CN7206900000000,2023-05-01,72,069,PR,Humacao Municipio,18671,17301,1370,7.3
CN7207100000000,2023-05-01,72,071,PR,Isabela Municipio,13243,12288,955,7.2
CN7207300000000,2023-05-01,72,073,PR,Jayuya Municipio,4775,4230,545,11.4
CN7207500000000,2023-05-01,72,075,PR,Juana Diaz Municipio,16757,15463,1294,7.7
CN7207700000000,2023-05-01,72,077,PR,Juncos Municipio,13304,12423,881,6.6
CN7207900000000,2023-05-01,72,079,PR,Lajas Municipio,5531,5020,511,9.2
CN7208100000000,2023-05-01,72,081,PR,Lares Municipio,7443,6648,795,10.7
CN7208300000000,2023-05-01,72,083,PR,Las Marias Municipio,2514,2246,268,10.7
CN7208500000000,2023-05-01,72,085,PR,Las Piedras Municipio,12219,11431,788,6.4
CN7208700000000,2023-05-01,72,087,PR,Loiza Municipio,8787,8325,462,5.3
CN7208900000000,2023-05-01,72,089,PR,Luquillo Municipio,6567,6125,442,6.7
CN7209100000000,2023-05-01,72,091,PR,Manati Municipio,11940,11189,751,6.3
CN7209300000000,2023-05-01,72,093,PR,Maricao Municipio,2112,1896,216,10.2
CN7209500000000,2023-05-01,72,095,PR,Maunabo Municipio,3178,2692,486,15.3
CN7209700000000,2023-05-01,72,097,PR,Mayaguez Municipio,24055,22334,1721,7.2
CN7209900000000,2023-05-01,72,099,PR,Moca Municipio,11723,10739,984,8.4
CN7210100000000,2023-05-01,72,101,PR,Morovis Municipio,8614,7986,628,7.3
CN7210300000000,2023-05-01,72,103,PR,Naguabo Municipio,8770,8245,525,6
CN7210500000000,2023-05-01,72,105,PR,Naranjito Municipio,7483,7002,481,6.4
CN7210700000000,2023-05-01,72,107,PR,Orocovis Municipio,5170,4713,457,8.8
CN7210900000000,2023-05-01,72,109,PR,Patillas Municipio,4423,3944,479,10.8
CN7211100000000,2023-05-01,72,111,PR,Penuelas Municipio,6098,5482,616,10.1
CN7211300000000,2023-05-01,72,113,PR,Ponce Municipio,48285,44752,3533,7.3
CN7211500000000,2023-05-01,72,115,PR,Quebradillas Municipio,6446,5962,484,7.5
CN7211700000000,2023-05-01,72,117,PR,Rincon Municipio,5284,4768,516,9.8
CN7211900000000,2023-05-01,72,119,PR,Rio Grande Municipio,17959,17107,852,4.7
CN7212100000000,2023-05-01,72,121,PR,Sabana Grande Municipio,6368,5825,543,8.5
CN7212300000000,2023-05-01,72,123,PR,Salinas Municipio,7320,6642,678,9.3
CN7212500000000,2023-05-01,72,125,PR,San German Municipio,10395,9565,830,8
CN7212700000000,2023-05-01,72,127,PR,San Juan Municipio,142254,136050,6204,4.4
CN7212900000000,2023-05-01,72,129,PR,San Lorenzo Municipio,12290,11566,724,5.9
CN7213100000000,2023-05-01,72,131,PR,San Sebastian Municipio,11023,9940,1083,9.8
CN7213300000000,2023-05-01,72,133,PR,Santa Isabel Municipio,8085,7341,744,9.2
CN7213500000000,2023-05-01,72,135,PR,Toa Alta Municipio,29715,28419,1296,4.4
CN7213700000000,2023-05-01,72,137,PR,Toa Baja Municipio,30832,29494,1338,4.3
CN7213900000000,2023-05-01,72,139,PR,Trujillo Alto Municipio,28712,27875,837,2.9
CN7214100000000,2023-05-01,72,141,PR,Utuado Municipio,7307,6681,626,8.6
CN7214300000000,2023-05-01,72,143,PR,Vega Alta Municipio,10368,9749,619,6
CN7214500000000,2023-05-01,72,145,PR,Vega Baja Municipio,14019,12872,1147,8.2
CN7214700000000,2023-05-01,72,147,PR,Vieques Municipio,2646,2550,96,3.6
CN7214900000000,2023-05-01,72,149,PR,Villalba Municipio,7712,6848,864,11.2
CN7215100000000,2023-05-01,72,151,PR,Yabucoa Municipio,9135,8330,805,8.8
CN7215300000000,2023-05-01,72,153,PR,Yauco Municipio,10301,9071,1230,11.9
